SubmitTime,StartTime,EndTime,QueuedTime,RunTime,NodesRequested,walltime,bslowdown
35,41,2862,6,2821,2,18000,1.00212690535
85,91,2783,6,2692,2,18000,1.00222882615
114,120,2967,6,2847,2,18000,1.00210748156
193,199,3002,6,2803,2,18000,1.00214056368
300,306,3080,6,2774,2,18000,1.0021629416
505,511,3264,6,2753,2,18000,1.00217944061
561,567,3399,6,2832,2,18000,1.00211864407
631,637,651,6,14,2,108000,1.42857142857
745,751,3521,6,2770,2,18000,1.00216606498
813,820,3610,7,2790,2,18000,1.00250896057
903,909,3604,6,2695,2,18000,1.00222634508
919,925,3705,6,2780,2,18000,1.00215827338
1091,1098,3833,7,2735,2,18000,1.00255941499
1120,1126,3867,6,2741,2,18000,1.00218898212
1142,1148,3828,6,2680,2,18000,1.00223880597
1157,1163,3977,6,2814,2,18000,1.00213219616
1179,1185,4039,6,2854,2,18000,1.00210231254
1210,1216,4012,6,2796,2,18000,1.00214592275
1226,1232,4011,6,2779,2,18000,1.00215905002
1242,1248,3987,6,2739,2,18000,1.0021905805
1243,1254,3922,11,2668,2,18000,1.00412293853
1269,1275,4059,6,2784,2,18000,1.00215517241
1436,1443,4215,7,2772,2,18000,1.00252525253
1465,1471,4245,6,2774,2,18000,1.0021629416
1545,1551,4357,6,2806,2,18000,1.00213827512
1561,1567,4371,6,2804,2,18000,1.00213980029
1608,1615,1678,7,63,4,3540,1.11111111111
1620,1626,4477,6,2851,2,18000,1.00210452473
1643,1649,4432,6,2783,2,18000,1.00215594682
1644,1655,4448,11,2793,2,18000,1.00393841747
1710,1716,4397,6,2681,2,18000,1.00223797091
1711,1722,4446,11,2724,2,18000,1.00403817915
1901,1907,4728,6,2821,2,18000,1.00212690535
1938,1945,4699,7,2754,2,18000,1.00254175744
2053,2059,4839,6,2780,2,18000,1.00215827338
2085,2091,4932,6,2841,2,18000,1.00211193242
2125,2131,4968,6,2837,2,18000,1.00211491012
2429,2435,5047,6,2612,2,18000,1.00229709035
2686,2692,5485,6,2793,2,18000,1.00214822771
2787,2793,5590,6,2797,2,18000,1.00214515552
2864,2871,5514,7,2643,2,18000,1.00264850549
2970,2976,5718,6,2742,2,18000,1.00218818381
3004,3010,5905,6,2895,2,18000,1.00207253886
3082,3088,5877,6,2789,2,18000,1.00215130871
3266,3272,5929,6,2657,2,18000,1.00225818592
3401,3407,6211,6,2804,2,18000,1.00213980029
3525,3531,6296,6,2765,2,18000,1.00216998192
3605,3612,6364,7,2752,2,18000,1.00254360465
3621,3627,6310,6,2683,2,18000,1.00223630265
3708,3715,6361,7,2646,2,18000,1.00264550265
3824,3831,6605,7,2774,2,18000,1.00252343187
3840,3847,6635,7,2788,2,18000,1.0025107604
3869,3875,6525,6,2650,2,18000,1.00226415094
3925,3931,6718,6,2787,2,18000,1.00215285253
3981,3987,6696,6,2709,2,18000,1.00221483942
3997,4003,6880,6,2877,2,18000,1.00208550574
4013,4019,6705,6,2686,2,18000,1.00223380491
4015,4025,6894,10,2869,2,18000,1.00348553503
4043,4049,6820,6,2771,2,18000,1.00216528329
4062,4068,6847,6,2779,2,18000,1.00215905002
4217,4223,6852,6,2629,2,18000,1.00228223659
4248,4254,6998,6,2744,2,18000,1.00218658892
4361,4367,7044,6,2677,2,18000,1.0022413149
4376,4382,7205,6,2823,2,18000,1.00212539851
4402,4408,7233,6,2825,2,18000,1.00212389381
4436,4442,7060,6,2618,2,18000,1.00229182582
4453,4458,7222,5,2764,2,18000,1.0018089725
4454,4464,7262,10,2798,2,18000,1.00357398142
4479,4485,7196,6,2711,2,18000,1.00221320546
4702,4708,7524,6,2816,2,18000,1.00213068182
4730,4736,7530,6,2794,2,18000,1.00214745884
4842,4848,7576,6,2728,2,18000,1.00219941349
4933,4939,7780,6,2841,2,18000,1.00211193242
4971,4977,7778,6,2801,2,18000,1.00214209211
5049,5055,7848,6,2793,2,18000,1.00214822771
5487,5493,8215,6,2722,2,18000,1.00220426157
5515,5521,8220,6,2699,2,18000,1.00222304557
5594,5600,8361,6,2761,2,18000,1.00217312568
5721,5727,8534,6,2807,2,18000,1.00213751336
5878,5885,8661,7,2776,2,18000,1.00252161383
5907,5913,8785,6,2872,2,18000,1.00208913649
5932,5938,8815,6,2877,2,18000,1.00208550574
6212,6218,9103,6,2885,2,18000,1.0020797227
6299,6305,9188,6,2883,2,18000,1.00208116545
6314,6320,9125,6,2805,2,18000,1.00213903743
6365,6371,9095,6,2724,2,18000,1.00220264317
6366,6377,9306,11,2929,2,18000,1.00375554797
6527,6533,9325,6,2792,2,18000,1.00214899713
6607,6614,9247,7,2633,2,18000,1.00265856438
6639,6645,9349,6,2704,2,18000,1.00221893491
6698,6704,9409,6,2705,2,18000,1.0022181146
6714,6720,9457,6,2737,2,18000,1.00219218122
6729,6735,9502,6,2767,2,18000,1.00216841344
6822,6828,9493,6,2665,2,18000,1.00225140713
6850,6857,9625,7,2768,2,18000,1.00252890173
6866,6872,9550,6,2678,2,18000,1.00224047797
6882,6888,9584,6,2696,2,18000,1.00222551929
6897,6903,9602,6,2699,2,18000,1.00222304557
6999,7006,9674,7,2668,2,18000,1.00262368816
7043,7049,9805,6,2756,2,18000,1.00217706821
7062,7068,9647,6,2579,2,18000,1.00232648313
7199,7205,9898,6,2693,2,18000,1.00222799851
7215,7222,10025,7,2803,2,18000,1.0024973243
7231,7237,10087,6,2850,2,18000,1.00210526316
7247,7253,9971,6,2718,2,18000,1.00220750552
7263,7269,10081,6,2812,2,18000,1.00213371266
7526,7532,10218,6,2686,2,18000,1.00223380491
7542,7548,10222,6,2674,2,18000,1.00224382947
7579,7585,10381,6,2796,2,18000,1.00214592275
7780,7786,10652,6,2866,2,18000,1.00209351012
7782,7792,10593,10,2801,2,18000,1.00357015352
7850,7856,10545,6,2689,2,18000,1.00223131276
8219,8225,11032,6,2807,2,18000,1.00213751336
8234,8241,10932,7,2691,2,18000,1.00260126347
8362,8368,11000,6,2632,2,18000,1.00227963526
8536,8542,11343,6,2801,2,18000,1.00214209211
8665,8672,11471,7,2799,2,18000,1.00250089318
8787,8793,11511,6,2718,2,18000,1.00220750552
8816,8823,11543,7,2720,2,18000,1.00257352941
9099,9105,11786,6,2681,2,18000,1.00223797091
9115,9121,11858,6,2737,2,18000,1.00219218122
9131,9137,11978,6,2841,2,18000,1.00211193242
9190,9196,11846,6,2650,2,18000,1.00226415094
9249,9255,12022,6,2767,2,18000,1.00216841344
9308,9314,12059,6,2745,2,18000,1.00218579235
9327,9333,12058,6,2725,2,18000,1.00220183486
9352,9359,12152,7,2793,2,18000,1.00250626566
9412,9418,12176,6,2758,2,18000,1.00217548949
9459,9465,12207,6,2742,2,18000,1.00218818381
9497,9503,12287,6,2784,2,18000,1.00215517241
9512,9519,12297,7,2778,2,18000,1.00251979842
9552,9559,12220,7,2661,2,18000,1.00263059
9587,9593,12470,6,2877,2,18000,1.00208550574
9604,9610,12227,6,2617,2,18000,1.00229270157
9629,9635,12433,6,2798,2,18000,1.00214438885
9648,9654,12439,6,2785,2,18000,1.00215439856
9676,9682,12524,6,2842,2,18000,1.0021111893
9807,9812,12498,5,2686,2,18000,1.0018615041
9900,9907,12621,7,2714,2,18000,1.00257921887
9975,9981,12837,6,2856,2,18000,1.00210084034
10026,10032,12838,6,2806,2,18000,1.00213827512
10082,10089,12807,7,2718,2,18000,1.00257542311
10098,10104,12925,6,2821,2,18000,1.00212690535
10220,10226,12947,6,2721,2,18000,1.00220507166
10236,10242,13062,6,2820,2,18000,1.00212765957
10382,10389,13092,7,2703,2,18000,1.00258971513
10548,10554,13285,6,2731,2,18000,1.00219699744
10596,10602,13151,6,2549,2,18000,1.00235386426
10655,10661,13274,6,2613,2,18000,1.00229621125
10934,10940,13824,6,2884,2,18000,1.00208044383
11003,11009,13805,6,2796,2,18000,1.00214592275
11034,11040,13872,6,2832,2,18000,1.00211864407
11346,11351,14100,5,2749,2,18000,1.00181884322
11473,11479,14370,6,2891,2,18000,1.00207540643
11516,11522,14232,6,2710,2,18000,1.00221402214
11545,11551,14420,6,2869,2,18000,1.00209132102
11788,11794,14527,6,2733,2,18000,1.00219538968
11848,11854,14691,6,2837,2,18000,1.00211491012
11864,11870,14396,6,2526,2,18000,1.00237529691
11981,11987,14818,6,2831,2,18000,1.00211939244
12024,12030,14817,6,2787,2,18000,1.00215285253
12060,12066,14779,6,2713,2,18000,1.0022115739
12061,12072,14665,11,2593,2,18000,1.00424219051
12154,12160,14900,6,2740,2,18000,1.00218978102
12180,12186,14923,6,2737,2,18000,1.00219218122
12209,12215,14963,6,2748,2,18000,1.00218340611
12227,12233,14997,6,2764,2,18000,1.002170767
12229,12239,15000,10,2761,2,18000,1.00362187613
12290,12296,15125,6,2829,2,18000,1.00212089077
12306,12312,15171,6,2859,2,18000,1.00209863589
12436,12442,15205,6,2763,2,18000,1.00217155266
12452,12458,15335,6,2877,2,18000,1.00208550574
12472,12478,15114,6,2636,2,18000,1.00227617602
12502,12508,15256,6,2748,2,18000,1.00218340611
12529,12534,15349,5,2815,2,18000,1.00177619893
12626,12632,15413,6,2781,2,18000,1.0021574973
12809,12815,15612,6,2797,2,18000,1.00214515552
12849,12855,15642,6,2787,2,18000,1.00215285253
12850,12861,15651,11,2790,2,18000,1.00394265233
12927,12933,15707,6,2774,2,18000,1.0021629416
12949,12956,15746,7,2790,2,18000,1.00250896057
13065,13071,15729,6,2658,2,18000,1.00225733634
13096,13102,15897,6,2795,2,18000,1.00214669052
13156,13162,15965,6,2803,2,18000,1.00214056368
13278,13284,16081,6,2797,2,18000,1.00214515552
13295,13301,16183,6,2882,2,18000,1.00208188758
13807,13813,16712,6,2899,2,18000,1.0020696792
13826,13832,16494,6,2662,2,18000,1.0022539444
13875,13882,16584,7,2702,2,18000,1.00259067358
14101,14107,16882,6,2775,2,18000,1.00216216216
14236,14242,17041,6,2799,2,18000,1.00214362272
14374,14380,17038,6,2658,2,18000,1.00225733634
14399,14405,17205,6,2800,2,18000,1.00214285714
14421,14428,17175,7,2747,2,18000,1.00254823444
14530,14536,17223,6,2687,2,18000,1.00223297358
14666,14673,17373,7,2700,2,18000,1.00259259259
14695,14701,17519,6,2818,2,18000,1.00212916962
14782,14788,17473,6,2685,2,18000,1.00223463687
14820,14826,17587,6,2761,2,18000,1.00217312568
14821,14832,17488,11,2656,2,18000,1.00414156627
14904,14910,17671,6,2761,2,18000,1.00217312568
14925,14932,17718,7,2786,2,18000,1.00251256281
14966,14972,17707,6,2735,2,18000,1.00219378428
15001,15007,17780,6,2773,2,18000,1.0021637216
15003,15013,17793,10,2780,2,18000,1.0035971223
15116,15122,17955,6,2833,2,18000,1.00211789622
15132,15138,17830,6,2692,2,18000,1.00222882615
15176,15182,17986,6,2804,2,18000,1.00213980029
15207,15213,18076,6,2863,2,18000,1.00209570381
15258,15264,17955,6,2691,2,18000,1.0022296544
15339,15345,18160,6,2815,2,18000,1.00213143872
15355,15362,18187,7,2825,2,18000,1.00247787611
15416,15423,18219,7,2796,2,18000,1.00250357654
15616,15622,18300,6,2678,2,18000,1.00224047797
15645,15651,18504,6,2853,2,18000,1.00210304942
15660,15667,18453,7,2786,2,18000,1.00251256281
15710,15716,18365,6,2649,2,18000,1.00226500566
15732,15738,18480,6,2742,2,18000,1.00218818381
15748,15755,18539,7,2784,2,18000,1.00251436782
15901,15907,18500,6,2593,2,18000,1.0023139221
15967,15973,18684,6,2711,2,18000,1.00221320546
16086,16092,18913,6,2821,2,18000,1.00212690535
16186,16192,18846,6,2654,2,18000,1.00226073851
16497,16502,19298,5,2796,2,18000,1.00178826896
16585,16591,19325,6,2734,2,18000,1.00219458669
16716,16722,19562,6,2840,2,18000,1.00211267606
16885,16891,19672,6,2781,2,18000,1.0021574973
17040,17046,19866,6,2820,2,18000,1.00212765957
17056,17062,19898,6,2836,2,18000,1.00211565585
17178,17184,20045,6,2861,2,18000,1.00209716882
17207,17213,20022,6,2809,2,18000,1.00213599146
17226,17232,20029,6,2797,2,18000,1.00214515552
17376,17382,20145,6,2763,2,18000,1.00217155266
17476,17482,20141,6,2659,2,18000,1.0022564874
17492,17498,20296,6,2798,2,18000,1.00214438885
17520,17526,20198,6,2672,2,18000,1.00224550898
17589,17595,20408,6,2813,2,18000,1.00213295414
17673,17680,20526,7,2846,2,18000,1.00245959241
17708,17714,20562,6,2848,2,18000,1.00210674157
17725,17731,20540,6,2809,2,18000,1.00213599146
17781,17788,20508,7,2720,2,18000,1.00257352941
17798,17804,20495,6,2691,2,18000,1.0022296544
17832,17839,20616,7,2777,2,18000,1.0025207058
17954,17960,20806,6,2846,2,18000,1.00210822207
17969,17976,20810,7,2834,2,18000,1.00247000706
17989,17995,20778,6,2783,2,18000,1.00215594682
18078,18084,20909,6,2825,2,18000,1.00212389381
18163,18169,20752,6,2583,2,18000,1.00232288037
18188,18195,20989,7,2794,2,18000,1.00250536865
18223,18229,20928,6,2699,2,18000,1.00222304557
18302,18309,21036,7,2727,2,18000,1.00256692336
18366,18373,21163,7,2790,2,18000,1.00250896057
18457,18463,21208,6,2745,2,18000,1.00218579235
18482,18488,21153,6,2665,2,18000,1.00225140713
18501,18507,21340,6,2833,2,18000,1.00211789622
18517,18523,21275,6,2752,2,18000,1.00218023256
18542,18548,21418,6,2870,2,18000,1.00209059233
18685,18691,21500,6,2809,2,18000,1.00213599146
18848,18855,21671,7,2816,2,18000,1.00248579545
18914,18920,21561,6,2641,2,18000,1.00227186672
19302,19308,22062,6,2754,2,18000,1.00217864924
19327,19334,22149,7,2815,2,18000,1.00248667851
19565,19571,22396,6,2825,2,18000,1.00212389381
19674,19680,22441,6,2761,2,18000,1.00217312568
19867,19873,22701,6,2828,2,18000,1.00212164074
19901,19908,22806,7,2898,2,18000,1.00241545894
20027,20033,22924,6,2891,2,18000,1.00207540643
20043,20049,22859,6,2810,2,18000,1.00213523132
20058,20065,22836,7,2771,2,18000,1.00252616384
20143,20149,22835,6,2686,2,18000,1.00223380491
20159,20165,22938,6,2773,2,18000,1.0021637216
20200,20206,22998,6,2792,2,18000,1.00214899713
20299,20306,23142,7,2836,2,18000,1.00246826516
20412,20418,23161,6,2743,2,18000,1.00218738607
20498,20504,23265,6,2761,2,18000,1.00217312568
20514,20519,23208,5,2689,2,18000,1.0018594273
20530,20536,23376,6,2840,2,18000,1.00211267606
20546,20552,23311,6,2759,2,18000,1.00217470098
20565,20571,23318,6,2747,2,18000,1.00218420095
20618,20624,23473,6,2849,2,18000,1.00210600211
20756,20762,23567,6,2805,2,18000,1.00213903743
20781,20787,23567,6,2780,2,18000,1.00215827338
20810,20816,23515,6,2699,2,18000,1.00222304557
20826,20832,23604,6,2772,2,18000,1.00216450216
20910,20916,23700,6,2784,2,18000,1.00215517241
20929,20935,23601,6,2666,2,18000,1.00225056264
20992,20998,23793,6,2795,2,18000,1.00214669052
21039,21045,23733,6,2688,2,18000,1.00223214286
21157,21163,23870,6,2707,2,18000,1.0022164758
21173,21179,23947,6,2768,2,18000,1.00216763006
21210,21216,23965,6,2749,2,18000,1.00218261186
21276,21282,23891,6,2609,2,18000,1.0022997317
21344,21350,24151,6,2801,2,18000,1.00214209211
21419,21425,24066,6,2641,2,18000,1.00227186672
21501,21508,24368,7,2860,2,18000,1.00244755245
21564,21570,24248,6,2678,2,18000,1.00224047797
21674,21680,24464,6,2784,2,18000,1.00215517241
22064,22071,24842,7,2771,2,18000,1.00252616384
22152,22158,24835,6,2677,2,18000,1.0022413149
22400,22406,25136,6,2730,2,18000,1.0021978022
22444,22451,25106,7,2655,2,18000,1.00263653484
22704,22710,25504,6,2794,2,18000,1.00214745884
22807,22813,25563,6,2750,2,18000,1.00218181818
22838,22845,25620,7,2775,2,18000,1.00252252252
22840,22851,25591,11,2740,2,18000,1.00401459854
22862,22868,25532,6,2664,2,18000,1.00225225225
22926,22932,25728,6,2796,2,18000,1.00214592275
22941,22948,25729,7,2781,2,18000,1.00251708019
23002,23008,25777,6,2769,2,18000,1.00216684724
23146,23153,25879,7,2726,2,18000,1.002567865
23166,23172,25861,6,2689,2,18000,1.00223131276
23209,23216,26008,7,2792,2,18000,1.00250716332
23266,23272,26059,6,2787,2,18000,1.00215285253
23314,23320,26092,6,2772,2,18000,1.00216450216
23330,23336,26152,6,2816,2,18000,1.00213068182
23379,23385,26043,6,2658,2,18000,1.00225733634
23476,23483,26282,7,2799,2,18000,1.00250089318
23517,23523,26219,6,2696,2,18000,1.00222551929
23570,23577,26389,7,2812,2,18000,1.00248933144
23572,23583,26391,11,2808,2,18000,1.00391737892
23604,23610,26423,6,2813,2,18000,1.00213295414
23620,23626,26335,6,2709,2,18000,1.00221483942
23701,23707,26512,6,2805,2,18000,1.00213903743
23736,23742,26525,6,2783,2,18000,1.00215594682
23795,23802,26617,7,2815,2,18000,1.00248667851
23871,23877,26670,6,2793,2,18000,1.00214822771
23893,23899,26635,6,2736,2,18000,1.00219298246
23949,23956,26730,7,2774,2,18000,1.00252343187
23968,23974,26690,6,2716,2,18000,1.00220913108
24068,24074,26804,6,2730,2,18000,1.0021978022
24152,24158,26836,6,2678,2,18000,1.00224047797
24252,24258,26996,6,2738,2,18000,1.00219138057
24370,24376,27169,6,2793,2,18000,1.00214822771
24468,24474,27192,6,2718,2,18000,1.00220750552
24838,24844,27650,6,2806,2,18000,1.00213827512
24854,24860,27649,6,2789,2,18000,1.00215130871
25109,25115,27803,6,2688,2,18000,1.00223214286
25137,25143,28002,6,2859,2,18000,1.00209863589
25507,25513,28190,6,2677,2,18000,1.0022413149
25535,25541,28210,6,2669,2,18000,1.00224803297
25567,25573,28386,6,2813,2,18000,1.00213295414
25595,25601,28413,6,2812,2,18000,1.00213371266
25623,25629,28462,6,2833,2,18000,1.00211789622
25732,25738,28508,6,2770,2,18000,1.00216606498
25733,25744,28551,11,2807,2,18000,1.00391877449
25781,25787,28578,6,2791,2,18000,1.00214976711
25864,25870,28692,6,2822,2,18000,1.00212615167
25882,25888,28691,6,2803,2,18000,1.00214056368
26011,26017,28826,6,2809,2,18000,1.00213599146
26045,26051,28855,6,2804,2,18000,1.00213980029
26061,26067,28733,6,2666,2,18000,1.00225056264
26095,26102,28899,7,2797,2,18000,1.00250268144
26155,26161,28921,6,2760,2,18000,1.00217391304
26222,26227,29067,5,2840,2,18000,1.00176056338
26284,26290,29050,6,2760,2,18000,1.00217391304
26337,26344,28995,7,2651,2,18000,1.00264051301
26391,26397,29131,6,2734,2,18000,1.00219458669
26407,26413,29244,6,2831,2,18000,1.00211939244
26426,26432,29105,6,2673,2,18000,1.00224466891
26513,26519,29206,6,2687,2,18000,1.00223297358
26529,26535,29324,6,2789,2,18000,1.00215130871
26619,26625,29439,6,2814,2,18000,1.00213219616
26638,26644,29497,6,2853,2,18000,1.00210304942
26673,26679,29435,6,2756,2,18000,1.00217706821
26692,26698,29477,6,2779,2,18000,1.00215905002
26732,26739,29522,7,2783,2,18000,1.00251527129
26807,26813,29612,6,2799,2,18000,1.00214362272
26839,26845,29563,6,2718,2,18000,1.00220750552
26998,27005,29896,7,2891,2,18000,1.00242130751
27170,27176,29865,6,2689,2,18000,1.00223131276
27195,27201,30041,6,2840,2,18000,1.00211267606
27651,27657,30248,6,2591,2,18000,1.00231570822
27653,27663,30331,10,2668,2,18000,1.00374812594
27806,27812,30691,6,2879,2,18000,1.00208405696
28005,28011,30823,6,2812,2,18000,1.00213371266
28192,28198,31006,6,2808,2,18000,1.00213675214
28213,28220,30890,7,2670,2,18000,1.00262172285
28388,28394,31020,6,2626,2,18000,1.00228484387
28416,28422,31232,6,2810,2,18000,1.00213523132
28465,28472,31187,7,2715,2,18000,1.00257826888
28509,28516,31298,7,2782,2,18000,1.00251617541
28553,28560,31184,7,2624,2,18000,1.00266768293
28582,28588,31393,6,2805,2,18000,1.00213903743
28695,28701,31492,6,2791,2,18000,1.00214976711
28696,28707,31453,11,2746,2,18000,1.00400582666
28735,28741,31527,6,2786,2,18000,1.00215362527
28828,28835,31453,7,2618,2,18000,1.00267379679
28857,28863,31577,6,2714,2,18000,1.00221075903
28901,28907,31733,6,2826,2,18000,1.00212314225
28923,28929,31765,6,2836,2,18000,1.00211565585
28998,29004,31719,6,2715,2,18000,1.00220994475
29051,29057,31818,6,2761,2,18000,1.00217312568
29070,29076,31905,6,2829,2,18000,1.00212089077
29105,29111,31938,6,2827,2,18000,1.00212239123
29134,29140,31921,6,2781,2,18000,1.0021574973
29208,29214,31858,6,2644,2,18000,1.00226928896
29247,29253,32048,6,2795,2,18000,1.00214669052
29327,29333,32162,6,2829,2,18000,1.00212089077
29436,29442,32280,6,2838,2,18000,1.0021141649
29452,29458,32287,6,2829,2,18000,1.00212089077
29478,29484,32244,6,2760,2,18000,1.00217391304
29500,29506,32324,6,2818,2,18000,1.00212916962
29526,29532,32207,6,2675,2,18000,1.00224299065
29564,29570,32375,6,2805,2,18000,1.00213903743
29615,29621,32249,6,2628,2,18000,1.00228310502
29867,29873,32599,6,2726,2,18000,1.00220102715
29900,29906,32703,6,2797,2,18000,1.00214515552
30043,30049,32832,6,2783,2,18000,1.00215594682
30252,30258,33100,6,2842,2,18000,1.0021111893
30335,30341,33138,6,2797,2,18000,1.00214515552
30696,30701,33485,5,2784,2,18000,1.00179597701
30827,30833,33648,6,2815,2,18000,1.00213143872
30893,30899,33587,6,2688,2,18000,1.00223214286
31010,31016,33801,6,2785,2,18000,1.00215439856
31026,31032,33693,6,2661,2,18000,1.00225479143
31186,31192,34061,6,2869,2,18000,1.00209132102
31202,31208,34004,6,2796,2,18000,1.00214592275
31234,31240,33914,6,2674,2,18000,1.00224382947
31300,31306,34123,6,2817,2,18000,1.00212992545
31394,31400,34216,6,2816,2,18000,1.00213068182
31455,31461,34156,6,2695,2,18000,1.00222634508
31456,31467,34262,11,2795,2,18000,1.00393559928
31494,31501,34306,7,2805,2,18000,1.00249554367
31529,31535,34340,6,2805,2,18000,1.00213903743
31579,31586,34274,7,2688,2,18000,1.00260416667
31721,31727,34474,6,2747,2,18000,1.00218420095
31737,31743,34596,6,2853,2,18000,1.00210304942
31768,31774,34573,6,2799,2,18000,1.00214362272
31821,31828,34613,7,2785,2,18000,1.00251346499
31859,31865,34500,6,2635,2,18000,1.00227703985
31907,31913,34764,6,2851,2,18000,1.00210452473
31923,31929,34756,6,2827,2,18000,1.00212239123
31942,31949,34804,7,2855,2,18000,1.00245183888
32050,32056,34785,6,2729,2,18000,1.00219860755
32165,32171,34860,6,2689,2,18000,1.00223131276
32206,32212,34982,6,2770,2,18000,1.00216606498
32244,32250,35114,6,2864,2,18000,1.00209497207
32260,32266,35112,6,2846,2,18000,1.00210822207
32283,32289,34883,6,2594,2,18000,1.00231303007
32299,32306,35009,7,2703,2,18000,1.00258971513
32326,32332,35102,6,2770,2,18000,1.00216606498
32377,32383,35071,6,2688,2,18000,1.00223214286
32602,32608,35458,6,2850,2,18000,1.00210526316
32707,32713,35566,6,2853,2,18000,1.00210304942
32837,32843,35530,6,2687,2,18000,1.00223297358
33103,33109,35772,6,2663,2,18000,1.00225309801
33141,33148,35831,7,2683,2,18000,1.00260901975
33490,33495,36350,5,2855,2,18000,1.00175131349
33590,33596,36328,6,2732,2,18000,1.00219619327
33650,33656,36432,6,2776,2,18000,1.00216138329
33696,33702,36495,6,2793,2,18000,1.00214822771
33810,33816,36340,6,2524,2,18000,1.00237717908
33918,33924,36661,6,2737,2,18000,1.00219218122
34007,34013,36825,6,2812,2,18000,1.00213371266
34064,34070,36748,6,2678,2,18000,1.00224047797
34126,34132,36843,6,2711,2,18000,1.00221320546
34162,34168,36705,6,2537,2,18000,1.00236499803
34218,34224,37066,6,2842,2,18000,1.0021111893
34267,34273,37149,6,2876,2,18000,1.00208623088
34282,34289,37085,7,2796,2,18000,1.00250357654
34308,34314,37083,6,2769,2,18000,1.00216684724
34342,34349,37171,7,2822,2,18000,1.00248051028
34475,34481,37237,6,2756,2,18000,1.00217706821
34505,34511,37360,6,2849,2,18000,1.00210600211
34578,34583,37459,5,2876,2,18000,1.00173852573
34600,34606,37410,6,2804,2,18000,1.00213980029
34616,34622,37488,6,2866,2,18000,1.00209351012
34759,34766,37552,7,2786,2,18000,1.00251256281
34776,34782,37526,6,2744,2,18000,1.00218658892
34792,34798,37599,6,2801,2,18000,1.00214209211
34808,34814,37567,6,2753,2,18000,1.00217944061
34861,34868,37519,7,2651,2,18000,1.00264051301
34886,34892,37742,6,2850,2,18000,1.00210526316
34982,34989,37825,7,2836,2,18000,1.00246826516
35011,35017,37810,6,2793,2,18000,1.00214822771
35074,35080,37789,6,2709,2,18000,1.00221483942
35106,35112,37900,6,2788,2,18000,1.00215208034
35122,35128,37863,6,2735,2,18000,1.00219378428
35123,35134,37842,11,2708,2,18000,1.0040620384
35461,35467,38259,6,2792,2,18000,1.00214899713
35533,35539,38349,6,2810,2,18000,1.00213523132
35567,35573,38348,6,2775,2,18000,1.00216216216
35773,35779,38595,6,2816,2,18000,1.00213068182
35835,35841,38618,6,2777,2,18000,1.00216060497
36331,36337,39168,6,2831,2,18000,1.00211939244
36346,36352,39110,6,2758,2,18000,1.00217548949
36362,36368,39148,6,2780,2,18000,1.00215827338
36434,36440,39208,6,2768,2,18000,1.00216763006
36496,36502,39217,6,2715,2,18000,1.00220994475
36664,36670,39507,6,2837,2,18000,1.00211491012
36708,36715,39491,7,2776,2,18000,1.00252161383
36749,36755,39559,6,2804,2,18000,1.00213980029
36827,36833,39703,6,2870,2,18000,1.00209059233
36846,36853,39656,7,2803,2,18000,1.0024973243
37070,37076,39889,6,2813,2,18000,1.00213295414
37086,37092,39917,6,2825,2,18000,1.00212389381
37087,37098,39938,11,2840,2,18000,1.00387323944
37151,37157,39914,6,2757,2,18000,1.00217627856
37173,37179,39881,6,2702,2,18000,1.00222057735
37238,37244,40083,6,2839,2,18000,1.00211342022
37363,37369,40042,6,2673,2,18000,1.00224466891
37414,37420,40285,6,2865,2,18000,1.00209424084
37462,37468,40261,6,2793,2,18000,1.00214822771
37491,37497,40309,6,2812,2,18000,1.00213371266
37523,37529,40298,6,2769,2,18000,1.00216684724
37539,37545,40271,6,2726,2,18000,1.00220102715
37555,37561,40454,6,2893,2,18000,1.00207397166
37570,37576,40306,6,2730,2,18000,1.0021978022
37601,37608,40309,7,2701,2,18000,1.00259163273
37744,37750,40448,6,2698,2,18000,1.00222386953
37792,37798,40524,6,2726,2,18000,1.00220102715
37814,37820,40475,6,2655,2,18000,1.00225988701
37830,37836,40532,6,2696,2,18000,1.00222551929
37846,37852,40668,6,2816,2,18000,1.00213068182
37865,37871,40652,6,2781,2,18000,1.0021574973
37902,37909,40696,7,2787,2,18000,1.00251166128
38261,38268,41096,7,2828,2,18000,1.00247524752
38349,38356,41073,7,2717,2,18000,1.002576371
38351,38362,41127,11,2765,2,18000,1.00397830018
38597,38603,41391,6,2788,2,18000,1.00215208034
38619,38625,41407,6,2782,2,18000,1.00215672178
39113,39118,41871,5,2753,2,18000,1.00181620051
39151,39157,42004,6,2847,2,18000,1.00210748156
39170,39176,41859,6,2683,2,18000,1.00223630265
39211,39217,41999,6,2782,2,18000,1.00215672178
39226,39233,41956,7,2723,2,18000,1.00257069409
39492,39498,42290,6,2792,2,18000,1.00214899713
39512,39518,42400,6,2882,2,18000,1.00208188758
39562,39568,42415,6,2847,2,18000,1.00210748156
39657,39664,42477,7,2813,2,18000,1.0024884465
39705,39711,42590,6,2879,2,18000,1.00208405696
39883,39889,42738,6,2849,2,18000,1.00210600211
39899,39905,42720,6,2815,2,18000,1.00213143872
39918,39924,42591,6,2667,2,18000,1.00224971879
39919,39930,42713,11,2783,2,18000,1.00395256917
39942,39948,42751,6,2803,2,18000,1.00214056368
40045,40051,42826,6,2775,2,18000,1.00216216216
40086,40092,42891,6,2799,2,18000,1.00214362272
40264,40270,43076,6,2806,2,18000,1.00213827512
40280,40286,43097,6,2811,2,18000,1.00213447172
40296,40302,43012,6,2710,2,18000,1.00221402214
40313,40318,43153,5,2835,2,18000,1.00176366843
40314,40324,43018,10,2694,2,18000,1.00371195249
40315,40329,43110,14,2781,2,18000,1.00503416037
40316,40334,43067,18,2733,2,18000,1.00658616905
40451,40457,43300,6,2843,2,18000,1.00211044671
40467,40473,43346,6,2873,2,18000,1.00208840933
40483,40489,43200,6,2711,2,18000,1.00221320546
40527,40534,43255,7,2721,2,18000,1.00257258361
40544,40551,43349,7,2798,2,18000,1.00250178699
40655,40661,43459,6,2798,2,18000,1.00214438885
40670,40677,43491,7,2814,2,18000,1.00248756219
40699,40705,43514,6,2809,2,18000,1.00213599146
41075,41081,43935,6,2854,2,18000,1.00210231254
41100,41106,43938,6,2832,2,18000,1.00211864407
41129,41135,43701,6,2566,2,18000,1.00233826968
41394,41400,44262,6,2862,2,18000,1.00209643606
41410,41416,44101,6,2685,2,18000,1.00223463687
41863,41870,44477,7,2607,2,18000,1.00268507863
41879,41886,44555,7,2669,2,18000,1.00262270513
41958,41964,44760,6,2796,2,18000,1.00214592275
42002,42008,44629,6,2621,2,18000,1.00228920259
42018,42024,44784,6,2760,2,18000,1.00217391304
42294,42300,45027,6,2727,2,18000,1.00220022002
42404,42410,45235,6,2825,2,18000,1.00212389381
42420,42426,45206,6,2780,2,18000,1.00215827338
42480,42486,45197,6,2711,2,18000,1.00221320546
42593,42599,45345,6,2746,2,18000,1.00218499636
42594,42605,45282,11,2677,2,18000,1.00410907733
42716,42722,45511,6,2789,2,18000,1.00215130871
42732,42738,45575,6,2837,2,18000,1.00211491012
42748,42754,45542,6,2788,2,18000,1.00215208034
42763,42770,45444,7,2674,2,18000,1.00261780105
42830,42836,45513,6,2677,2,18000,1.0022413149
42892,42898,45659,6,2761,2,18000,1.00217312568
43014,43020,45818,6,2798,2,18000,1.00214438885
43029,43035,45863,6,2828,2,18000,1.00212164074
43071,43077,45819,6,2742,2,18000,1.00218818381
43087,43093,45890,6,2797,2,18000,1.00214515552
43103,43109,45914,6,2805,2,18000,1.00213903743
43119,43125,45936,6,2811,2,18000,1.00213447172
43156,43162,45840,6,2678,2,18000,1.00224047797
43204,43210,46070,6,2860,2,18000,1.0020979021
43257,43263,46062,6,2799,2,18000,1.00214362272
43304,43310,46113,6,2803,2,18000,1.00214056368
43348,43355,46133,7,2778,2,18000,1.00251979842
43364,43370,46214,6,2844,2,18000,1.00210970464
43462,43468,46236,6,2768,2,18000,1.00216763006
43493,43500,46291,7,2791,2,18000,1.00250806163
43516,43522,46372,6,2850,2,18000,1.00210526316
43702,43708,46534,6,2826,2,18000,1.00212314225
43938,43944,46659,6,2715,2,18000,1.00220994475
43939,43950,46648,11,2698,2,18000,1.00407709414
44102,44108,46771,6,2663,2,18000,1.00225309801
44264,44271,46994,7,2723,2,18000,1.00257069409
44482,44488,47279,6,2791,2,18000,1.00214976711
44557,44563,47269,6,2706,2,18000,1.0022172949
44632,44638,47297,6,2659,2,18000,1.0022564874
44762,44768,47496,6,2728,2,18000,1.00219941349
44787,44793,47654,6,2861,2,18000,1.00209716882
45028,45035,47875,7,2840,2,18000,1.00246478873
45199,45205,47930,6,2725,2,18000,1.00220183486
45215,45221,47995,6,2774,2,18000,1.0021629416
45237,45243,48101,6,2858,2,18000,1.00209937019
45284,45290,47940,6,2650,2,18000,1.00226415094
45346,45352,48044,6,2692,2,18000,1.00222882615
45443,45450,48244,7,2794,2,18000,1.00250536865
45509,45515,48373,6,2858,2,18000,1.00209937019
45524,45531,48272,7,2741,2,18000,1.00255381248
45544,45550,48232,6,2682,2,18000,1.00223713647
45578,45585,48487,7,2902,2,18000,1.00241212957
45663,45669,48514,6,2845,2,18000,1.00210896309
45819,45825,48662,6,2837,2,18000,1.00211491012
45835,45841,48646,6,2805,2,18000,1.00213903743
45851,45857,48657,6,2800,2,18000,1.00214285714
45867,45873,48661,6,2788,2,18000,1.00215208034
45893,45899,48731,6,2832,2,18000,1.00211864407
45918,45924,48690,6,2766,2,18000,1.0021691974
45940,45946,48662,6,2716,2,18000,1.00220913108
46063,46070,48871,7,2801,2,18000,1.00249910746
46079,46085,48775,6,2690,2,18000,1.00223048327
46114,46121,48752,7,2631,2,18000,1.00266058533
46137,46143,48963,6,2820,2,18000,1.00212765957
46217,46223,48817,6,2594,2,18000,1.00231303007
46239,46245,48990,6,2745,2,18000,1.00218579235
46296,46302,49107,6,2805,2,18000,1.00213903743
46373,46379,49145,6,2766,2,18000,1.0021691974
46536,46542,49090,6,2548,2,18000,1.00235478807
46652,46658,49499,6,2841,2,18000,1.00211193242
46668,46674,49343,6,2669,2,18000,1.00224803297
46773,46779,49629,6,2850,2,18000,1.00210526316
46998,47004,49791,6,2787,2,18000,1.00215285253
47272,47278,50020,6,2742,2,18000,1.00218818381
47289,47295,50095,6,2800,2,18000,1.00214285714
47305,47311,50073,6,2762,2,18000,1.00217233888
47499,47505,50212,6,2707,2,18000,1.0022164758
47657,47663,50412,6,2749,2,18000,1.00218261186
47879,47885,50676,6,2791,2,18000,1.00214976711
47932,47938,50656,6,2718,2,18000,1.00220750552
47948,47954,50591,6,2637,2,18000,1.00227531286
47998,48004,50685,6,2681,2,18000,1.00223797091
48045,48051,50863,6,2812,2,18000,1.00213371266
48104,48110,50949,6,2839,2,18000,1.00211342022
48235,48241,50927,6,2686,2,18000,1.00223380491
48251,48256,51040,5,2784,2,18000,1.00179597701
48273,48279,51099,6,2820,2,18000,1.00212765957
48375,48382,51135,7,2753,2,18000,1.00254268071
48490,48496,51181,6,2685,2,18000,1.00223463687
48515,48521,51318,6,2797,2,18000,1.00214515552
48649,48655,51367,6,2712,2,18000,1.00221238938
48665,48671,51357,6,2686,2,18000,1.00223380491
48667,48677,51305,10,2628,2,18000,1.00380517504
48668,48682,51462,14,2780,2,18000,1.00503597122
48669,48687,51496,18,2809,2,18000,1.00640797437
48691,48697,51438,6,2741,2,18000,1.00218898212
48732,48738,51559,6,2821,2,18000,1.00212690535
48754,48761,51545,7,2784,2,18000,1.00251436782
48780,48786,51449,6,2663,2,18000,1.00225309801
48821,48827,51668,6,2841,2,18000,1.00211193242
48873,48879,51695,6,2816,2,18000,1.00213068182
48966,48972,51745,6,2773,2,18000,1.0021637216
48991,48997,51690,6,2693,2,18000,1.00222799851
49091,49097,51875,6,2778,2,18000,1.00215982721
49110,49117,51667,7,2550,2,18000,1.00274509804
49148,49154,51930,6,2776,2,18000,1.00216138329
49345,49351,52114,6,2763,2,18000,1.00217155266
49503,49509,52311,6,2802,2,18000,1.00214132762
49631,49637,52413,6,2776,2,18000,1.00216138329
49794,49800,52365,6,2565,2,18000,1.00233918129
50024,50030,52879,6,2849,2,18000,1.00210600211
50077,50083,52878,6,2795,2,18000,1.00214669052
50098,50105,52861,7,2756,2,18000,1.00253991292
50214,50220,52903,6,2683,2,18000,1.00223630265
50415,50421,53278,6,2857,2,18000,1.00210010501
50592,50598,53423,6,2825,2,18000,1.00212389381
50652,50658,212327,6,161669,12,345600,1.00003711287
50658,50664,53483,6,2819,2,18000,1.00212841433
50680,50686,53381,6,2695,2,18000,1.00222634508
50695,50701,53302,6,2601,2,18000,1.00230680507
50866,50872,53692,6,2820,2,18000,1.00212765957
50928,50934,53710,6,2776,2,18000,1.00216138329
50950,50956,53718,6,2762,2,18000,1.00217233888
51044,51050,53829,6,2779,2,18000,1.00215905002
51101,51107,53900,6,2793,2,18000,1.00214822771
51138,51144,53925,6,2781,2,18000,1.0021574973
51182,51188,53930,6,2742,2,18000,1.00218818381
51308,51314,54100,6,2786,2,18000,1.00215362527
51324,51330,54140,6,2810,2,18000,1.00213523132
51362,51368,54164,6,2796,2,18000,1.00214592275
51378,51384,54189,6,2805,2,18000,1.00213903743
51441,51447,54201,6,2754,2,18000,1.00217864924
51457,51463,54172,6,2709,2,18000,1.00221483942
51473,51479,54271,6,2792,2,18000,1.00214899713
51498,51504,54354,6,2850,2,18000,1.00210526316
51548,51554,54310,6,2756,2,18000,1.00217706821
51564,51569,54379,5,2810,2,18000,1.00177935943
51671,51677,54430,6,2753,2,18000,1.00217944061
51672,51683,54478,11,2795,2,18000,1.00393559928
51692,51698,54522,6,2824,2,18000,1.00212464589
51707,51714,54505,7,2791,2,18000,1.00250806163
51748,51754,54444,6,2690,2,18000,1.00223048327
51879,51885,54780,6,2895,2,18000,1.00207253886
51934,51940,54722,6,2782,2,18000,1.00215672178
52118,52124,54806,6,2682,2,18000,1.00223713647
52314,52320,55009,6,2689,2,18000,1.00223131276
52368,52374,54995,6,2621,2,18000,1.00228920259
52414,52421,55186,7,2765,2,18000,1.00253164557
52671,52677,54185,6,1508,1,36000,1.00397877984
52864,52871,55683,7,2812,2,18000,1.00248933144
52881,52887,55714,6,2827,2,18000,1.00212239123
52882,52893,55643,11,2750,2,18000,1.004
52904,52910,55645,6,2735,2,18000,1.00219378428
53282,53288,56080,6,2792,2,18000,1.00214899713
53304,53310,56054,6,2744,2,18000,1.00218658892
53382,53388,56174,6,2786,2,18000,1.00215362527
53426,53432,56284,6,2852,2,18000,1.00210378682
53486,53492,56392,6,2900,2,18000,1.00206896552
53693,53699,56517,6,2818,2,18000,1.00212916962
53712,53719,56595,7,2876,2,18000,1.00243393602
53728,53734,56489,6,2755,2,18000,1.00217785844
53834,53840,56587,6,2747,2,18000,1.00218420095
53903,53909,56522,6,2613,2,18000,1.00229621125
53928,53934,56492,6,2558,2,18000,1.00234558249
53953,53960,56747,7,2787,2,18000,1.00251166128
54103,54109,56961,6,2852,2,18000,1.00210378682
54143,54150,56823,7,2673,2,18000,1.0026187804
54166,54172,56955,6,2783,2,18000,1.00215594682
54181,54188,56875,7,2687,2,18000,1.00260513584
54188,54195,54227,7,32,1,36000,1.21875
54197,54203,56942,6,2739,2,18000,1.0021905805
54213,54219,56931,6,2712,2,18000,1.00221238938
54229,54237,54243,8,6,1,36000,1.4
54257,54263,65497,6,11234,1,36000,1.00053409293
54275,54281,57093,6,2812,2,18000,1.00213371266
54313,54319,57059,6,2740,2,18000,1.00218978102
54356,54362,57159,6,2797,2,18000,1.00214515552
54382,54388,57150,6,2762,2,18000,1.00217233888
54432,54438,57252,6,2814,2,18000,1.00213219616
54448,54454,57169,6,2715,2,18000,1.00220994475
54483,54489,57192,6,2703,2,18000,1.00221975583
54508,54514,57310,6,2796,2,18000,1.00214592275
54524,54530,57380,6,2850,2,18000,1.00210526316
54725,54731,57337,6,2606,2,18000,1.00230237913
54782,54788,57581,6,2793,2,18000,1.00214822771
54807,54813,57615,6,2802,2,18000,1.00214132762
54999,55005,57716,6,2711,2,18000,1.00221320546
55015,55020,57807,5,2787,2,18000,1.00179404377
55189,55196,57807,7,2611,2,18000,1.00268096515
55645,55651,58461,6,2810,2,18000,1.00213523132
55646,55657,58517,11,2860,2,18000,1.00384615385
55687,55693,58492,6,2799,2,18000,1.00214362272
55718,55725,58527,7,2802,2,18000,1.00249821556
56058,56064,58892,6,2828,2,18000,1.00212164074
56083,56089,58938,6,2849,2,18000,1.00210600211
56176,56182,59059,6,2877,2,18000,1.00208550574
56287,56293,58973,6,2680,2,18000,1.00223880597
56393,56399,59221,6,2822,2,18000,1.00212615167
56490,56496,59203,6,2707,2,18000,1.0022164758
56506,56512,59307,6,2795,2,18000,1.00214669052
56522,56528,59193,6,2665,2,18000,1.00225140713
56524,56534,59245,10,2711,2,18000,1.00368867577
56590,56596,59419,6,2823,2,18000,1.00212539851
56607,56613,59403,6,2790,2,18000,1.00215053763
56749,56755,59474,6,2719,2,18000,1.00220669364
56827,56833,59498,6,2665,2,18000,1.00225140713
56877,56883,59537,6,2654,2,18000,1.00226073851
56936,56942,59773,6,2831,2,18000,1.00211939244
56952,56958,59655,6,2697,2,18000,1.0022246941
56968,56974,59608,6,2634,2,18000,1.00227790433
56969,56980,59558,11,2578,2,18000,1.00426687355
57062,57068,59657,6,2589,2,18000,1.0023174971
57096,57102,59797,6,2695,2,18000,1.00222634508
57152,57159,59954,7,2795,2,18000,1.00250447227
57169,57175,59736,6,2561,2,18000,1.00234283483
57184,57190,59995,6,2805,2,18000,1.00213903743
57200,57206,59946,6,2740,2,18000,1.00218978102
57257,57263,60008,6,2745,2,18000,1.00218579235
57313,57319,60203,6,2884,2,18000,1.00208044383
57338,57344,60210,6,2866,2,18000,1.00209351012
57381,57388,60182,7,2794,2,18000,1.00250536865
57583,57589,60373,6,2784,2,18000,1.00215517241
57618,57625,60499,7,2874,2,18000,1.00243562978
57717,57724,60566,7,2842,2,18000,1.00246305419
57809,57815,60571,6,2756,2,18000,1.00217706821
57810,57821,60670,11,2849,2,18000,1.00386100386
58465,58471,61213,6,2742,2,18000,1.00218818381
58493,58500,61339,7,2839,2,18000,1.00246565692
58519,58525,61190,6,2665,2,18000,1.00225140713
58535,58541,61138,6,2597,2,18000,1.00231035811
58896,58902,61718,6,2816,2,18000,1.00213068182
58940,58946,61691,6,2745,2,18000,1.00218579235
58974,58980,61722,6,2742,2,18000,1.00218818381
59061,59067,61891,6,2824,2,18000,1.00212464589
59195,59201,62034,6,2833,2,18000,1.00211789622
59211,59217,61935,6,2718,2,18000,1.00220750552
59227,59232,62041,5,2809,2,18000,1.00177999288
59249,59255,62040,6,2785,2,18000,1.00215439856
59311,59318,62117,7,2799,2,18000,1.00250089318
59405,59411,62048,6,2637,2,18000,1.00227531286
59420,59426,62262,6,2836,2,18000,1.00211565585
59477,59483,62330,6,2847,2,18000,1.00210748156
59502,59508,62286,6,2778,2,18000,1.00215982721
59539,59545,62313,6,2768,2,18000,1.00216763006
59561,59568,62224,7,2656,2,18000,1.00263554217
59612,59618,62407,6,2789,2,18000,1.00215130871
59659,59665,62426,6,2761,2,18000,1.00217312568
59661,59671,62412,10,2741,2,18000,1.00364830354
59738,59744,62362,6,2618,2,18000,1.00229182582
59776,59783,62480,7,2697,2,18000,1.00259547646
59799,59805,62482,6,2677,2,18000,1.0022413149
59950,59956,62816,6,2860,2,18000,1.0020979021
59966,59972,62771,6,2799,2,18000,1.00214362272
59998,60004,62721,6,2717,2,18000,1.002208318
60014,60019,62863,5,2844,2,18000,1.0017580872
60185,60191,63026,6,2835,2,18000,1.00211640212
60207,60213,63045,6,2832,2,18000,1.00211864407
60223,60229,62829,6,2600,2,18000,1.00230769231
60375,60381,63180,6,2799,2,18000,1.00214362272
60503,60508,63291,5,2783,2,18000,1.00179662235
60569,60575,63444,6,2869,2,18000,1.00209132102
60585,60591,63409,6,2818,2,18000,1.00212916962
60672,60678,63406,6,2728,2,18000,1.00219941349
61139,61145,64033,6,2888,2,18000,1.00207756233
61189,61195,64015,6,2820,2,18000,1.00212765957
61217,61224,64089,7,2865,2,18000,1.00244328098
61342,61348,64142,6,2794,2,18000,1.00214745884
61693,61700,64563,7,2863,2,18000,1.00244498778
61722,61728,64528,6,2800,2,18000,1.00214285714
61738,61744,64525,6,2781,2,18000,1.0021574973
61895,61901,64672,6,2771,2,18000,1.00216528329
61939,61945,64780,6,2835,2,18000,1.00211640212
62035,62042,64870,7,2828,2,18000,1.00247524752
62052,62058,64926,6,2868,2,18000,1.00209205021
62053,62064,64835,11,2771,2,18000,1.00396968603
62055,62069,64846,14,2777,2,18000,1.0050414116
62120,62126,64950,6,2824,2,18000,1.00212464589
62227,62233,64968,6,2735,2,18000,1.00219378428
62265,62271,65019,6,2748,2,18000,1.00218340611
62290,62296,64995,6,2699,2,18000,1.00222304557
62315,62322,65173,7,2851,2,18000,1.00245527885
62331,62337,65119,6,2782,2,18000,1.00215672178
62363,62369,65237,6,2868,2,18000,1.00209205021
62410,62416,65227,6,2811,2,18000,1.00213447172
62426,62432,65229,6,2797,2,18000,1.00214515552
62441,62447,65119,6,2672,2,18000,1.00224550898
62482,62488,65338,6,2850,2,18000,1.00210526316
62484,62494,65370,10,2876,2,18000,1.00347705146
62723,62730,65585,7,2855,2,18000,1.00245183888
62739,62745,65445,6,2700,1,36000,1.00222222222
62774,62780,65644,6,2864,2,18000,1.00209497207
62818,62825,65575,7,2750,2,18000,1.00254545455
62835,62841,65525,6,2684,2,18000,1.00223546945
62866,62872,65756,6,2884,2,18000,1.00208044383
63028,63034,65662,6,2628,2,18000,1.00228310502
63047,63053,65683,6,2630,2,18000,1.00228136882
63185,63191,65978,6,2787,2,18000,1.00215285253
63294,63300,66124,6,2824,2,18000,1.00212464589
63411,63417,66239,6,2822,2,18000,1.00212615167
63412,63423,66251,11,2828,2,18000,1.00388967468
63447,63453,66262,6,2809,2,18000,1.00213599146
64016,64022,66652,6,2630,2,18000,1.00228136882
64035,64041,66924,6,2883,2,18000,1.00208116545
64091,64097,66824,6,2727,2,18000,1.00220022002
64144,64150,66938,6,2788,2,18000,1.00215208034
64529,64535,67353,6,2818,2,18000,1.00212916962
64530,64541,67348,11,2807,2,18000,1.00391877449
64565,64571,67259,6,2688,2,18000,1.00223214286
64674,64680,67246,6,2566,2,18000,1.00233826968
64782,64788,67571,6,2783,2,18000,1.00215594682
64838,64844,67567,6,2723,2,18000,1.00220345207
64854,64860,67618,6,2758,2,18000,1.00217548949
64873,64879,67583,6,2704,2,18000,1.00221893491
64929,64935,67552,6,2617,2,18000,1.00229270157
64951,64957,67778,6,2821,2,18000,1.00212690535
64970,64976,67769,6,2793,2,18000,1.00214822771
64998,65005,67577,7,2572,2,18000,1.00272161742
65021,65027,67871,6,2844,2,18000,1.00210970464
65121,65128,67917,7,2789,2,18000,1.00250986016
65123,65134,67823,11,2689,2,18000,1.00409074005
65177,65183,67971,6,2788,2,18000,1.00215208034
65232,65238,68058,6,2820,2,18000,1.00212765957
65233,65244,67921,11,2677,2,18000,1.00410907733
65249,65255,68040,6,2785,2,18000,1.00215439856
65340,65347,67993,7,2646,2,18000,1.00264550265
65372,65378,67936,6,2558,2,18000,1.00234558249
65528,65534,68327,6,2793,2,18000,1.00214822771
65578,65585,68313,7,2728,2,18000,1.0025659824
65594,65600,68456,6,2856,2,18000,1.00210084034
65648,65654,68267,6,2613,2,18000,1.00229621125
65664,65671,68371,7,2700,2,18000,1.00259259259
65686,65693,68514,7,2821,2,18000,1.00248138958
65759,65765,68453,6,2688,2,18000,1.00223214286
65980,65986,68819,6,2833,2,18000,1.00211789622
66127,66133,68872,6,2739,2,18000,1.0021905805
66243,66249,69087,6,2838,2,18000,1.0021141649
66260,66266,69062,6,2796,2,18000,1.00214592275
66275,66281,69058,6,2777,2,18000,1.00216060497
66653,66659,69389,6,2730,2,18000,1.0021978022
66826,66832,69617,6,2785,2,18000,1.00215439856
66925,66931,69610,6,2679,2,18000,1.00223964166
66941,66947,69751,6,2804,2,18000,1.00213980029
67250,67256,70034,6,2778,2,18000,1.00215982721
67267,67273,69973,6,2700,2,18000,1.00222222222
67351,67357,70185,6,2828,2,18000,1.00212164074
67367,67373,70173,6,2800,2,18000,1.00214285714
67556,67562,70401,6,2839,2,18000,1.00211342022
67573,67578,70430,5,2852,2,18000,1.00175315568
67574,67584,70362,10,2778,2,18000,1.00359971202
67587,67593,90588,6,22995,1,36000,1.00026092629
67590,67599,70349,9,2750,2,18000,1.00327272727
67591,67604,70387,13,2783,2,18000,1.00467121811
67619,67626,70338,7,2712,2,18000,1.00258112094
67705,67711,90599,6,22888,1,36000,1.0002621461
67771,67777,70665,6,2888,2,18000,1.00207756233
67787,67793,70524,6,2731,2,18000,1.00219699744
67825,67831,70635,6,2804,2,18000,1.00213980029
67875,67881,70733,6,2852,2,18000,1.00210378682
67918,67924,70697,6,2773,2,18000,1.0021637216
67934,67940,70783,6,2843,2,18000,1.00211044671
67950,67956,70762,6,2806,2,18000,1.00213827512
67972,67979,70770,7,2791,2,18000,1.00250806163
67995,68001,70767,6,2766,2,18000,1.0021691974
68042,68048,70868,6,2820,2,18000,1.00212765957
68061,68067,70936,6,2869,2,18000,1.00209132102
68269,68275,71057,6,2782,2,18000,1.00215672178
68315,68321,71155,6,2834,2,18000,1.00211714891
68332,68338,71037,6,2699,2,18000,1.00222304557
68374,68380,71236,6,2856,2,18000,1.00210084034
68456,68462,71128,6,2666,2,18000,1.00225056264
68458,68468,71225,10,2757,2,18000,1.00362713094
68518,68524,71274,6,2750,2,18000,1.00218181818
68822,68828,71639,6,2811,2,18000,1.00213447172
68888,68894,71573,6,2679,2,18000,1.00223964166
69063,69069,71853,6,2784,2,18000,1.00215517241
69064,69075,71760,11,2685,2,18000,1.00409683426
69091,69097,71818,6,2721,2,18000,1.00220507166
69392,69399,72067,7,2668,2,18000,1.00262368816
69611,69617,72417,6,2800,2,18000,1.00214285714
69627,69633,72460,6,2827,2,18000,1.00212239123
69755,69760,72577,5,2817,2,18000,1.00177493788
69974,69980,72723,6,2743,2,18000,1.00218738607
70037,70043,72818,6,2775,2,18000,1.00216216216
70175,70181,73066,6,2885,2,18000,1.0020797227
70191,70197,72868,6,2671,2,18000,1.00224634968
70340,70346,73197,6,2851,2,18000,1.00210452473
70356,70362,73137,6,2775,2,18000,1.00216216216
70372,70378,73122,6,2744,2,18000,1.00218658892
70391,70397,73105,6,2708,2,18000,1.00221565731
70407,70413,73187,6,2774,2,18000,1.0021629416
70433,70439,73103,6,2664,2,18000,1.00225225225
70527,70534,73204,7,2670,2,18000,1.00262172285
70636,70642,73470,6,2828,2,18000,1.00212164074
70669,70675,73452,6,2777,2,18000,1.00216060497
70702,70708,73609,6,2901,2,18000,1.00206825233
70737,70743,73544,6,2801,2,18000,1.00214209211
70766,70772,73489,6,2717,2,18000,1.002208318
70783,70789,73589,6,2800,2,18000,1.00214285714
70784,70795,73637,11,2842,2,18000,1.00387051372
70785,70800,73535,15,2735,2,18000,1.00548446069
70871,70877,73690,6,2813,2,18000,1.00213295414
70938,70943,73754,5,2811,2,18000,1.00177872643
71039,71045,73712,6,2667,2,18000,1.00224971879
71059,71065,73801,6,2736,2,18000,1.00219298246
71129,71135,73934,6,2799,2,18000,1.00214362272
71158,71164,73942,6,2778,2,18000,1.00215982721
71229,71235,74034,6,2799,2,18000,1.00214362272
71245,71251,74074,6,2823,2,18000,1.00212539851
71278,71284,73982,6,2698,2,18000,1.00222386953
71577,71583,74246,6,2663,2,18000,1.00225309801
71641,71647,74433,6,2786,2,18000,1.00215362527
71764,71770,74468,6,2698,2,18000,1.00222386953
71823,71829,74615,6,2786,2,18000,1.00215362527
71855,71862,74657,7,2795,2,18000,1.00250447227
72069,72075,74740,6,2665,2,18000,1.00225140713
72114,72120,72121,6,1,2,300,1.0
72419,72425,75227,6,2802,2,18000,1.00214132762
72463,72470,75138,7,2668,2,18000,1.00262368816
72580,72586,75413,6,2827,2,18000,1.00212239123
72726,72732,75536,6,2804,2,18000,1.00213980029
72821,72827,75615,6,2788,2,18000,1.00215208034
72869,72875,75618,6,2743,2,18000,1.00218738607
73068,73074,75908,6,2834,2,18000,1.00211714891
73107,73113,75843,6,2730,2,18000,1.0021978022
73108,73119,75866,11,2747,2,18000,1.0040043684
73124,73131,75988,7,2857,2,18000,1.00245012251
73141,73147,75943,6,2796,2,18000,1.00214592275
73189,73195,75990,6,2795,2,18000,1.00214669052
73205,73211,75815,6,2604,2,18000,1.00230414747
73206,73217,75991,11,2774,2,18000,1.00396539293
73454,73460,76134,6,2674,2,18000,1.00224382947
73473,73479,76171,6,2692,2,18000,1.00222882615
73493,73499,76338,6,2839,2,18000,1.00211342022
73537,73543,76286,6,2743,2,18000,1.00218738607
73553,73559,76443,6,2884,2,18000,1.00208044383
73592,73598,76472,6,2874,2,18000,1.00208768267
73611,73617,76525,6,2908,2,18000,1.00206327373
73640,73647,76494,7,2847,2,18000,1.00245872849
73692,73698,76527,6,2829,2,18000,1.00212089077
73714,73720,76510,6,2790,2,18000,1.00215053763
73756,73762,76459,6,2697,2,18000,1.0022246941
73805,73811,76647,6,2836,2,18000,1.00211565585
73936,73942,76709,6,2767,2,18000,1.00216841344
73952,73958,76534,6,2576,2,18000,1.00232919255
73984,73990,76815,6,2825,2,18000,1.00212389381
74035,74041,76877,6,2836,2,18000,1.00211565585
74077,74083,76901,6,2818,2,18000,1.00212916962
74248,74254,77062,6,2808,2,18000,1.00213675214
74436,74443,77114,7,2671,2,18000,1.0026207413
74472,74478,77247,6,2769,2,18000,1.00216684724
74619,74625,77433,6,2808,2,18000,1.00213675214
74671,74677,77450,6,2773,2,18000,1.0021637216
74742,74748,77525,6,2777,2,18000,1.00216060497
75140,75146,77991,6,2845,2,18000,1.00210896309
75231,75238,77932,7,2694,2,18000,1.00259836674
75415,75421,78183,6,2762,2,18000,1.00217233888
75540,75546,78328,6,2782,2,18000,1.00215672178
75616,75623,78264,7,2641,2,18000,1.00265051117
75633,75639,78337,6,2698,2,18000,1.00222386953
75816,75823,78622,7,2799,2,18000,1.00250089318
75846,75852,78700,6,2848,2,18000,1.00210674157
75869,75875,78553,6,2678,2,18000,1.00224047797
75911,75917,78764,6,2847,2,18000,1.00210748156
75945,75951,78805,6,2854,2,18000,1.00210231254
75991,75997,78792,6,2795,2,18000,1.00214669052
75992,76003,78858,11,2855,2,18000,1.00385288967
76008,76014,78777,6,2763,2,18000,1.00217155266
76136,76142,79006,6,2864,2,18000,1.00209497207
76171,76177,78896,6,2719,2,18000,1.00220669364
76290,76297,79029,7,2732,2,18000,1.00256222548
76340,76347,79193,7,2846,2,18000,1.00245959241
76445,76452,79256,7,2804,2,18000,1.00249643367
76461,76467,79154,6,2687,2,18000,1.00223297358
76477,76483,79265,6,2782,2,18000,1.00215672178
76496,76502,79325,6,2823,2,18000,1.00212539851
76512,76518,79336,6,2818,2,18000,1.00212916962
76528,76535,79392,7,2857,2,18000,1.00245012251
76530,76541,79405,11,2864,2,18000,1.00384078212
76546,76552,79382,6,2830,2,18000,1.00212014134
76649,76655,79455,6,2800,2,18000,1.00214285714
76711,76717,79439,6,2722,2,18000,1.00220426157
76817,76824,79528,7,2704,2,18000,1.0025887574
76880,76886,79744,6,2858,2,18000,1.00209937019
76905,76911,79611,6,2700,2,18000,1.00222222222
77065,77071,79783,6,2712,2,18000,1.00221238938
77116,77122,79971,6,2849,2,18000,1.00210600211
77249,77255,79966,6,2711,2,18000,1.00221320546
77435,77442,80204,7,2762,2,18000,1.00253439537
77452,77458,80208,6,2750,2,18000,1.00218181818
77531,77536,80232,5,2696,2,18000,1.00185459941
77935,77941,80625,6,2684,2,18000,1.00223546945
77995,78001,80823,6,2822,2,18000,1.00212615167
78190,78196,80846,6,2650,2,18000,1.00226415094
78265,78272,81120,7,2848,2,18000,1.00245786517
78332,78338,81038,6,2700,2,18000,1.00222222222
78348,78354,80901,6,2547,2,18000,1.0023557126
78555,78561,81361,6,2800,2,18000,1.00214285714
78629,78635,81437,6,2802,2,18000,1.00214132762
78702,78708,81546,6,2838,2,18000,1.0021141649
78767,78773,81570,6,2797,2,18000,1.00214515552
78784,78790,81590,6,2800,2,18000,1.00214285714
78800,78806,81682,6,2876,2,18000,1.00208623088
78816,78822,81561,6,2739,2,18000,1.0021905805
78860,78866,81636,6,2770,2,18000,1.00216606498
78898,78904,81674,6,2770,2,18000,1.00216606498
79010,79016,81729,6,2713,2,18000,1.0022115739
79033,79039,81874,6,2835,2,18000,1.00211640212
79153,79159,81967,6,2808,2,18000,1.00213675214
79194,79201,82014,7,2813,2,18000,1.0024884465
79258,79265,82046,7,2781,2,18000,1.00251708019
79275,79281,82107,6,2826,2,18000,1.00212314225
79328,79335,82076,7,2741,2,18000,1.00255381248
79345,79351,82140,6,2789,2,18000,1.00215130871
79384,79391,82192,7,2801,2,18000,1.00249910746
79400,79407,82282,7,2875,2,18000,1.00243478261
79417,79424,82166,7,2742,2,18000,1.00255288111
79440,79446,82282,6,2836,2,18000,1.00211565585
79457,79463,82125,6,2662,2,18000,1.0022539444
79532,79538,82259,6,2721,2,18000,1.00220507166
79612,79619,82431,7,2812,2,18000,1.00248933144
79746,79752,82551,6,2799,2,18000,1.00214362272
79787,79793,82497,6,2704,2,18000,1.00221893491
79967,79973,82778,6,2805,2,18000,1.00213903743
79983,79989,82696,6,2707,2,18000,1.0022164758
80205,80212,82935,7,2723,2,18000,1.00257069409
80221,80227,82976,6,2749,2,18000,1.00218261186
80237,80243,83041,6,2798,2,18000,1.00214438885
80628,80635,83291,7,2656,2,18000,1.00263554217
80781,80788,80793,7,5,2,300,1.2
80804,80811,80845,7,34,2,300,1.20588235294
80826,80833,83723,7,2890,2,18000,1.00242214533
80848,80855,83515,7,2660,2,18000,1.00263157895
80856,80867,80939,11,72,2,360,1.15277777778
80905,80911,83614,6,2703,2,18000,1.00221975583
80948,80954,81088,6,134,2,360,1.0447761194
81041,81047,83920,6,2873,2,18000,1.00208840933
81122,81128,83928,6,2800,2,18000,1.00214285714
81231,81237,81273,6,36,2,300,1.16666666667
81284,81290,81328,6,38,2,300,1.15789473684
81340,81346,81657,6,311,2,300,1.0192926045
81363,81370,84226,7,2856,2,18000,1.00245098039
81441,81447,84250,6,2803,2,18000,1.00214056368
81549,81555,84204,6,2649,2,18000,1.00226500566
81564,81570,84404,6,2834,2,18000,1.00211714891
81580,81586,84355,6,2769,2,18000,1.00216684724
81596,81602,84299,6,2697,2,18000,1.0022246941
81640,81646,84335,6,2689,2,18000,1.00223131276
81672,81678,82033,6,355,2,360,1.01690140845
81677,81684,84482,7,2798,2,18000,1.00250178699
81693,81699,84378,6,2679,2,18000,1.00223964166
81730,81736,84445,6,2709,2,18000,1.00221483942
81876,81882,84683,6,2801,2,18000,1.00214209211
81970,81976,84724,6,2748,2,18000,1.00218340611
82016,82022,84801,6,2779,2,18000,1.00215905002
82047,82054,84927,7,2873,2,18000,1.00243647755
82049,82060,82407,11,347,2,360,1.03170028818
82079,82085,84982,6,2897,2,18000,1.00207110804
82110,82116,84747,6,2631,2,18000,1.00228050171
82129,82135,85018,6,2883,2,18000,1.00208116545
82145,82151,84991,6,2840,2,18000,1.00211267606
82170,82176,84883,6,2707,2,18000,1.0022164758
82195,82201,85044,6,2843,2,18000,1.00211044671
82262,82268,84973,6,2705,2,18000,1.0022181146
82285,82291,85023,6,2732,2,18000,1.00219619327
82286,82297,85155,11,2858,2,18000,1.00384884535
82434,82440,85238,6,2798,2,18000,1.00214438885
82499,82506,85316,7,2810,2,18000,1.0024911032
82553,82559,85326,6,2767,2,18000,1.00216841344
82698,82704,85323,6,2619,2,18000,1.00229095074
82780,82786,85588,6,2802,2,18000,1.00214132762
82938,82944,85581,6,2637,2,18000,1.00227531286
82979,82985,85708,6,2723,2,18000,1.00220345207
83044,83050,85734,6,2684,2,18000,1.00223546945
83293,83299,85977,6,2678,2,18000,1.00224047797
83516,83522,86099,6,2577,2,18000,1.00232828871
83617,83623,86309,6,2686,2,18000,1.00223380491
83727,83733,86585,6,2852,2,18000,1.00210378682
83921,83927,86706,6,2779,2,18000,1.00215905002
83937,83944,86708,7,2764,2,18000,1.00253256151
84206,84212,86954,6,2742,2,18000,1.00218818381
84229,84235,86932,6,2697,2,18000,1.0022246941
84254,84260,86970,6,2710,2,18000,1.00221402214
84301,84307,86968,6,2661,2,18000,1.00225479143
84338,84344,87134,6,2790,2,18000,1.00215053763
84357,84363,87031,6,2668,2,18000,1.00224887556
84377,84383,87154,6,2771,2,18000,1.00216528329
84408,84414,87218,6,2804,2,18000,1.00213980029
84446,84452,87145,6,2693,2,18000,1.00222799851
84484,84491,87353,7,2862,2,18000,1.00244584207
84684,84690,87471,6,2781,2,18000,1.0021574973
84727,84733,87534,6,2801,2,18000,1.00214209211
84749,84755,87569,6,2814,2,18000,1.00213219616
84804,84810,87566,6,2756,2,18000,1.00217706821
84885,84892,87578,7,2686,2,18000,1.00260610573
84929,84936,87693,7,2757,2,18000,1.00253899166
84978,84984,87838,6,2854,2,18000,1.00210231254
84994,85000,87553,6,2553,2,18000,1.00235017626
84995,85006,87757,11,2751,2,18000,1.00399854598
85022,85028,87815,6,2787,2,18000,1.00215285253
85038,85045,87834,7,2789,2,18000,1.00250986016
85054,85061,87871,7,2810,2,18000,1.0024911032
85158,85164,87849,6,2685,2,18000,1.00223463687
85241,85247,88174,6,2927,2,18000,1.00204988042
85320,85326,88103,6,2777,2,18000,1.00216060497
85336,85342,88049,6,2707,2,18000,1.0022164758
85337,85348,88264,11,2916,2,18000,1.00377229081
85583,85589,88305,6,2716,2,18000,1.00220913108
85599,85606,88404,7,2798,2,18000,1.00250178699
85711,85717,88319,6,2602,2,18000,1.00230591852
85736,85742,88362,6,2620,2,18000,1.00229007634
85976,85983,88774,7,2791,2,18000,1.00250806163
86047,86053,86116,6,63,2,3540,1.09523809524
86102,86108,88807,6,2699,2,18000,1.00222304557
86311,86317,88976,6,2659,2,18000,1.0022564874
86588,86594,89390,6,2796,2,18000,1.00214592275
86710,86716,89517,6,2801,2,18000,1.00214209211
86711,86722,89355,11,2633,2,18000,1.00417774402
86934,86940,89690,6,2750,2,18000,1.00218181818
86957,86963,89841,6,2878,2,18000,1.0020847811
86974,86979,89791,5,2812,2,18000,1.00177809388
86975,86985,89780,10,2795,2,18000,1.00357781753
87032,87038,89811,6,2773,2,18000,1.0021637216
87137,87144,89981,7,2837,2,18000,1.00246739514
87154,87161,89940,7,2779,2,18000,1.00251889169
87156,87166,89952,10,2786,2,18000,1.00358937545
87222,87228,90047,6,2819,2,18000,1.00212841433
87357,87363,90059,6,2696,2,18000,1.00222551929
87473,87479,90175,6,2696,2,18000,1.00222551929
87536,87543,90271,7,2728,2,18000,1.0025659824
87556,87562,90277,6,2715,2,18000,1.00220994475
87572,87578,90129,6,2551,2,18000,1.00235201882
87574,87584,90363,10,2779,2,18000,1.0035984167
87590,87596,90325,6,2729,2,18000,1.00219860755
87697,87703,90569,6,2866,2,18000,1.00209351012
87760,87766,90449,6,2683,2,18000,1.00223630265
87817,87823,90530,6,2707,2,18000,1.0022164758
87836,87842,90668,6,2826,2,18000,1.00212314225
87852,87859,90686,7,2827,2,18000,1.0024761231
87854,87865,90626,11,2761,2,18000,1.00398406375
87873,87879,90587,6,2708,2,18000,1.00221565731
88053,88059,90877,6,2818,2,18000,1.00212916962
88106,88112,90929,6,2817,2,18000,1.00212992545
88175,88181,91055,6,2874,2,18000,1.00208768267
88266,88272,91044,6,2772,2,18000,1.00216450216
88308,88314,91064,6,2750,2,18000,1.00218181818
88323,88329,91101,6,2772,2,18000,1.00216450216
88364,88370,91089,6,2719,2,18000,1.00220669364
88407,88413,91253,6,2840,2,18000,1.00211267606
88777,88783,91595,6,2812,2,18000,1.00213371266
88809,88815,91436,6,2621,2,18000,1.00228920259
88978,88984,91788,6,2804,2,18000,1.00213980029
89358,89365,92190,7,2825,2,18000,1.00247787611
89393,89399,92156,6,2757,2,18000,1.00217627856
89518,89524,92267,6,2743,2,18000,1.00218738607
89692,89698,92493,6,2795,2,18000,1.00214669052
89784,89790,92566,6,2776,2,18000,1.00216138329
89800,89806,92590,6,2784,2,18000,1.00215517241
89816,89822,92608,6,2786,2,18000,1.00215362527
89844,89850,92700,6,2850,2,18000,1.00210526316
89944,89951,92749,7,2798,2,18000,1.00250178699
89960,89966,92661,6,2695,2,18000,1.00222634508
89985,89991,92821,6,2830,2,18000,1.00212014134
90051,90057,92881,6,2824,2,18000,1.00212464589
90066,90073,92740,7,2667,2,18000,1.00262467192
90132,90138,92908,6,2770,2,18000,1.00216606498
90176,90182,92899,6,2717,2,18000,1.002208318
90275,90281,93089,6,2808,2,18000,1.00213675214
90291,90297,93031,6,2734,2,18000,1.00219458669
90328,90334,93102,6,2768,2,18000,1.00216763006
90366,90372,93179,6,2807,2,18000,1.00213751336
90451,90457,93183,6,2726,2,18000,1.00220102715
90532,90538,93420,6,2882,2,18000,1.00208188758
90572,90578,93451,6,2873,2,18000,1.00208840933
90591,90597,93325,6,2728,2,18000,1.00219941349
90628,90634,93463,6,2829,2,18000,1.00212089077
90671,90678,93530,7,2852,2,18000,1.00245441795
90687,90693,93398,6,2705,2,18000,1.0022181146
90879,90885,93633,6,2748,2,18000,1.00218340611
90932,90938,93739,6,2801,2,18000,1.00214209211
91047,91053,93675,6,2622,2,18000,1.00228832952
91063,91070,93887,7,2817,2,18000,1.00248491303
91079,91085,93922,6,2837,2,18000,1.00211491012
91095,91101,93991,6,2890,2,18000,1.00207612457
91111,91117,93904,6,2787,2,18000,1.00215285253
91258,91264,94169,6,2905,2,18000,1.00206540448
91438,91444,94281,6,2837,2,18000,1.00211491012
91598,91604,94434,6,2830,2,18000,1.00212014134
91791,91797,94632,6,2835,2,18000,1.00211640212
92159,92165,94831,6,2666,2,18000,1.00225056264
92194,92200,95016,6,2816,2,18000,1.00213068182
92268,92274,95073,6,2799,2,18000,1.00214362272
92497,92503,95326,6,2823,2,18000,1.00212539851
92569,92575,95371,6,2796,2,18000,1.00214592275
92594,92600,95284,6,2684,2,18000,1.00223546945
92610,92616,95346,6,2730,2,18000,1.0021978022
92663,92669,95495,6,2826,2,18000,1.00212314225
92704,92710,95527,6,2817,2,18000,1.00212992545
92744,92750,95352,6,2602,2,18000,1.00230591852
92760,92766,95601,6,2835,2,18000,1.00211640212
92824,92831,95718,7,2887,2,18000,1.00242466228
92884,92890,95631,6,2741,2,18000,1.00218898212
92903,92909,95680,6,2771,2,18000,1.00216528329
92918,92924,95736,6,2812,2,18000,1.00213371266
93032,93038,95755,6,2717,2,18000,1.002208318
93091,93098,95917,7,2819,2,18000,1.00248315005
93107,93113,95972,6,2859,2,18000,1.00209863589
93182,93188,95803,6,2615,2,18000,1.00229445507
93197,93203,96023,6,2820,2,18000,1.00212765957
93327,93334,96038,7,2704,2,18000,1.0025887574
93399,93405,96296,6,2891,2,18000,1.00207540643
93421,93428,96224,7,2796,2,18000,1.00250357654
93453,93459,96272,6,2813,2,18000,1.00213295414
93468,93474,96330,6,2856,2,18000,1.00210084034
93533,93539,96302,6,2763,2,18000,1.00217155266
93635,93641,96338,6,2697,2,18000,1.0022246941
93676,93682,96535,6,2853,2,18000,1.00210304942
93741,93747,96553,6,2806,2,18000,1.00213827512
93891,93897,96675,6,2778,2,18000,1.00215982721
93907,93913,96587,6,2674,2,18000,1.00224382947
93926,93932,96681,6,2749,2,18000,1.00218261186
93992,93998,96799,6,2801,2,18000,1.00214209211
94172,94178,96981,6,2803,2,18000,1.00214056368
94284,94290,97091,6,2801,2,18000,1.00214209211
94436,94442,97238,6,2796,2,18000,1.00214592275
94635,94641,97510,6,2869,2,18000,1.00209132102
94835,94841,97741,6,2900,2,18000,1.00206896552
95020,95026,97869,6,2843,2,18000,1.00211044671
95077,95083,97880,6,2797,2,18000,1.00214515552
95288,95294,98135,6,2841,2,18000,1.00211193242
95330,95336,97992,6,2656,2,18000,1.00225903614
95349,95355,98185,6,2830,2,18000,1.00212014134
95365,95371,98092,6,2721,2,18000,1.00220507166
95381,95387,98153,6,2766,2,18000,1.0021691974
95498,95504,98273,6,2769,2,18000,1.00216684724
95530,95536,98331,6,2795,2,18000,1.00214669052
95602,95608,98449,6,2841,2,18000,1.00211193242
95634,95640,98451,6,2811,2,18000,1.00213447172
95682,95688,98467,6,2779,2,18000,1.00215905002
95720,95726,98292,6,2566,2,18000,1.00233826968
95739,95745,98504,6,2759,2,18000,1.00217470098
95758,95764,98510,6,2746,2,18000,1.00218499636
95805,95811,98527,6,2716,2,18000,1.00220913108
95920,95926,98445,6,2519,2,18000,1.00238189758
95976,95982,98632,6,2650,2,18000,1.00226415094
96027,96033,98666,6,2633,2,18000,1.00227876946
96043,96049,98829,6,2780,2,18000,1.00215827338
96227,96234,98947,7,2713,2,18000,1.00258016955
96275,96281,98976,6,2695,2,18000,1.00222634508
96300,96306,98863,6,2557,2,18000,1.0023464998
96315,96322,99083,7,2761,2,18000,1.00253531329
96332,96338,98991,6,2653,2,18000,1.00226159065
96348,96354,99113,6,2759,2,18000,1.00217470098
96538,96545,99342,7,2797,2,18000,1.00250268144
96555,96561,99240,6,2679,2,18000,1.00223964166
96590,96596,99378,6,2782,2,18000,1.00215672178
96678,96684,99431,6,2747,2,18000,1.00218420095
96693,96700,99368,7,2668,2,18000,1.00262368816
96801,96807,99591,6,2784,2,18000,1.00215517241
96985,96991,99749,6,2758,2,18000,1.00217548949
97094,97101,99853,7,2752,2,18000,1.00254360465
97241,97247,99859,6,2612,2,18000,1.00229709035
97513,97519,100367,6,2848,2,18000,1.00210674157
97743,97750,100647,7,2897,2,18000,1.00241629272
97871,97877,100647,6,2770,2,18000,1.00216606498
97887,97894,100681,7,2787,2,18000,1.00251166128
97994,98000,100691,6,2691,2,18000,1.0022296544
98095,98101,100905,6,2804,2,18000,1.00213980029
98139,98145,100888,6,2743,2,18000,1.00218738607
98155,98161,100932,6,2771,2,18000,1.00216528329
98189,98196,100864,7,2668,2,18000,1.00262368816
98277,98283,101029,6,2746,2,18000,1.00218499636
98294,98300,101037,6,2737,2,18000,1.00219218122
98335,98341,101001,6,2660,2,18000,1.0022556391
98449,98455,101179,6,2724,2,18000,1.00220264317
98465,98471,101244,6,2773,2,18000,1.0021637216
98466,98477,101276,11,2799,2,18000,1.00392997499
98483,98489,101268,6,2779,2,18000,1.00215905002
98506,98512,101286,6,2774,2,18000,1.0021629416
98522,98528,101361,6,2833,2,18000,1.00211789622
98538,98544,101362,6,2818,2,18000,1.00212916962
98634,98640,101444,6,2804,2,18000,1.00213980029
98669,98675,101503,6,2828,2,18000,1.00212164074
98831,98837,101675,6,2838,2,18000,1.0021141649
98866,98872,101724,6,2852,2,18000,1.00210378682
98955,98961,101710,6,2749,2,18000,1.00218261186
98980,98986,101607,6,2621,2,18000,1.00228920259
98998,99004,101808,6,2804,2,18000,1.00213980029
99091,99097,101903,6,2806,2,18000,1.00213827512
99117,99123,102018,6,2895,2,18000,1.00207253886
99243,99249,101862,6,2613,2,18000,1.00229621125
99345,99351,101966,6,2615,2,18000,1.00229445507
99371,99377,102180,6,2803,2,18000,1.00214056368
99387,99393,102204,6,2811,2,18000,1.00213447172
99436,99442,102144,6,2702,2,18000,1.00222057735
99592,99599,102306,7,2707,2,18000,1.00258588844
99753,99759,102497,6,2738,2,18000,1.00219138057
99855,99861,102645,6,2784,2,18000,1.00215517241
99872,99878,102626,6,2748,2,18000,1.00218340611
100370,100377,103149,7,2772,2,18000,1.00252525253
100643,100650,103519,7,2869,2,18000,1.00243987452
100659,100666,103338,7,2672,2,18000,1.00261976048
100682,100688,103412,6,2724,2,18000,1.00220264317
100698,100704,103527,6,2823,2,18000,1.00212539851
100868,100874,103694,6,2820,2,18000,1.00212765957
100890,100897,103735,7,2838,2,18000,1.00246652572
100906,100913,103718,7,2805,2,18000,1.00249554367
100935,100941,103737,6,2796,2,18000,1.00214592275
101004,101010,103868,6,2858,2,18000,1.00209937019
101033,101039,103863,6,2824,2,18000,1.00212464589
101048,101055,103758,7,2703,2,18000,1.00258971513
101182,101188,103845,6,2657,2,18000,1.00225818592
101247,101253,104116,6,2863,2,18000,1.00209570381
101270,101276,104065,6,2789,2,18000,1.00215130871
101286,101292,104140,6,2848,2,18000,1.00210674157
101301,101307,104031,6,2724,2,18000,1.00220264317
101364,101370,104200,6,2830,2,18000,1.00212014134
101365,101376,104070,11,2694,2,18000,1.00408314774
101446,101452,104176,6,2724,2,18000,1.00220264317
101506,101512,104330,6,2818,2,18000,1.00212916962
101609,101615,104392,6,2777,2,18000,1.00216060497
101677,101684,104466,7,2782,2,18000,1.00251617541
101712,101718,104396,6,2678,2,18000,1.00224047797
101728,101734,104439,6,2705,2,18000,1.0022181146
101812,101818,104588,6,2770,2,18000,1.00216606498
101865,101871,104698,6,2827,2,18000,1.00212239123
101905,101911,104720,6,2809,2,18000,1.00213599146
101968,101974,104754,6,2780,2,18000,1.00215827338
102022,102028,104740,6,2712,2,18000,1.00221238938
102149,102154,104957,5,2803,2,18000,1.00178380307
102183,102189,104993,6,2804,2,18000,1.00213980029
102205,102212,104955,7,2743,2,18000,1.00255195042
102308,102314,104992,6,2678,2,18000,1.00224047797
102499,102505,105444,6,2939,2,18000,1.00204151072
102628,102633,105422,5,2789,2,18000,1.00179275726
102646,102653,105322,7,2669,2,18000,1.00262270513
103153,103159,105850,6,2691,2,18000,1.0022296544
103341,103347,106106,6,2759,2,18000,1.00217470098
103415,103422,106151,7,2729,2,18000,1.00256504214
103523,103530,106373,7,2843,2,18000,1.00246218783
103539,103546,106402,7,2856,2,18000,1.00245098039
103697,103704,106480,7,2776,2,18000,1.00252161383
103720,103726,106487,6,2761,2,18000,1.00217312568
103739,103745,106339,6,2594,2,18000,1.00231303007
103741,103751,106532,10,2781,2,18000,1.00359582884
103760,103766,106545,6,2779,2,18000,1.00215905002
103847,103854,106635,7,2781,2,18000,1.00251708019
103866,103873,106739,7,2866,2,18000,1.00244242847
103882,103888,106710,6,2822,2,18000,1.00212615167
104033,104039,106818,6,2779,2,18000,1.00215905002
104067,104074,106869,7,2795,2,18000,1.00250447227
104083,104090,106799,7,2709,2,18000,1.00258397933
104118,104124,106718,6,2594,2,18000,1.00231303007
104144,104150,106947,6,2797,2,18000,1.00214515552
104179,104185,106973,6,2788,2,18000,1.00215208034
104204,104210,107026,6,2816,2,18000,1.00213068182
104331,104337,107194,6,2857,2,18000,1.00210010501
104396,104402,107227,6,2825,2,18000,1.00212389381
104398,104408,107158,10,2750,2,18000,1.00363636364
104442,104448,106990,6,2542,2,18000,1.00236034618
104467,104473,107246,6,2773,2,18000,1.0021637216
104592,104598,107400,6,2802,2,18000,1.00214132762
104699,104705,107416,6,2711,2,18000,1.00221320546
104724,104730,107473,6,2743,2,18000,1.00218738607
104743,104749,107435,6,2686,2,18000,1.00223380491
104759,104765,107470,6,2705,2,18000,1.0022181146
104959,104965,107750,6,2785,2,18000,1.00215439856
104960,104971,107764,11,2793,2,18000,1.00393841747
104996,105002,107711,6,2709,2,18000,1.00221483942
104997,105008,107758,11,2750,2,18000,1.004
105325,105331,108134,6,2803,2,18000,1.00214056368
105424,105430,108296,6,2866,2,18000,1.00209351012
105447,105453,108060,6,2607,2,18000,1.00230149597
105854,105861,108678,7,2817,2,18000,1.00248491303
106108,106114,108757,6,2643,2,18000,1.00227014756
106155,106161,109016,6,2855,2,18000,1.00210157618
106341,106347,109219,6,2872,2,18000,1.00208913649
106375,106382,109287,7,2905,2,18000,1.00240963855
106404,106410,109252,6,2842,2,18000,1.0021111893
106482,106488,109199,6,2711,2,18000,1.00221320546
106498,106504,109324,6,2820,2,18000,1.00212765957
106534,106540,109392,6,2852,2,18000,1.00210378682
106551,106558,109266,7,2708,2,18000,1.00258493353
106639,106645,109498,6,2853,2,18000,1.00210304942
106712,106718,109521,6,2803,2,18000,1.00214056368
106728,106734,109569,6,2835,2,18000,1.00211640212
106743,106749,109531,6,2782,2,18000,1.00215672178
106802,106809,109748,7,2939,2,18000,1.0023817625
106822,106828,109866,6,3038,2,18000,1.00197498354
106871,106878,109716,7,2838,2,18000,1.00246652572
106949,106955,109753,6,2798,2,18000,1.00214438885
106974,106981,109821,7,2840,2,18000,1.00246478873
106993,106999,109774,6,2775,2,18000,1.00216216216
107028,107034,109733,6,2699,2,18000,1.00222304557
107159,107166,109964,7,2798,2,18000,1.00250178699
107197,107204,109901,7,2697,2,18000,1.00259547646
107229,107236,110024,7,2788,2,18000,1.0025107604
107248,107255,110004,7,2749,2,18000,1.0025463805
107403,107409,110103,6,2694,2,18000,1.00222717149
107419,107425,110217,6,2792,2,18000,1.00214899713
107438,107444,110220,6,2776,2,18000,1.00216138329
107473,107480,110172,7,2692,2,18000,1.00260029718
107475,107485,110274,10,2789,2,18000,1.00358551452
107715,107721,110558,6,2837,2,18000,1.00211491012
107753,107759,110587,6,2828,2,18000,1.00212164074
107769,107774,110623,5,2849,2,18000,1.00175500176
107770,107780,110449,10,2669,2,18000,1.00374672162
108061,108068,110956,7,2888,2,18000,1.00242382271
108137,108143,110927,6,2784,2,18000,1.00215517241
108298,108305,111192,7,2887,2,18000,1.00242466228
108679,108685,111460,6,2775,2,18000,1.00216216216
108759,108766,111632,7,2866,2,18000,1.00244242847
109019,109025,111864,6,2839,2,18000,1.00211342022
109202,109208,111977,6,2769,2,18000,1.00216684724
109221,109227,112045,6,2818,2,18000,1.00212916962
109255,109262,112111,7,2849,2,18000,1.00245700246
109271,109277,112081,6,2804,2,18000,1.00213980029
109291,109297,112114,6,2817,2,18000,1.00212992545
109328,109334,112170,6,2836,2,18000,1.00211565585
109394,109400,112165,6,2765,2,18000,1.00216998192
109502,109508,112330,6,2822,2,18000,1.00212615167
109524,109530,112156,6,2626,2,18000,1.00228484387
109540,109546,112280,6,2734,2,18000,1.00219458669
109571,109577,112355,6,2778,2,18000,1.00215982721
109717,109723,112543,6,2820,2,18000,1.00212765957
109735,109742,112549,7,2807,2,18000,1.00249376559
109751,109757,112547,6,2790,2,18000,1.00215053763
109767,109773,112553,6,2780,2,18000,1.00215827338
109783,109789,112603,6,2814,2,18000,1.00213219616
109824,109830,112642,6,2812,2,18000,1.00213371266
109868,109874,112519,6,2645,2,18000,1.002268431
109903,109909,112731,6,2822,2,18000,1.00212615167
109965,109971,112756,6,2785,2,18000,1.00215439856
110006,110012,112774,6,2762,2,18000,1.00217233888
110028,110034,112842,6,2808,2,18000,1.00213675214
110103,110109,112846,6,2737,2,18000,1.00219218122
110174,110180,112982,6,2802,2,18000,1.00214132762
110218,110225,113006,7,2781,2,18000,1.00251708019
110234,110241,113139,7,2898,2,18000,1.00241545894
110276,110282,113099,6,2817,2,18000,1.00212992545
110451,110457,113213,6,2756,2,18000,1.00217706821
110561,110567,113312,6,2745,2,18000,1.00218579235
110590,110596,113338,6,2742,2,18000,1.00218818381
110624,110630,113418,6,2788,2,18000,1.00215208034
110929,110935,113708,6,2773,2,18000,1.0021637216
110958,110964,113808,6,2844,2,18000,1.00210970464
111195,111202,114019,7,2817,2,18000,1.00248491303
111463,111470,114200,7,2730,2,18000,1.00256410256
111636,111642,114431,6,2789,2,18000,1.00215130871
111868,111874,114618,6,2744,2,18000,1.00218658892
111981,111987,114697,6,2710,2,18000,1.00221402214
112047,112053,114849,6,2796,2,18000,1.00214592275
112085,112091,114946,6,2855,2,18000,1.00210157618
112114,112120,114906,6,2786,2,18000,1.00215362527
112129,112136,114951,7,2815,2,18000,1.00248667851
112158,112164,114991,6,2827,2,18000,1.00212239123
112174,112180,114954,6,2774,2,18000,1.0021629416
112175,112186,115041,11,2855,2,18000,1.00385288967
112282,112288,115086,6,2798,2,18000,1.00214438885
112331,112337,115138,6,2801,2,18000,1.00214209211
112356,112363,115207,7,2844,2,18000,1.00246132208
112523,112529,115282,6,2753,2,18000,1.00217944061
112545,112551,115223,6,2672,2,18000,1.00224550898
112562,112568,115334,6,2766,2,18000,1.0021691974
112563,112574,115372,11,2798,2,18000,1.00393137956
112565,112579,115393,14,2814,2,18000,1.00497512438
112606,112612,115302,6,2690,2,18000,1.00223048327
112643,112649,115439,6,2790,2,18000,1.00215053763
112733,112739,115438,6,2699,2,18000,1.00222304557
112759,112765,115570,6,2805,2,18000,1.00213903743
112778,112784,115554,6,2770,2,18000,1.00216606498
112845,112850,115638,5,2788,2,18000,1.00179340029
112860,112866,115649,6,2783,2,18000,1.00215594682
112985,112992,115776,7,2784,2,18000,1.00251436782
113008,113014,115826,6,2812,2,18000,1.00213371266
113102,113108,115906,6,2798,2,18000,1.00214438885
113142,113148,115949,6,2801,2,18000,1.00214209211
113217,113223,116103,6,2880,2,18000,1.00208333333
113315,113321,116106,6,2785,2,18000,1.00215439856
113340,113347,116078,7,2731,2,18000,1.00256316368
113422,113428,116276,6,2848,2,18000,1.00210674157
113710,113716,116501,6,2785,2,18000,1.00215439856
113810,113817,116601,7,2784,2,18000,1.00251436782
114022,114028,116789,6,2761,2,18000,1.00217312568
114204,114210,116971,6,2761,2,18000,1.00217312568
114433,114439,117226,6,2787,2,18000,1.00215285253
114620,114627,117428,7,2801,2,18000,1.00249910746
114699,114705,117498,6,2793,2,18000,1.00214822771
114853,114859,117527,6,2668,2,18000,1.00224887556
114910,114916,117765,6,2849,2,18000,1.00210600211
114947,114954,117774,7,2820,2,18000,1.0024822695
114964,114970,117752,6,2782,2,18000,1.00215672178
114965,114976,117778,11,2802,2,18000,1.00392576731
114994,115000,117678,6,2678,2,18000,1.00224047797
115043,115049,117958,6,2909,2,18000,1.00206256446
115087,115093,117808,6,2715,2,18000,1.00220994475
115140,115146,117957,6,2811,2,18000,1.00213447172
115209,115216,118033,7,2817,2,18000,1.00248491303
115225,115232,118007,7,2775,2,18000,1.00252252252
115285,115291,118071,6,2780,2,18000,1.00215827338
115304,115310,117919,6,2609,2,18000,1.0022997317
115336,115342,118148,6,2806,2,18000,1.00213827512
115374,115380,118175,6,2795,2,18000,1.00214669052
115395,115402,118185,7,2783,2,18000,1.00251527129
115441,115447,118252,6,2805,2,18000,1.00213903743
115442,115453,118205,11,2752,2,18000,1.00399709302
115557,115563,118217,6,2654,2,18000,1.00226073851
115573,115579,118375,6,2796,2,18000,1.00214592275
115642,115649,118304,7,2655,2,18000,1.00263653484
115658,115665,118353,7,2688,2,18000,1.00260416667
115778,115784,118576,6,2792,2,18000,1.00214899713
115829,115835,118594,6,2759,2,18000,1.00217470098
115910,115917,118617,7,2700,2,18000,1.00259259259
115951,115957,118839,6,2882,2,18000,1.00208188758
116081,116087,118885,6,2798,2,18000,1.00214438885
116107,116113,118900,6,2787,2,18000,1.00215285253
116108,116119,118707,11,2588,2,18000,1.0042503864
116278,116284,119041,6,2757,2,18000,1.00217627856
116505,116511,119302,6,2791,2,18000,1.00214976711
116604,116611,119445,7,2834,2,18000,1.00247000706
116792,116799,119420,7,2621,2,18000,1.00267073636
116973,116980,119790,7,2810,2,18000,1.0024911032
117229,117235,120021,6,2786,2,18000,1.00215362527
117431,117437,120163,6,2726,2,18000,1.00220102715
117500,117506,120345,6,2839,2,18000,1.00211342022
117529,117535,120174,6,2639,2,18000,1.00227358848
117680,117687,120549,7,2862,2,18000,1.00244584207
117753,117760,120582,7,2822,2,18000,1.00248051028
117770,117776,120587,6,2811,2,18000,1.00213447172
117787,117793,120486,6,2693,2,18000,1.00222799851
117788,117799,120622,11,2823,2,18000,1.00389656394
117810,117816,120588,6,2772,2,18000,1.00216450216
117920,117926,120628,6,2702,2,18000,1.00222057735
117959,117965,120715,6,2750,2,18000,1.00218181818
117960,117971,120743,11,2772,2,18000,1.00396825397
118009,118015,120801,6,2786,2,18000,1.00215362527
118037,118044,120720,7,2676,2,18000,1.00261584454
118073,118079,120806,6,2727,2,18000,1.00220022002
118151,118157,120877,6,2720,2,18000,1.00220588235
118178,118184,120986,6,2802,2,18000,1.00214132762
118194,118201,120896,7,2695,2,18000,1.0025974026
118211,118216,121009,5,2793,2,18000,1.00179018976
118227,118233,120944,6,2711,2,18000,1.00221320546
118255,118261,121076,6,2815,2,18000,1.00213143872
118307,118313,120880,6,2567,2,18000,1.00233735878
118355,118361,121239,6,2878,2,18000,1.0020847811
118378,118384,121075,6,2691,2,18000,1.0022296544
118554,118560,490348,6,371788,2,540000,1.00001613823
118579,118585,121344,6,2759,2,18000,1.00217470098
118595,118602,121189,7,2587,2,18000,1.00270583688
118622,118627,121412,5,2785,2,18000,1.00179533214
118709,118715,121519,6,2804,2,18000,1.00213980029
118840,118846,121614,6,2768,2,18000,1.00216763006
118889,118895,121694,6,2799,2,18000,1.00214362272
118905,118911,121742,6,2831,2,18000,1.00211939244
119044,119050,121914,6,2864,2,18000,1.00209497207
119306,119312,122011,6,2699,2,18000,1.00222304557
119423,119429,122206,6,2777,2,18000,1.00216060497
119446,119452,122262,6,2810,2,18000,1.00213523132
119704,119710,137168,6,17458,4,432000,1.00034368198
119799,119805,122622,6,2817,2,18000,1.00212992545
120024,120030,122861,6,2831,2,18000,1.00211939244
120166,120172,122952,6,2780,2,18000,1.00215827338
120183,120189,122852,6,2663,2,18000,1.00225309801
120347,120353,123149,6,2796,2,18000,1.00214592275
120484,120491,123110,7,2619,2,18000,1.00267277587
120552,120557,123387,5,2830,2,18000,1.00176678445
120585,120591,123293,6,2702,2,18000,1.00222057735
120593,120600,122524,7,1924,1,1800,1.00363825364
120602,120608,123461,6,2853,2,18000,1.00210304942
120603,120614,123506,11,2892,2,18000,1.00380359613
120626,120632,123397,6,2765,2,18000,1.00216998192
120644,120650,123485,6,2835,2,18000,1.00211640212
120723,120729,123527,6,2798,2,18000,1.00214438885
120724,120735,123496,11,2761,2,18000,1.00398406375
120751,120757,123479,6,2722,2,18000,1.00220426157
120806,120812,123678,6,2866,2,18000,1.00209351012
120808,120818,123612,10,2794,2,18000,1.00357909807
120881,120887,123661,6,2774,2,18000,1.0021629416
120882,120893,123679,11,2786,2,18000,1.00394831299
120899,120905,123737,6,2832,2,18000,1.00211864407
120946,120952,123746,6,2794,2,18000,1.00214745884
120990,120996,123782,6,2786,2,18000,1.00215362527
121013,121019,123889,6,2870,2,18000,1.00209059233
121080,121085,123772,5,2687,2,18000,1.00186081131
121081,121091,123871,10,2780,2,18000,1.0035971223
121192,121198,124008,6,2810,2,18000,1.00213523132
121226,121232,373514,6,252282,2,576000,1.00002378291
121242,121248,123890,6,2642,2,18000,1.00227100681
121348,121354,123970,6,2616,2,18000,1.00229357798
121416,121423,124234,7,2811,2,18000,1.002490217
121524,121530,124314,6,2784,2,18000,1.00215517241
121590,121596,121598,6,2,1,345600,1.0
121618,121624,124456,6,2832,2,18000,1.00211864407
121657,121663,121664,6,1,1,345600,1.0
121697,121704,124456,7,2752,2,18000,1.00254360465
121745,121751,124551,6,2800,2,18000,1.00214285714
121759,121765,121766,6,1,1,345600,1.0
121915,121921,124728,6,2807,2,18000,1.00213751336
122009,122015,124765,6,2750,2,18000,1.00218181818
122208,122214,124909,6,2695,2,18000,1.00222634508
122218,122224,141365,6,19141,32,21600,1.00031346325
122266,122272,124903,6,2631,2,18000,1.00228050171
122624,122630,125440,6,2810,2,18000,1.00213523132
122692,122698,124595,6,1897,1,1800,1.00316288877
122855,122861,125610,6,2749,2,18000,1.00218261186
122872,122878,125607,6,2729,2,18000,1.00219860755
122953,122960,125673,7,2713,2,18000,1.00258016955
123113,123119,125810,6,2691,2,18000,1.0022296544
123152,123158,125869,6,2711,2,18000,1.00221320546
123296,123302,126160,6,2858,2,18000,1.00209937019
123391,123397,126045,6,2648,2,18000,1.00226586103
123408,123414,126231,6,2817,2,18000,1.00212992545
123463,123469,126218,6,2749,2,18000,1.00218261186
123483,123489,126345,6,2856,2,18000,1.00210084034
123499,123505,126347,6,2842,2,18000,1.0021111893
123501,123511,126330,10,2819,2,18000,1.00354735722
123517,123523,126315,6,2792,2,18000,1.00214899713
123533,123539,126457,6,2918,2,18000,1.00205620288
123616,123622,126230,6,2608,2,18000,1.0023006135
123664,123670,126500,6,2830,2,18000,1.00212014134
123681,123688,126456,7,2768,2,18000,1.00252890173
123683,123694,126478,11,2784,2,18000,1.00395114943
123741,123747,126542,6,2795,2,18000,1.00214669052
123758,123764,126386,6,2622,2,18000,1.00228832952
123775,123781,126671,6,2890,2,18000,1.00207612457
123792,123798,126664,6,2866,2,18000,1.00209351012
123874,123880,126717,6,2837,2,18000,1.00211491012
123891,123897,126792,6,2895,2,18000,1.00207253886
123892,123903,126590,11,2687,2,18000,1.00409378489
123971,123977,126726,6,2749,2,18000,1.00218261186
124010,124016,126719,6,2703,2,18000,1.00221975583
124102,124109,126466,7,2357,1,36000,1.00296987696
124108,124115,126860,7,2745,1,36000,1.00255009107
124237,124243,126996,6,2753,2,18000,1.00217944061
124285,124291,124305,6,14,2,108000,1.42857142857
124317,124324,127027,7,2703,2,18000,1.00258971513
124460,124466,127259,6,2793,2,18000,1.00214822771
124461,124472,127292,11,2820,2,18000,1.00390070922
124552,124559,127289,7,2730,2,18000,1.00256410256
124731,124738,127413,7,2675,2,18000,1.00261682243
124769,124775,127503,6,2728,2,18000,1.00219941349
124906,124912,127734,6,2822,2,18000,1.00212615167
124922,124929,127692,7,2763,2,18000,1.0025334781
125444,125451,128256,7,2805,2,18000,1.00249554367
125611,125617,128430,6,2813,2,18000,1.00213295414
125612,125623,128396,11,2773,2,18000,1.00396682294
125677,125683,128468,6,2785,2,18000,1.00215439856
125814,125821,128500,7,2679,2,18000,1.00261291527
125872,125878,128713,6,2835,2,18000,1.00211640212
126049,126055,128915,6,2860,2,18000,1.0020979021
126163,126169,128906,6,2737,2,18000,1.00219218122
126223,126229,128942,6,2713,2,18000,1.0022115739
126238,126245,129055,7,2810,2,18000,1.0024911032
126240,126251,129129,11,2878,2,18000,1.00382209868
126319,126324,129088,5,2764,2,18000,1.0018089725
126319,126330,126783,11,453,1,36000,1.02428256071
126335,126341,129053,6,2712,2,18000,1.00221238938
126352,126358,129207,6,2849,2,18000,1.00210600211
126353,126364,129206,11,2842,2,18000,1.00387051372
126392,126397,129215,5,2818,2,18000,1.00177430802
126461,126467,129258,6,2791,2,18000,1.00214976711
126462,126473,129305,11,2832,2,18000,1.00388418079
126482,126488,129161,6,2673,2,18000,1.00224466891
126503,126510,129184,7,2674,2,18000,1.00261780105
126545,126551,129237,6,2686,2,18000,1.00223380491
126592,126598,129461,6,2863,2,18000,1.00209570381
126665,126672,129472,7,2800,2,18000,1.0025
126681,126687,129328,6,2641,2,18000,1.00227186672
126720,126726,129325,6,2599,2,18000,1.00230858022
126721,126732,129525,11,2793,2,18000,1.00393841747
126737,126743,129536,6,2793,2,18000,1.00214822771
126794,126800,129455,6,2655,2,18000,1.00225988701
126988,126994,386220,6,259226,1,259200,1.00002314583
126991,127000,386236,9,259236,1,259200,1.0000347174
126999,127006,129687,7,2681,2,18000,1.00261096606
127031,127042,128313,11,1271,1,259200,1.00865460268
127031,127037,129724,6,2687,2,18000,1.00223297358
127262,127268,129724,6,2456,2,18000,1.00244299674
127294,127300,129724,6,2424,2,18000,1.00247524752
127295,127306,129724,11,2418,2,18000,1.00454921423
127415,127421,129724,6,2303,2,18000,1.00260529744
127507,127513,129724,6,2211,2,18000,1.00271370421
127695,127701,129724,6,2023,2,18000,1.00296589224
127737,127743,129724,6,1981,2,18000,1.00302877335
127882,127888,128127,6,239,4,3600,1.02510460251
127959,127965,128507,6,542,4,3600,1.0110701107
128243,128250,135092,7,6842,1,259200,1.00102309266
128258,128264,129724,6,1460,2,18000,1.00410958904
128338,128344,128409,6,65,1,259200,1.09230769231
128398,128404,129724,6,1320,2,18000,1.00454545455
128434,128440,129724,6,1284,2,18000,1.0046728972
128440,128446,131999,6,3553,1,36000,1.00168871376
128473,128479,129724,6,1245,2,18000,1.00481927711
128483,128489,150993,6,22504,1,36000,1.00026661927
128504,128510,129724,6,1214,2,18000,1.00494233937
128515,128521,135732,6,7211,1,259200,1.00083206213
128716,128722,129724,6,1002,2,18000,1.00598802395
128749,128755,490351,6,361596,2,540000,1.0000165931
128910,128916,129724,6,808,2,18000,1.00742574257
128926,128933,129724,7,791,2,18000,1.00884955752
128946,128953,129724,7,771,2,18000,1.00907911803
129056,129062,129724,6,662,2,18000,1.00906344411
129057,129068,129724,11,656,2,18000,1.01676829268
129092,129098,129724,6,626,2,18000,1.00958466454
129132,129138,129724,6,586,2,18000,1.01023890785
129164,129170,129724,6,554,2,18000,1.01083032491
129186,129192,129724,6,532,2,18000,1.01127819549
129209,129215,129724,6,509,2,18000,1.01178781925
129210,129221,129724,11,503,2,18000,1.02186878728
129228,129234,129724,6,490,2,18000,1.01224489796
129244,129250,129724,6,474,2,18000,1.01265822785
129260,129266,129724,6,458,2,18000,1.01310043668
129307,129313,129724,6,411,2,18000,1.01459854015
129330,129336,129724,6,388,2,18000,1.01546391753
129331,129342,129724,11,382,2,18000,1.02879581152
129362,129368,129371,6,3,1,259200,1.0
129403,129409,135465,6,6056,1,259200,1.00099075297
129457,129463,129724,6,261,2,18000,1.02298850575
129473,129480,129724,7,244,2,18000,1.02868852459
129475,129486,129724,11,238,2,18000,1.04621848739
129528,129535,129724,7,189,2,18000,1.03703703704
129545,129551,129724,6,173,2,18000,1.03468208092
129610,129616,130115,6,499,4,3600,1.0120240481
129691,129697,129724,6,27,2,18000,1.22222222222
130811,130817,133647,6,2830,2,18000,1.00212014134
130812,130823,133534,11,2711,2,18000,1.00405754334
130813,130828,133636,15,2808,2,18000,1.00534188034
130814,130833,133606,19,2773,2,18000,1.00685178507
130816,130838,133545,22,2707,2,18000,1.00812707795
130817,130843,133575,26,2732,2,18000,1.00951683748
130818,130849,133596,31,2747,2,18000,1.01128503822
130819,130854,133639,35,2785,2,18000,1.01256732496
130821,130859,133791,38,2932,2,18000,1.01296043656
130822,130864,133735,42,2871,2,18000,1.01462904911
130823,130869,133656,46,2787,2,18000,1.01650520273
130824,130874,133683,50,2809,2,18000,1.0177999288
130826,130879,133731,53,2852,2,18000,1.01858345021
130827,130885,133573,58,2688,2,18000,1.02157738095
130828,130890,133748,62,2858,2,18000,1.02169349195
130829,130895,133790,66,2895,2,18000,1.02279792746
130831,130900,133648,69,2748,2,18000,1.02510917031
130832,130905,133828,73,2923,2,18000,1.02497434143
130833,130910,133762,77,2852,2,18000,1.02699859748
130834,130915,133696,81,2781,2,18000,1.02912621359
130836,130920,133599,84,2679,2,18000,1.0313549832
130837,130926,133736,89,2810,2,18000,1.03167259786
130838,130931,133698,93,2767,2,18000,1.03361040838
130839,130936,133564,97,2628,2,18000,1.03691019787
130841,130941,133498,100,2557,2,18000,1.03910833007
130842,130946,133768,104,2822,2,18000,1.03685329554
130843,130951,133785,108,2834,2,18000,1.03810868031
130844,130957,133788,113,2831,2,18000,1.0399152243
130846,130962,133738,116,2776,2,18000,1.04178674352
130847,130967,133729,120,2762,2,18000,1.0434467777
130849,130972,133746,123,2774,2,18000,1.04434030281
130850,130977,133658,127,2681,2,18000,1.04737038419
130851,130982,133779,131,2797,2,18000,1.0468358956
130852,130988,133750,136,2762,2,18000,1.04923968139
130854,130993,133722,139,2729,2,18000,1.05093440821
130855,130998,133772,143,2774,2,18000,1.05155010815
130856,131003,133759,147,2756,2,18000,1.05333817126
130857,131008,133716,151,2708,2,18000,1.05576070901
130858,131013,133768,155,2755,2,18000,1.05626134301
130860,131018,133935,158,2917,2,18000,1.05416523826
133423,133429,133518,6,89,1,1800,1.06741573034
133824,133830,133911,6,81,1,1800,1.07407407407
134046,134052,134182,6,130,2,18000,1.04615384615
134048,134058,134182,10,124,2,18000,1.08064516129
134049,134063,134182,14,119,2,18000,1.11764705882
134050,134068,134182,18,114,2,18000,1.15789473684
134051,134073,134182,22,109,2,18000,1.20183486239
134053,134078,134182,25,104,2,18000,1.24038461538
134054,134084,134182,30,98,2,18000,1.30612244898
134055,134089,134182,34,93,2,18000,1.36559139785
134056,134094,134182,38,88,2,18000,1.43181818182
134057,134099,134182,42,83,2,18000,1.50602409639
134059,134104,134182,45,78,2,18000,1.57692307692
134060,134109,134182,49,73,2,18000,1.67123287671
134061,134114,134182,53,68,2,18000,1.77941176471
134062,134120,134182,58,62,2,18000,1.93548387097
134064,134125,134182,61,57,2,18000,2.0701754386
134065,134130,134182,65,52,2,18000,2.25
134066,134135,134182,69,47,2,18000,2.46808510638
134067,134140,134182,73,42,2,18000,2.7380952381
134069,134145,134182,76,37,2,18000,3.05405405405
134070,134150,134182,80,32,2,18000,3.5
134071,134155,134182,84,27,2,18000,4.11111111111
134072,134161,134182,89,21,2,18000,5.2380952381
134074,134166,134182,92,16,2,18000,6.75
134075,134171,134182,96,11,2,18000,9.72727272727
134077,134176,134182,99,6,2,18000,10.5
134078,134181,134182,103,1,2,18000,10.4
134079,134187,134188,108,1,2,18000,10.9
134080,134192,134193,112,1,2,18000,11.3
134082,134197,134198,115,1,2,18000,11.6
134083,134202,134203,119,1,2,18000,12.0
134084,134207,134208,123,1,2,18000,12.4
134085,134212,134213,127,1,2,18000,12.8
134087,134218,134219,131,1,2,18000,13.2
134088,134223,134224,135,1,2,18000,13.6
134089,134228,134229,139,1,2,18000,14.0
134090,134233,134234,143,1,2,18000,14.4
134092,134238,134239,146,1,2,18000,14.7
134093,134243,134244,150,1,2,18000,15.1
134094,134248,134249,154,1,2,18000,15.5
134095,134253,134254,158,1,2,18000,15.9
134293,134299,134480,6,181,2,18000,1.03314917127
134294,134305,134480,11,175,2,18000,1.06285714286
134295,134310,134480,15,170,2,18000,1.08823529412
134297,134315,134480,18,165,2,18000,1.10909090909
134298,134320,134480,22,160,2,18000,1.1375
134299,134325,134480,26,155,2,18000,1.16774193548
134300,134331,134480,31,149,2,18000,1.20805369128
134302,134336,134480,34,144,2,18000,1.23611111111
134303,134341,134480,38,139,2,18000,1.27338129496
134304,134346,134480,42,134,2,18000,1.31343283582
134305,134351,134480,46,129,2,18000,1.35658914729
134307,134356,134480,49,124,2,18000,1.39516129032
134308,134361,134480,53,119,2,18000,1.44537815126
134309,134366,134480,57,114,2,18000,1.5
134310,134372,134480,62,108,2,18000,1.57407407407
134312,134377,134480,65,103,2,18000,1.63106796117
134313,134382,134480,69,98,2,18000,1.70408163265
134314,134387,134480,73,93,2,18000,1.78494623656
134315,134392,134480,77,88,2,18000,1.875
134317,134397,134480,80,83,2,18000,1.96385542169
134318,134402,134480,84,78,2,18000,2.07692307692
134319,134407,134480,88,73,2,18000,2.20547945205
134320,134412,134480,92,68,2,18000,2.35294117647
134322,134418,134480,96,62,2,18000,2.54838709677
134323,134423,134480,100,57,2,18000,2.75438596491
134324,134428,134480,104,52,2,18000,3.0
134325,134433,134480,108,47,2,18000,3.29787234043
134327,134439,134480,112,41,2,18000,3.73170731707
134328,134444,134480,116,36,2,18000,4.22222222222
134330,134449,134480,119,31,2,18000,4.83870967742
134331,134454,134480,123,26,2,18000,5.73076923077
134332,134459,134480,127,21,2,18000,7.04761904762
134333,134464,134480,131,16,2,18000,9.1875
134335,134469,134480,134,11,2,18000,13.1818181818
134336,134475,134480,139,5,2,18000,14.4
134338,134485,134486,147,1,2,18000,14.8
134340,134490,134491,150,1,2,18000,15.1
134341,134495,134496,154,1,2,18000,15.5
134342,134500,134501,158,1,2,18000,15.9
134516,134522,137209,6,2687,2,18000,1.00223297358
134517,134533,137453,16,2920,2,18000,1.00547945205
134517,134527,136437,10,1910,1,1800,1.00523560209
134519,134538,137178,19,2640,2,18000,1.0071969697
134520,134544,137215,24,2671,2,18000,1.00898539873
134521,134549,137402,28,2853,2,18000,1.00981423063
134523,134554,137352,31,2798,2,18000,1.01107934239
134524,134559,137178,35,2619,2,18000,1.01336387934
134525,134564,137207,39,2643,2,18000,1.01475595914
134526,134569,137304,43,2735,2,18000,1.01572212066
134528,134575,137247,47,2672,2,18000,1.01758982036
134529,134580,137465,51,2885,2,18000,1.01767764298
134530,134585,137460,55,2875,2,18000,1.01913043478
134531,134590,137503,59,2913,2,18000,1.02025403364
134533,134595,137369,62,2774,2,18000,1.02235039654
134534,134600,137500,66,2900,2,18000,1.02275862069
134535,134606,137349,71,2743,2,18000,1.02588406854
134536,134611,137288,75,2677,2,18000,1.02801643631
134538,134616,137389,78,2773,2,18000,1.02812838082
134539,134621,137413,82,2792,2,18000,1.02936962751
134540,134703,393941,163,259238,1,259200,1.00062876584
134540,134626,137446,86,2820,2,18000,1.0304964539
134541,134631,137510,90,2879,2,18000,1.03126085446
134543,134636,137448,93,2812,2,18000,1.03307254623
134544,134641,137387,97,2746,2,18000,1.03532410779
134545,134646,137326,101,2680,2,18000,1.03768656716
134546,134652,137283,106,2631,2,18000,1.04028886355
134548,134657,137398,109,2741,2,18000,1.03976650857
134549,134662,137529,113,2867,2,18000,1.03941402163
134550,134667,137567,117,2900,2,18000,1.04034482759
134551,134672,137323,121,2651,2,18000,1.04564315353
134553,134677,137445,124,2768,2,18000,1.04479768786
134554,134682,137369,128,2687,2,18000,1.04763676963
134555,134687,137196,132,2509,2,18000,1.05261060183
134556,134693,137525,137,2832,2,18000,1.04837570621
134558,134698,137526,140,2828,2,18000,1.0495049505
134559,134709,137527,150,2818,2,18000,1.0532292406
134560,134714,137577,154,2863,2,18000,1.05378973105
134562,134719,137511,157,2792,2,18000,1.05623209169
134563,134725,137604,162,2879,2,18000,1.05626953803
134564,134730,137472,166,2742,2,18000,1.06053975201
134565,134735,137604,170,2869,2,18000,1.0592540955
135633,135639,137467,6,1828,1,259200,1.00328227571
136432,136438,490351,6,353913,4,540000,1.00001695332
136627,136633,145347,6,8714,1,36000,1.00068854717
136694,136700,221581,6,84881,1,259200,1.0000706872
136703,136709,395917,6,259208,1,259200,1.00002314743
136713,136719,266122,6,129403,1,259200,1.00004636678
137008,137014,396216,6,259202,1,259200,1.00002314797
137018,137024,396240,6,259216,1,259200,1.00002314672
137052,137058,137096,6,38,1,1800,1.15789473684
137374,137380,137459,6,79,1,1800,1.07594936709
137959,137965,138199,6,234,1,1800,1.02564102564
138071,138077,138116,6,39,1,1800,1.15384615385
138313,138319,140996,6,2677,2,18000,1.0022413149
138314,138325,141095,11,2770,2,18000,1.00397111913
138315,138330,141092,15,2762,2,18000,1.00543084721
138317,138335,141098,18,2763,2,18000,1.00651465798
138318,138340,141081,22,2741,2,18000,1.00802626779
138319,138345,141064,26,2719,2,18000,1.0095623391
138320,138351,141125,31,2774,2,18000,1.01117519827
138322,138356,141074,34,2718,2,18000,1.01250919794
138323,138361,140978,38,2617,2,18000,1.01452044326
138324,138366,141208,42,2842,2,18000,1.01477832512
138325,138374,141269,49,2895,2,18000,1.01692573402
138327,138379,141175,52,2796,2,18000,1.01859799714
138328,138384,141098,56,2714,2,18000,1.02063375092
138330,138389,141134,59,2745,2,18000,1.02149362477
138331,138395,141194,64,2799,2,18000,1.02286530904
138332,138400,141141,68,2741,2,18000,1.02480846406
138333,138405,141156,72,2751,2,18000,1.02617230098
138335,138410,141204,75,2794,2,18000,1.0268432355
138336,138415,141099,79,2684,2,18000,1.02943368107
138337,138420,141259,83,2839,2,18000,1.02923564635
138338,138425,141123,87,2698,2,18000,1.03224610823
138340,138430,141140,90,2710,2,18000,1.0332103321
138341,138435,141069,94,2634,2,18000,1.03568716781
138342,138441,141231,99,2790,2,18000,1.03548387097
138343,138446,141165,103,2719,2,18000,1.03788157411
138345,138451,141190,106,2739,2,18000,1.03870025557
138346,138457,141245,111,2788,2,18000,1.03981348637
138347,138462,141339,115,2877,2,18000,1.03997219326
138348,138467,141209,119,2742,2,18000,1.04339897885
138350,138472,141086,122,2614,2,18000,1.04667176741
138351,138477,141047,126,2570,2,18000,1.04902723735
138352,138482,141216,130,2734,2,18000,1.0475493782
138353,138487,141339,134,2852,2,18000,1.04698457223
138354,138493,141202,139,2709,2,18000,1.05131044666
138356,138498,141256,142,2758,2,18000,1.05148658448
138357,138503,141208,146,2705,2,18000,1.053974122
138358,138508,141333,150,2825,2,18000,1.05309734513
138359,138513,141288,154,2775,2,18000,1.0554954955
138361,138518,141358,157,2840,2,18000,1.05528169014
138362,138523,141349,161,2826,2,18000,1.05697098372
138425,138528,138605,103,77,1,1800,2.33766233766
139472,139479,139705,7,226,1,1800,1.03097345133
139493,139499,139525,6,26,2,10800,1.23076923077
139598,139605,139634,7,29,1,1800,1.24137931034
139641,139647,150561,6,10914,2,10800,1.00054975261
139950,139956,140027,6,71,1,1800,1.08450704225
140741,140747,140871,6,124,1,1800,1.04838709677
140979,140989,143636,10,2647,2,18000,1.00377786173
140997,141007,143674,10,2667,2,18000,1.00374953131
141047,141058,143867,11,2809,2,18000,1.00391598434
141065,141075,143835,10,2760,2,18000,1.00362318841
141079,141084,143826,5,2742,2,18000,1.00182348651
141080,141091,143984,11,2893,2,18000,1.00380228137
141095,141101,143882,6,2781,2,18000,1.0021574973
141096,141107,143905,11,2798,2,18000,1.00393137956
141097,141112,143887,15,2775,2,18000,1.00540540541
141112,141118,143910,6,2792,2,18000,1.00214899713
141113,141124,143883,11,2759,2,18000,1.00398695179
141114,141129,143953,15,2824,2,18000,1.00531161473
141116,141134,143880,18,2746,2,18000,1.00655498908
141130,141140,143950,10,2810,2,18000,1.00355871886
141131,141145,143905,14,2760,2,18000,1.00507246377
141146,141152,143799,6,2647,2,18000,1.00226671704
141147,141158,143892,11,2734,2,18000,1.00402340892
141148,141163,143867,15,2704,2,18000,1.00554733728
141163,141169,144080,6,2911,2,18000,1.00206114737
141177,141183,144033,6,2850,2,18000,1.00210526316
141179,141189,143811,10,2622,2,18000,1.00381388253
141193,141201,143858,8,2657,2,18000,1.00301091457
141208,141214,143923,6,2709,2,18000,1.00221483942
141209,141220,143890,11,2670,2,18000,1.00411985019
141210,141225,143947,15,2722,2,18000,1.00551065393
141212,141230,144019,18,2789,2,18000,1.00645392614
141226,141236,144083,10,2847,2,18000,1.00351246927
141227,141241,143932,14,2691,2,18000,1.00520252694
141229,141246,144061,17,2815,2,18000,1.00603907638
141243,141252,144023,9,2771,2,18000,1.00324792494
141258,141264,143961,6,2697,2,18000,1.0022246941
141259,141270,144128,11,2858,2,18000,1.00384884535
141274,141280,144096,6,2816,2,18000,1.00213068182
141275,141286,143974,11,2688,2,18000,1.0040922619
141290,141299,144103,9,2804,2,18000,1.00320970043
141334,141344,144107,10,2763,2,18000,1.00361925443
141349,141355,144175,6,2820,2,18000,1.00212765957
141350,141361,144144,11,2783,2,18000,1.00395256917
141351,141366,144078,15,2712,2,18000,1.00553097345
141366,141372,144196,6,2824,2,18000,1.00212464589
142924,142930,402161,6,259231,1,259200,1.00002314538
143074,143080,402325,6,259245,1,259200,1.00002314413
143637,143647,146409,10,2762,2,18000,1.00362056481
143675,143685,146455,10,2770,2,18000,1.0036101083
143803,143810,146482,7,2672,2,18000,1.00261976048
143818,143824,146611,6,2787,2,18000,1.00215285253
143832,143838,146518,6,2680,2,18000,1.00223880597
143846,143853,146520,7,2667,2,18000,1.00262467192
143862,143869,146730,7,2861,2,18000,1.00244669696
143877,143883,146706,6,2823,2,18000,1.00212539851
143878,143889,146558,11,2669,2,18000,1.00412139378
143894,143900,146706,6,2806,2,18000,1.00213827512
143896,143906,146689,10,2783,2,18000,1.0035932447
143897,143911,146612,14,2701,2,18000,1.00518326546
143898,143916,146688,18,2772,2,18000,1.00649350649
143899,143921,146454,22,2533,2,18000,1.00868535334
143901,143926,146648,25,2722,2,18000,1.00918442322
143915,143933,146555,18,2622,2,18000,1.00686498856
143916,143938,146730,22,2792,2,18000,1.00787965616
143918,143943,146676,25,2733,2,18000,1.00914745701
143933,143949,146652,16,2703,2,18000,1.00591934887
143934,143954,146800,20,2846,2,18000,1.00702740689
143949,143960,146756,11,2796,2,18000,1.0039341917
143963,143969,146621,6,2652,2,18000,1.00226244344
143965,143975,146758,10,2783,2,18000,1.0035932447
143966,143980,146760,14,2780,2,18000,1.00503597122
143981,143987,146714,6,2727,2,18000,1.00220022002
143995,144001,146876,6,2875,2,18000,1.00208695652
144019,144030,146741,11,2711,2,18000,1.00405754334
144033,144040,146705,7,2665,2,18000,1.00262664165
144035,144046,146787,11,2741,2,18000,1.00401313389
144061,144072,146753,11,2681,2,18000,1.00410294666
144079,144089,146751,10,2662,2,18000,1.003756574
144093,144100,146876,7,2776,2,18000,1.00252161383
144095,144106,147026,11,2920,2,18000,1.00376712329
144110,144116,146841,6,2725,2,18000,1.00220183486
144111,144122,146927,11,2805,2,18000,1.00392156863
144112,144127,146817,15,2690,2,18000,1.00557620818
144130,144139,146859,9,2720,2,18000,1.00330882353
144145,144155,146912,10,2757,2,18000,1.00362713094
144177,144186,146889,9,2703,2,18000,1.00332963374
144198,144208,147100,10,2892,2,18000,1.00345781466
145352,145358,151038,6,5680,2,36000,1.00105633803
145374,145380,251675,6,106295,4,360000,1.00005644668
146000,146007,251802,7,105795,4,360000,1.0000661657
146249,146255,265635,6,119380,4,360000,1.00005025967
146410,146420,149194,10,2774,2,18000,1.00360490267
146455,146465,149141,10,2676,2,18000,1.00373692078
146469,146475,149343,6,2868,2,18000,1.00209205021
146484,146493,149453,9,2960,2,18000,1.00304054054
146520,146529,149239,9,2710,2,18000,1.00332103321
146534,146540,149202,6,2662,2,18000,1.0022539444
146558,146567,149460,9,2893,2,18000,1.00311095748
146572,146578,149278,6,2700,2,18000,1.00222222222
146614,146623,149289,9,2666,2,18000,1.00337584396
146615,146628,149440,13,2812,2,18000,1.0046230441
146630,146636,149438,6,2802,2,18000,1.00214132762
146650,146660,149518,10,2858,2,18000,1.00349895031
146665,146671,149474,6,2803,2,18000,1.00214056368
146680,146688,149448,8,2760,2,18000,1.00289855072
146694,146700,149523,6,2823,2,18000,1.00212539851
146695,146706,149419,11,2713,2,18000,1.00405455216
146710,146715,239090,5,92375,4,360000,1.0000541272
146710,146721,149478,11,2757,2,18000,1.00398984403
146711,146726,149478,15,2752,2,18000,1.0054505814
146712,146731,149597,19,2866,2,18000,1.00662944871
146727,146737,149416,10,2679,2,18000,1.0037327361
146742,146748,149474,6,2726,2,18000,1.00220102715
146743,146754,149605,11,2851,2,18000,1.00385829533
146744,146759,149494,15,2735,2,18000,1.00548446069
146760,146766,149440,6,2674,2,18000,1.00224382947
146762,146772,149638,10,2866,2,18000,1.00348918353
146763,146777,149465,14,2688,2,18000,1.00520833333
146764,146782,149564,18,2782,2,18000,1.00647016535
146779,146788,149559,9,2771,2,18000,1.00324792494
146794,146800,149578,6,2778,2,18000,1.00215982721
146809,146815,149609,6,2794,2,18000,1.00214745884
146823,146830,149713,7,2883,2,18000,1.00242802636
146844,146852,149775,8,2923,2,18000,1.00273691413
146854,146860,245118,6,98258,4,360000,1.00006106373
146863,146871,149467,8,2596,2,18000,1.0030816641
146877,146887,149710,10,2823,2,18000,1.00354233085
146879,146892,149677,13,2785,2,18000,1.00466786355
146893,146901,149763,8,2862,2,18000,1.00279524808
146914,146924,149701,10,2777,2,18000,1.00360100828
146928,146938,149743,10,2805,2,18000,1.00356506239
147028,147037,149788,9,2751,2,18000,1.00327153762
147103,147112,149892,9,2780,2,18000,1.00323741007
149143,149152,151946,9,2794,2,18000,1.00322118826
149194,149205,151949,11,2744,2,18000,1.00400874636
149210,149216,152101,6,2885,2,18000,1.0020797227
149240,149250,152114,10,2864,2,18000,1.00349162011
149279,149289,152061,10,2772,2,18000,1.00360750361
149294,149299,151941,5,2642,2,18000,1.00189250568
149345,149354,152258,9,2904,2,18000,1.00309917355
149418,149428,152171,10,2743,2,18000,1.00364564346
149432,149438,152246,6,2808,2,18000,1.00213675214
149447,149453,152201,6,2748,2,18000,1.00218340611
149449,149459,152259,10,2800,2,18000,1.00357142857
149450,149464,152247,14,2783,2,18000,1.00503054258
149465,149471,152232,6,2761,2,18000,1.00217312568
149466,149477,152261,11,2784,2,18000,1.00395114943
149467,149482,152139,15,2657,2,18000,1.00564546481
149469,149487,152149,18,2662,2,18000,1.00676183321
149484,149493,152151,9,2658,2,18000,1.00338600451
149485,149498,152271,13,2773,2,18000,1.00468806347
149486,149503,152316,17,2813,2,18000,1.00604337007
149487,149508,152351,21,2843,2,18000,1.00738656349
149489,149515,152322,26,2807,2,18000,1.00926255789
149503,149520,152389,17,2869,2,18000,1.00592540955
149519,149529,152303,10,2774,2,18000,1.00360490267
149534,149540,152280,6,2740,2,18000,1.00218978102
149560,149570,152227,10,2657,2,18000,1.00376364321
149575,149581,152498,6,2917,2,18000,1.00205690778
149590,149596,152280,6,2684,2,18000,1.00223546945
149604,149611,152258,7,2647,2,18000,1.00264450321
149619,149625,152435,6,2810,2,18000,1.00213523132
149621,149631,152395,10,2764,2,18000,1.00361794501
149638,149649,152280,11,2631,2,18000,1.0041809198
149678,149688,152604,10,2916,2,18000,1.00342935528
149687,149694,219294,7,69600,4,360000,1.00010057471
149705,149713,152565,8,2852,2,18000,1.00280504909
149719,149726,152498,7,2772,2,18000,1.00252525253
149721,149732,152548,11,2816,2,18000,1.00390625
149744,149754,152476,10,2722,2,18000,1.00367376929
149765,149774,152552,9,2778,2,18000,1.00323974082
149780,149786,152607,6,2821,2,18000,1.00212690535
149795,149801,152547,6,2746,2,18000,1.00218499636
149895,149903,152733,8,2830,2,18000,1.00282685512
149959,149965,170552,6,20587,4,360000,1.00029144606
150407,150413,220983,6,70570,4,360000,1.00008502196
150636,150642,205865,6,55223,4,360000,1.00010865038
151064,151071,161572,7,10501,2,36000,1.00066660318
151155,151161,154287,6,3126,4,360000,1.0019193858
151329,151336,197418,7,46082,4,360000,1.00015190313
151510,151516,215350,6,63834,1,259200,1.0000939938
151942,151952,154687,10,2735,2,18000,1.00365630713
151953,151959,215350,6,63391,1,259200,1.00009465066
151957,151965,154637,8,2672,2,18000,1.00299401198
151958,151970,154751,12,2781,2,18000,1.00431499461
152061,152072,154658,11,2586,2,18000,1.00425367363
152106,152112,154898,6,2786,2,18000,1.00215362527
152121,152127,154741,6,2614,2,18000,1.00229533282
152142,152150,154931,8,2781,2,18000,1.00287666307
152157,152163,155084,6,2921,2,18000,1.00205409106
152158,152169,155082,11,2913,2,18000,1.00377617576
152173,152182,155000,9,2818,2,18000,1.00319375444
152203,152213,154884,10,2671,2,18000,1.00374391614
152230,152238,154920,8,2682,2,18000,1.00298284862
152245,152252,154987,7,2735,2,18000,1.00255941499
152260,152266,155111,6,2845,2,18000,1.00210896309
152261,152272,154985,11,2713,2,18000,1.00405455216
152263,152277,155139,14,2862,2,18000,1.00489168414
152264,152282,154909,18,2627,2,18000,1.00685192234
152265,152287,155066,22,2779,2,18000,1.00791651673
152280,152293,155115,13,2822,2,18000,1.00460666194
152281,152303,208440,22,56137,1,259200,1.00039189839
152281,152298,155098,17,2800,2,18000,1.00607142857
152299,152310,155089,11,2779,2,18000,1.00395825837
152300,152315,155062,15,2747,2,18000,1.00546050237
152301,152320,155204,19,2884,2,18000,1.00658807212
152316,152326,155174,10,2848,2,18000,1.00351123596
152331,152337,155204,6,2867,2,18000,1.00209277991
152332,152343,155149,11,2806,2,18000,1.00392017106
152353,152362,155094,9,2732,2,18000,1.0032942899
152392,152400,155207,8,2807,2,18000,1.00285001781
152407,152413,155130,6,2717,2,18000,1.002208318
152437,152446,155299,9,2853,2,18000,1.00315457413
152479,152487,155277,8,2790,2,18000,1.00286738351
152500,152509,155002,9,2493,2,18000,1.0036101083
152501,152514,155358,13,2844,2,18000,1.00457102672
152549,152558,155263,9,2705,2,18000,1.0033271719
152551,152564,155360,13,2796,2,18000,1.00464949928
152566,152572,155329,6,2757,2,18000,1.00217627856
152567,152578,155407,11,2829,2,18000,1.00388829975
152606,152616,155289,10,2673,2,18000,1.00374111485
152621,152628,155385,7,2757,2,18000,1.00253899166
152737,152745,155530,8,2785,2,18000,1.00287253142
153238,153244,185388,6,32144,4,360000,1.00018666003
153478,153484,183885,6,30401,4,360000,1.00019736193
153629,153636,194307,7,40671,4,360000,1.00017211281
153820,153826,217281,6,63455,4,360000,1.0000945552
153964,153971,173079,7,19108,4,360000,1.00036633871
154076,154082,192289,6,38207,4,360000,1.00015703929
154175,154181,205190,6,51009,4,360000,1.0001176263
154638,154648,157430,10,2782,2,18000,1.0035945363
154659,154670,157411,11,2741,2,18000,1.00401313389
154690,154698,157297,8,2599,2,18000,1.00307810696
154741,154752,157395,11,2643,2,18000,1.00416193719
154792,154798,157604,6,2806,2,18000,1.00213827512
154886,154896,157512,10,2616,2,18000,1.00382262997
154901,154910,157847,9,2937,2,18000,1.00306435138
154915,154921,157718,6,2797,2,18000,1.00214515552
154930,154936,157491,6,2555,2,18000,1.00234833659
154945,154951,157796,6,2845,2,18000,1.00210896309
154987,154996,157705,9,2709,2,18000,1.00332225914
155002,155008,157769,6,2761,2,18000,1.00217312568
155003,155014,157756,11,2742,2,18000,1.00401167031
155004,155019,157637,15,2618,2,18000,1.00572956455
155065,155073,157882,8,2809,2,18000,1.00284798861
155080,155086,157927,6,2841,2,18000,1.00211193242
155094,155100,157806,6,2706,2,18000,1.0022172949
155096,155106,157874,10,2768,2,18000,1.00361271676
155097,155111,157922,14,2811,2,18000,1.00498043401
155098,155116,157900,18,2784,2,18000,1.00646551724
155113,155123,157788,10,2665,2,18000,1.00375234522
155114,155128,157831,14,2703,2,18000,1.00517943026
155129,155135,157871,6,2736,2,18000,1.00219298246
155145,155151,158051,6,2900,2,18000,1.00206896552
155146,155157,157787,11,2630,2,18000,1.00418250951
155161,155167,157963,6,2796,2,18000,1.00214592275
155176,155185,157783,9,2598,2,18000,1.00346420323
155207,155218,157905,11,2687,2,18000,1.00409378489
155208,155223,157870,15,2647,2,18000,1.0056667926
155223,155229,158056,6,2827,2,18000,1.00212239123
155265,155275,158033,10,2758,2,18000,1.00362581581
155280,155288,158048,8,2760,2,18000,1.00289855072
155294,155300,158022,6,2722,2,18000,1.00220426157
155309,155315,158139,6,2824,2,18000,1.00212464589
155330,155340,158205,10,2865,2,18000,1.0034904014
155360,155369,158199,9,2830,2,18000,1.00318021201
155361,155375,158053,14,2678,2,18000,1.00522778193
155389,155396,158211,7,2815,2,18000,1.00248667851
155410,155419,158103,9,2684,2,18000,1.00335320417
155533,155541,158362,8,2821,2,18000,1.0028358738
157300,157308,159960,8,2652,2,18000,1.00301659125
157397,157407,160009,10,2602,2,18000,1.00384319754
157412,157422,160358,10,2936,2,18000,1.00340599455
157433,157441,160218,8,2777,2,18000,1.00288080663
157493,157503,160203,10,2700,2,18000,1.0037037037
157514,157524,160173,10,2649,2,18000,1.00377500944
157605,157615,160229,10,2614,2,18000,1.00382555471
157639,157648,160290,9,2642,2,18000,1.00340651022
157708,157716,160415,8,2699,2,18000,1.00296406076
157722,157728,160565,6,2837,2,18000,1.00211491012
157759,157767,160656,8,2889,2,18000,1.00276912426
157774,157780,160412,6,2632,2,18000,1.00227963526
157789,157795,160576,6,2781,2,18000,1.0021574973
157791,157801,160529,10,2728,2,18000,1.00366568915
157792,157806,160644,14,2838,2,18000,1.00493305144
157807,157812,160484,5,2672,2,18000,1.00187125749
157808,157818,160638,10,2820,2,18000,1.00354609929
157832,157843,160530,11,2687,2,18000,1.00409378489
157849,157858,160477,9,2619,2,18000,1.00343642612
157870,157881,160600,11,2719,2,18000,1.004045605
157885,157891,160645,6,2754,2,18000,1.00217864924
157886,157897,160674,11,2777,2,18000,1.00396110911
157888,157902,160695,14,2793,2,18000,1.00501253133
157903,157911,160742,8,2831,2,18000,1.00282585659
157917,157924,160722,7,2798,2,18000,1.00250178699
157933,157940,160781,7,2841,2,18000,1.00246392115
157935,157946,160765,11,2819,2,18000,1.00390209294
157965,157974,160680,9,2706,2,18000,1.00332594235
158026,158034,160705,8,2671,2,18000,1.00299513291
158041,158047,160740,6,2693,2,18000,1.00222799851
158056,158062,160810,6,2748,2,18000,1.00218340611
158058,158068,160881,10,2813,2,18000,1.00355492357
158059,158073,160948,14,2875,2,18000,1.00486956522
158060,158078,160847,18,2769,2,18000,1.00650054171
158106,158114,160886,8,2772,2,18000,1.00288600289
158142,158151,160839,9,2688,2,18000,1.00334821429
158200,158211,160949,11,2738,2,18000,1.00401753104
158216,158222,161193,6,2971,2,18000,1.00201952205
158218,158228,161004,10,2776,2,18000,1.00360230548
158364,158374,160968,10,2594,2,18000,1.00385505012
158438,158444,167586,6,9142,32,21600,1.00065631153
158800,158806,158807,6,1,2,300,1.0
159962,159971,162755,9,2784,2,18000,1.00323275862
160011,160020,162825,9,2805,2,18000,1.00320855615
160175,160184,162919,9,2735,2,18000,1.00329067642
160206,160214,162738,8,2524,2,18000,1.00316957211
160221,160230,162933,9,2703,2,18000,1.00332963374
160236,160242,163040,6,2798,2,18000,1.00214438885
160293,160301,163021,8,2720,2,18000,1.00294117647
160360,160369,163166,9,2797,2,18000,1.00321773329
160414,160423,163144,9,2721,2,18000,1.0033076075
160429,160435,163160,6,2725,2,18000,1.00220183486
160478,160488,163328,10,2840,2,18000,1.00352112676
160493,160499,163212,6,2713,2,18000,1.0022115739
160529,160540,163338,11,2798,2,18000,1.00393137956
160531,160546,163356,15,2810,2,18000,1.00533807829
160568,160577,163320,9,2743,2,18000,1.00328107911
160584,160590,163405,6,2815,2,18000,1.00213143872
160601,160611,163392,10,2781,2,18000,1.00359582884
160641,160649,163503,8,2854,2,18000,1.00280308339
160656,160662,163404,6,2742,2,18000,1.00218818381
160657,160668,163587,11,2919,2,18000,1.00376841384
160672,160678,163510,6,2832,2,18000,1.00211864407
160687,160693,163407,6,2714,2,18000,1.00221075903
160688,160699,163488,11,2789,2,18000,1.00394406597
160703,160709,163489,6,2780,2,18000,1.00215827338
160717,160724,163592,7,2868,2,18000,1.00244072524
160732,160739,163420,7,2681,2,18000,1.00261096606
160748,160753,163541,5,2788,2,18000,1.00179340029
160749,160759,163518,10,2759,2,18000,1.00362450163
160767,160776,163673,9,2897,2,18000,1.00310666206
160782,160792,163265,10,2473,2,18000,1.00404367165
160812,160821,163593,9,2772,2,18000,1.00324675325
160840,160850,163579,10,2729,2,18000,1.00366434591
160855,160861,163503,6,2642,2,18000,1.00227100681
160882,160892,163718,10,2826,2,18000,1.00353857042
160897,160903,163539,6,2636,2,18000,1.00227617602
160948,160959,163787,11,2828,2,18000,1.00388967468
160964,160970,163794,6,2824,2,18000,1.00212464589
160979,160985,163700,6,2715,2,18000,1.00220994475
161006,161015,163787,9,2772,2,18000,1.00324675325
161194,161204,163922,10,2718,2,18000,1.00367917586
161851,161857,173265,6,11408,1,36000,1.0005259467
162048,162055,162171,7,116,4,3600,1.06034482759
162741,162750,165504,9,2754,2,18000,1.00326797386
162756,162766,165602,10,2836,2,18000,1.00352609309
162827,162836,165721,9,2885,2,18000,1.00311958406
162922,162930,165710,8,2780,2,18000,1.00287769784
162938,162944,165720,6,2776,2,18000,1.00216138329
163025,163031,165840,6,2809,2,18000,1.00213599146
163044,163051,165910,7,2859,2,18000,1.00244840853
163147,163156,166027,9,2871,2,18000,1.00313479624
163161,163171,165833,10,2662,2,18000,1.003756574
163176,163182,165931,6,2749,2,18000,1.00218261186
163214,163223,165935,9,2712,2,18000,1.00331858407
163268,163277,165981,9,2704,2,18000,1.00332840237
163322,163332,166035,10,2703,2,18000,1.00369959304
163338,163344,166100,6,2756,2,18000,1.00217706821
163339,163350,166160,11,2810,2,18000,1.00391459075
163357,163367,166167,10,2800,2,18000,1.00357142857
163393,163403,166215,10,2812,2,18000,1.00355618777
163408,163415,166113,7,2698,2,18000,1.00259451446
163409,163421,166178,12,2757,2,18000,1.00435255713
163410,163426,166190,16,2764,2,18000,1.00578871201
163425,163432,166017,7,2585,2,18000,1.00270793037
163490,163499,166286,9,2787,2,18000,1.00322927879
163491,163505,166177,14,2672,2,18000,1.00523952096
163506,163513,166256,7,2743,2,18000,1.00255195042
163507,163518,166280,11,2762,2,18000,1.00398262129
163522,163528,166222,6,2694,2,18000,1.00222717149
163524,163534,166189,10,2655,2,18000,1.00376647834
163545,163551,166344,6,2793,2,18000,1.00214822771
163547,163557,166192,10,2635,2,18000,1.00379506641
163581,163591,166232,10,2641,2,18000,1.00378644453
163598,163604,166433,6,2829,2,18000,1.00212089077
163599,163610,166386,11,2776,2,18000,1.00396253602
163601,163615,166376,14,2761,2,18000,1.00507062658
163674,163684,166354,10,2670,2,18000,1.00374531835
163701,163711,166457,10,2746,2,18000,1.0036416606
163719,163730,166582,11,2852,2,18000,1.0038569425
163789,163798,166617,9,2819,2,18000,1.0031926215
163790,163803,166408,13,2605,2,18000,1.00499040307
163806,163812,166557,6,2745,2,18000,1.00218579235
163925,163934,166734,9,2800,2,18000,1.00321428571
164063,164069,164192,6,123,48,144000,1.0487804878
164242,164248,186964,6,22716,48,144000,1.00026413101
165508,165515,168394,7,2879,2,18000,1.00243139979
165605,165614,168174,9,2560,2,18000,1.003515625
165711,165721,168489,10,2768,2,18000,1.00361271676
165727,165733,168529,6,2796,2,18000,1.00214592275
165728,165739,168493,11,2754,2,18000,1.00399419027
165835,165845,168632,10,2787,2,18000,1.00358808755
165850,165856,168598,6,2742,2,18000,1.00218818381
165911,165921,168611,10,2690,2,18000,1.00371747212
165932,165943,168659,11,2716,2,18000,1.00405007364
165947,165954,168623,7,2669,2,18000,1.00262270513
165984,165993,168682,9,2689,2,18000,1.00334696913
166021,166028,168814,7,2786,2,18000,1.00251256281
166037,166043,168930,6,2887,2,18000,1.00207828195
166038,166049,168903,11,2854,2,18000,1.00385423966
166102,166111,168995,9,2884,2,18000,1.00312066574
166118,166124,168889,6,2765,2,18000,1.00216998192
166161,166171,168969,10,2798,2,18000,1.00357398142
166177,166183,168878,6,2695,2,18000,1.00222634508
166192,166199,168935,7,2736,2,18000,1.00255847953
166194,166205,169058,11,2853,2,18000,1.00385559061
166195,166210,168800,15,2590,2,18000,1.00579150579
166196,166215,169010,19,2795,2,18000,1.00679785331
166197,166220,168900,23,2680,2,18000,1.00858208955
166219,166226,169157,7,2931,2,18000,1.00238826339
166234,166240,168821,6,2581,2,18000,1.00232468036
166235,166246,168909,11,2663,2,18000,1.00413067968
166256,166267,169016,11,2749,2,18000,1.00400145507
166281,166291,169087,10,2796,2,18000,1.00357653791
166296,166302,168962,6,2660,2,18000,1.0022556391
166345,166355,169193,10,2838,2,18000,1.00352360817
166360,166366,169098,6,2732,2,18000,1.00219619327
166378,166388,169217,10,2829,2,18000,1.00353481796
166393,166399,169257,6,2858,2,18000,1.00209937019
166408,166419,169099,11,2680,2,18000,1.00410447761
166436,166445,169179,9,2734,2,18000,1.00329188003
166460,166468,169306,8,2838,2,18000,1.00281888654
166560,166568,169311,8,2743,2,18000,1.00291651476
166585,166594,169393,9,2799,2,18000,1.00321543408
166619,166629,169445,10,2816,2,18000,1.00355113636
166688,166694,166757,6,63,4,432000,1.09523809524
166737,166746,169634,9,2888,2,18000,1.00311634349
167156,167162,205200,6,38038,4,432000,1.000157737
168098,168104,168108,6,4,2,300,1.0
168117,168123,168137,6,14,2,300,1.42857142857
168147,168153,168212,6,59,2,300,1.10169491525
168177,168185,170993,8,2808,2,18000,1.00284900285
168347,168353,168368,6,15,2,300,1.4
168376,168382,168418,6,36,2,300,1.16666666667
168396,168405,171226,9,2821,2,18000,1.00319035803
168426,168432,168465,6,33,2,360,1.18181818182
168473,168479,168790,6,311,2,300,1.0192926045
168491,168500,171127,9,2627,2,18000,1.00342596117
168506,168512,171344,6,2832,2,18000,1.00211864407
168530,168540,171202,10,2662,2,18000,1.003756574
168601,168609,171507,8,2898,2,18000,1.0027605245
168616,168622,171443,6,2821,2,18000,1.00212690535
168631,168637,171292,6,2655,2,18000,1.00225988701
168646,168652,171520,6,2868,2,18000,1.00209205021
168662,168670,171410,8,2740,2,18000,1.00291970803
168683,168693,171558,10,2865,2,18000,1.0034904014
168803,168811,171529,8,2718,2,18000,1.00294334069
168804,168816,169165,12,349,2,360,1.03438395415
168818,168825,171567,7,2742,2,18000,1.00255288111
168833,168839,171585,6,2746,2,18000,1.00218499636
168881,168890,171691,9,2801,2,18000,1.00321313816
168897,168903,171570,6,2667,2,18000,1.00224971879
168912,168918,171688,6,2770,2,18000,1.00216606498
168913,168924,171670,11,2746,2,18000,1.00400582666
168914,168929,171799,15,2870,2,18000,1.00522648084
168933,168941,171709,8,2768,2,18000,1.00289017341
168947,168954,171851,7,2897,2,18000,1.00241629272
168963,168974,171848,11,2874,2,18000,1.00382741823
168978,168984,171693,6,2709,2,18000,1.00221483942
168999,169006,171811,7,2805,2,18000,1.00249554367
169014,169021,171803,7,2782,2,18000,1.00251617541
169029,169035,171870,6,2835,2,18000,1.00211640212
169060,169069,171885,9,2816,2,18000,1.00319602273
169091,169098,171823,7,2725,2,18000,1.00256880734
169106,169112,171652,6,2540,2,18000,1.00236220472
169107,169118,171921,11,2803,2,18000,1.00392436675
169160,169168,171910,8,2742,2,18000,1.00291757841
169179,169185,169285,6,100,2,360,1.06
169182,169191,172094,9,2903,2,18000,1.00310024113
169197,169225,171982,28,2757,2,18000,1.01015596663
169218,169231,171956,13,2725,2,18000,1.0047706422
169258,169268,172026,10,2758,2,18000,1.00362581581
169307,169317,172051,10,2734,2,18000,1.00365764448
169322,169328,172204,6,2876,2,18000,1.00208623088
169396,169404,172216,8,2812,2,18000,1.00284495021
169447,169456,172153,9,2697,2,18000,1.00333704116
169637,169646,172345,9,2699,2,18000,1.00333456836
170372,170378,170435,6,57,1,432000,1.10526315789
170582,170588,170633,6,45,1,432000,1.13333333333
170687,170693,171072,6,379,1,432000,1.01583113456
170996,171004,173787,8,2783,2,18000,1.00287459576
171131,171138,173915,7,2777,2,18000,1.0025207058
171205,171213,174061,8,2848,2,18000,1.00280898876
171226,171237,174005,11,2768,2,18000,1.00397398844
171294,171303,174181,9,2878,2,18000,1.00312717165
171345,171355,173907,10,2552,2,18000,1.0039184953
171412,171422,174062,10,2640,2,18000,1.00378787879
171446,171454,174309,8,2855,2,18000,1.00280210158
171512,171518,174188,6,2670,2,18000,1.00224719101
171527,171533,174243,6,2710,2,18000,1.00221402214
171542,171548,174387,6,2839,2,18000,1.00211342022
171560,171569,174229,9,2660,2,18000,1.00338345865
171575,171582,174185,7,2603,2,18000,1.00268920476
171577,171588,174345,11,2757,2,18000,1.00398984403
171592,171597,174169,5,2572,2,18000,1.00194401244
171607,171613,171631,6,18,1,432000,1.33333333333
171656,171664,174331,8,2667,2,18000,1.00299962505
171671,171681,174487,10,2806,2,18000,1.00356379187
171683,171689,171757,6,68,4,3540,1.08823529412
171685,171695,171757,10,62,2,3540,1.16129032258
171689,171701,174454,12,2753,2,18000,1.00435888122
171704,171710,174520,6,2810,2,18000,1.00213523132
171705,171716,174537,11,2821,2,18000,1.00389932648
171721,171727,174485,6,2758,2,18000,1.00217548949
171801,171811,174571,10,2760,2,18000,1.00362318841
171816,171822,174651,6,2829,2,18000,1.00212089077
171817,171828,174542,11,2714,2,18000,1.00405305822
171832,171838,174634,6,2796,2,18000,1.00214592275
171851,171859,174642,8,2783,2,18000,1.00287459576
171866,171872,174725,6,2853,2,18000,1.00210304942
171881,171887,174695,6,2808,2,18000,1.00213675214
171896,171902,174808,6,2906,2,18000,1.00206469374
171911,171921,174806,10,2885,2,18000,1.00346620451
171926,171932,174705,6,2773,2,18000,1.0021637216
171957,171967,174760,10,2793,2,18000,1.00358037952
171985,171993,174647,8,2654,2,18000,1.00301431801
172030,172037,174781,7,2744,2,18000,1.00255102041
172051,172062,174675,11,2613,2,18000,1.00420972063
172095,172105,174893,10,2788,2,18000,1.00358680057
172153,172164,174903,11,2739,2,18000,1.00401606426
172205,172216,175018,11,2802,2,18000,1.00392576731
172220,172227,174907,7,2680,2,18000,1.0026119403
172349,172356,175127,7,2771,2,18000,1.00252616384
173788,173798,176433,10,2635,2,18000,1.00379506641
173911,173919,176691,8,2772,2,18000,1.00288600289
173926,173932,176674,6,2742,2,18000,1.00218818381
174008,174017,176868,9,2851,2,18000,1.00315678709
174063,174072,176877,9,2805,2,18000,1.00320855615
174064,174078,176753,14,2675,2,18000,1.00523364486
174171,174180,176928,9,2748,2,18000,1.00327510917
174187,174193,176843,6,2650,2,18000,1.00226415094
174188,174199,176902,11,2703,2,18000,1.00406955235
174190,174204,176934,14,2730,2,18000,1.00512820513
174232,174240,177036,8,2796,2,18000,1.00286123033
174248,174254,177091,6,2837,2,18000,1.00211491012
174312,174320,176956,8,2636,2,18000,1.00303490137
174333,174342,177148,9,2806,2,18000,1.00320741269
174348,174356,177095,8,2739,2,18000,1.00292077401
174391,174399,177135,8,2736,2,18000,1.00292397661
174455,174465,177279,10,2814,2,18000,1.00355366027
174489,174498,177405,9,2907,2,18000,1.00309597523
174490,174503,177192,13,2689,2,18000,1.00483451097
174521,174531,177241,10,2710,2,18000,1.0036900369
174539,174549,177345,10,2796,2,18000,1.00357653791
174554,174560,177360,6,2800,2,18000,1.00214285714
174572,174582,177384,10,2802,2,18000,1.00356887937
174638,174645,177363,7,2718,2,18000,1.00257542311
174657,174662,177447,5,2785,2,18000,1.00179533214
174658,174668,177411,10,2743,2,18000,1.00364564346
174660,174673,177319,13,2646,2,18000,1.00491307634
174679,174686,177599,7,2913,2,18000,1.00240302094
174697,174706,177545,9,2839,2,18000,1.00317013033
174713,174719,177478,6,2759,2,18000,1.00217470098
174728,174736,177464,8,2728,2,18000,1.00293255132
174762,174771,177435,9,2664,2,18000,1.00337837838
174783,174793,177551,10,2758,2,18000,1.00362581581
174808,174817,177610,9,2793,2,18000,1.00322234157
174823,174830,177567,7,2737,2,18000,1.00255754476
174897,174905,177606,8,2701,2,18000,1.00296186598
174913,174918,177790,5,2872,2,18000,1.00174094708
174914,174924,177675,10,2751,2,18000,1.0036350418
175022,175030,177735,8,2705,2,18000,1.00295748614
175129,175139,177843,10,2704,2,18000,1.00369822485
175975,175981,244041,6,68060,1,432000,1.00008815751
176436,176444,179151,8,2707,2,18000,1.00295530107
176678,176685,179446,7,2761,2,18000,1.00253531329
176693,176702,179408,9,2706,2,18000,1.00332594235
176757,176765,179534,8,2769,2,18000,1.00288912965
176846,176854,179700,8,2846,2,18000,1.00281096275
176870,176879,179683,9,2804,2,18000,1.00320970043
176885,176891,179765,6,2874,2,18000,1.00208768267
176903,176913,179630,10,2717,2,18000,1.00368053
176931,176939,179700,8,2761,2,18000,1.00289750091
176948,176954,179792,6,2838,2,18000,1.0021141649
176963,176969,179679,6,2710,2,18000,1.00221402214
177037,177047,179772,10,2725,2,18000,1.00366972477
177093,177102,179926,9,2824,2,18000,1.00318696884
177108,177114,180071,6,2957,2,18000,1.00202908353
177139,177147,179843,8,2696,2,18000,1.00296735905
177154,177159,179987,5,2828,2,18000,1.00176803395
177193,177204,179877,11,2673,2,18000,1.00411522634
177242,177252,179939,10,2687,2,18000,1.00372162263
177282,177290,180095,8,2805,2,18000,1.00285204991
177322,177330,179956,8,2626,2,18000,1.00304645849
177347,177356,180049,9,2693,2,18000,1.00334199777
177362,177371,180222,9,2851,2,18000,1.00315678709
177378,177384,180045,6,2661,2,18000,1.00225479143
177393,177399,180200,6,2801,2,18000,1.00214209211
177408,177417,180146,9,2729,2,18000,1.00329791132
177422,177429,180306,7,2877,2,18000,1.00243309002
177438,177446,180333,8,2887,2,18000,1.0027710426
177453,177459,180260,6,2801,2,18000,1.00214209211
177468,177475,180117,7,2642,2,18000,1.00264950795
177484,177489,180286,5,2797,2,18000,1.0017876296
177548,177556,180380,8,2824,2,18000,1.00283286119
177563,177569,180371,6,2802,2,18000,1.00214132762
177578,177584,180142,6,2558,2,18000,1.00234558249
177601,177610,180285,9,2675,2,18000,1.00336448598
177616,177623,180451,7,2828,2,18000,1.00247524752
177618,177628,180459,10,2831,2,18000,1.00353232073
177676,177686,180378,10,2692,2,18000,1.00371471025
177737,177747,180702,10,2955,2,18000,1.00338409475
177792,177801,180565,9,2764,2,18000,1.00325615051
177844,177854,180595,10,2741,2,18000,1.00364830354
179153,179162,181893,9,2731,2,18000,1.00329549616
179409,179419,182263,10,2844,2,18000,1.0035161744
179449,179457,181998,8,2541,2,18000,1.00314836678
179538,179546,182368,8,2822,2,18000,1.00283486889
179633,179641,182437,8,2796,2,18000,1.00286123033
179682,179691,182351,9,2660,2,18000,1.00338345865
179697,179704,182465,7,2761,2,18000,1.00253531329
179712,179718,182391,6,2673,2,18000,1.00224466891
179714,179724,182565,10,2841,2,18000,1.00351988736
179765,179776,182551,11,2775,2,18000,1.00396396396
179781,179787,182544,6,2757,2,18000,1.00217627856
179796,179803,182603,7,2800,2,18000,1.0025
179845,179855,182526,10,2671,2,18000,1.00374391614
179879,179888,182702,9,2814,2,18000,1.00319829424
179927,179937,182745,10,2808,2,18000,1.00356125356
179942,179950,182780,8,2830,2,18000,1.00282685512
179958,179967,182640,9,2673,2,18000,1.00336700337
179989,179998,182834,9,2836,2,18000,1.00317348378
180047,180056,182857,9,2801,2,18000,1.00321313816
180062,180069,182745,7,2676,2,18000,1.00261584454
180077,180084,182865,7,2781,2,18000,1.00251708019
180096,180106,182905,10,2799,2,18000,1.00357270454
180120,180128,182995,8,2867,2,18000,1.00279037321
180145,180154,182917,9,2763,2,18000,1.00325732899
180161,180167,182989,6,2822,2,18000,1.00212615167
180206,180212,182873,6,2661,2,18000,1.00225479143
180225,180233,183058,8,2825,2,18000,1.00283185841
180262,180271,182993,9,2722,2,18000,1.00330639236
180288,180296,183048,8,2752,2,18000,1.00290697674
180289,180302,183045,13,2743,2,18000,1.00473933649
180308,180317,183168,9,2851,2,18000,1.00315678709
180336,180345,183100,9,2755,2,18000,1.00326678766
180372,180383,183257,11,2874,2,18000,1.00382741823
180388,180394,183047,6,2653,2,18000,1.00226159065
180389,180400,183159,11,2759,2,18000,1.00398695179
180454,180462,183269,8,2807,2,18000,1.00285001781
180469,180475,183195,6,2720,2,18000,1.00220588235
180568,180576,183406,8,2830,2,18000,1.00282685512
180599,180606,183446,7,2840,2,18000,1.00246478873
180704,180714,183501,10,2787,2,18000,1.00358808755
181897,181904,184815,7,2911,2,18000,1.00240467193
181899,181910,240922,11,59012,4,432000,1.00018640277
182001,182010,184665,9,2655,2,18000,1.00338983051
182266,182274,184880,8,2606,2,18000,1.00306983883
182349,182362,185067,13,2705,2,18000,1.00480591497
182370,182379,185106,9,2727,2,18000,1.00330033003
182392,182402,185192,10,2790,2,18000,1.00358422939
182450,182456,185289,6,2833,2,18000,1.00211789622
182469,182476,185223,7,2747,2,18000,1.00254823444
182530,182537,185340,7,2803,2,18000,1.0024973243
182546,182555,185205,9,2650,2,18000,1.00339622642
182561,182567,185386,6,2819,2,18000,1.00212841433
182577,182583,185343,6,2760,2,18000,1.00217391304
182605,182614,185424,9,2810,2,18000,1.00320284698
182643,182651,185403,8,2752,2,18000,1.00290697674
182705,182713,185488,8,2775,2,18000,1.00288288288
182748,182789,185517,41,2728,2,18000,1.01502932551
182749,182794,185489,45,2695,2,18000,1.01669758813
182783,182800,185686,17,2886,2,18000,1.00589050589
182835,182845,185564,10,2719,2,18000,1.00367782273
182860,182868,185625,8,2757,2,18000,1.00290170475
182876,182882,185703,6,2821,2,18000,1.00212690535
182877,182888,185704,11,2816,2,18000,1.00390625
182908,182917,185767,9,2850,2,18000,1.00315789474
182923,182930,185804,7,2874,2,18000,1.00243562978
182991,183000,185741,9,2741,2,18000,1.00328347318
183007,183013,185726,6,2713,2,18000,1.0022115739
183008,183019,185808,11,2789,2,18000,1.00394406597
183049,183057,185905,8,2848,2,18000,1.00280898876
183050,183062,185863,12,2801,2,18000,1.00428418422
183051,183068,185738,17,2670,2,18000,1.0063670412
183067,183074,185945,7,2871,2,18000,1.00243817485
183105,183111,185969,6,2858,2,18000,1.00209937019
183161,183170,185968,9,2798,2,18000,1.00321658327
183176,183182,185924,6,2742,2,18000,1.00218818381
183198,183206,185828,8,2622,2,18000,1.00305110603
183260,183268,186108,8,2840,2,18000,1.00281690141
183275,183281,186150,6,2869,2,18000,1.00209132102
183409,183417,186285,8,2868,2,18000,1.00278940028
183447,183457,186260,10,2803,2,18000,1.00356760614
183502,183513,186202,11,2689,2,18000,1.00409074005
184667,184676,187565,9,2889,2,18000,1.0031152648
184818,184826,187640,8,2814,2,18000,1.00284292822
184884,184891,187682,7,2791,2,18000,1.00250806163
185071,185079,187893,8,2814,2,18000,1.00284292822
185109,185117,187972,8,2855,2,18000,1.00280210158
185195,185203,187962,8,2759,2,18000,1.0028996013
185219,185225,187951,6,2726,2,18000,1.00220102715
185234,185240,187845,6,2605,2,18000,1.00230326296
185293,185301,188103,8,2802,2,18000,1.0028551035
185343,185351,188048,8,2697,2,18000,1.00296625881
185358,185365,188200,7,2835,2,18000,1.0024691358
185389,185397,187945,8,2548,2,18000,1.00313971743
185405,185415,188271,10,2856,2,18000,1.00350140056
185427,185435,188278,8,2843,2,18000,1.00281392895
185492,185499,188296,7,2797,2,18000,1.00250268144
185493,185505,188197,12,2692,2,18000,1.0044576523
185517,185528,188258,11,2730,2,18000,1.00402930403
185567,185575,188316,8,2741,2,18000,1.00291864283
185628,185636,188306,8,2670,2,18000,1.00299625468
185690,185697,188556,7,2859,2,18000,1.00244840853
185706,185714,188469,8,2755,2,18000,1.00290381125
185707,185720,188555,13,2835,2,18000,1.00458553792
185729,185737,188406,8,2669,2,18000,1.00299737729
185745,185751,188561,6,2810,2,18000,1.00213523132
185746,185757,188596,11,2839,2,18000,1.00387460373
185771,185778,188648,7,2870,2,18000,1.00243902439
185805,185815,188619,10,2804,2,18000,1.00356633381
185820,185827,188450,7,2623,2,18000,1.00266869996
185836,185842,188708,6,2866,2,18000,1.00209351012
185864,185874,188564,10,2690,2,18000,1.00371747212
185907,185916,188653,9,2737,2,18000,1.00328827183
185925,185936,188810,11,2874,2,18000,1.00382741823
185947,185956,188647,9,2691,2,18000,1.00334448161
185972,185980,188710,8,2730,2,18000,1.00293040293
185973,185985,188781,12,2796,2,18000,1.00429184549
186120,186126,188965,6,2839,2,18000,1.00211342022
186151,186162,189041,11,2879,2,18000,1.0038207711
186203,186213,188893,10,2680,2,18000,1.00373134328
186262,186271,189081,9,2810,2,18000,1.00320284698
186287,186296,189112,9,2816,2,18000,1.00319602273
187578,187584,190399,6,2815,2,18000,1.00213143872
187644,187651,190517,7,2866,2,18000,1.00244242847
187683,187693,190530,10,2837,2,18000,1.00352485019
187847,187856,190639,9,2783,2,18000,1.00323392023
187894,187904,190710,10,2806,2,18000,1.00356379187
187946,187956,190779,10,2823,2,18000,1.00354233085
187962,187968,190874,6,2906,2,18000,1.00206469374
187977,187983,190704,6,2721,2,18000,1.00220507166
187978,187989,190908,11,2919,2,18000,1.00376841384
188053,188059,190857,6,2798,2,18000,1.00214438885
188105,188114,190750,9,2636,2,18000,1.00341426404
188200,188208,191061,8,2853,2,18000,1.0028040659
188216,188222,190919,6,2697,2,18000,1.0022246941
188261,188269,191117,8,2848,2,18000,1.00280898876
188276,188282,191051,6,2769,2,18000,1.00216684724
188291,188297,190975,6,2678,2,18000,1.00224047797
188307,188313,191070,6,2757,2,18000,1.00217627856
188308,188319,191122,11,2803,2,18000,1.00392436675
188325,188331,191186,6,2855,2,18000,1.00210157618
188408,188418,191244,10,2826,2,18000,1.00353857042
188454,188462,191220,8,2758,2,18000,1.00290065265
188473,188480,191151,7,2671,2,18000,1.0026207413
188557,188566,191260,9,2694,2,18000,1.00334075724
188559,188572,191366,13,2794,2,18000,1.00465282749
188574,188580,191289,6,2709,2,18000,1.00221483942
188575,188586,191284,11,2698,2,18000,1.00407709414
188600,188607,191356,7,2749,2,18000,1.0025463805
188622,188630,191419,8,2789,2,18000,1.00286841162
188654,188661,191503,7,2842,2,18000,1.00246305419
188656,188666,191372,10,2706,2,18000,1.0036954915
188657,188672,191469,15,2797,2,18000,1.00536288881
188709,188719,191536,10,2817,2,18000,1.00354987575
188724,188730,191551,6,2821,2,18000,1.00212690535
188783,188792,191550,9,2758,2,18000,1.00326323423
188811,188821,191590,10,2769,2,18000,1.00361141206
188898,188904,191732,6,2828,2,18000,1.00212164074
188968,188976,191721,8,2745,2,18000,1.0029143898
189042,189052,191866,10,2814,2,18000,1.00355366027
189096,189102,191797,6,2695,2,18000,1.00222634508
189120,189126,192081,6,2955,2,18000,1.00203045685
190410,190417,192969,7,2552,2,18000,1.00274294671
190518,190528,193402,10,2874,2,18000,1.00347947112
190534,190541,193337,7,2796,2,18000,1.00250357654
190642,190650,193419,8,2769,2,18000,1.00288912965
190705,190715,193514,10,2799,2,18000,1.00357270454
190720,190726,193393,6,2667,2,18000,1.00224971879
190751,190761,193398,10,2637,2,18000,1.00379218809
190782,190790,193505,8,2715,2,18000,1.002946593
190829,190835,190935,6,100,1,1800,1.06
190859,190868,193673,9,2805,2,18000,1.00320855615
190877,190885,193725,8,2840,2,18000,1.00281690141
190911,190920,193746,9,2826,2,18000,1.00318471338
190926,190932,193747,6,2815,2,18000,1.00213143872
190973,190986,193728,13,2742,2,18000,1.00474106492
191053,191062,193895,9,2833,2,18000,1.00317684433
191069,191075,193813,6,2738,2,18000,1.00219138057
191084,191090,193836,6,2746,2,18000,1.00218499636
191118,191128,193888,10,2760,2,18000,1.00362318841
191134,191140,193914,6,2774,2,18000,1.0021629416
191152,191162,193702,10,2540,2,18000,1.00393700787
191189,191197,194052,8,2855,2,18000,1.00280210158
191223,191231,194046,8,2815,2,18000,1.00284191829
191229,191237,191340,8,103,1,1800,1.07766990291
191244,191255,194041,11,2786,2,18000,1.00394831299
191263,191271,193960,8,2689,2,18000,1.00297508367
191287,191295,194075,8,2780,2,18000,1.00287769784
191303,191309,194085,6,2776,2,18000,1.00216138329
191358,191368,194074,10,2706,2,18000,1.0036954915
191374,191380,194153,6,2773,2,18000,1.0021637216
191375,191386,193969,11,2583,2,18000,1.00425861401
191421,191430,194116,9,2686,2,18000,1.00335070737
191470,191480,194314,10,2834,2,18000,1.00352858151
191505,191515,194264,10,2749,2,18000,1.00363768643
191540,191548,194374,8,2826,2,18000,1.00283085633
191555,191561,194290,6,2729,2,18000,1.00219860755
191556,191567,194244,11,2677,2,18000,1.00410907733
191594,191601,194432,7,2831,2,18000,1.00247262451
191723,191733,194497,10,2764,2,18000,1.00361794501
191738,191745,194424,7,2679,2,18000,1.00261291527
191801,191808,194411,7,2603,2,18000,1.00268920476
191869,191877,194699,8,2822,2,18000,1.00283486889
191928,191935,192448,7,513,1,1800,1.01364522417
192084,192092,194902,8,2810,2,18000,1.00284697509
192983,192989,195538,6,2549,2,18000,1.00235386426
193350,193356,196163,6,2807,2,18000,1.00213751336
193396,193404,196059,8,2655,2,18000,1.00301318267
193411,193417,196094,6,2677,2,18000,1.0022413149
193412,193423,196206,11,2783,2,18000,1.00395256917
193428,193434,196048,6,2614,2,18000,1.00229533282
193508,193516,196361,8,2845,2,18000,1.00281195079
193524,193530,196323,6,2793,2,18000,1.00214822771
193675,193684,196418,9,2734,2,18000,1.00329188003
193703,193713,196460,10,2747,2,18000,1.00364033491
193728,193736,196397,8,2661,2,18000,1.00300638858
193729,193742,196572,13,2830,2,18000,1.00459363958
193748,193757,196525,9,2768,2,18000,1.00325144509
193750,193763,196557,13,2794,2,18000,1.00465282749
193815,193824,196499,9,2675,2,18000,1.00336448598
193837,193847,196384,10,2537,2,18000,1.00394166338
193889,193899,196738,10,2839,2,18000,1.00352236703
193905,193911,196669,6,2758,2,18000,1.00217548949
193920,193926,196718,6,2792,2,18000,1.00214899713
193963,193971,196780,8,2809,2,18000,1.00284798861
193978,193985,196767,7,2782,2,18000,1.00251617541
194038,194045,194084,7,39,1,1800,1.17948717949
194043,194056,196745,13,2689,2,18000,1.00483451097
194059,194065,196805,6,2740,2,18000,1.00218978102
194060,194071,196764,11,2693,2,18000,1.00408466394
194076,194085,196863,9,2778,2,18000,1.00323974082
194077,194091,196875,14,2784,2,18000,1.00502873563
194093,194100,196841,7,2741,2,18000,1.00255381248
194118,194127,196939,9,2812,2,18000,1.00320056899
194155,194164,196893,9,2729,2,18000,1.00329791132
194248,194256,196828,8,2572,2,18000,1.00311041991
194266,194276,197024,10,2748,2,18000,1.00363901019
194294,194302,197068,8,2766,2,18000,1.0028922632
194315,194325,197033,10,2708,2,18000,1.00369276219
194377,194385,197235,8,2850,2,18000,1.00280701754
194399,194406,194476,7,70,1,1800,1.1
194414,194423,197278,9,2855,2,18000,1.00315236427
194429,194435,197182,6,2747,2,18000,1.00218420095
194444,194451,197345,7,2894,2,18000,1.00241879751
194510,194516,197390,6,2874,2,18000,1.00208768267
194702,194710,197591,8,2881,2,18000,1.00277681361
194903,194913,197560,10,2647,2,18000,1.00377786173
195292,195298,195559,6,261,1,1800,1.02298850575
195549,195555,198280,6,2725,2,18000,1.00220183486
196061,196067,198749,6,2682,2,18000,1.00223713647
196062,196073,198706,11,2633,2,18000,1.00417774402
196096,196105,198919,9,2814,2,18000,1.00319829424
196165,196175,198849,10,2674,2,18000,1.00373971578
196207,196217,199050,10,2833,2,18000,1.00352982704
196326,196335,199155,9,2820,2,18000,1.00319148936
196362,196372,199223,10,2851,2,18000,1.00350754121
196387,196396,199200,9,2804,2,18000,1.00320970043
196403,196409,199224,6,2815,2,18000,1.00213143872
196421,196429,199288,8,2859,2,18000,1.00279818118
196462,196471,199250,9,2779,2,18000,1.00323857503
196499,196510,199405,11,2895,2,18000,1.00379965458
196526,196536,199401,10,2865,2,18000,1.0034904014
196560,196568,199302,8,2734,2,18000,1.00292611558
196575,196584,199274,9,2690,2,18000,1.00334572491
196670,196681,199413,11,2732,2,18000,1.00402635432
196719,196729,199531,10,2802,2,18000,1.00356887937
196741,196749,199558,8,2809,2,18000,1.00284798861
196757,196763,199455,6,2692,2,18000,1.00222882615
196772,196778,199572,6,2794,2,18000,1.00214745884
196773,196784,199565,11,2781,2,18000,1.00395541172
196788,196794,199711,6,2917,2,18000,1.00205690778
196807,196816,199522,9,2706,2,18000,1.00332594235
196832,196839,199589,7,2750,2,18000,1.00254545455
196848,196854,199504,6,2650,2,18000,1.00226415094
196866,196874,199532,8,2658,2,18000,1.00300978179
196882,196888,199728,6,2840,2,18000,1.00211267606
196897,196904,199753,7,2849,2,18000,1.00245700246
196940,196950,199848,10,2898,2,18000,1.00345065562
197027,197036,199669,9,2633,2,18000,1.0034181542
197042,197048,199773,6,2725,2,18000,1.00220183486
197070,197079,199752,9,2673,2,18000,1.00336700337
197185,197193,199953,8,2760,2,18000,1.00289855072
197238,197246,200065,8,2819,2,18000,1.00283788578
197280,197290,200041,10,2751,2,18000,1.0036350418
197346,197356,200128,10,2772,2,18000,1.00360750361
197392,197402,200091,10,2689,2,18000,1.00371885459
197564,197572,200360,8,2788,2,18000,1.00286944046
197595,197602,200321,7,2719,2,18000,1.00257447591
198283,198291,201183,8,2892,2,18000,1.00276625173
198709,198717,201493,8,2776,2,18000,1.00288184438
198749,198760,201601,11,2841,2,18000,1.0038718761
198851,198860,201579,9,2719,2,18000,1.00331004046
198922,198930,201527,8,2597,2,18000,1.00308047747
199052,199062,201869,10,2807,2,18000,1.00356252227
199159,199167,201864,8,2697,2,18000,1.00296625881
199202,199211,201904,9,2693,2,18000,1.00334199777
199227,199234,201903,7,2669,2,18000,1.00262270513
199229,199240,202037,11,2797,2,18000,1.00393278513
199253,199261,201916,8,2655,2,18000,1.00301318267
199278,199285,202021,7,2736,2,18000,1.00255847953
199294,199300,202032,6,2732,2,18000,1.00219619327
199309,199315,202150,6,2835,2,18000,1.00211640212
199404,199412,202134,8,2722,2,18000,1.00293901543
199420,199426,202159,6,2733,2,18000,1.00219538968
199421,199432,202183,11,2751,2,18000,1.00399854598
199459,199466,202174,7,2708,2,18000,1.00258493353
199505,199515,202247,10,2732,2,18000,1.00366032211
199524,199533,202351,9,2818,2,18000,1.00319375444
199540,199546,202212,6,2666,2,18000,1.00225056264
199541,199552,202295,11,2743,2,18000,1.0040102078
199559,199569,202346,10,2777,2,18000,1.00360100828
199575,199581,202412,6,2831,2,18000,1.00211939244
199576,199587,202335,11,2748,2,18000,1.00400291121
199592,199600,202252,8,2652,2,18000,1.00301659125
199672,199680,202585,8,2905,2,18000,1.00275387263
199715,199723,202486,8,2763,2,18000,1.00289540355
199730,199739,202566,9,2827,2,18000,1.00318358684
199755,199763,202553,8,2790,2,18000,1.00286738351
199756,199769,202540,13,2771,2,18000,1.00469144713
199775,199784,202485,9,2701,2,18000,1.00333209922
199849,199859,202693,10,2834,2,18000,1.00352858151
199954,199964,202715,10,2751,2,18000,1.0036350418
200044,200052,202890,8,2838,2,18000,1.00281888654
200066,200076,202861,10,2785,2,18000,1.00359066427
200093,200102,202874,9,2772,2,18000,1.00324675325
200131,200139,202901,8,2762,2,18000,1.00289645185
200324,200332,203153,8,2821,2,18000,1.0028358738
200362,200372,202987,10,2615,2,18000,1.00382409178
201188,201194,203997,6,2803,2,18000,1.00214056368
201403,201409,201447,6,38,1,1800,1.15789473684
201494,201504,204292,10,2788,2,18000,1.00358680057
201528,201539,204319,11,2780,2,18000,1.00395683453
201572,201578,274143,6,72565,4,540000,1.00008268449
201581,201590,204348,9,2758,2,18000,1.00326323423
201605,201612,204393,7,2781,2,18000,1.00251708019
201633,201639,269505,6,67866,4,540000,1.00008840951
201717,201723,201798,6,75,1,1800,1.08
201791,201797,283029,6,81232,4,540000,1.00007386252
201867,201875,204646,8,2771,2,18000,1.00288704439
201882,201888,204687,6,2799,2,18000,1.00214362272
201904,201920,204646,16,2726,2,18000,1.00586940572
201905,201914,204565,9,2651,2,18000,1.0033949453
201921,201927,204815,6,2888,2,18000,1.00207756233
202024,202032,204907,8,2875,2,18000,1.0027826087
202040,202046,204658,6,2612,2,18000,1.00229709035
202041,202052,204853,11,2801,2,18000,1.00392716887
202137,202146,204888,9,2742,2,18000,1.00328227571
202152,202161,204782,9,2621,2,18000,1.00343380389
202167,202173,205013,6,2840,2,18000,1.00211267606
202183,202189,204973,6,2784,2,18000,1.00215517241
202185,202195,205020,10,2825,2,18000,1.00353982301
202212,202223,204924,11,2701,2,18000,1.00407256572
202250,202259,204909,9,2650,2,18000,1.00339622642
202266,202272,205031,6,2759,2,18000,1.00217470098
202297,202306,204982,9,2676,2,18000,1.0033632287
202303,202312,202537,9,225,1,1800,1.04
202337,202346,205188,9,2842,2,18000,1.00316678395
202353,202359,205037,6,2678,2,18000,1.00224047797
202354,202365,205070,11,2705,2,18000,1.00406654344
202413,202423,205264,10,2841,2,18000,1.00351988736
202489,202497,205257,8,2760,2,18000,1.00289855072
202490,202502,205258,12,2756,2,18000,1.00435413643
202549,202555,205341,6,2786,2,18000,1.00215362527
202565,202571,205245,6,2674,2,18000,1.00224382947
202581,202587,205343,6,2756,2,18000,1.00217706821
202597,202603,205316,6,2713,2,18000,1.0022115739
202697,202705,205540,8,2835,2,18000,1.00282186949
202719,202727,205441,8,2714,2,18000,1.0029476787
202862,202872,205604,10,2732,2,18000,1.00366032211
202878,202885,205622,7,2737,2,18000,1.00255754476
202893,202901,205572,8,2671,2,18000,1.00299513291
202908,202914,205754,6,2840,2,18000,1.00211267606
202990,202998,205689,8,2691,2,18000,1.00297287254
203155,203165,206014,10,2849,2,18000,1.00351000351
203781,203787,203812,6,25,1,1800,1.24
204004,204010,206805,6,2795,2,18000,1.00214669052
204114,204121,204176,7,55,1,1800,1.12727272727
204294,204303,206946,9,2643,2,18000,1.00340522134
204322,204330,207086,8,2756,2,18000,1.00290275762
204350,204359,207199,9,2840,2,18000,1.00316901408
204394,204404,207199,10,2795,2,18000,1.00357781753
204567,204576,207430,9,2854,2,18000,1.00315346882
204649,204658,207295,9,2637,2,18000,1.00341296928
204651,204663,207551,12,2888,2,18000,1.00415512465
204666,204673,207387,7,2714,2,18000,1.00257921887
204688,204698,207564,10,2866,2,18000,1.00348918353
204786,204793,207549,7,2756,2,18000,1.00253991292
204817,204826,207552,9,2726,2,18000,1.00330154072
204855,204864,207495,9,2631,2,18000,1.00342075257
204891,204899,207649,8,2750,2,18000,1.00290909091
204895,204905,205023,10,118,1,1800,1.08474576271
204910,204918,207580,8,2662,2,18000,1.0030052592
204912,204924,207717,12,2793,2,18000,1.00429645542
204928,204935,207845,7,2910,2,18000,1.00240549828
204976,204984,207766,8,2782,2,18000,1.00287562904
204991,204997,207867,6,2870,2,18000,1.00209059233
205017,205024,207720,7,2696,2,18000,1.00259643917
205034,205040,207816,6,2776,2,18000,1.00216138329
205035,205046,207855,11,2809,2,18000,1.00391598434
205051,205057,207644,6,2587,2,18000,1.00231928875
205074,205081,207887,7,2806,2,18000,1.00249465431
205191,205199,207932,8,2733,2,18000,1.00292718624
205249,205256,208032,7,2776,2,18000,1.00252161383
205266,205272,208078,6,2806,2,18000,1.00213827512
205267,205278,208098,11,2820,2,18000,1.00390070922
205268,205283,207974,15,2691,2,18000,1.00557413601
205320,205328,208076,8,2748,2,18000,1.00291120815
205346,205352,208166,6,2814,2,18000,1.00213219616
205347,205358,207942,11,2584,2,18000,1.00425696594
205445,205452,208109,7,2657,2,18000,1.00263455024
205544,205551,208386,7,2835,2,18000,1.0024691358
205577,205583,208523,6,2940,2,18000,1.00204081633
205607,205616,208374,9,2758,2,18000,1.00326323423
205624,205633,208385,9,2752,2,18000,1.00327034884
205695,205700,208504,5,2804,2,18000,1.0017831669
205758,205766,208559,8,2793,2,18000,1.00286430362
206021,206028,208748,7,2720,2,18000,1.00257352941
206809,206817,209576,8,2759,2,18000,1.0028996013
206949,206957,209767,8,2810,2,18000,1.00284697509
207088,207097,209934,9,2837,2,18000,1.00317236517
207201,207209,209946,8,2737,2,18000,1.00292290829
207202,207214,209961,12,2747,2,18000,1.00436840189
207298,207306,210105,8,2799,2,18000,1.00285816363
207389,207398,210148,9,2750,2,18000,1.00327272727
207432,207442,210148,10,2706,2,18000,1.0036954915
207498,207507,210148,9,2641,2,18000,1.00340780008
207552,207560,210148,8,2588,2,18000,1.00309119011
207553,207566,210148,13,2582,2,18000,1.0050348567
207554,207571,210148,17,2577,2,18000,1.00659681801
207570,207577,210148,7,2571,2,18000,1.002722676
207585,207591,210148,6,2557,2,18000,1.0023464998
207648,207655,210148,7,2493,2,18000,1.00280786201
207663,207669,210148,6,2479,2,18000,1.00242033078
207719,207728,210148,9,2420,2,18000,1.00371900826
207735,207741,210148,6,2407,2,18000,1.00249272954
207769,207777,210148,8,2371,2,18000,1.00337410375
207818,207827,210148,9,2321,2,18000,1.00387763895
207846,207856,210148,10,2292,2,18000,1.00436300175
207861,207868,210148,7,2280,2,18000,1.00307017544
207877,207883,210148,6,2265,2,18000,1.00264900662
207892,207898,210148,6,2250,2,18000,1.00266666667
207936,207943,210148,7,2205,2,18000,1.00317460317
207951,207957,210148,6,2191,2,18000,1.00273847558
207976,207985,210148,9,2163,2,18000,1.00416088766
208035,208043,210148,8,2105,2,18000,1.00380047506
208078,208087,210149,9,2062,2,18000,1.00436469447
208080,208093,210149,13,2056,2,18000,1.0063229572
208102,208109,210149,7,2040,2,18000,1.00343137255
208117,208124,210149,7,2025,2,18000,1.00345679012
208171,208177,210148,6,1971,2,18000,1.00304414003
208290,208296,238689,6,30393,16,57600,1.00019741388
208377,208385,210149,8,1764,2,18000,1.00453514739
208393,208400,210148,7,1748,2,18000,1.00400457666
208395,208405,210149,10,1744,2,18000,1.00573394495
208506,208516,210148,10,1632,2,18000,1.00612745098
208525,208535,210149,10,1614,2,18000,1.00619578686
208562,208570,210148,8,1578,2,18000,1.00506970849
208752,208760,210149,8,1389,2,18000,1.00575953924
209417,209424,412702,7,203278,1,345600,1.0000344356
209578,209587,210148,9,561,2,18000,1.01604278075
209768,209778,210148,10,370,2,18000,1.02702702703
209937,209945,210148,8,203,2,18000,1.039408867
209953,209959,210148,6,189,2,18000,1.03174603175
209969,209975,210148,6,173,2,18000,1.03468208092
210109,210116,210148,7,32,2,18000,1.21875
210378,210384,213193,6,2809,2,18000,1.00213599146
210379,210389,213068,10,2679,2,18000,1.0037327361
210380,210394,213271,14,2877,2,18000,1.00486618005
210381,210399,213138,18,2739,2,18000,1.00657174151
210383,210405,213089,22,2684,2,18000,1.00819672131
210384,210410,213322,26,2912,2,18000,1.00892857143
210385,210416,213238,31,2822,2,18000,1.01098511694
210387,210421,213219,34,2798,2,18000,1.01215153681
210388,210426,213186,38,2760,2,18000,1.01376811594
210389,210431,213318,42,2887,2,18000,1.01454797368
210390,210436,213252,46,2816,2,18000,1.01633522727
210392,210441,213218,49,2777,2,18000,1.01764494058
210393,210446,213302,53,2856,2,18000,1.01855742297
210394,210451,213258,57,2807,2,18000,1.02030637691
210395,210457,213331,62,2874,2,18000,1.02157272095
210397,210462,213269,65,2807,2,18000,1.02315639473
210398,210467,213162,69,2695,2,18000,1.02560296846
210399,210472,213262,73,2790,2,18000,1.02616487455
210400,210477,213318,77,2841,2,18000,1.0271031327
210402,210482,213281,80,2799,2,18000,1.0285816363
210403,210487,213188,84,2701,2,18000,1.03109959274
210404,210492,213144,88,2652,2,18000,1.03318250377
210405,210498,213223,93,2725,2,18000,1.03412844037
210407,210503,213319,96,2816,2,18000,1.03409090909
210408,210508,213230,100,2722,2,18000,1.03673769287
210409,210513,213304,104,2791,2,18000,1.03726262988
210411,210518,213298,107,2780,2,18000,1.03848920863
210412,210524,213159,112,2635,2,18000,1.04250474383
210413,210529,213430,116,2901,2,18000,1.03998621165
210414,210534,213398,120,2864,2,18000,1.04189944134
210415,210539,213319,124,2780,2,18000,1.04460431655
210417,210544,213403,127,2859,2,18000,1.04442112627
210418,210549,213412,131,2863,2,18000,1.04575619979
210419,210554,213389,135,2835,2,18000,1.04761904762
210421,210560,213252,139,2692,2,18000,1.05163447251
210422,210565,213347,143,2782,2,18000,1.05140186916
210423,210570,213495,147,2925,2,18000,1.05025641026
210424,210575,213244,151,2669,2,18000,1.05657549644
210426,210580,213237,154,2657,2,18000,1.05796010538
210427,210585,213422,158,2837,2,18000,1.05569263306
212776,212782,213677,6,895,2,108000,1.00670391061
213068,213080,215870,12,2790,2,18000,1.00430107527
213092,213101,215903,9,2802,2,18000,1.00321199143
213140,213150,215903,10,2753,2,18000,1.00363240102
213155,213161,215878,6,2717,2,18000,1.002208318
213169,213175,215901,6,2726,2,18000,1.00220102715
213170,213181,215959,11,2778,2,18000,1.00395968323
213185,213197,215974,12,2777,2,18000,1.00432120994
213199,213206,216014,7,2808,2,18000,1.00249287749
213201,213211,215873,10,2662,2,18000,1.003756574
213222,213229,216069,7,2840,2,18000,1.00246478873
213223,213235,216080,12,2845,2,18000,1.00421792619
213238,213244,215991,6,2747,2,18000,1.00218420095
213239,213250,216043,11,2793,2,18000,1.00393841747
213240,213255,216022,15,2767,2,18000,1.00542103361
213255,213261,216043,6,2782,2,18000,1.00215672178
213256,213267,216110,11,2843,2,18000,1.0038691523
213257,213272,216129,15,2857,2,18000,1.00525026251
213258,213277,216143,19,2866,2,18000,1.00662944871
213273,213284,216094,11,2810,2,18000,1.00391459075
213274,213289,216026,15,2737,2,18000,1.00548045305
213275,213294,216132,19,2838,2,18000,1.00669485553
213277,213299,216210,22,2911,2,18000,1.00755754036
213291,213305,216105,14,2800,2,18000,1.005
213306,213312,216162,6,2850,2,18000,1.00210526316
213307,213318,216065,11,2747,2,18000,1.0040043684
213309,213323,216151,14,2828,2,18000,1.00495049505
213323,213329,216168,6,2839,2,18000,1.00211342022
213325,213335,216040,10,2705,2,18000,1.00369685767
213326,213340,215948,14,2608,2,18000,1.00536809816
213327,213345,216122,18,2777,2,18000,1.00648181491
213328,213350,216142,22,2792,2,18000,1.00787965616
213343,213356,216111,13,2755,2,18000,1.00471869328
213358,213364,216139,6,2775,2,18000,1.00216216216
213372,213378,217017,6,3639,10,3600,1.00164880462
213391,213400,216142,9,2742,2,18000,1.00328227571
213405,213412,216198,7,2786,2,18000,1.00251256281
213407,213418,216170,11,2752,2,18000,1.00399709302
213422,213428,216211,6,2783,2,18000,1.00215594682
213436,213442,216337,6,2895,2,18000,1.00207253886
213437,213448,216246,11,2798,2,18000,1.00393137956
213498,213506,216216,8,2710,2,18000,1.00295202952
213969,213975,413982,6,200007,1,345600,1.00002999895
214295,214301,381058,6,166757,1,345600,1.0000359805
214568,214574,222508,6,7934,2,108000,1.00075623897
215191,215197,265885,6,50688,4,360000,1.00011837121
215326,215332,248127,6,32795,4,144000,1.00018295472
215874,215884,218712,10,2828,2,18000,1.00353606789
215875,215889,218695,14,2806,2,18000,1.00498930862
215889,215895,218561,6,2666,2,18000,1.00225056264
215904,215912,218756,8,2844,2,18000,1.00281293952
215905,215918,218633,13,2715,2,18000,1.00478821363
215907,215923,218556,16,2633,2,18000,1.00607671857
215949,215959,218490,10,2531,2,18000,1.00395100751
215963,215970,218681,7,2711,2,18000,1.00258207304
215978,215986,218740,8,2754,2,18000,1.00290486565
215992,216002,218880,10,2878,2,18000,1.00347463516
216016,216025,218739,9,2714,2,18000,1.00331613854
216031,216037,218920,6,2883,2,18000,1.00208116545
216032,216043,218881,11,2838,2,18000,1.00387596899
216048,216054,218793,6,2739,2,18000,1.0021905805
216049,216060,218792,11,2732,2,18000,1.00402635432
216050,216065,218821,15,2756,2,18000,1.00544267054
216065,216076,218874,11,2798,2,18000,1.00393137956
216080,216086,218922,6,2836,2,18000,1.00211565585
216081,216092,218738,11,2646,2,18000,1.00415721844
216096,216105,219013,9,2908,2,18000,1.00309491059
216112,216118,218877,6,2759,2,18000,1.00217470098
216113,216124,218973,11,2849,2,18000,1.00386100386
216114,216129,218797,15,2668,2,18000,1.00562218891
216129,216135,218942,6,2807,2,18000,1.00213751336
216131,216141,218902,10,2761,2,18000,1.00362187613
216146,216151,218833,5,2682,2,18000,1.00186428039
216147,216157,218784,10,2627,2,18000,1.00380662352
216148,216178,216188,30,10,1,259200,4.0
216148,216162,218964,14,2802,2,18000,1.00499643112
216149,216167,218861,18,2694,2,18000,1.00668151448
216151,216172,218871,21,2699,2,18000,1.0077806595
216165,216184,219048,19,2864,2,18000,1.00663407821
216167,216189,218910,22,2721,2,18000,1.00808526277
216181,216195,219051,14,2856,2,18000,1.00490196078
216182,216200,218983,18,2783,2,18000,1.00646784046
216200,216209,218972,9,2763,2,18000,1.00325732899
216215,216221,218960,6,2739,2,18000,1.0021905805
216217,216227,219095,10,2868,2,18000,1.00348675035
216232,216238,218848,6,2610,2,18000,1.00229885057
216247,216257,219026,10,2769,2,18000,1.00361141206
216338,216349,218930,11,2581,2,18000,1.00426191399
216356,216362,266039,6,49677,1,259200,1.00012078024
216366,216372,225376,6,9004,1,259200,1.0006663705
217074,217080,221849,6,4769,1,43200,1.00125812539
217365,217371,246436,6,29065,6,72000,1.00020643386
217771,217777,223540,6,5763,36,72000,1.00104112441
218491,218502,221288,11,2786,2,18000,1.00394831299
218558,218567,221325,9,2758,2,18000,1.00326323423
218573,218579,221260,6,2681,2,18000,1.00223797091
218636,218644,221399,8,2755,2,18000,1.00290381125
218684,218692,221451,8,2759,2,18000,1.0028996013
218699,218706,221455,7,2749,2,18000,1.0025463805
218714,218723,221499,9,2776,2,18000,1.00324207493
218742,218750,221572,8,2822,2,18000,1.00283486889
218743,218755,221378,12,2623,2,18000,1.00457491422
218744,218761,221637,17,2876,2,18000,1.00591098748
218759,218767,221483,8,2716,2,18000,1.0029455081
218786,218795,221507,9,2712,2,18000,1.00331858407
218800,218806,221612,6,2806,2,18000,1.00213827512
218801,218812,221414,11,2602,2,18000,1.00422751729
218803,218817,221560,14,2743,2,18000,1.00510390084
218824,218832,221530,8,2698,2,18000,1.00296515938
218838,218844,221504,6,2660,2,18000,1.0022556391
218846,218852,218857,6,5,3,360000,1.1
218853,218859,221617,6,2758,2,18000,1.00217548949
218868,218874,221589,6,2715,2,18000,1.00220994475
218883,218889,221676,6,2787,2,18000,1.00215285253
218884,218895,221660,11,2765,2,18000,1.00397830018
218885,218900,221782,15,2882,2,18000,1.00520471895
218886,218905,221764,19,2859,2,18000,1.00664568031
218888,218910,221717,22,2807,2,18000,1.00783754898
218902,218916,221715,14,2799,2,18000,1.00500178635
218917,218923,221665,6,2742,2,18000,1.00218818381
218931,218938,221784,7,2846,2,18000,1.00245959241
218933,218943,221675,10,2732,2,18000,1.00366032211
218934,218949,221698,15,2749,2,18000,1.00545652965
218949,218955,221603,6,2648,2,18000,1.00226586103
218964,218971,221652,7,2681,2,18000,1.00261096606
218965,218977,221872,12,2895,2,18000,1.00414507772
218981,218987,221735,6,2748,2,18000,1.00218340611
218983,218993,221604,10,2611,2,18000,1.00382995021
218997,219003,221802,6,2799,2,18000,1.00214362272
219015,219024,221800,9,2776,2,18000,1.00324207493
219030,219037,221791,7,2754,2,18000,1.00254175744
219033,219043,222518,10,3475,3,180000,1.00287769784
219051,219059,221628,8,2569,2,18000,1.00311405216
219052,219065,221809,13,2744,2,18000,1.00473760933
219098,219106,221954,8,2848,2,18000,1.00280898876
219424,219430,222525,6,3095,4,360000,1.00193861066
221266,221272,223896,6,2624,2,18000,1.00228658537
221290,221299,223962,9,2663,2,18000,1.00337964701
221327,221337,224192,10,2855,2,18000,1.00350262697
221381,221389,224211,8,2822,2,18000,1.00283486889
221400,221410,224133,10,2723,2,18000,1.00367242012
221415,221425,223993,10,2568,2,18000,1.003894081
221454,221463,224274,9,2811,2,18000,1.00320170758
221469,221475,224233,6,2758,2,18000,1.00217548949
221484,221494,224250,10,2756,2,18000,1.00362844702
221503,221511,224243,8,2732,2,18000,1.00292825769
221518,221524,224224,6,2700,2,18000,1.00222222222
221519,221530,224393,11,2863,2,18000,1.00384212365
221535,221542,224336,7,2794,2,18000,1.00250536865
221563,221572,224373,9,2801,2,18000,1.00321313816
221579,221585,224355,6,2770,2,18000,1.00216606498
221594,221600,224349,6,2749,2,18000,1.00218261186
221609,221615,224050,6,2435,2,18000,1.00246406571
221610,221621,224311,11,2690,2,18000,1.00408921933
221626,221632,224368,6,2736,2,18000,1.00219298246
221627,221638,224414,11,2776,2,18000,1.00396253602
221642,221648,224374,6,2726,2,18000,1.00220102715
221643,221654,224433,11,2779,2,18000,1.00395825837
221658,221664,224311,6,2647,2,18000,1.00226671704
221675,221681,224397,6,2716,2,18000,1.00220913108
221676,221687,224384,11,2697,2,18000,1.00407860586
221678,221692,224419,14,2727,2,18000,1.00513384672
221693,221699,224487,6,2788,2,18000,1.00215208034
221707,221714,224511,7,2797,2,18000,1.00250268144
221722,221728,224516,6,2788,2,18000,1.00215208034
221724,221734,224574,10,2840,2,18000,1.00352112676
221738,221746,224528,8,2782,2,18000,1.00287562904
221765,221775,224580,10,2805,2,18000,1.00356506239
221783,221794,224651,11,2857,2,18000,1.00385019251
221798,221804,224662,6,2858,2,18000,1.00209937019
221799,221810,224498,11,2688,2,18000,1.0040922619
221814,221820,224638,6,2818,2,18000,1.00212916962
221815,221826,224615,11,2789,2,18000,1.00394406597
221817,221831,224620,14,2789,2,18000,1.00501972033
221875,221884,224640,9,2756,2,18000,1.00326560232
221926,221932,265170,6,43238,1,43200,1.00013876683
221958,221965,224748,7,2783,2,18000,1.00251527129
223303,223309,285428,6,62119,2,108000,1.00009658881
223622,223628,315869,6,92241,4,360000,1.000065047
223903,223909,226672,6,2763,2,18000,1.00217155266
223965,223973,226805,8,2832,2,18000,1.00282485876
223996,224004,226805,8,2801,2,18000,1.00285612281
224046,224052,239251,6,15199,3,180000,1.00039476281
224052,224062,226869,10,2807,2,18000,1.00356252227
224136,224144,226944,8,2800,2,18000,1.00285714286
224195,224203,227026,8,2823,2,18000,1.00283386468
224214,224222,226895,8,2673,2,18000,1.00299289188
224229,224235,226954,6,2719,2,18000,1.00220669364
224244,224250,227053,6,2803,2,18000,1.00214056368
224245,224256,227021,11,2765,2,18000,1.00397830018
224261,224267,227011,6,2744,2,18000,1.00218658892
224276,224285,227104,9,2819,2,18000,1.0031926215
224315,224322,227001,7,2679,2,18000,1.00261291527
224316,224327,227161,11,2834,2,18000,1.00388143966
224337,224347,227190,10,2843,2,18000,1.00351741119
224352,224361,227079,9,2718,2,18000,1.00331125828
224367,224373,227103,6,2730,2,18000,1.0021978022
224383,224389,227019,6,2630,2,18000,1.00228136882
224384,224395,226993,11,2598,2,18000,1.00423402617
224386,224400,227196,14,2796,2,18000,1.00500715308
224402,224408,227245,6,2837,2,18000,1.00211491012
224403,224414,227187,11,2773,2,18000,1.00396682294
224404,224419,227263,15,2844,2,18000,1.0052742616
224420,224425,227182,5,2757,2,18000,1.00181356547
224421,224431,227214,10,2783,2,18000,1.0035932447
224436,224444,227173,8,2729,2,18000,1.00293147673
224488,224498,227238,10,2740,2,18000,1.00364963504
224503,224509,227303,6,2794,2,18000,1.00214745884
224519,224525,227441,6,2916,2,18000,1.00205761317
224520,224531,227322,11,2791,2,18000,1.0039412397
224535,224541,227395,6,2854,2,18000,1.00210231254
224575,224585,227325,10,2740,2,18000,1.00364963504
224590,224597,227276,7,2679,2,18000,1.00261291527
224618,224627,227406,9,2779,2,18000,1.00323857503
224634,224641,227402,7,2761,2,18000,1.00253531329
224652,224658,227453,6,2795,2,18000,1.00214669052
224653,224664,227360,11,2696,2,18000,1.00408011869
224655,224669,227332,14,2663,2,18000,1.00525722869
224672,224678,227535,6,2857,2,18000,1.00210010501
224754,224760,227542,6,2782,2,18000,1.00215672178
224988,224994,229816,6,4822,1,36000,1.00124429697
225375,225381,265804,6,40423,1,259200,1.00014843035
225556,225562,229819,6,4257,1,36000,1.00140944327
225588,225594,229823,6,4229,1,36000,1.00141877512
225604,225610,229826,6,4216,1,36000,1.00142314991
226252,226259,229785,7,3526,4,3600,1.00198525241
226674,226684,229447,10,2763,2,18000,1.00361925443
226810,226816,229490,6,2674,2,18000,1.00224382947
226811,226822,229515,11,2693,2,18000,1.00408466394
226872,226880,229513,8,2633,2,18000,1.00303835929
226898,226907,229607,9,2700,2,18000,1.00333333333
226945,226956,229759,11,2803,2,18000,1.00392436675
226961,226967,229785,6,2818,2,18000,1.00212916962
226995,227005,229884,10,2879,2,18000,1.00347342827
227011,227017,229825,6,2808,2,18000,1.00213675214
227028,227034,229786,6,2752,2,18000,1.00218023256
227029,227040,229745,11,2705,2,18000,1.00406654344
227030,227045,229841,15,2796,2,18000,1.00536480687
227032,227050,229857,18,2807,2,18000,1.00641254008
227057,227064,229688,7,2624,2,18000,1.00266768293
227082,227090,229886,8,2796,2,18000,1.00286123033
227103,227114,229792,11,2678,2,18000,1.00410754294
227119,227125,230002,6,2877,2,18000,1.00208550574
227164,227172,229950,8,2778,2,18000,1.00287976962
227180,227185,229912,5,2727,2,18000,1.00183351669
227196,227202,229877,6,2675,2,18000,1.00224299065
227197,227208,229940,11,2732,2,18000,1.00402635432
227198,227213,229907,15,2694,2,18000,1.00556792873
227217,227223,230052,6,2829,2,18000,1.00212089077
227218,227229,230026,11,2797,2,18000,1.00393278513
227248,227254,229919,6,2665,2,18000,1.00225140713
227249,227260,229952,11,2692,2,18000,1.00408618128
227265,227274,230121,9,2847,2,18000,1.00316122234
227291,227297,230015,6,2718,2,18000,1.00220750552
227309,227314,230058,5,2744,2,18000,1.00182215743
227326,227336,229907,10,2571,2,18000,1.00388953715
227327,227341,230103,14,2762,2,18000,1.00506879073
227344,227351,230016,7,2665,2,18000,1.00262664165
227363,227371,230244,8,2873,2,18000,1.00278454577
227398,227406,230249,8,2843,2,18000,1.00281392895
227413,227419,230035,6,2616,2,18000,1.00229357798
227414,227425,230229,11,2804,2,18000,1.00392296719
227446,227452,230083,6,2631,2,18000,1.00228050171
227462,227468,230283,6,2815,2,18000,1.00213143872
227538,227546,230394,8,2848,2,18000,1.00280898876
227554,227560,230377,6,2817,2,18000,1.00212992545
228523,228529,229092,6,563,4,21600,1.01065719361
228891,228897,228961,6,64,4,21600,1.09375
229450,229459,232279,9,2820,2,18000,1.00319148936
229491,229501,232243,10,2742,2,18000,1.00364697301
229515,229530,232292,15,2762,2,18000,1.00543084721
229516,229524,232238,8,2714,2,18000,1.0029476787
229609,229618,232300,9,2682,2,18000,1.0033557047
229656,229662,230170,6,508,4,21600,1.01181102362
229690,229699,232538,9,2839,2,18000,1.00317013033
229746,229756,232453,10,2697,2,18000,1.00370782351
229761,229770,232552,9,2782,2,18000,1.00323508267
229787,229796,232551,9,2755,2,18000,1.00326678766
229788,229802,232552,14,2750,2,18000,1.00509090909
229804,229810,232460,6,2650,2,18000,1.00226415094
229825,229836,232535,11,2699,2,18000,1.00407558355
229844,229852,232606,8,2754,2,18000,1.00290486565
229860,229868,232722,8,2854,2,18000,1.00280308339
229878,229889,232658,11,2769,2,18000,1.00397255327
229896,229902,232753,6,2851,2,18000,1.00210452473
229897,229908,232432,11,2524,2,18000,1.00435816165
229913,229919,232667,6,2748,2,18000,1.00218340611
229914,229925,232767,11,2842,2,18000,1.00387051372
229915,229930,232711,15,2781,2,18000,1.00539374326
229931,229937,232678,6,2741,2,18000,1.00218898212
229946,229951,232640,5,2689,2,18000,1.0018594273
229962,229968,232802,6,2834,2,18000,1.00211714891
229963,229974,232716,11,2742,2,18000,1.00401167031
229976,229982,265588,6,35606,1,54000,1.00016851093
229982,229988,265581,6,35593,1,54000,1.00016857247
229988,229994,265553,6,35559,1,54000,1.00016873365
229994,230001,265588,7,35587,1,54000,1.00019670104
229998,230007,266910,9,36903,1,72000,1.00024388261
230004,230013,232864,9,2851,2,18000,1.00315678709
230019,230027,232840,8,2813,2,18000,1.00284393886
230020,230032,232993,12,2961,2,18000,1.0040526849
230036,230042,232747,6,2705,2,18000,1.0022181146
230037,230048,232867,11,2819,2,18000,1.00390209294
230055,230063,232732,8,2669,2,18000,1.00299737729
230071,230077,232824,6,2747,2,18000,1.00218420095
230087,230094,232737,7,2643,2,18000,1.00264850549
230106,230114,232971,8,2857,2,18000,1.00280014001
230125,230133,232819,8,2686,2,18000,1.00297840655
230232,230240,233050,8,2810,2,18000,1.00284697509
230249,230255,233027,6,2772,2,18000,1.00216450216
230265,230271,233107,6,2836,2,18000,1.00211565585
230287,230295,233174,8,2879,2,18000,1.00277874262
230379,230388,233197,9,2809,2,18000,1.00320398718
230395,230406,233245,11,2839,2,18000,1.00387460373
231885,231891,231892,6,1,1,72000,1.0
232010,232016,233487,6,1471,1,72000,1.00407885792
232211,232217,297359,6,65142,1,432000,1.00009210648
232219,232225,232227,6,2,1,73800,1.0
232240,232249,234943,9,2694,2,18000,1.00334075724
232255,232261,235026,6,2765,2,18000,1.00216998192
232279,232290,235048,11,2758,2,18000,1.00398839739
232295,232303,235075,8,2772,2,18000,1.00288600289
232310,232316,235138,6,2822,2,18000,1.00212615167
232435,232443,235197,8,2754,2,18000,1.00290486565
232456,232464,235330,8,2866,2,18000,1.00279134682
232471,232477,235251,6,2774,2,18000,1.0021629416
232535,232546,235344,11,2798,2,18000,1.00393137956
232551,232557,235282,6,2725,2,18000,1.00220183486
232567,232573,235419,6,2846,2,18000,1.00210822207
232568,232579,235359,11,2780,2,18000,1.00395683453
232569,232584,235407,15,2823,2,18000,1.00531349628
232609,232617,235460,8,2843,2,18000,1.00281392895
232640,232651,235506,11,2855,2,18000,1.00385288967
232661,232669,235469,8,2800,2,18000,1.00285714286
232677,232683,235557,6,2874,2,18000,1.00208768267
232692,232698,235514,6,2816,2,18000,1.00213068182
232713,232722,235338,9,2616,2,18000,1.00344036697
232728,232734,235569,6,2835,2,18000,1.00211640212
232729,232740,235477,11,2737,2,18000,1.0040189989
232744,232750,235530,6,2780,2,18000,1.00215827338
232745,232756,235399,11,2643,2,18000,1.00416193719
232760,232766,235510,6,2744,2,18000,1.00218658892
232761,232772,235440,11,2668,2,18000,1.00412293853
232777,232783,235477,6,2694,2,18000,1.00222717149
232805,232813,235568,8,2755,2,18000,1.00290381125
232819,232830,235504,11,2674,2,18000,1.00411368736
232834,232840,235600,6,2760,2,18000,1.00217391304
232849,232855,235572,6,2717,2,18000,1.002208318
232868,232878,235556,10,2678,2,18000,1.00373412995
232869,232883,235647,14,2764,2,18000,1.00506512301
232974,232982,235842,8,2860,2,18000,1.0027972028
232995,233004,235832,9,2828,2,18000,1.0031824611
233029,233039,235954,10,2915,2,18000,1.00343053173
233050,233061,235851,11,2790,2,18000,1.00394265233
233108,233118,235966,10,2848,2,18000,1.00351123596
233176,233185,235897,9,2712,2,18000,1.00331858407
233200,233208,235898,8,2690,2,18000,1.0029739777
233225,233231,239944,6,6713,1,73800,1.00089378817
233253,233260,235976,7,2716,2,18000,1.00257731959
233285,233291,269166,6,35875,1,72000,1.00016724739
234699,234705,269230,6,34525,4,144000,1.00017378711
234949,234955,252774,6,17819,4,144000,1.00033671923
234952,234961,237755,9,2794,2,18000,1.00322118826
235031,235037,237905,6,2868,2,18000,1.00209205021
235049,235059,237823,10,2764,2,18000,1.00361794501
235077,235087,237856,10,2769,2,18000,1.00361141206
235138,235149,237873,11,2724,2,18000,1.00403817915
235200,235208,237711,8,2503,2,18000,1.0031961646
235253,235263,237914,10,2651,2,18000,1.00377216145
235284,235293,238002,9,2709,2,18000,1.00332225914
235330,235341,238034,11,2693,2,18000,1.00408466394
235346,235352,238131,6,2779,2,18000,1.00215905002
235347,235358,238061,11,2703,2,18000,1.00406955235
235362,235370,238217,8,2847,2,18000,1.00280997541
235401,235410,238177,9,2767,2,18000,1.00325262017
235416,235423,238188,7,2765,2,18000,1.00253164557
235432,235438,238213,6,2775,2,18000,1.00216216216
235449,235455,238332,6,2877,2,18000,1.00208550574
235467,235473,238156,6,2683,2,18000,1.00223630265
235482,235487,238217,5,2730,2,18000,1.00183150183
235483,235494,238378,11,2884,2,18000,1.00381414702
235484,235499,238228,15,2729,2,18000,1.00549651887
235507,235515,238425,8,2910,2,18000,1.00274914089
235508,235521,238157,13,2636,2,18000,1.00493171472
235524,235530,238230,6,2700,2,18000,1.00222222222
235525,235536,238239,11,2703,2,18000,1.00406955235
235541,235547,238195,6,2648,2,18000,1.00226586103
235557,235567,238324,10,2757,2,18000,1.00362713094
235573,235579,238319,6,2740,2,18000,1.00218978102
235574,235585,238456,11,2871,2,18000,1.00383141762
235576,235590,238434,14,2844,2,18000,1.00492264416
235577,235595,238248,18,2653,2,18000,1.00678477196
235602,235611,238181,9,2570,2,18000,1.00350194553
235650,235658,238456,8,2798,2,18000,1.00285918513
235834,235844,238580,10,2736,2,18000,1.00365497076
235849,235855,238669,6,2814,2,18000,1.00213219616
235864,235870,238368,6,2498,2,18000,1.00240192154
235898,235908,238461,10,2553,2,18000,1.00391696044
235914,235920,238641,6,2721,2,18000,1.00220507166
235956,235966,238662,10,2696,2,18000,1.00370919881
235972,235978,238773,6,2795,2,18000,1.00214669052
235987,235994,238769,7,2775,2,18000,1.00252252252
236567,236573,237710,6,1137,2,14400,1.00527704485
237422,237428,237436,6,8,1,72000,1.4
237457,237463,237469,6,6,1,72000,1.2
237720,237726,240605,6,2879,2,18000,1.00208405696
237756,237766,240539,10,2773,2,18000,1.00360620267
237827,237834,240477,7,2643,2,18000,1.00264850549
237857,237867,240523,10,2656,2,18000,1.00376506024
237876,237884,240731,8,2847,2,18000,1.00280997541
237907,237916,240792,9,2876,2,18000,1.00312934631
237922,237928,240837,6,2909,2,18000,1.00206256446
238005,238013,240834,8,2821,2,18000,1.0028358738
238036,238045,240754,9,2709,2,18000,1.00332225914
238063,238072,240639,9,2567,2,18000,1.00350603818
238134,238142,241022,8,2880,2,18000,1.00277777778
238161,238166,240931,5,2765,2,18000,1.00180831826
238162,238172,240858,10,2686,2,18000,1.00372300819
238182,238188,240956,6,2768,2,18000,1.00216763006
238183,238194,240981,11,2787,2,18000,1.0039468963
238199,238205,240899,6,2694,2,18000,1.00222717149
238200,238211,240872,11,2661,2,18000,1.00413378429
238215,238225,240949,10,2724,2,18000,1.00367107195
238231,238237,240992,6,2755,2,18000,1.00217785844
238232,238243,240920,11,2677,2,18000,1.00410907733
238233,238248,241031,15,2783,2,18000,1.00538986705
238235,238253,241153,18,2900,2,18000,1.00620689655
238255,238261,240721,6,2460,2,18000,1.00243902439
238256,238267,240987,11,2720,2,18000,1.00404411765
238321,238330,241006,9,2676,2,18000,1.0033632287
238336,238342,241094,6,2752,2,18000,1.00218023256
238337,238348,241171,11,2823,2,18000,1.00389656394
238372,238379,241074,7,2695,2,18000,1.0025974026
238387,238393,241053,6,2660,2,18000,1.0022556391
238428,238436,241290,8,2854,2,18000,1.00280308339
238448,238455,241127,7,2672,2,18000,1.00261976048
238465,238471,241008,6,2537,2,18000,1.00236499803
238466,238477,241182,11,2705,2,18000,1.00406654344
238467,238482,241206,15,2724,2,18000,1.00550660793
238593,238599,241216,6,2617,2,18000,1.00229270157
238643,238652,241473,9,2821,2,18000,1.00319035803
238664,238673,241443,9,2770,2,18000,1.00324909747
238679,238685,241446,6,2761,2,18000,1.00217312568
238722,238729,260457,7,21728,1,21600,1.00032216495
238773,238780,241410,7,2630,2,18000,1.00266159696
238790,238796,241638,6,2842,2,18000,1.0021111893
238993,238999,239103,6,104,1,7200,1.05769230769
240480,240488,243296,8,2808,2,18000,1.00284900285
240526,240534,243263,8,2729,2,18000,1.00293147673
240541,240550,243335,9,2785,2,18000,1.00323159785
240608,240616,243409,8,2793,2,18000,1.00286430362
240642,240650,243433,8,2783,2,18000,1.00287459576
240725,240733,243599,8,2866,2,18000,1.00279134682
240740,240746,243462,6,2716,2,18000,1.00220913108
240756,240765,243608,9,2843,2,18000,1.00316567007
240792,240803,243575,11,2772,2,18000,1.00396825397
240836,240845,243519,9,2674,2,18000,1.0033657442
240860,240866,243566,6,2700,2,18000,1.00222222222
240861,240872,243703,11,2831,2,18000,1.00388555281
240877,240883,243673,6,2790,2,18000,1.00215053763
240901,240910,243702,9,2792,2,18000,1.0032234957
240923,240931,243789,8,2858,2,18000,1.00279916025
240939,240945,243637,6,2692,2,18000,1.00222882615
240954,240960,243659,6,2699,2,18000,1.00222304557
240970,240976,243799,6,2823,2,18000,1.00212539851
240985,240992,243860,7,2868,2,18000,1.00244072524
241001,241007,243789,6,2782,2,18000,1.00215672178
241002,241013,243895,11,2882,2,18000,1.00381679389
241017,241024,243726,7,2702,2,18000,1.00259067358
241019,241030,243872,11,2842,2,18000,1.00387051372
241034,241041,243782,7,2741,2,18000,1.00255381248
241036,241047,243724,11,2677,2,18000,1.00410907733
241054,241065,243879,11,2814,2,18000,1.0039090263
241075,241085,243868,10,2783,2,18000,1.0035932447
241097,241105,243964,8,2859,2,18000,1.00279818118
241131,241139,243966,8,2827,2,18000,1.00282985497
241156,241164,243970,8,2806,2,18000,1.0028510335
241174,241183,243834,9,2651,2,18000,1.0033949453
241190,241196,243914,6,2718,2,18000,1.00220750552
241208,241217,244107,9,2890,2,18000,1.00311418685
241224,241230,244063,6,2833,2,18000,1.00211789622
241288,241295,241298,7,3,1,21600,1.0
241291,241300,244024,9,2724,2,18000,1.00330396476
241414,241421,244132,7,2711,2,18000,1.00258207304
241445,241455,244231,10,2776,2,18000,1.00360230548
241460,241466,244320,6,2854,2,18000,1.00210231254
241475,241484,244224,9,2740,2,18000,1.00328467153
241641,241649,244394,8,2745,2,18000,1.0029143898
243264,243275,246104,11,2829,2,18000,1.00388829975
243298,243307,246222,9,2915,2,18000,1.00308747856
243337,243346,246056,9,2710,2,18000,1.00332103321
243411,243420,246130,9,2710,2,18000,1.00332103321
243435,243444,246169,9,2725,2,18000,1.00330275229
243466,243474,246216,8,2742,2,18000,1.00291757841
243521,243530,246229,9,2699,2,18000,1.00333456836
243568,243577,246196,9,2619,2,18000,1.00343642612
243583,243589,246442,6,2853,2,18000,1.00210304942
243602,243610,246483,8,2873,2,18000,1.00278454577
243617,243623,246273,6,2650,2,18000,1.00226415094
243638,243648,246575,10,2927,2,18000,1.00341646737
243661,243670,246451,9,2781,2,18000,1.00323624595
243676,243684,246386,8,2702,2,18000,1.0029607698
243712,243718,246596,6,2878,2,18000,1.0020847811
243713,243724,246645,11,2921,2,18000,1.00376583362
243729,243735,246495,6,2760,2,18000,1.00217391304
243730,243741,246659,11,2918,2,18000,1.00376970528
243786,243794,246540,8,2746,2,18000,1.00291332848
243802,243808,246622,6,2814,2,18000,1.00213219616
243803,243814,246683,11,2869,2,18000,1.00383408853
243805,243819,246637,14,2818,2,18000,1.00496806246
243835,243845,246669,10,2824,2,18000,1.00354107649
243863,243871,246531,8,2660,2,18000,1.0030075188
243880,243886,246674,6,2788,2,18000,1.00215208034
243881,243892,246616,11,2724,2,18000,1.00403817915
243882,243897,246634,15,2737,2,18000,1.00548045305
243897,243907,246642,10,2735,2,18000,1.00365630713
243916,243925,246771,9,2846,2,18000,1.0031623331
243965,243975,246738,10,2763,2,18000,1.00361925443
243967,243981,246744,14,2763,2,18000,1.00506695621
243984,243990,246665,6,2675,2,18000,1.00224299065
244027,244035,246767,8,2732,2,18000,1.00292825769
244067,244074,246812,7,2738,2,18000,1.00255661066
244110,244119,246924,9,2805,2,18000,1.00320855615
244134,244143,246978,9,2835,2,18000,1.00317460317
244226,244235,246926,9,2691,2,18000,1.00334448161
244241,244247,246960,6,2713,2,18000,1.0022115739
244321,244331,247038,10,2707,2,18000,1.00369412634
244398,244406,247084,8,2678,2,18000,1.00298730396
244924,244930,244931,6,1,2,300,1.0
246063,246069,248757,6,2688,2,18000,1.00223214286
246105,246115,248960,10,2845,2,18000,1.00351493849
246133,246141,249024,8,2883,2,18000,1.00277488727
246170,246180,248670,10,2490,2,18000,1.00401606426
246198,246207,248930,9,2723,2,18000,1.00330517811
246219,246227,249043,8,2816,2,18000,1.00284090909
246235,246241,248951,6,2710,2,18000,1.00221402214
246236,246247,249016,11,2769,2,18000,1.00397255327
246278,246284,248991,6,2707,2,18000,1.0022164758
246389,246398,249184,9,2786,2,18000,1.0032304379
246445,246453,249026,8,2573,2,18000,1.00310921104
246461,246467,249282,6,2815,2,18000,1.00213143872
246485,246494,249361,9,2867,2,18000,1.00313916986
246500,246506,249375,6,2869,2,18000,1.00209132102
246534,246542,249015,8,2473,2,18000,1.00323493732
246549,246555,249297,6,2742,2,18000,1.00218818381
246577,246586,249152,9,2566,2,18000,1.00350740452
246599,246607,249390,8,2783,2,18000,1.00287459576
246617,246627,249504,10,2877,2,18000,1.00347584289
246633,246639,249394,6,2755,2,18000,1.00217785844
246649,246655,249366,6,2711,2,18000,1.00221320546
246650,246661,249535,11,2874,2,18000,1.00382741823
246652,246666,249515,14,2849,2,18000,1.00491400491
246653,246671,249250,18,2579,2,18000,1.0069794494
246669,246677,249433,8,2756,2,18000,1.00290275762
246671,246682,249557,11,2875,2,18000,1.00382608696
246672,246688,249531,16,2843,2,18000,1.0056278579
246687,246694,249512,7,2818,2,18000,1.00248403123
246689,246700,249329,11,2629,2,18000,1.00418410042
246742,246749,249532,7,2783,2,18000,1.00251527129
246757,246763,249499,6,2736,2,18000,1.00219298246
246773,246779,249421,6,2642,2,18000,1.00227100681
246774,246785,249626,11,2841,2,18000,1.0038718761
246815,246824,249622,9,2798,2,18000,1.00321658327
246927,246937,249696,10,2759,2,18000,1.00362450163
246929,246942,249725,13,2783,2,18000,1.00467121811
246963,246972,249822,9,2850,2,18000,1.00315789474
246982,246989,249652,7,2663,2,18000,1.00262861434
247041,247049,249752,8,2703,2,18000,1.00295967444
247087,247095,249847,8,2752,2,18000,1.00290697674
248672,248681,251403,9,2722,2,18000,1.00330639236
248760,248768,251506,8,2738,2,18000,1.00292184076
248932,248941,251809,9,2868,2,18000,1.00313807531
248953,248962,251790,9,2828,2,18000,1.0031824611
248968,248974,251620,6,2646,2,18000,1.0022675737
248993,249003,251924,10,2921,2,18000,1.00342348511
249017,249026,251824,9,2798,2,18000,1.00321658327
249019,249032,251609,13,2577,2,18000,1.00504462553
249035,249041,251708,6,2667,2,18000,1.00224971879
249036,249047,251734,11,2687,2,18000,1.00409378489
249052,249058,251883,6,2825,2,18000,1.00212389381
249153,249163,251954,10,2791,2,18000,1.00358294518
249187,249196,252043,9,2847,2,18000,1.00316122234
249251,249261,252066,10,2805,2,18000,1.00356506239
249284,249293,251984,9,2691,2,18000,1.00334448161
249299,249308,252151,9,2843,2,18000,1.00316567007
249330,249340,252066,10,2726,2,18000,1.00366837858
249365,249372,252136,7,2764,2,18000,1.00253256151
249381,249387,252138,6,2751,2,18000,1.00218102508
249382,249393,252163,11,2770,2,18000,1.00397111913
249385,249398,249403,13,5,2,300,1.8
249398,249404,252184,6,2780,2,18000,1.00215827338
249399,249410,252306,11,2896,2,18000,1.00379834254
249411,249416,249443,5,27,2,300,1.18518518519
249424,249432,252268,8,2836,2,18000,1.00282087447
249440,249446,252118,6,2672,2,18000,1.00224550898
249450,249456,249506,6,50,2,300,1.12
249502,249510,252167,8,2657,2,18000,1.00301091457
249504,249515,249567,11,52,4,21600,1.21153846154
249516,249522,249783,6,261,2,300,1.02298850575
249518,249528,252085,10,2557,2,18000,1.00391083301
249520,249533,252357,13,2824,2,18000,1.00460339943
249521,249538,252346,17,2808,2,18000,1.00605413105
249538,249544,252323,6,2779,2,18000,1.00215905002
249539,249550,252366,11,2816,2,18000,1.00390625
249540,249555,252498,15,2943,2,18000,1.00509683996
249559,249568,252505,9,2937,2,18000,1.00306435138
249623,249634,252441,11,2807,2,18000,1.00391877449
249639,249645,252505,6,2860,2,18000,1.0020979021
249654,249663,252582,9,2919,2,18000,1.00308324769
249697,249707,252415,10,2708,2,18000,1.00369276219
249728,249737,252486,9,2749,2,18000,1.00327391779
249753,249763,252470,10,2707,2,18000,1.00369412634
249792,249798,249814,6,16,2,300,1.375
249821,249827,249856,6,29,2,300,1.20689655172
249824,249833,252531,9,2698,2,18000,1.0033358043
249849,249858,252608,9,2750,2,18000,1.00327272727
249864,249870,249900,6,30,2,300,1.2
249908,249914,250225,6,311,2,300,1.0192926045
250239,250245,250601,6,356,2,360,1.01685393258
250615,250621,250794,6,173,2,360,1.03468208092
251403,251414,254146,11,2732,2,18000,1.00402635432
251507,251517,254178,10,2661,2,18000,1.00375798572
251611,251620,254431,9,2811,2,18000,1.00320170758
251626,251632,254443,6,2811,2,18000,1.00213447172
251710,251720,254407,10,2687,2,18000,1.00372162263
251734,251745,254613,11,2868,2,18000,1.00383542538
251792,251801,254555,9,2754,2,18000,1.00326797386
251811,251820,254633,9,2813,2,18000,1.00319943121
251826,251835,254556,9,2721,2,18000,1.0033076075
251882,251894,254669,12,2775,2,18000,1.00432432432
251928,251935,254716,7,2781,2,18000,1.00251708019
251956,251965,254826,9,2861,2,18000,1.00314575323
251987,251995,254569,8,2574,2,18000,1.00310800311
252046,252054,254886,8,2832,2,18000,1.00282485876
252067,252077,254928,10,2851,2,18000,1.00350754121
252068,252082,254742,14,2660,2,18000,1.00526315789
252087,252096,254774,9,2678,2,18000,1.00336071695
252121,252129,254871,8,2742,2,18000,1.00291757841
252142,252147,254832,5,2685,2,18000,1.00186219739
252143,252153,254870,10,2717,2,18000,1.00368053
252158,252164,255070,6,2906,2,18000,1.00206469374
252175,252181,254977,6,2796,2,18000,1.00214592275
252176,252187,254882,11,2695,2,18000,1.00408163265
252191,252197,254859,6,2662,2,18000,1.0022539444
252272,252279,255020,7,2741,2,18000,1.00255381248
252309,252318,254986,9,2668,2,18000,1.00337331334
252324,252334,255022,10,2688,2,18000,1.0037202381
252350,252357,255201,7,2844,2,18000,1.00246132208
252365,252371,255106,6,2735,2,18000,1.00219378428
252380,252386,255196,6,2810,2,18000,1.00213523132
252417,252427,255169,10,2742,2,18000,1.00364697301
252445,252452,255231,7,2779,2,18000,1.00251889169
252474,252481,255208,7,2727,2,18000,1.00256692336
252489,252497,255387,8,2890,2,18000,1.00276816609
252506,252512,255244,6,2732,2,18000,1.00219619327
252507,252518,255324,11,2806,2,18000,1.00392017106
252508,252523,255184,15,2661,2,18000,1.00563697858
252533,252542,255406,9,2864,2,18000,1.0031424581
252582,252593,255304,11,2711,2,18000,1.00405754334
252610,252619,255412,9,2793,2,18000,1.00322234157
252808,252814,283722,6,30908,4,144000,1.0001941245
253264,253270,253333,6,63,2,3540,1.09523809524
254147,254157,257010,10,2853,2,18000,1.00350508237
254180,254189,256958,9,2769,2,18000,1.00325027086
254409,254418,257316,9,2898,2,18000,1.00310559006
254432,254442,257300,10,2858,2,18000,1.00349895031
254448,254453,257258,5,2805,2,18000,1.00178253119
254556,254572,257320,16,2748,2,18000,1.0058224163
254558,254566,257371,8,2805,2,18000,1.00285204991
254573,254581,257425,8,2844,2,18000,1.00281293952
254616,254624,257440,8,2816,2,18000,1.00284090909
254635,254644,257517,9,2873,2,18000,1.00313261399
254672,254680,257382,8,2702,2,18000,1.0029607698
254718,254727,257406,9,2679,2,18000,1.00335946249
254745,254753,257422,8,2669,2,18000,1.00299737729
254776,254785,257332,9,2547,2,18000,1.0035335689
254828,254837,257688,9,2851,2,18000,1.00315678709
254843,254849,257785,6,2936,2,18000,1.00204359673
254862,254871,257644,9,2773,2,18000,1.0032455824
254875,254881,255410,6,529,2,10800,1.01134215501
254877,254887,257714,10,2827,2,18000,1.00353731871
254879,254892,257712,13,2820,2,18000,1.00460992908
254894,254901,257679,7,2778,2,18000,1.00251979842
254896,254907,257678,11,2771,2,18000,1.00396968603
254930,254939,257717,9,2778,2,18000,1.00323974082
254981,254988,257747,7,2759,2,18000,1.00253715114
254996,255002,257705,6,2703,2,18000,1.00221975583
255022,255031,257840,9,2809,2,18000,1.00320398718
255037,255043,257822,6,2779,2,18000,1.00215905002
255072,255081,257884,9,2803,2,18000,1.00321084552
255109,255117,257890,8,2773,2,18000,1.00288496213
255171,255180,257894,9,2714,2,18000,1.00331613854
255186,255195,258080,9,2885,2,18000,1.00311958406
255202,255208,258088,6,2880,2,18000,1.00208333333
255203,255214,258128,11,2914,2,18000,1.00377487989
255219,255225,258018,6,2793,2,18000,1.00214822771
255235,255243,257911,8,2668,2,18000,1.00299850075
255250,255256,258029,6,2773,2,18000,1.0021637216
255307,255315,258043,8,2728,2,18000,1.00293255132
255325,255335,257957,10,2622,2,18000,1.00381388253
255388,255398,258122,10,2724,2,18000,1.00367107195
255407,255426,258174,19,2748,2,18000,1.00691411936
255411,255420,266357,9,10937,2,10800,1.00082289476
255422,255432,258192,10,2760,2,18000,1.00362318841
256967,256973,259785,6,2812,2,18000,1.00213371266
257014,257021,259655,7,2634,2,18000,1.00265755505
257260,257269,260048,9,2779,2,18000,1.00323857503
257304,257311,260058,7,2747,2,18000,1.00254823444
257319,257327,260131,8,2804,2,18000,1.00285306705
257340,257347,260189,7,2842,2,18000,1.00246305419
257342,257353,260023,11,2670,2,18000,1.00411985019
257372,257383,260219,11,2836,2,18000,1.0038787024
257388,257393,260063,5,2670,2,18000,1.00187265918
257409,257417,260229,8,2812,2,18000,1.00284495021
257426,257436,260131,10,2695,2,18000,1.00371057514
257427,257441,260301,14,2860,2,18000,1.0048951049
257442,257452,260102,10,2650,2,18000,1.00377358491
257519,257528,260202,9,2674,2,18000,1.0033657442
257649,257656,260473,7,2817,2,18000,1.00248491303
257681,257689,260380,8,2691,2,18000,1.00297287254
257682,257695,260492,13,2797,2,18000,1.00464783697
257697,257703,260406,6,2703,2,18000,1.00221975583
257713,257720,260384,7,2664,2,18000,1.00262762763
257715,257726,260526,11,2800,2,18000,1.00392857143
257730,257737,260414,7,2677,2,18000,1.00261486739
257732,257743,260398,11,2655,2,18000,1.00414312618
257750,257759,260563,9,2804,2,18000,1.00320970043
257787,257796,260583,9,2787,2,18000,1.00322927879
257824,257833,260617,9,2784,2,18000,1.00323275862
257843,257851,260609,8,2758,2,18000,1.00290065265
257886,257895,260735,9,2840,2,18000,1.00316901408
257902,257908,260629,6,2721,2,18000,1.00220507166
257904,257914,260736,10,2822,2,18000,1.00354358611
257919,257925,260839,6,2914,2,18000,1.00205902539
257959,257968,260795,9,2827,2,18000,1.00318358684
258021,258029,260798,8,2769,2,18000,1.00288912965
258036,258043,260765,7,2722,2,18000,1.0025716385
258051,258058,260922,7,2864,2,18000,1.00244413408
258083,258092,260829,9,2737,2,18000,1.00328827183
258099,258105,260892,6,2787,2,18000,1.00215285253
258123,258133,260951,10,2818,2,18000,1.00354861604
258139,258145,260897,6,2752,2,18000,1.00218023256
258176,258185,261079,9,2894,2,18000,1.00310988252
258195,258204,260890,9,2686,2,18000,1.00335070737
259657,259666,262236,9,2570,2,18000,1.00350194553
259786,259796,262446,10,2650,2,18000,1.00377358491
260024,260034,262846,10,2812,2,18000,1.00355618777
260050,260059,262960,9,2901,2,18000,1.00310237849
260066,260072,262755,6,2683,2,18000,1.00223630265
260067,260078,262683,11,2605,2,18000,1.00422264875
260104,260113,262906,9,2793,2,18000,1.00322234157
260132,260142,262828,10,2686,2,18000,1.00372300819
260133,260147,262803,14,2656,2,18000,1.00527108434
260192,260200,263005,8,2805,2,18000,1.00285204991
260207,260213,262907,6,2694,2,18000,1.00222717149
260223,260230,262987,7,2757,2,18000,1.00253899166
260238,260245,262972,7,2727,2,18000,1.00256692336
260303,260312,263065,9,2753,2,18000,1.00326916092
260385,260390,263113,5,2723,2,18000,1.00183621006
260386,260396,263169,10,2773,2,18000,1.00360620267
260401,260409,263144,8,2735,2,18000,1.0029250457
260417,260423,263032,6,2609,2,18000,1.0022997317
260418,260429,263110,11,2681,2,18000,1.00410294666
260478,260484,263201,6,2717,2,18000,1.002208318
260493,260503,263355,10,2852,2,18000,1.00350631136
260527,260537,263335,10,2798,2,18000,1.00357398142
260565,260574,263442,9,2868,2,18000,1.00313807531
260587,260594,263353,7,2759,2,18000,1.00253715114
260612,260620,263390,8,2770,2,18000,1.00288808664
260627,260633,263243,6,2610,2,18000,1.00229885057
260643,260649,263437,6,2788,2,18000,1.00215208034
260739,260746,263637,7,2891,2,18000,1.00242130751
260741,260751,263462,10,2711,2,18000,1.00368867577
260766,260776,263600,10,2824,2,18000,1.00354107649
260797,260806,263520,9,2714,2,18000,1.00331613854
260812,260818,263578,6,2760,2,18000,1.00217391304
260831,260840,263456,9,2616,2,18000,1.00344036697
260846,260852,263700,6,2848,2,18000,1.00210674157
260893,260903,263567,10,2664,2,18000,1.00375375375
260895,260908,263727,13,2819,2,18000,1.00461156438
260910,260917,263719,7,2802,2,18000,1.00249821556
260926,260933,263731,7,2798,2,18000,1.00250178699
260954,260962,263714,8,2752,2,18000,1.00290697674
261081,261090,263825,9,2735,2,18000,1.00329067642
262239,262247,265012,8,2765,2,18000,1.00289330922
262450,262458,265352,8,2894,2,18000,1.00276434001
262682,262694,265359,12,2665,2,18000,1.00450281426
262759,262766,265554,7,2788,2,18000,1.0025107604
262804,262814,265558,10,2744,2,18000,1.00364431487
262832,262840,265535,8,2695,2,18000,1.00296846011
262847,262857,265421,10,2564,2,18000,1.00390015601
262908,262923,280944,15,18021,2,18000,1.00083236224
262909,262917,265713,8,2796,2,18000,1.00286123033
262962,262971,265741,9,2770,2,18000,1.00324909747
262977,262983,265743,6,2760,2,18000,1.00217391304
262992,262998,281038,6,18040,2,18000,1.00033259424
263007,263016,281045,9,18029,2,18000,1.00049919574
263035,263043,265753,8,2710,2,18000,1.00295202952
263066,263076,281079,10,18003,2,18000,1.00055546298
263113,263121,281130,8,18009,2,18000,1.00044422233
263114,263127,281155,13,18028,2,18000,1.00072110051
263148,263155,281195,7,18040,2,18000,1.00038802661
263172,263180,281211,8,18031,2,18000,1.00044368033
263204,263212,281215,8,18003,2,18000,1.00044437038
263252,263258,281294,6,18036,2,18000,1.000332668
263338,263346,281367,8,18021,2,18000,1.00044392653
263357,263367,281404,10,18037,2,18000,1.00055441592
263358,263372,281378,14,18006,2,18000,1.0007775186
263392,263401,281432,9,18031,2,18000,1.00049914037
263438,263448,281460,10,18012,2,18000,1.00055518543
263453,263460,281488,7,18028,2,18000,1.00038828489
263470,263476,281490,6,18014,2,18000,1.00033307428
263471,263482,281498,11,18016,2,18000,1.00061056838
263524,263532,281552,8,18020,2,18000,1.00044395117
263567,263578,281608,11,18030,2,18000,1.00061009429
263582,263589,281610,7,18021,2,18000,1.00038843571
263601,263611,281628,10,18017,2,18000,1.00055503136
263637,263648,266211,11,2563,2,18000,1.00429184549
263701,263711,281757,10,18046,2,18000,1.00055413942
263716,263725,281734,9,18009,2,18000,1.00049975012
263733,263738,281759,5,18021,2,18000,1.00027745408
263734,263744,281790,10,18046,2,18000,1.00055413942
263735,263749,281773,14,18024,2,18000,1.00077674212
263828,263836,266445,8,2609,2,18000,1.00306630893
265014,265023,266134,9,1111,2,18000,1.00810081008
265355,265364,266475,9,1111,2,18000,1.00810081008
265370,265376,266482,6,1106,2,18000,1.00542495479
265423,265432,266540,9,1108,2,18000,1.00812274368
265539,265547,266660,8,1113,2,18000,1.00718778077
265563,265569,265570,6,1,2,18000,1.0
265715,265722,266831,7,1109,2,18000,1.00631199279
265744,265750,268448,6,2698,2,18000,1.00222386953
265745,265756,266866,11,1110,2,18000,1.00990990991
265761,265767,266880,6,1113,2,18000,1.00539083558
287784,287790,287827,6,37,1,1800,1.16216216216
288099,288106,288177,7,71,1,1800,1.0985915493
288689,288695,288918,6,223,1,1800,1.0269058296
289280,289286,289296,6,10,4,540000,1.6
289319,289325,441894,6,152569,4,540000,1.00003932647
289348,289354,490351,6,200997,4,540000,1.00002985119
289416,289422,292141,6,2719,2,18000,1.00220669364
289417,289428,292136,11,2708,2,18000,1.0040620384
289418,289433,292103,15,2670,2,18000,1.00561797753
289420,289438,292068,18,2630,2,18000,1.00684410646
289421,289443,292216,22,2773,2,18000,1.00793364587
289422,289448,292374,26,2926,2,18000,1.00888585099
289423,289454,292147,31,2693,2,18000,1.01151132566
289425,289459,292255,34,2796,2,18000,1.0121602289
289426,289464,292251,38,2787,2,18000,1.01363473269
289427,289469,292078,42,2609,2,18000,1.01609812189
289428,289475,292246,47,2771,2,18000,1.01696138578
289497,289503,289512,6,9,4,540000,1.5
290288,290294,290320,6,26,1,1800,1.23076923077
290617,290624,290682,7,58,1,1800,1.12068965517
291392,291398,291517,6,119,1,1800,1.05042016807
292080,292086,294852,6,2766,2,18000,1.0021691974
292081,292092,294823,11,2731,2,18000,1.00402782863
292106,292112,294921,6,2809,2,18000,1.00213599146
292137,292143,295027,6,2884,2,18000,1.00208044383
292152,292158,294799,6,2641,2,18000,1.00227186672
292154,292164,294831,10,2667,2,18000,1.00374953131
292218,292224,294940,6,2716,2,18000,1.00220913108
292248,292255,295073,7,2818,2,18000,1.00248403123
292264,292271,294991,7,2720,2,18000,1.00257352941
292266,292277,294979,11,2702,2,18000,1.00407105848
292376,292382,295141,6,2759,2,18000,1.00217470098
293741,293747,293764,6,17,1,432000,1.35294117647
293798,293804,294836,6,1032,2,14400,1.00581395349
293807,293813,490349,6,196536,1,432000,1.00003052876
294218,294224,351956,6,57732,1,57600,1.0001039285
294801,294807,297721,6,2914,2,18000,1.00205902539
294826,294832,297566,6,2734,2,18000,1.00219458669
294841,294847,297559,6,2712,2,18000,1.00221238938
294857,294862,297525,5,2663,2,18000,1.00187758167
294925,294931,297756,6,2825,2,18000,1.00212389381
294938,294944,425854,6,130910,1,172860,1.00004583302
294939,294954,411890,15,116936,1,172860,1.0001282753
294944,294949,297693,5,2744,2,18000,1.00182215743
294957,294964,400536,7,105572,1,172860,1.00006630546
294981,294987,297362,6,2375,2,18000,1.00252631579
294997,295002,297784,5,2782,2,18000,1.00179726815
295030,295036,297910,6,2874,2,18000,1.00208768267
295077,295083,297796,6,2713,2,18000,1.0022115739
295145,295151,297800,6,2649,2,18000,1.00226500566
296785,296791,308751,6,11960,1,72000,1.00050167224
296921,296927,360985,6,64058,1,72000,1.00009366512
297367,297373,300149,6,2776,2,18000,1.00216138329
297526,297533,300281,7,2748,2,18000,1.00254730713
297560,297567,300243,7,2676,2,18000,1.00261584454
297576,297582,300335,6,2753,2,18000,1.00217944061
297696,297702,300573,6,2871,2,18000,1.00208986416
297724,297730,300486,6,2756,2,18000,1.00217706821
297758,297764,300422,6,2658,2,18000,1.00225733634
297783,297789,300496,6,2707,2,18000,1.0022164758
297798,297804,300484,6,2680,2,18000,1.00223880597
297814,297820,300593,6,2773,2,18000,1.0021637216
297912,297918,300721,6,2803,2,18000,1.00214056368
298023,298029,298097,6,68,1,72000,1.08823529412
300166,300172,302877,6,2705,2,18000,1.0022181146
300203,300209,462560,6,162351,12,345600,1.00003695696
300245,300251,302992,6,2741,2,18000,1.00218898212
300284,300291,303087,7,2796,2,18000,1.00250357654
300336,300342,303083,6,2741,2,18000,1.00218898212
300424,300430,303249,6,2819,2,18000,1.00212841433
300487,300493,303332,6,2839,2,18000,1.00211342022
300488,300499,303279,11,2780,2,18000,1.00395683453
300504,300510,318512,6,18002,2,18000,1.0003332963
300576,300582,318600,6,18018,2,18000,1.00033300033
300596,300602,303275,6,2673,2,18000,1.00224466891
300722,300728,318767,6,18039,2,18000,1.00033261267
301044,301050,301056,6,6,1,259200,1.2
301061,301067,303348,6,2281,1,259200,1.00263042525
301116,301122,303394,6,2272,1,259200,1.00264084507
301800,301807,355533,7,53726,4,360000,1.00013029073
302889,302896,305744,7,2848,2,18000,1.00245786517
302994,303000,305830,6,2830,2,18000,1.00212014134
303087,303093,305847,6,2754,2,18000,1.00217864924
303104,303110,305865,6,2755,2,18000,1.00217785844
303252,303258,306161,6,2903,2,18000,1.00206682742
303279,303285,306118,6,2833,2,18000,1.00211789622
303281,303291,306199,10,2908,2,18000,1.00343878955
303335,303341,306180,6,2839,2,18000,1.00211342022
305758,305764,308546,6,2782,2,18000,1.00215672178
305832,305838,308722,6,2884,2,18000,1.00208044383
305848,305854,308793,6,2939,2,18000,1.00204151072
305866,305873,308656,7,2783,2,18000,1.00251527129
306120,306127,308948,7,2821,2,18000,1.00248138958
306165,306172,308998,7,2826,2,18000,1.00247699929
306182,306188,309071,6,2883,2,18000,1.00208116545
306201,306207,309004,6,2797,2,18000,1.00214515552
306408,306414,317318,6,10904,2,10800,1.00055025679
307208,307215,307219,7,4,1,259200,1.1
307211,307221,439959,10,132738,1,259200,1.00007533638
307339,307345,439996,6,132651,1,259200,1.00004523147
308568,308574,311434,6,2860,2,18000,1.0020979021
308668,308674,311519,6,2845,2,18000,1.00210896309
308724,308730,311472,6,2742,2,18000,1.00218818381
308794,308800,311644,6,2844,2,18000,1.00210970464
308955,308961,311616,6,2655,2,18000,1.00225988701
309002,309008,311534,6,2526,2,18000,1.00237529691
309017,309024,311800,7,2776,2,18000,1.00252161383
309080,309086,311892,6,2806,2,18000,1.00213827512
311445,311452,314132,7,2680,2,18000,1.0026119403
311475,311481,314346,6,2865,2,18000,1.00209424084
311520,311526,314334,6,2808,2,18000,1.00213675214
311536,311542,314184,6,2642,2,18000,1.00227100681
311617,311623,314506,6,2883,2,18000,1.00208116545
311646,311652,314433,6,2781,2,18000,1.0021574973
311800,311806,312440,6,634,16,3600,1.0094637224
311801,311812,314642,11,2830,2,18000,1.0038869258
311894,311900,314672,6,2772,2,18000,1.00216450216
312346,312353,440061,7,127708,1,259200,1.00005481254
312421,312427,317588,6,5161,1,259200,1.00116256539
313732,313738,430722,6,116984,10,360000,1.00005128907
314137,314143,316738,6,2595,2,18000,1.00231213873
314186,314192,317055,6,2863,2,18000,1.00209570381
314336,314343,316942,7,2599,2,18000,1.00269334359
314352,314357,317201,5,2844,2,18000,1.0017580872
314435,314441,317210,6,2769,2,18000,1.00216684724
314508,314514,317240,6,2726,2,18000,1.00220102715
314645,314651,317325,6,2674,2,18000,1.00224382947
314674,314681,317476,7,2795,2,18000,1.00250447227
316752,316759,319462,7,2703,2,18000,1.00258971513
316946,316952,319734,6,2782,2,18000,1.00215672178
317057,317064,319867,7,2803,2,18000,1.0024973243
317204,317210,319985,6,2775,2,18000,1.00216216216
317220,317226,320065,6,2839,2,18000,1.00211342022
317242,317248,319998,6,2750,2,18000,1.00218181818
317329,317336,320069,7,2733,2,18000,1.00256128796
317477,317483,320354,6,2871,2,18000,1.00208986416
317599,317605,490351,6,172746,1,259200,1.00003473308
317607,317613,440405,6,122792,1,259200,1.00004886312
318318,318340,344890,22,26550,1,180000,1.00082862524
318318,318345,347218,27,28873,1,180000,1.00093512971
318318,318323,319832,5,1509,1,180000,1.00331345262
318318,318334,328713,16,10379,1,180000,1.00154157433
318318,318350,331265,32,12915,1,180000,1.00247773906
318318,318329,350225,11,31896,1,180000,1.00034487083
318319,318356,329518,37,11162,1,180000,1.00331481813
318319,318371,325909,52,7538,1,180000,1.00689838153
318319,318366,320655,47,2289,1,180000,1.02053298384
318319,318361,320705,42,2344,1,180000,1.01791808874
318319,318377,323236,58,4859,1,180000,1.01193661247
318320,318398,330898,78,12500,1,180000,1.00624
318320,318408,330815,88,12407,1,180000,1.00709277021
318320,318387,329918,67,11531,1,180000,1.00581042407
318320,318382,324498,62,6116,1,180000,1.01013734467
318320,318392,326027,72,7635,1,180000,1.0094302554
318321,318418,320931,97,2513,1,180000,1.03859928372
318321,318413,329669,92,11256,1,180000,1.00817341862
318321,318434,329551,113,11117,1,180000,1.01016461276
318321,318429,321355,108,2926,1,180000,1.03691045796
318321,318424,408428,103,90004,1,180000,1.00114439358
318322,318440,340902,118,22462,1,180000,1.00525331671
318322,318461,328075,139,9614,1,180000,1.01445808196
318322,318456,334428,134,15972,1,180000,1.00838968194
318322,318450,327140,128,8690,1,180000,1.01472957422
318322,318466,333676,144,15210,1,180000,1.00946745562
318322,318445,323366,123,4921,1,180000,1.02499491973
318323,318471,362379,148,43908,1,180000,1.00337068416
318323,318523,354550,200,36027,1,180000,1.00555139201
318944,318950,320226,6,1276,1,72000,1.00470219436
319293,319299,321487,6,2188,16,3600,1.00274223035
319464,319470,322250,6,2780,2,18000,1.00215827338
319737,319743,322503,6,2760,2,18000,1.00217391304
319869,319875,322596,6,2721,2,18000,1.00220507166
319986,319992,322814,6,2822,2,18000,1.00212615167
320002,320008,322697,6,2689,2,18000,1.00223131276
320066,320073,322956,7,2883,2,18000,1.00242802636
320082,320088,322972,6,2884,2,18000,1.00208044383
320120,320126,320130,6,4,2,432000,1.0
320245,320251,320255,6,4,2,432000,1.0
320356,320362,323194,6,2832,2,18000,1.00211864407
320369,320376,320678,7,302,2,432000,1.02317880795
320715,320721,321008,6,287,2,432000,1.02090592334
320922,320929,320937,7,8,10,360000,1.5
320977,320983,320990,6,7,10,360000,1.3
321027,321033,321096,6,63,2,432000,1.09523809524
321110,321116,329699,6,8583,2,432000,1.00069905627
321331,321337,403537,6,82200,4,360000,1.0000729927
321931,321938,441225,7,119287,1,345600,1.000058682
322030,322036,401166,6,79130,4,360000,1.00007582459
322253,322259,324916,6,2657,2,18000,1.00225818592
322356,322362,399216,6,76854,4,360000,1.00007807011
322506,322512,325309,6,2797,2,18000,1.00214515552
322541,322547,377500,6,54953,4,360000,1.00010918421
322598,322604,325395,6,2791,2,18000,1.00214976711
322699,322705,325374,6,2669,2,18000,1.00224803297
322776,322782,324676,6,1894,32,43200,1.00316789863
322796,322802,352627,6,29825,4,360000,1.00020117351
322815,322821,325647,6,2826,2,18000,1.00212314225
322959,322965,325791,6,2826,2,18000,1.00212314225
322974,322980,325816,6,2836,2,18000,1.00211565585
323195,323201,325998,6,2797,2,18000,1.00214515552
323418,323424,323432,6,8,10,360000,1.4
323574,323580,323586,6,6,10,360000,1.2
323681,323687,323693,6,6,10,360000,1.2
324069,324075,490351,6,166276,10,360000,1.00003608458
324918,324924,327767,6,2843,2,18000,1.00211044671
325053,325059,362975,6,37916,4,360000,1.00015824454
325066,325072,333000,6,7928,4,360000,1.0007568113
325311,325317,328082,6,2765,2,18000,1.00216998192
325375,325381,328070,6,2689,2,18000,1.00223131276
325396,325403,328019,7,2616,2,18000,1.00267584098
325650,325656,328335,6,2679,2,18000,1.00223964166
325794,325800,328647,6,2847,2,18000,1.00210748156
325819,325825,328606,6,2781,2,18000,1.0021574973
326002,326008,328896,6,2888,2,18000,1.00207756233
326446,326452,350723,6,24271,4,360000,1.0002472086
326513,326518,387821,5,61303,4,360000,1.00008156208
327299,327305,348921,6,21616,32,43200,1.00027757217
327309,327315,341203,6,13888,4,360000,1.00043202765
327769,327775,330399,6,2624,2,18000,1.00228658537
328023,328029,330804,6,2775,2,18000,1.00216216216
328073,328079,330783,6,2704,2,18000,1.00221893491
328089,328095,330847,6,2752,2,18000,1.00218023256
328336,328342,331198,6,2856,2,18000,1.00210084034
328608,328614,331328,6,2714,2,18000,1.00221075903
328650,328656,331223,6,2567,2,18000,1.00233735878
328898,328904,331648,6,2744,2,18000,1.00218658892
330401,330407,333217,6,2810,2,18000,1.00213523132
330787,330793,333516,6,2723,2,18000,1.00220345207
330805,330811,333489,6,2678,2,18000,1.00224047797
330849,330856,333630,7,2774,2,18000,1.00252343187
331200,331207,333860,7,2653,2,18000,1.00263852243
331225,331231,334008,6,2777,2,18000,1.00216060497
331312,331318,331319,6,1,2,300,1.0
331331,331337,333981,6,2644,2,18000,1.00226928896
331650,331656,334395,6,2739,2,18000,1.0021905805
333219,333225,336052,6,2827,2,18000,1.00212239123
333491,333497,336305,6,2808,2,18000,1.00213675214
333519,333525,336120,6,2595,2,18000,1.00231213873
333634,333640,336462,6,2822,2,18000,1.00212615167
333861,333867,336515,6,2648,2,18000,1.00226586103
333985,333991,336827,6,2836,2,18000,1.00211565585
334010,334016,336830,6,2814,2,18000,1.00213219616
334396,334402,337287,6,2885,2,18000,1.0020797227
335004,335010,335014,6,4,2,300,1.0
335022,335028,335053,6,25,2,300,1.24
335063,335069,335124,6,55,2,300,1.10909090909
335133,335139,335402,6,263,2,300,1.02281368821
335413,335419,335439,6,20,2,300,1.3
335450,335456,335499,6,43,2,300,1.13953488372
335507,335514,335548,7,34,2,300,1.20588235294
335556,335562,335878,6,316,2,300,1.01898734177
336055,336062,338846,7,2784,2,18000,1.00251436782
336122,336128,338869,6,2741,2,18000,1.00218898212
336306,336312,339195,6,2883,2,18000,1.00208116545
336463,336469,339207,6,2738,2,18000,1.00219138057
336517,336523,339222,6,2699,2,18000,1.00222304557
336831,336837,339711,6,2874,2,18000,1.00208768267
336833,336843,339632,10,2789,2,18000,1.00358551452
337289,337295,340176,6,2881,2,18000,1.0020826102
338440,338446,338508,6,62,2,3540,1.09677419355
338849,338855,341581,6,2726,2,18000,1.00220102715
338871,338877,341639,6,2762,2,18000,1.00217233888
339199,339205,341988,6,2783,2,18000,1.00215594682
339215,339221,341981,6,2760,2,18000,1.00217391304
339230,339237,341866,7,2629,2,18000,1.00266260936
339634,339640,342305,6,2665,2,18000,1.00225140713
339714,339721,342497,7,2776,2,18000,1.00252161383
340178,340184,343007,6,2823,2,18000,1.00212539851
341585,341591,344343,6,2752,2,18000,1.00218023256
341641,341647,344252,6,2605,2,18000,1.00230326296
341868,341874,344724,6,2850,2,18000,1.00210526316
341984,341990,344821,6,2831,2,18000,1.00211939244
341999,342006,344646,7,2640,2,18000,1.00265151515
342305,342311,345160,6,2849,2,18000,1.00210600211
342501,342508,345322,7,2814,2,18000,1.00248756219
343009,343015,345822,6,2807,2,18000,1.00213751336
344255,344261,347018,6,2757,2,18000,1.00217627856
344347,344353,347080,6,2727,2,18000,1.00220022002
344647,344653,347497,6,2844,2,18000,1.00210970464
344728,344735,347497,7,2762,2,18000,1.00253439537
344822,344828,347613,6,2785,2,18000,1.00215439856
345162,345168,347966,6,2798,2,18000,1.00214438885
345326,345332,348159,6,2827,2,18000,1.00212239123
345824,345830,348676,6,2846,2,18000,1.00210822207
347018,347025,349762,7,2737,2,18000,1.00255754476
347084,347090,349767,6,2677,2,18000,1.0022413149
347503,347509,350335,6,2826,2,18000,1.00212314225
347504,347515,350065,11,2550,2,18000,1.00431372549
347616,347622,350428,6,2806,2,18000,1.00213827512
347969,347975,350751,6,2776,2,18000,1.00216138329
348162,348168,351010,6,2842,2,18000,1.0021111893
348679,348685,351481,6,2796,2,18000,1.00214592275
349763,349769,352629,6,2860,2,18000,1.0020979021
349779,349785,352576,6,2791,2,18000,1.00214976711
350067,350073,352916,6,2843,2,18000,1.00211044671
350338,350344,353135,6,2791,2,18000,1.00214976711
350431,350437,353177,6,2740,2,18000,1.00218978102
350754,350760,353475,6,2715,2,18000,1.00220994475
351011,351018,353698,7,2680,2,18000,1.0026119403
351483,351489,354322,6,2833,2,18000,1.00211789622
352579,352585,355286,6,2701,2,18000,1.00222139948
352632,352638,355323,6,2685,2,18000,1.00223463687
352917,352924,355718,7,2794,2,18000,1.00250536865
353138,353145,355994,7,2849,2,18000,1.00245700246
353179,353185,355836,6,2651,2,18000,1.00226329687
353478,353485,356198,7,2713,2,18000,1.00258016955
353695,353701,356576,6,2875,2,18000,1.00208695652
354325,354331,357028,6,2697,2,18000,1.0022246941
355300,355306,358135,6,2829,2,18000,1.00212089077
355325,355331,358142,6,2811,2,18000,1.00213447172
355722,355727,358403,5,2676,2,18000,1.00186846039
355840,355846,358703,6,2857,2,18000,1.00210010501
355996,356002,358713,6,2711,2,18000,1.00221320546
356200,356206,359047,6,2841,2,18000,1.00211193242
356579,356585,359398,6,2813,2,18000,1.00213295414
357025,357031,359833,6,2802,2,18000,1.00214132762
358146,358152,360766,6,2614,2,18000,1.00229533282
358147,358158,360932,11,2774,2,18000,1.00396539293
358406,358412,361109,6,2697,2,18000,1.0022246941
358706,358712,361505,6,2793,2,18000,1.00214822771
358721,358727,361579,6,2852,2,18000,1.00210378682
359062,359068,361905,6,2837,2,18000,1.00211491012
359399,359405,362153,6,2748,2,18000,1.00218340611
359836,359843,362623,7,2780,2,18000,1.00251798561
360769,360775,363601,6,2826,2,18000,1.00212314225
360936,360942,363763,6,2821,2,18000,1.00212690535
361112,361117,363951,5,2834,2,18000,1.00176429076
361508,361514,364289,6,2775,2,18000,1.00216216216
361582,361588,364280,6,2692,2,18000,1.00222882615
361907,361913,364749,6,2836,2,18000,1.00211565585
362155,362161,364942,6,2781,2,18000,1.0021574973
362641,362647,365411,6,2764,2,18000,1.002170767
363605,363611,366210,6,2599,2,18000,1.00230858022
363650,363656,363756,6,100,1,1800,1.06
363765,363772,366460,7,2688,2,18000,1.00260416667
363953,363959,366705,6,2746,2,18000,1.00218499636
364051,364057,364150,6,93,1,1800,1.06451612903
364284,364290,367108,6,2818,2,18000,1.00212916962
364300,364306,366998,6,2692,2,18000,1.00222882615
364752,364759,367554,7,2795,2,18000,1.00250447227
364753,364764,365208,11,444,1,1800,1.02477477477
364944,364950,367626,6,2676,2,18000,1.00224215247
365429,365435,368249,6,2814,2,18000,1.00213219616
366225,366231,369034,6,2803,2,18000,1.00214056368
366459,366465,369195,6,2730,2,18000,1.0021978022
366719,366726,369424,7,2698,2,18000,1.00259451446
366847,366853,366890,6,37,1,1800,1.16216216216
367010,367016,369830,6,2814,2,18000,1.00213219616
367111,367117,369846,6,2729,2,18000,1.00219860755
367203,367210,367278,7,68,1,1800,1.10294117647
367572,367578,370304,6,2726,2,18000,1.00220102715
367628,367634,370307,6,2673,2,18000,1.00224466891
368117,368124,368373,7,249,1,1800,1.0281124498
368251,368257,371060,6,2803,2,18000,1.00214056368
369054,369060,371734,6,2674,2,18000,1.00224382947
369198,369205,372065,7,2860,2,18000,1.00244755245
369426,369434,372169,8,2735,2,18000,1.0029250457
369834,369840,372519,6,2679,2,18000,1.00223964166
369849,369856,372548,7,2692,2,18000,1.00260029718
370309,370315,373185,6,2870,2,18000,1.00209059233
370310,370321,373208,11,2887,2,18000,1.00381018358
371063,371069,373899,6,2830,2,18000,1.00212014134
371737,371743,374554,6,2811,2,18000,1.00213447172
372066,372073,374955,7,2882,2,18000,1.00242886884
372170,372176,374972,6,2796,2,18000,1.00214592275
372521,372527,375319,6,2792,2,18000,1.00214899713
372548,372554,375384,6,2830,2,18000,1.00212014134
373188,373194,375888,6,2694,2,18000,1.00222717149
373210,373216,375951,6,2735,2,18000,1.00219378428
373901,373907,376584,6,2677,2,18000,1.0022413149
374192,374198,374237,6,39,1,1800,1.15384615385
374515,374521,374592,6,71,1,1800,1.08450704225
374556,374563,377460,7,2897,2,18000,1.00241629272
374958,374964,377787,6,2823,2,18000,1.00212539851
374974,374980,377639,6,2659,2,18000,1.0022564874
375092,375098,375320,6,222,1,1800,1.02702702703
375321,375326,378028,5,2702,2,18000,1.00185048113
375387,375392,378181,5,2789,2,18000,1.00179275726
375891,375897,378720,6,2823,2,18000,1.00212539851
375953,375959,378707,6,2748,2,18000,1.00218340611
376587,376593,379395,6,2802,2,18000,1.00214132762
376597,376603,376625,6,22,1,1800,1.27272727273
376924,376930,376983,6,53,1,1800,1.11320754717
377463,377469,380313,6,2844,2,18000,1.00210970464
377640,377646,380167,6,2521,2,18000,1.00238000793
377691,377697,377817,6,120,1,1800,1.05
377791,377797,380449,6,2652,2,18000,1.00226244344
378029,378035,380826,6,2791,2,18000,1.00214976711
378183,378189,380996,6,2807,2,18000,1.00213751336
378709,378715,381449,6,2734,2,18000,1.00219458669
378725,378731,381464,6,2733,2,18000,1.00219538968
379399,379405,382031,6,2626,2,18000,1.00228484387
380168,380174,383005,6,2831,2,18000,1.00211939244
380316,380322,383167,6,2845,2,18000,1.00210896309
380452,380458,383212,6,2754,2,18000,1.00217864924
380829,380836,383540,7,2704,2,18000,1.0025887574
381000,381006,383735,6,2729,2,18000,1.00219860755
381454,381460,384210,6,2750,2,18000,1.00218181818
381466,381472,382080,6,608,4,600,1.00986842105
381469,381478,384295,9,2817,2,18000,1.00319488818
382032,382038,384845,6,2807,2,18000,1.00213751336
382470,382476,383115,6,639,6,600,1.00938967136
383007,383013,385825,6,2812,2,18000,1.00213371266
383046,383052,383053,6,1,1,54000,1.0
383059,383065,383066,6,1,1,54000,1.0
383068,383074,383076,6,2,1,54000,1.0
383171,383177,385963,6,2786,2,18000,1.00215362527
383214,383220,386074,6,2854,2,18000,1.00210231254
383314,383320,427625,6,44305,1,54000,1.0001354249
383322,383329,427796,7,44467,1,54000,1.00015742011
383330,383337,427541,7,44204,1,54000,1.00015835671
383337,383343,428129,6,44786,1,54000,1.00013397044
383430,383436,383578,6,142,4,600,1.04225352113
383490,383501,490352,11,106851,1,259200,1.00010294709
383490,383496,490352,6,106856,1,259200,1.00005615033
383491,383507,457036,16,73529,1,259200,1.00021760122
383491,383517,490348,26,106831,1,259200,1.00024337505
383491,383522,490344,31,106822,1,259200,1.00029020239
383491,383512,490346,21,106834,1,259200,1.00019656664
383492,383538,490348,46,106810,1,259200,1.00043067129
383492,383543,466763,51,83220,1,259200,1.00061283345
383492,383528,490349,36,106821,1,259200,1.00033701239
383492,383533,490352,41,106819,1,259200,1.00038382685
383542,383549,386256,7,2707,2,18000,1.00258588844
383604,383610,490346,6,106736,1,259200,1.00005621346
383737,383743,386625,6,2882,2,18000,1.00208188758
383867,383873,384356,6,483,4,1200,1.01242236025
384211,384217,386976,6,2759,2,18000,1.00217470098
384298,384304,387130,6,2826,2,18000,1.00212314225
384418,384424,385658,6,1234,4,1200,1.00486223663
384862,384868,387736,6,2868,2,18000,1.00209205021
385193,385199,393121,6,7922,1,57600,1.0007573845
385235,385241,385242,6,1,1,72000,1.0
385332,385343,490352,11,105009,1,259200,1.00010475293
385332,385338,490351,6,105013,1,259200,1.00005713578
385332,385353,490351,21,104998,1,259200,1.00020000381
385332,385348,490346,16,104998,1,259200,1.00015238385
385332,385359,490346,27,104987,1,259200,1.0002571747
385333,385375,401535,42,16160,1,259200,1.0025990099
385333,385370,490349,37,104979,1,259200,1.00035245144
385333,385364,490352,31,104988,1,259200,1.00029527184
385465,385471,386122,6,651,1,72000,1.00921658986
385823,385829,385858,6,29,3,576000,1.20689655172
385840,385846,388528,6,2682,2,18000,1.00223713647
385877,385883,411290,6,25407,3,604800,1.00023615539
385966,385972,388742,6,2770,2,18000,1.00216606498
385979,385985,386602,6,617,4,600,1.00972447326
386078,386084,388778,6,2694,2,18000,1.00222717149
386120,386126,386311,6,185,2,432000,1.03243243243
386260,386266,389078,6,2812,2,18000,1.00213371266
386326,386332,399656,6,13324,2,432000,1.00045031522
386603,386609,386616,6,7,1,72000,1.3
386628,386634,389496,6,2862,2,18000,1.00209643606
386978,386985,389694,7,2709,2,18000,1.00258397933
387132,387138,389858,6,2720,2,18000,1.00220588235
387497,387503,387670,6,167,1,72000,1.03592814371
387737,387743,390528,6,2785,2,18000,1.00215439856
388544,388550,391387,6,2837,2,18000,1.00211491012
388744,388750,391534,6,2784,2,18000,1.00215517241
388779,388785,391637,6,2852,2,18000,1.00210378682
389081,389087,391792,6,2705,2,18000,1.0022181146
389416,389422,390662,6,1240,27,3540,1.00483870968
389437,389444,389450,7,6,32,43200,1.3
389499,389505,392074,6,2569,2,18000,1.00233553912
389640,389646,391780,6,2134,32,43200,1.00281162137
389696,389703,392074,7,2371,2,18000,1.00295234078
389863,389869,392074,6,2205,2,18000,1.00272108844
390530,390536,392074,6,1538,2,18000,1.00390117035
390754,390761,390764,7,3,4,432000,1.0
390819,390825,490348,6,99523,2,324000,1.00006028757
390961,390967,390990,6,23,4,432000,1.26086956522
391022,391028,490352,6,99324,2,324000,1.00006040836
391387,391393,392074,6,681,2,18000,1.00881057269
391538,391544,392074,6,530,2,18000,1.01132075472
391641,391647,392074,6,427,2,18000,1.01405152225
391796,391802,392074,6,272,2,18000,1.02205882353
392119,392125,394945,6,2820,2,18000,1.00212765957
392120,392130,394915,10,2785,2,18000,1.00359066427
392122,392135,394886,13,2751,2,18000,1.00472555434
392123,392140,394953,17,2813,2,18000,1.00604337007
392125,392146,394919,21,2773,2,18000,1.0075730256
392127,392151,394892,24,2741,2,18000,1.00875592849
392129,392156,394962,27,2806,2,18000,1.00962223806
392130,392161,395036,31,2875,2,18000,1.0107826087
392132,392167,394955,35,2788,2,18000,1.01255380201
392134,392172,394906,38,2734,2,18000,1.01389904901
392135,392177,395101,42,2924,2,18000,1.01436388509
392137,392182,394847,45,2665,2,18000,1.01688555347
392139,392187,394991,48,2804,2,18000,1.01711840228
392140,392192,395067,52,2875,2,18000,1.01808695652
392141,392198,395027,57,2829,2,18000,1.02014846235
392143,392203,394970,60,2767,2,18000,1.02168413444
392145,392208,395027,63,2819,2,18000,1.02234835048
392146,392213,395069,67,2856,2,18000,1.02345938375
392148,392219,394947,71,2728,2,18000,1.02602639296
392149,392224,395083,75,2859,2,18000,1.02623294858
392151,392229,394861,78,2632,2,18000,1.02963525836
392152,392234,395059,82,2825,2,18000,1.02902654867
392154,392239,394987,85,2748,2,18000,1.03093158661
392156,392244,395134,88,2890,2,18000,1.03044982699
392157,392250,395088,93,2838,2,18000,1.03276955603
392159,392255,394978,96,2723,2,18000,1.0352552332
392161,392260,394929,99,2669,2,18000,1.03709254402
392163,392265,395094,102,2829,2,18000,1.03605514316
392166,392270,395023,104,2753,2,18000,1.03777697058
392167,392275,394922,108,2647,2,18000,1.04080090669
392169,392280,395067,111,2787,2,18000,1.0398277718
392171,392285,395022,114,2737,2,18000,1.04165144319
392172,392291,395075,119,2784,2,18000,1.04274425287
392174,392296,395086,122,2790,2,18000,1.04372759857
392176,392301,395099,125,2798,2,18000,1.04467476769
392178,392306,395170,128,2864,2,18000,1.04469273743
392179,392311,395221,132,2910,2,18000,1.04536082474
392181,392316,395209,135,2893,2,18000,1.04666436225
392183,392321,395072,138,2751,2,18000,1.05016357688
392185,392326,395113,141,2787,2,18000,1.05059203445
392690,392696,433813,6,41117,4,360000,1.00014592504
392778,392784,423231,6,30447,32,43200,1.00019706375
392802,392809,392847,7,38,4,432000,1.18421052632
393176,393182,435896,6,42714,4,360000,1.00014046917
393643,393649,440622,6,46973,4,360000,1.00012773295
393665,393671,393710,6,39,4,432000,1.15384615385
394458,394464,394504,6,40,4,432000,1.15
394849,394858,397593,9,2735,2,18000,1.00329067642
394864,394872,397657,8,2785,2,18000,1.00287253142
394889,394897,397585,8,2688,2,18000,1.00297619048
394906,394912,397764,6,2852,2,18000,1.00210378682
394921,394927,397642,6,2715,2,18000,1.00220994475
394922,394933,397665,11,2732,2,18000,1.00402635432
394923,394938,397719,15,2781,2,18000,1.00539374326
394938,394944,397746,6,2802,2,18000,1.00214132762
394939,394950,397823,11,2873,2,18000,1.00382875044
394955,394961,397731,6,2770,2,18000,1.00216606498
394956,394967,397802,11,2835,2,18000,1.00388007055
394958,394972,397724,14,2752,2,18000,1.0050872093
394972,394978,397825,6,2847,2,18000,1.00210748156
394974,394984,397724,10,2740,2,18000,1.00364963504
394975,394989,397881,14,2892,2,18000,1.00484094053
394990,394996,397535,6,2539,2,18000,1.00236313509
394992,395002,397622,10,2620,2,18000,1.00381679389
395007,395013,397695,6,2682,2,18000,1.00223713647
395026,395034,397904,8,2870,2,18000,1.00278745645
395027,395039,397814,12,2775,2,18000,1.00432432432
395042,395048,397705,6,2657,2,18000,1.00225818592
395043,395054,397753,11,2699,2,18000,1.00407558355
395044,395059,397704,15,2645,2,18000,1.0056710775
395059,395070,397728,11,2658,2,18000,1.00413844996
395075,395081,397708,6,2627,2,18000,1.00228397411
395076,395087,397790,11,2703,2,18000,1.00406955235
395078,395092,397855,14,2763,2,18000,1.00506695621
395079,395097,397886,18,2789,2,18000,1.00645392614
395080,395102,397748,22,2646,2,18000,1.00831443689
395095,395109,397896,14,2787,2,18000,1.00502332257
395097,395114,397886,17,2772,2,18000,1.00613275613
395098,395119,397834,21,2715,2,18000,1.00773480663
395099,395124,397960,25,2836,2,18000,1.00881523272
395115,395130,397729,15,2599,2,18000,1.00577145056
395116,395135,397974,19,2839,2,18000,1.00669249736
395117,395140,397996,23,2856,2,18000,1.00805322129
395135,395146,397951,11,2805,2,18000,1.00392156863
395174,395181,397769,7,2588,2,18000,1.00270479134
395211,395220,398039,9,2819,2,18000,1.0031926215
395226,395232,398128,6,2896,2,18000,1.0020718232
395551,395557,490347,6,94790,2,604800,1.00006329782
397537,397547,400277,10,2730,2,18000,1.00366300366
397583,397597,400411,14,2814,2,18000,1.00497512438
397598,397604,400239,6,2635,2,18000,1.00227703985
397623,397633,400448,10,2815,2,18000,1.00355239787
397645,397654,400290,9,2636,2,18000,1.00341426404
397660,397668,400249,8,2581,2,18000,1.00309957381
397675,397681,400491,6,2810,2,18000,1.00213523132
397696,397706,400574,10,2868,2,18000,1.00348675035
397712,397718,400365,6,2647,2,18000,1.00226671704
397713,397724,400526,11,2802,2,18000,1.00392576731
397715,397729,400469,14,2740,2,18000,1.00510948905
397731,397737,400503,6,2766,2,18000,1.0021691974
397732,397743,400613,11,2870,2,18000,1.00383275261
397733,397748,400517,15,2769,2,18000,1.00541711809
397734,397753,400567,19,2814,2,18000,1.00675195451
397736,397758,400496,22,2738,2,18000,1.00803506209
397737,397763,400367,26,2604,2,18000,1.00998463902
397754,397769,400565,15,2796,2,18000,1.00536480687
397755,397774,400712,19,2938,2,18000,1.00646698434
397757,397779,400534,22,2755,2,18000,1.00798548094
397772,397786,400599,14,2813,2,18000,1.004976893
397773,397791,400402,18,2611,2,18000,1.00689391038
397791,397801,400548,10,2747,2,18000,1.00364033491
397807,397813,400632,6,2819,2,18000,1.00212841433
397823,397829,400586,6,2757,2,18000,1.00217627856
397837,397844,400624,7,2780,2,18000,1.00251798561
397839,397850,400536,11,2686,2,18000,1.00409530901
397840,397855,400683,15,2828,2,18000,1.00530410184
397856,397866,400446,10,2580,2,18000,1.00387596899
397884,397893,400660,9,2767,2,18000,1.00325262017
397899,397905,400740,6,2835,2,18000,1.00211640212
397900,397911,400816,11,2905,2,18000,1.00378657487
397901,397916,400765,15,2849,2,18000,1.00526500527
397916,397922,400526,6,2604,2,18000,1.00230414747
397954,397962,400739,8,2777,2,18000,1.00288080663
397969,397975,400805,6,2830,2,18000,1.00212014134
397985,397991,400861,6,2870,2,18000,1.00209059233
398000,398007,400845,7,2838,2,18000,1.00246652572
398041,398050,400810,9,2760,2,18000,1.00326086957
398124,398130,400063,6,1933,1,1800,1.00310398345
398130,398139,400881,9,2742,2,18000,1.00328227571
398286,398293,408827,7,10534,2,10800,1.0006645149
398950,398956,398957,6,1,1,72000,1.0
398951,398961,398962,10,1,1,72000,1.1
398951,398967,398968,16,1,1,72000,1.7
398951,398973,398974,22,1,1,72000,2.3
398951,398978,398979,27,1,1,72000,2.8
398951,398983,398985,32,2,1,72000,3.4
398952,398999,401473,47,2474,1,72000,1.01899757478
398952,399022,471044,70,72022,1,72000,1.00097192525
398952,398994,401546,42,2552,1,72000,1.01645768025
398952,399015,401848,63,2833,1,72000,1.02223791034
398952,399009,400720,57,1711,1,72000,1.03331385155
398952,399004,401798,52,2794,1,72000,1.01861130995
398953,399048,401683,95,2635,1,72000,1.03605313093
398953,399033,401718,80,2685,1,72000,1.02979515829
398953,399043,400847,90,1804,1,72000,1.04988913525
398953,399038,401638,85,2600,1,72000,1.03269230769
398954,399069,403440,115,4371,1,72000,1.02630976893
398954,399054,400813,100,1759,1,72000,1.05685048323
398954,399059,434119,105,35060,1,72000,1.00299486594
398954,399064,414611,110,15547,1,72000,1.00707532
398954,399074,399075,120,1,1,72000,12.1
398954,399080,399081,126,1,1,72000,12.7
398955,399114,401153,159,2039,1,72000,1.07797940167
398955,399109,402917,154,3808,1,72000,1.04044117647
398955,399101,399102,146,1,1,72000,14.7
398955,399095,399096,140,1,1,72000,14.1
398955,399090,399091,135,1,1,72000,13.6
398955,399085,399086,130,1,1,72000,13.1
398956,399140,406061,184,6921,1,72000,1.0265857535
398956,399119,401774,163,2655,1,72000,1.06139359699
398956,399135,402321,179,3186,1,72000,1.05618330195
398956,399125,404540,169,5415,1,72000,1.03120960295
398956,399130,406886,174,7756,1,72000,1.02243424446
398957,399145,471153,188,72008,1,72000,1.00261082102
398957,399166,399891,209,725,1,72000,1.28827586207
398957,399161,400978,204,1817,1,72000,1.11227297744
398957,399171,400865,214,1694,1,72000,1.12632821724
398957,399150,400530,193,1380,1,72000,1.13985507246
398957,399155,400425,198,1270,1,72000,1.15590551181
398958,399182,471196,224,72014,1,72000,1.00311050629
398958,399192,399193,234,1,1,72000,23.5
398958,399177,400043,219,866,1,72000,1.25288683603
398958,399198,399199,240,1,1,72000,24.1
398958,399203,399204,245,1,1,72000,24.6
398958,399187,399988,229,801,1,72000,1.28589263421
398959,399229,400298,270,1069,1,72000,1.25257249766
398959,399219,399220,260,1,1,72000,26.1
398959,399213,399214,254,1,1,72000,25.5
398959,399208,399209,249,1,1,72000,25.0
398959,399234,400677,275,1443,1,72000,1.19057519058
398959,399224,405286,265,6062,1,72000,1.04371494556
398960,399256,400893,296,1637,1,72000,1.18081857056
398960,399246,405297,286,6051,1,72000,1.04726491489
398960,399251,400624,291,1373,1,72000,1.21194464676
398960,399240,409630,280,10390,1,72000,1.02694898941
400241,400250,403046,9,2796,2,18000,1.00321888412
400256,400262,403129,6,2867,2,18000,1.00209277991
400278,400288,403139,10,2851,2,18000,1.00350754121
400293,400302,402978,9,2676,2,18000,1.0033632287
400368,400376,403221,8,2845,2,18000,1.00281195079
400369,400382,403114,13,2732,2,18000,1.00475841874
400404,400413,403202,9,2789,2,18000,1.00322696307
400415,400421,400422,6,1,1,172860,1.0
400419,400427,403167,8,2740,2,18000,1.00291970803
400448,400458,403303,10,2845,2,18000,1.00351493849
400463,400469,403210,6,2741,2,18000,1.00218898212
400478,400484,403220,6,2736,2,18000,1.00219298246
400495,400502,403317,7,2815,2,18000,1.00248667851
400510,400517,403337,7,2820,2,18000,1.0024822695
400512,400523,403150,11,2627,2,18000,1.00418728588
400527,400533,403299,6,2766,2,18000,1.0021691974
400528,400539,403340,11,2801,2,18000,1.00392716887
400529,400544,403198,15,2654,2,18000,1.00565184627
400539,400555,440774,16,40219,1,172860,1.00039782192
400545,400550,403316,5,2766,2,18000,1.0018076645
400546,400561,403342,15,2781,2,18000,1.00539374326
400561,400567,403323,6,2756,2,18000,1.00217706821
400576,400582,403345,6,2763,2,18000,1.00217155266
400577,400588,403467,11,2879,2,18000,1.0038207711
400579,400593,403506,14,2913,2,18000,1.00480604188
400594,400600,403319,6,2719,2,18000,1.00220669364
400609,400615,403244,6,2629,2,18000,1.00228223659
400625,400631,403413,6,2782,2,18000,1.00215672178
400626,400637,403424,11,2787,2,18000,1.0039468963
400642,400648,403406,6,2758,2,18000,1.00217548949
400663,400671,403357,8,2686,2,18000,1.00297840655
400685,400695,403540,10,2845,2,18000,1.00351493849
400713,400723,403606,10,2883,2,18000,1.00346860909
400741,400751,403505,10,2754,2,18000,1.00363108206
400742,400756,403374,14,2618,2,18000,1.00534759358
400771,400776,403553,5,2777,2,18000,1.00180050414
400810,400816,403655,6,2839,2,18000,1.00211342022
400826,400832,403521,6,2689,2,18000,1.00223131276
400827,400838,403652,11,2814,2,18000,1.0039090263
400846,400856,403686,10,2830,2,18000,1.0035335689
400864,400872,403575,8,2703,2,18000,1.00295967444
400884,400892,403751,8,2859,2,18000,1.00279818118
402979,402989,405806,10,2817,2,18000,1.00354987575
403049,403057,405829,8,2772,2,18000,1.00288600289
403116,403125,405907,9,2782,2,18000,1.00323508267
403131,403140,405906,9,2766,2,18000,1.0032537961
403146,403152,405819,6,2667,2,18000,1.00224971879
403161,403168,405848,7,2680,2,18000,1.0026119403
403176,403183,405921,7,2738,2,18000,1.00255661066
403202,403209,406073,7,2864,2,18000,1.00244413408
403204,403215,405904,11,2689,2,18000,1.00409074005
403220,403227,405903,7,2676,2,18000,1.00261584454
403235,403241,406055,6,2814,2,18000,1.00213219616
403236,403247,406136,11,2889,2,18000,1.00380754586
403251,403257,406094,6,2837,2,18000,1.00211491012
403302,403311,406120,9,2809,2,18000,1.00320398718
403318,403324,406162,6,2838,2,18000,1.0021141649
403319,403330,406155,11,2825,2,18000,1.00389380531
403321,403335,406266,14,2931,2,18000,1.00477652678
403337,403343,406047,6,2704,2,18000,1.00221893491
403338,403349,406001,11,2652,2,18000,1.00414781297
403354,403360,405940,6,2580,2,18000,1.0023255814
403356,403366,406252,10,2886,2,18000,1.00346500347
403357,403371,406145,14,2774,2,18000,1.00504686373
403358,403376,406154,18,2778,2,18000,1.00647948164
403374,403382,406248,8,2866,2,18000,1.00279134682
403389,403395,406206,6,2811,2,18000,1.00213447172
403407,403418,406220,11,2802,2,18000,1.00392576731
403422,403429,406210,7,2781,2,18000,1.00251708019
403438,403444,406214,6,2770,2,18000,1.00216606498
403469,403478,406241,9,2763,2,18000,1.00325732899
403506,403516,406307,10,2791,2,18000,1.00358294518
403507,403522,406207,15,2685,2,18000,1.00558659218
403523,403533,406381,10,2848,2,18000,1.00351123596
403542,403552,406386,10,2834,2,18000,1.00352858151
403557,403564,406198,7,2634,2,18000,1.00265755505
403578,403587,406223,9,2636,2,18000,1.00341426404
403609,403618,406284,9,2666,2,18000,1.00337584396
403655,403663,406493,8,2830,2,18000,1.00282685512
403670,403676,406540,6,2864,2,18000,1.00209497207
403689,403697,406482,8,2785,2,18000,1.00287253142
403753,403762,406512,9,2750,2,18000,1.00327272727
405470,405476,405480,6,4,1,57600,1.0
405513,405519,434211,6,28692,1,36000,1.00020911752
405811,405817,408635,6,2818,2,18000,1.00212916962
405826,405832,408492,6,2660,2,18000,1.0022556391
405842,405848,408672,6,2824,2,18000,1.00212464589
405857,405864,408583,7,2719,2,18000,1.00257447591
405910,405916,408687,6,2771,2,18000,1.00216528329
405912,405922,408621,10,2699,2,18000,1.00370507595
405913,405927,408632,14,2705,2,18000,1.00517560074
405914,405932,408753,18,2821,2,18000,1.00638071606
405930,405938,408644,8,2706,2,18000,1.0029563932
405947,405953,408653,6,2700,2,18000,1.00222222222
406003,406012,408851,9,2839,2,18000,1.00317013033
406049,406058,408917,9,2859,2,18000,1.00314795383
406064,406070,408834,6,2764,2,18000,1.002170767
406079,406085,408662,6,2577,2,18000,1.00232828871
406095,406105,408925,10,2820,2,18000,1.00354609929
406123,406131,408764,8,2633,2,18000,1.00303835929
406138,406147,408988,9,2841,2,18000,1.00316789863
406155,406162,408868,7,2706,2,18000,1.00258684405
406157,406168,408975,11,2807,2,18000,1.00391877449
406158,406173,409037,15,2864,2,18000,1.00523743017
406173,406179,408892,6,2713,2,18000,1.0022115739
406202,406210,409019,8,2809,2,18000,1.00284798861
406219,406225,408954,6,2729,2,18000,1.00219860755
406220,406231,408893,11,2662,2,18000,1.0041322314
406222,406236,408974,14,2738,2,18000,1.00511322133
406223,406241,408956,18,2715,2,18000,1.00662983425
406240,406247,409088,7,2841,2,18000,1.00246392115
406242,406253,408983,11,2730,2,18000,1.00402930403
406259,406265,409079,6,2814,2,18000,1.00213219616
406260,406271,408912,11,2641,2,18000,1.00416508898
406261,406276,408922,15,2646,2,18000,1.00566893424
406276,406282,408965,6,2683,2,18000,1.00223630265
406291,406297,409044,6,2747,2,18000,1.00218420095
406309,406318,409183,9,2865,2,18000,1.00314136126
406384,406392,409236,8,2844,2,18000,1.00281293952
406400,406406,409109,6,2703,2,18000,1.00221975583
406483,406493,409335,10,2842,2,18000,1.00351864884
406498,406504,409282,6,2778,2,18000,1.00215982721
406515,406524,409321,9,2797,2,18000,1.00321773329
406544,406551,409272,7,2721,2,18000,1.00257258361
406722,406729,406982,7,253,16,7200,1.02766798419
407448,407454,409311,6,1857,16,7200,1.00323101777
407873,407879,412857,6,4978,1,72000,1.00120530333
407874,407890,414206,16,6316,1,72000,1.00253324889
407874,407884,416018,10,8134,1,72000,1.00122940743
407874,407907,422143,33,14236,1,72000,1.00231806687
407874,407896,414871,22,6975,1,72000,1.00315412186
407875,407912,490352,37,82440,1,72000,1.00044881126
407875,407927,437182,52,29255,1,72000,1.00177747394
407875,407933,440062,58,32129,1,72000,1.0018052227
407875,407922,433796,47,25874,1,72000,1.00181649532
407875,407917,452828,42,44911,1,72000,1.00093518292
407875,407938,425120,63,17182,1,72000,1.00366662787
407876,407969,436308,93,28339,1,72000,1.0032816966
407876,407954,436752,78,28798,1,72000,1.00270852143
407876,407959,455898,83,47939,1,72000,1.00173136695
407876,407943,413920,67,5977,1,72000,1.01120963694
407876,407964,455167,88,47203,1,72000,1.00186428829
407876,407948,466336,72,58388,1,72000,1.0012331301
408497,408503,411258,6,2755,2,18000,1.00217785844
408586,408595,411439,9,2844,2,18000,1.00316455696
408624,408632,411268,8,2636,2,18000,1.00303490137
408639,408645,411403,6,2758,2,18000,1.00217548949
408640,408651,411534,11,2883,2,18000,1.00381547
408656,408662,411381,6,2719,2,18000,1.00220669364
408657,408668,411539,11,2871,2,18000,1.00383141762
408675,408681,411355,6,2674,2,18000,1.00224382947
408677,408687,411471,10,2784,2,18000,1.00359195402
408692,408698,411523,6,2825,2,18000,1.00212389381
408754,408764,411524,10,2760,2,18000,1.00362318841
408770,408776,411447,6,2671,2,18000,1.00224634968
408835,408845,411739,10,2894,2,18000,1.00345542502
408856,408863,411662,7,2799,2,18000,1.00250089318
408871,408880,411712,9,2832,2,18000,1.0031779661
408889,408903,411708,14,2805,2,18000,1.00499108734
408904,408910,411791,6,2881,2,18000,1.0020826102
408920,408926,411691,6,2765,2,18000,1.00216998192
408921,408932,411733,11,2801,2,18000,1.00392716887
408936,408942,411774,6,2832,2,18000,1.00211864407
408937,408948,411796,11,2848,2,18000,1.00386235955
408956,408965,411682,9,2717,2,18000,1.003312477
408958,408971,411798,13,2827,2,18000,1.00459851433
408975,408981,411785,6,2804,2,18000,1.00213980029
408976,408987,411802,11,2815,2,18000,1.00390763766
408977,408992,411693,15,2701,2,18000,1.0055534987
408993,408999,411678,6,2679,2,18000,1.00223964166
408995,409005,411890,10,2885,2,18000,1.00346620451
409019,409030,411863,11,2833,2,18000,1.00388280974
409038,409048,411659,10,2611,2,18000,1.00382995021
409053,409059,411797,6,2738,2,18000,1.00219138057
409082,409090,411809,8,2719,2,18000,1.00294225818
409096,409102,409116,6,14,2,10800,1.42857142857
409098,409108,411843,10,2735,2,18000,1.00365630713
409112,409120,411844,8,2724,2,18000,1.00293685756
409186,409194,412029,8,2835,2,18000,1.00282186949
409239,409247,411864,8,2617,2,18000,1.00305693542
409274,409283,412058,9,2775,2,18000,1.00324324324
409290,409296,412136,6,2840,2,18000,1.00211267606
409321,409332,412031,11,2699,2,18000,1.00407558355
409336,409346,412165,10,2819,2,18000,1.00354735722
410805,410811,410815,6,4,2,10800,1.0
411018,411024,439557,6,28533,1,259200,1.00021028283
411047,411053,490345,6,79292,3,604800,1.00007566968
411094,411100,490350,6,79250,3,604800,1.00007570978
411178,411184,490351,6,79167,3,604800,1.00007578915
411222,411228,490348,6,79120,3,604800,1.00007583418
411260,411269,414147,9,2878,2,18000,1.00312717165
411275,411281,414125,6,2844,2,18000,1.00210970464
411331,411337,490351,6,79014,3,604800,1.00007593591
411356,411366,414212,10,2846,2,18000,1.00351370344
411378,411384,490352,6,78968,3,604800,1.00007598014
411384,411392,414082,8,2690,2,18000,1.0029739777
411406,411414,414110,8,2696,2,18000,1.00296735905
411441,411450,414366,9,2916,2,18000,1.00308641975
411456,411462,414113,6,2651,2,18000,1.00226329687
411472,411482,414405,10,2923,2,18000,1.00342114266
411526,411534,414421,8,2887,2,18000,1.0027710426
411528,411540,414309,12,2769,2,18000,1.00433369447
411543,411549,414335,6,2786,2,18000,1.00215362527
411544,411555,414431,11,2876,2,18000,1.00382475661
411663,411670,414312,7,2642,2,18000,1.00264950795
411680,411686,414353,6,2667,2,18000,1.00224971879
411681,411692,414311,11,2619,2,18000,1.00420007637
411697,411702,414470,5,2768,2,18000,1.00180635838
411698,411709,414576,11,2867,2,18000,1.00383676317
411699,411714,414394,15,2680,2,18000,1.00559701493
411719,411725,414347,6,2622,2,18000,1.00228832952
411720,411731,414599,11,2868,2,18000,1.00383542538
411736,411745,414631,9,2886,2,18000,1.00311850312
411751,411757,414530,6,2773,2,18000,1.0021637216
411772,411778,411779,6,1,1,172860,1.0
411777,411785,414554,8,2769,2,18000,1.00288912965
411792,411798,414565,6,2767,2,18000,1.00216841344
411793,411804,414433,11,2629,2,18000,1.00418410042
411809,411815,414645,6,2830,2,18000,1.00212014134
411811,411821,414723,10,2902,2,18000,1.00344589938
411812,411826,414657,14,2831,2,18000,1.00494524903
411813,411831,414543,18,2712,2,18000,1.00663716814
411814,411836,414627,22,2791,2,18000,1.0078824794
411846,411855,414544,9,2689,2,18000,1.00334696913
411848,411860,414610,12,2750,2,18000,1.00436363636
411867,411874,414617,7,2743,2,18000,1.00255195042
411868,411880,414718,12,2838,2,18000,1.00422832981
411893,411905,414590,12,2685,2,18000,1.00446927374
411893,411898,440773,5,28875,1,172860,1.00017316017
412033,412042,414890,9,2848,2,18000,1.00316011236
412034,412047,414851,13,2804,2,18000,1.00463623395
412061,412069,414721,8,2652,2,18000,1.00301659125
412136,412147,414998,11,2851,2,18000,1.00385829533
412168,412177,414931,9,2754,2,18000,1.00326797386
414084,414093,416658,9,2565,2,18000,1.00350877193
414113,414121,416856,8,2735,2,18000,1.0029250457
414129,414135,416916,6,2781,2,18000,1.0021574973
414130,414141,416888,11,2747,2,18000,1.0040043684
414149,414158,416850,9,2692,2,18000,1.00334323923
414214,414223,416968,9,2745,2,18000,1.00327868852
414312,414320,417203,8,2883,2,18000,1.00277488727
414313,414326,416962,13,2636,2,18000,1.00493171472
414329,414335,417051,6,2716,2,18000,1.00220913108
414345,414351,417153,6,2802,2,18000,1.00214132762
414361,414367,417058,6,2691,2,18000,1.0022296544
414362,414373,417162,11,2789,2,18000,1.00394406597
414378,414384,417201,6,2817,2,18000,1.00212992545
414397,414406,417268,9,2862,2,18000,1.00314465409
414412,414418,417123,6,2705,2,18000,1.0022181146
414428,414433,417118,5,2685,2,18000,1.00186219739
414446,414452,417104,6,2652,2,18000,1.00226244344
414447,414458,417201,11,2743,2,18000,1.0040102078
414473,414481,417250,8,2769,2,18000,1.00288912965
414532,414541,417291,9,2750,2,18000,1.00327272727
414553,414559,417449,6,2890,2,18000,1.00207612457
414554,414565,417427,11,2862,2,18000,1.00384346611
414569,414575,417447,6,2872,2,18000,1.00208913649
414571,414581,417239,10,2658,2,18000,1.00376222724
414586,414592,417067,6,2475,2,18000,1.00242424242
414603,414609,417263,6,2654,2,18000,1.00226073851
414604,414615,417370,11,2755,2,18000,1.00399274047
414619,414626,417292,7,2666,2,18000,1.00262565641
414621,414632,417450,11,2818,2,18000,1.00390347764
414636,414642,417434,6,2792,2,18000,1.00214899713
414637,414648,417426,11,2778,2,18000,1.00395968323
414653,414659,417225,6,2566,2,18000,1.00233826968
414669,414675,417527,6,2852,2,18000,1.00210378682
414722,414730,417632,8,2902,2,18000,1.0027567195
414724,414736,417500,12,2764,2,18000,1.00434153401
414740,414747,417376,7,2629,2,18000,1.00266260936
414855,414862,417652,7,2790,2,18000,1.00250896057
414895,414901,417731,6,2830,2,18000,1.00212014134
414933,414943,417710,10,2767,2,18000,1.00361402241
414999,415009,417890,10,2881,2,18000,1.00347101701
416660,416669,419360,9,2691,2,18000,1.00334448161
416852,416861,419612,9,2751,2,18000,1.00327153762
416867,416873,419683,6,2810,2,18000,1.00213523132
416891,416899,419730,8,2831,2,18000,1.00282585659
416919,416927,419675,8,2748,2,18000,1.00291120815
416965,416973,419771,8,2798,2,18000,1.00285918513
416980,416987,419674,7,2687,2,18000,1.00260513584
417054,417062,419878,8,2816,2,18000,1.00284090909
417069,417075,419902,6,2827,2,18000,1.00212239123
417070,417081,419720,11,2639,2,18000,1.00416824555
417107,417115,419848,8,2733,2,18000,1.00292718624
417122,417129,419961,7,2832,2,18000,1.00247175141
417138,417144,419955,6,2811,2,18000,1.00213447172
417156,417164,419988,8,2824,2,18000,1.00283286119
417171,417177,420037,6,2860,2,18000,1.0020979021
417203,417212,420079,9,2867,2,18000,1.00313916986
417204,417217,419987,13,2770,2,18000,1.00469314079
417220,417226,420055,6,2829,2,18000,1.00212089077
417235,417241,419976,6,2735,2,18000,1.00219378428
417251,417257,420106,6,2849,2,18000,1.00210600211
417252,417263,420010,11,2747,2,18000,1.0040043684
417269,417274,420123,5,2849,2,18000,1.00175500176
417270,417280,420158,10,2878,2,18000,1.00347463516
417295,417302,420146,7,2844,2,18000,1.00246132208
417296,417308,420120,12,2812,2,18000,1.00426742532
417377,417383,420234,6,2851,2,18000,1.00210452473
417378,417389,420150,11,2761,2,18000,1.00398406375
417428,417437,420266,9,2829,2,18000,1.00318133616
417430,417442,420272,12,2830,2,18000,1.00424028269
417445,417451,420271,6,2820,2,18000,1.00212765957
417461,417468,420185,7,2717,2,18000,1.002576371
417463,417474,420237,11,2763,2,18000,1.00398117988
417464,417479,420177,15,2698,2,18000,1.00555967383
417503,417511,420265,8,2754,2,18000,1.00290486565
417530,417538,420439,8,2901,2,18000,1.00275766977
417635,417643,420300,8,2657,2,18000,1.00301091457
417653,417663,420448,10,2785,2,18000,1.00359066427
417713,417721,420466,8,2745,2,18000,1.0029143898
417734,417742,420474,8,2732,2,18000,1.00292825769
417735,417747,417748,12,1,2,300,1.3
417892,417902,420729,10,2827,2,18000,1.00353731871
419361,419371,422212,10,2841,2,18000,1.00351988736
419615,419623,422386,8,2763,2,18000,1.00289540355
419676,419686,422455,10,2769,2,18000,1.00361141206
419677,419691,422401,14,2710,2,18000,1.00516605166
419693,419699,422447,6,2748,2,18000,1.00218340611
419722,419731,422619,9,2888,2,18000,1.00311634349
419738,419744,422556,6,2812,2,18000,1.00213371266
419775,419782,422507,7,2725,2,18000,1.00256880734
419851,419859,422633,8,2774,2,18000,1.00288392213
419880,419889,422602,9,2713,2,18000,1.00331736086
419906,419914,422750,8,2836,2,18000,1.00282087447
419959,419966,422656,7,2690,2,18000,1.00260223048
419978,419984,422766,6,2782,2,18000,1.00215672178
419979,419990,422693,11,2703,2,18000,1.00406955235
419996,420002,422784,6,2782,2,18000,1.00215672178
419997,420008,422823,11,2815,2,18000,1.00390763766
420013,420021,422561,8,2540,2,18000,1.0031496063
420038,420048,422882,10,2834,2,18000,1.00352858151
420058,420067,422802,9,2735,2,18000,1.00329067642
420082,420091,422968,9,2877,2,18000,1.0031282586
420108,420117,422787,9,2670,2,18000,1.00337078652
420130,420136,422940,6,2804,2,18000,1.00213980029
420131,420142,423014,11,2872,2,18000,1.00383008357
420150,420157,422735,7,2578,2,18000,1.00271528317
420152,420163,422840,11,2677,2,18000,1.00410907733
420169,420175,422993,6,2818,2,18000,1.00212916962
420187,420193,423085,6,2892,2,18000,1.0020746888
420188,420199,422849,11,2650,2,18000,1.0041509434
420238,420245,422992,7,2747,2,18000,1.00254823444
420240,420251,422986,11,2735,2,18000,1.00402193784
420272,420278,422927,6,2649,2,18000,1.00226500566
420274,420284,423076,10,2792,2,18000,1.00358166189
420275,420289,422921,14,2632,2,18000,1.00531914894
420276,420294,423033,18,2739,2,18000,1.00657174151
420302,420312,423143,10,2831,2,18000,1.00353232073
420442,420450,423078,8,2628,2,18000,1.00304414003
420458,420464,423260,6,2796,2,18000,1.00214592275
420475,420481,423310,6,2829,2,18000,1.00212089077
420476,420487,423310,11,2823,2,18000,1.00389656394
420739,420745,423424,6,2679,2,18000,1.00223964166
421488,421494,421498,6,4,2,300,1.0
421506,421512,421536,6,24,2,300,1.25
421547,421553,421612,6,59,2,300,1.10169491525
421620,421626,421876,6,250,2,300,1.024
421883,421889,421901,6,12,2,300,1.5
421912,421918,421959,6,41,2,300,1.14634146341
421967,421973,422014,6,41,2,300,1.14634146341
422022,422028,422339,6,311,2,300,1.0192926045
422217,422222,424774,5,2552,2,18000,1.00195924765
422353,422360,422685,7,325,2,300,1.02153846154
422388,422397,425047,9,2650,2,18000,1.00339622642
422404,422413,425194,9,2781,2,18000,1.00323624595
422449,422458,425193,9,2735,2,18000,1.00329067642
422464,422470,425197,6,2727,2,18000,1.00220022002
422509,422518,425222,9,2704,2,18000,1.00332840237
422561,422567,425379,6,2812,2,18000,1.00213371266
422562,422573,425293,11,2720,2,18000,1.00404411765
422604,422614,425375,10,2761,2,18000,1.00362187613
422624,422630,425348,6,2718,2,18000,1.00220750552
422641,422647,425458,6,2811,2,18000,1.00213447172
422659,422667,425452,8,2785,2,18000,1.00287253142
422695,422704,425497,9,2793,2,18000,1.00322234157
422699,422710,422949,11,239,2,300,1.0460251046
422737,422747,425549,10,2802,2,18000,1.00356887937
422754,422761,425557,7,2796,2,18000,1.00250357654
422770,422777,425598,7,2821,2,18000,1.00248138958
422785,422795,425696,10,2901,2,18000,1.00344708721
422801,422807,425510,6,2703,2,18000,1.00221975583
422820,422826,425547,6,2721,2,18000,1.00220507166
422836,422843,425615,7,2772,2,18000,1.00252525253
422852,422858,425612,6,2754,2,18000,1.00217864924
422853,422864,425767,11,2903,2,18000,1.0037891836
422886,422893,425631,7,2738,2,18000,1.00255661066
422924,422933,425698,9,2765,2,18000,1.00325497288
422940,422946,425777,6,2831,2,18000,1.00211939244
422955,422962,425750,7,2788,2,18000,1.0025107604
422970,422979,425764,9,2785,2,18000,1.00323159785
422990,422997,425743,7,2746,2,18000,1.00254916242
423005,423011,425854,6,2843,2,18000,1.00211044671
423006,423017,425653,11,2636,2,18000,1.00417298938
423021,423028,425705,7,2677,2,18000,1.00261486739
423037,423045,425698,8,2653,2,18000,1.0030154542
423077,423087,425805,10,2718,2,18000,1.00367917586
423092,423099,425943,7,2844,2,18000,1.00246132208
423094,423105,425994,11,2889,2,18000,1.00380754586
423147,423154,425964,7,2810,2,18000,1.0024911032
423263,423271,425954,8,2683,2,18000,1.00298173686
423313,423320,426049,7,2729,2,18000,1.00256504214
423315,423326,426138,11,2812,2,18000,1.00391180654
423425,423435,426212,10,2777,2,18000,1.00360100828
424775,424785,427606,10,2821,2,18000,1.00354484225
425049,425058,427827,9,2769,2,18000,1.00325027086
425196,425205,428104,9,2899,2,18000,1.0031045188
425198,425210,427969,12,2759,2,18000,1.00434940196
425214,425220,427845,6,2625,2,18000,1.00228571429
425229,425235,428106,6,2871,2,18000,1.00208986416
425298,425304,427953,6,2649,2,18000,1.00226500566
425350,425359,428157,9,2798,2,18000,1.00321658327
425378,425386,428171,8,2785,2,18000,1.00287253142
425391,425397,425471,6,74,4,3540,1.08108108108
425393,425408,425470,15,62,2,3540,1.24193548387
425393,425403,428220,10,2817,2,18000,1.00354987575
425456,425463,428253,7,2790,2,18000,1.00250896057
425471,425477,428400,6,2923,2,18000,1.0020526856
425499,425509,428207,10,2698,2,18000,1.00370644922
425514,425521,428081,7,2560,2,18000,1.002734375
425545,425558,428210,13,2652,2,18000,1.00490196078
425561,425567,428436,6,2869,2,18000,1.00209132102
425562,425573,428317,11,2744,2,18000,1.00400874636
425599,425609,428440,10,2831,2,18000,1.00353232073
425615,425623,428443,8,2820,2,18000,1.00283687943
425631,425637,428388,6,2751,2,18000,1.00218102508
425632,425643,428515,11,2872,2,18000,1.00383008357
425654,425664,428544,10,2880,2,18000,1.00347222222
425697,425707,428234,10,2527,2,18000,1.00395726157
425713,425719,428500,6,2781,2,18000,1.0021574973
425714,425725,428542,11,2817,2,18000,1.00390486333
425716,425730,428437,14,2707,2,18000,1.00517177687
425733,425739,425740,6,1,1,172860,1.0
425743,425754,428438,11,2684,2,18000,1.00409836066
425759,425765,428628,6,2863,2,18000,1.00209570381
425774,425781,428576,7,2795,2,18000,1.00250447227
425776,425787,428502,11,2715,2,18000,1.00405156538
425799,425806,428557,7,2751,2,18000,1.00254452926
425814,425820,428612,6,2792,2,18000,1.00214899713
425857,425869,428695,12,2826,2,18000,1.0042462845
425857,425863,440774,6,14911,1,172860,1.0004023875
425946,425954,428882,8,2928,2,18000,1.00273224044
425961,425967,428785,6,2818,2,18000,1.00212916962
425976,425982,428883,6,2901,2,18000,1.00206825233
425998,426006,428618,8,2612,2,18000,1.00306278714
426050,426060,428754,10,2694,2,18000,1.00371195249
426142,426149,428889,7,2740,2,18000,1.00255474453
426216,426223,428923,7,2700,2,18000,1.00259259259
427608,427617,430333,9,2716,2,18000,1.00331369661
427829,427838,430669,9,2831,2,18000,1.00317908866
427847,427856,430553,9,2697,2,18000,1.00333704116
427956,427964,430668,8,2704,2,18000,1.00295857988
427971,427980,430839,9,2859,2,18000,1.00314795383
428081,428092,430890,11,2798,2,18000,1.00393137956
428107,428115,430874,8,2759,2,18000,1.0028996013
428108,428121,430862,13,2741,2,18000,1.0047427946
428159,428169,430946,10,2777,2,18000,1.00360100828
428175,428182,430951,7,2769,2,18000,1.00252798844
428209,428218,431005,9,2787,2,18000,1.00322927879
428225,428231,430937,6,2706,2,18000,1.0022172949
428226,428237,431091,11,2854,2,18000,1.00385423966
428242,428248,430931,6,2683,2,18000,1.00223630265
428257,428265,430981,8,2716,2,18000,1.0029455081
428320,428328,431120,8,2792,2,18000,1.00286532951
428392,428399,431177,7,2778,2,18000,1.00251979842
428407,428413,431083,6,2670,2,18000,1.00224719101
428441,428446,431358,5,2912,2,18000,1.00171703297
428442,428453,431351,11,2898,2,18000,1.00379572119
428443,428458,431245,15,2787,2,18000,1.00538213132
428445,428463,431279,18,2816,2,18000,1.00639204545
428461,428470,431251,9,2781,2,18000,1.00323624595
428502,428512,431364,10,2852,2,18000,1.00350631136
428520,428525,431233,5,2708,2,18000,1.00184638109
428521,428531,431148,10,2617,2,18000,1.00382116928
428545,428559,431257,14,2698,2,18000,1.00518902891
428546,428553,431360,7,2807,2,18000,1.00249376559
428562,428568,431399,6,2831,2,18000,1.00211939244
428580,428587,431259,7,2672,2,18000,1.00261976048
428614,428624,431359,10,2735,2,18000,1.00365630713
428630,428636,431456,6,2820,2,18000,1.00212765957
428632,428642,431468,10,2826,2,18000,1.00353857042
428697,428706,431458,9,2752,2,18000,1.00327034884
428758,428765,431470,7,2705,2,18000,1.00258780037
428789,428797,431524,8,2727,2,18000,1.0029336267
428885,428893,431695,8,2802,2,18000,1.0028551035
428887,428899,431629,12,2730,2,18000,1.0043956044
428904,428910,431734,6,2824,2,18000,1.00212464589
428926,428934,431667,8,2733,2,18000,1.00292718624
430334,430344,433147,10,2803,2,18000,1.00356760614
430557,430565,433318,8,2753,2,18000,1.00290592081
430561,430571,430602,10,31,10,360000,1.32258064516
430671,430685,433496,14,2811,2,18000,1.00498043401
430672,430679,433512,7,2833,2,18000,1.00247087893
430694,430700,490345,6,59645,10,360000,1.00010059519
430842,430851,433736,9,2885,2,18000,1.00311958406
430863,430873,433616,10,2743,2,18000,1.00364564346
430879,430885,433573,6,2688,2,18000,1.00223214286
430894,430902,433834,8,2932,2,18000,1.00272851296
430934,430943,433786,9,2843,2,18000,1.00316567007
430952,430958,433625,6,2667,2,18000,1.00224971879
430953,430964,433813,11,2849,2,18000,1.00386100386
430954,430969,433718,15,2749,2,18000,1.00545652965
430983,430992,433564,9,2572,2,18000,1.0034992224
431008,431016,433683,8,2667,2,18000,1.00299962505
431084,431094,433885,10,2791,2,18000,1.00358294518
431100,431106,433905,6,2799,2,18000,1.00214362272
431122,431131,433909,9,2778,2,18000,1.00323974082
431150,431159,433930,9,2771,2,18000,1.00324792494
431181,431188,434006,7,2818,2,18000,1.00248403123
431236,431244,433950,8,2706,2,18000,1.0029563932
431251,431258,434078,7,2820,2,18000,1.0024822695
431253,431264,433908,11,2644,2,18000,1.00416036309
431269,431275,433886,6,2611,2,18000,1.00229797013
431270,431281,433998,11,2717,2,18000,1.004048583
431285,431291,434002,6,2711,2,18000,1.00221320546
431353,431363,434132,10,2769,2,18000,1.00361141206
431369,431374,434206,5,2832,2,18000,1.00176553672
431370,431381,434053,11,2672,2,18000,1.00411676647
431371,431386,434260,15,2874,2,18000,1.00521920668
431373,431391,434276,18,2885,2,18000,1.00623916811
431400,431410,434160,10,2750,2,18000,1.00363636364
431457,431467,434144,10,2677,2,18000,1.00373552484
431473,431479,434249,6,2770,2,18000,1.00216606498
431475,431485,434166,10,2681,2,18000,1.00372995151
431476,431490,434346,14,2856,2,18000,1.00490196078
431526,431535,434365,9,2830,2,18000,1.00318021201
431631,431641,434463,10,2822,2,18000,1.00354358611
431669,431678,434550,9,2872,2,18000,1.00313370474
431697,431706,434555,9,2849,2,18000,1.00315900316
431736,431745,434608,9,2863,2,18000,1.00314355571
432953,432960,434197,7,1237,27,3540,1.00565885206
433150,433159,436031,9,2872,2,18000,1.00313370474
433321,433330,435946,9,2616,2,18000,1.00344036697
433500,433508,436243,8,2735,2,18000,1.0029250457
433515,433523,436257,8,2734,2,18000,1.00292611558
433568,433576,436447,8,2871,2,18000,1.00278648555
433583,433589,436357,6,2768,2,18000,1.00216763006
433618,433628,436477,10,2849,2,18000,1.00351000351
433634,433640,436489,6,2849,2,18000,1.00210600211
433686,433694,436315,8,2621,2,18000,1.00305227013
433721,433729,436515,8,2786,2,18000,1.00287150036
433740,433747,436392,7,2645,2,18000,1.00264650284
433789,433797,436569,8,2772,2,18000,1.00288600289
433814,433824,436590,10,2766,2,18000,1.00361532899
433836,433846,436651,10,2805,2,18000,1.00356506239
433890,433896,436676,6,2780,2,18000,1.00215827338
433891,433902,436777,11,2875,2,18000,1.00382608696
433908,433916,436674,8,2758,2,18000,1.00290065265
433909,433922,436521,13,2599,2,18000,1.00500192382
433925,433931,436734,6,2803,2,18000,1.00214056368
433940,433947,436861,7,2914,2,18000,1.00240219629
433956,433962,436606,6,2644,2,18000,1.00226928896
434001,434009,436857,8,2848,2,18000,1.00280898876
434017,434023,436813,6,2790,2,18000,1.00215053763
434018,434029,436761,11,2732,2,18000,1.00402635432
434055,434064,436722,9,2658,2,18000,1.00338600451
434080,434089,436859,9,2770,2,18000,1.00324909747
434134,434143,436940,9,2797,2,18000,1.00321773329
434150,434156,437004,6,2848,2,18000,1.00210674157
434165,434171,436843,6,2672,2,18000,1.00224550898
434181,434187,437019,6,2832,2,18000,1.00211864407
434210,434217,436955,7,2738,2,18000,1.00255661066
434222,434228,434559,6,331,16,36000,1.01812688822
434250,434260,436987,10,2727,2,18000,1.00366703337
434267,434273,436878,6,2605,2,18000,1.00230326296
434282,434288,437082,6,2794,2,18000,1.00214745884
434348,434357,437081,9,2724,2,18000,1.00330396476
434367,434376,437202,9,2826,2,18000,1.00318471338
434465,434474,437268,9,2794,2,18000,1.00322118826
434549,434561,437445,12,2884,2,18000,1.00416088766
434566,434572,437378,6,2806,2,18000,1.00213827512
434610,434619,437513,9,2894,2,18000,1.00310988252
435949,435957,438625,8,2668,2,18000,1.00299850075
436034,436043,438787,9,2744,2,18000,1.00327988338
436245,436254,439106,9,2852,2,18000,1.00315568022
436262,436268,438850,6,2582,2,18000,1.00232378002
436318,436327,439115,9,2788,2,18000,1.00322812052
436359,436368,439040,9,2672,2,18000,1.00336826347
436390,436403,439107,13,2704,2,18000,1.00480769231
436448,436458,439114,10,2656,2,18000,1.00376506024
436480,436488,439398,8,2910,2,18000,1.00274914089
436498,436504,439304,6,2800,2,18000,1.00214285714
436517,436526,439282,9,2756,2,18000,1.00326560232
436533,436539,439434,6,2895,2,18000,1.00207253886
436571,436580,439167,9,2587,2,18000,1.00347893313
436593,436601,439457,8,2856,2,18000,1.00280112045
436608,436617,439434,9,2817,2,18000,1.00319488818
436652,436662,439550,10,2888,2,18000,1.00346260388
436675,436685,439582,10,2897,2,18000,1.00345184674
436691,436697,439491,6,2794,2,18000,1.00214745884
436725,436733,439406,8,2673,2,18000,1.00299289188
436742,436748,439616,6,2868,2,18000,1.00209205021
436765,436772,439370,7,2598,2,18000,1.00269438029
436782,436788,439561,6,2773,2,18000,1.0021637216
436815,436824,439543,9,2719,2,18000,1.00331004046
436850,436856,439648,6,2792,2,18000,1.00214899713
436867,436873,439692,6,2819,2,18000,1.00212841433
436869,436879,439543,10,2664,2,18000,1.00375375375
436870,436884,439748,14,2864,2,18000,1.00488826816
436887,436893,439651,6,2758,2,18000,1.00217548949
436942,436951,439652,9,2701,2,18000,1.00333209922
436957,436967,439671,10,2704,2,18000,1.00369822485
436988,436998,439540,10,2542,2,18000,1.00393391031
437007,437015,439579,8,2564,2,18000,1.0031201248
437022,437030,439832,8,2802,2,18000,1.0028551035
437084,437091,439711,7,2620,2,18000,1.00267175573
437085,437097,439899,12,2802,2,18000,1.00428265525
437205,437213,455259,8,18046,2,18000,1.00044331154
437271,437279,440024,8,2745,2,18000,1.0029143898
437380,437389,455416,9,18027,2,18000,1.00049925112
437450,437516,455549,66,18033,2,18000,1.00365995675
437515,437524,455570,9,18046,2,18000,1.00049872548
437619,437625,466818,6,29193,32,43200,1.00020552872
438626,438636,456671,10,18035,2,18000,1.00055447741
438788,438798,456806,10,18008,2,18000,1.00055530875
438854,438861,456873,7,18012,2,18000,1.0003886298
439042,439051,457080,9,18029,2,18000,1.00049919574
439108,439117,440227,9,1110,2,18000,1.00810810811
439109,439123,440234,14,1111,2,18000,1.01260126013
439126,439132,440247,6,1115,2,18000,1.00538116592
439127,439138,440247,11,1109,2,18000,1.00991884581
439170,439178,440258,8,1080,2,18000,1.00740740741
439284,439293,440408,9,1115,2,18000,1.00807174888
439307,439315,440426,8,1111,2,18000,1.00720072007
439372,439381,457408,9,18027,2,18000,1.00049925112
439401,439409,440515,8,1106,2,18000,1.00723327306
439416,439422,440538,6,1116,2,18000,1.00537634409
439436,439445,440553,9,1108,2,18000,1.00812274368
439438,439450,440559,12,1109,2,18000,1.01082055906
439459,439469,440575,10,1106,2,18000,1.00904159132
439493,439503,457534,10,18031,2,18000,1.00055460041
439541,439551,440659,10,1108,2,18000,1.00902527076
439557,439563,440671,6,1108,2,18000,1.00541516245
439559,439569,440684,10,1115,2,18000,1.00896860987
439560,439574,440684,14,1110,2,18000,1.01261261261
439575,439581,440697,6,1116,2,18000,1.00537634409
439591,439597,440710,6,1113,2,18000,1.00539083558
439592,439603,440676,11,1073,2,18000,1.01025163094
439617,439627,440737,10,1110,2,18000,1.00900900901
439649,439659,440769,10,1110,2,18000,1.00900900901
439664,439671,440778,7,1107,2,18000,1.00632339657
439666,439677,440789,11,1112,2,18000,1.00989208633
439681,439688,440798,7,1110,2,18000,1.00630630631
439696,439702,440810,6,1108,2,18000,1.00541516245
439712,439722,440837,10,1115,2,18000,1.00896860987
439750,439759,440871,9,1112,2,18000,1.00809352518
439833,439843,439844,10,1,2,18000,1.1
439907,439913,441023,6,1110,2,18000,1.00540540541
440026,440032,440033,6,1,2,18000,1.0
440380,440386,440387,6,1,2,18000,1.0
440381,440392,440393,11,1,2,18000,1.2
440449,440455,441569,6,1114,2,18000,1.00538599641
440543,440549,440550,6,1,2,18000,1.0
440554,440560,441677,6,1117,2,18000,1.00537153089
440555,440566,441671,11,1105,2,18000,1.00995475113
440570,440576,441687,6,1111,2,18000,1.00540054005
440890,440896,440897,6,1,2,18000,1.0
442729,442735,442736,6,1,2,18000,1.0
443461,443467,446220,6,2753,2,18000,1.00217944061
443462,443472,446315,10,2843,2,18000,1.00351741119
443463,443477,446123,14,2646,2,18000,1.00529100529
443464,443483,446067,19,2584,2,18000,1.00735294118
443466,443488,446251,22,2763,2,18000,1.00796235975
443467,443493,446353,26,2860,2,18000,1.00909090909
443468,443499,446457,31,2958,2,18000,1.01048005409
443470,443504,446193,34,2689,2,18000,1.01264410562
443471,443509,446337,38,2828,2,18000,1.01343705799
443472,443514,446255,42,2741,2,18000,1.01532287486
443473,443519,446308,46,2789,2,18000,1.0164933668
443475,443525,446253,50,2728,2,18000,1.01832844575
443476,443530,446289,54,2759,2,18000,1.01957230881
443477,443535,446415,58,2880,2,18000,1.02013888889
443478,443540,446394,62,2854,2,18000,1.02172389629
446073,446079,448961,6,2882,2,18000,1.00208188758
446125,446132,448829,7,2697,2,18000,1.00259547646
446195,446202,449035,7,2833,2,18000,1.00247087893
446223,446229,449122,6,2893,2,18000,1.00207397166
446255,446261,449094,6,2833,2,18000,1.00211789622
446256,446267,449108,11,2841,2,18000,1.0038718761
446271,446278,449037,7,2759,2,18000,1.00253715114
446289,446296,448782,7,2486,2,18000,1.0028157683
446311,446317,449087,6,2770,2,18000,1.00216606498
446326,446332,449181,6,2849,2,18000,1.00210600211
446341,446347,449095,6,2748,2,18000,1.00218340611
446356,446362,449210,6,2848,2,18000,1.00210674157
446396,446402,449149,6,2747,2,18000,1.00218420095
446418,446424,449079,6,2655,2,18000,1.00225988701
446458,446464,449244,6,2780,2,18000,1.00215827338
448783,448790,451667,7,2877,2,18000,1.00243309002
448836,448842,451716,6,2874,2,18000,1.00208768267
448965,448971,451792,6,2821,2,18000,1.00212690535
449037,449043,451841,6,2798,2,18000,1.00214438885
449038,449049,451800,11,2751,2,18000,1.00399854598
449082,449088,451601,6,2513,2,18000,1.00238758456
449099,449105,451726,6,2621,2,18000,1.00228920259
449100,449111,451821,11,2710,2,18000,1.00405904059
449102,449116,451882,14,2766,2,18000,1.00506146059
449117,449123,452000,6,2877,2,18000,1.00208550574
449132,449138,451978,6,2840,2,18000,1.00211267606
449150,449156,451791,6,2635,2,18000,1.00227703985
449184,449190,451926,6,2736,2,18000,1.00219298246
449211,449217,452087,6,2870,2,18000,1.00209059233
449245,449252,452003,7,2751,2,18000,1.00254452926
450038,450045,450139,7,94,1,1800,1.07446808511
450429,450435,450538,6,103,1,1800,1.05825242718
451134,451141,451644,7,503,1,1800,1.01391650099
451604,451610,454458,6,2848,2,18000,1.00210674157
451669,451675,454571,6,2896,2,18000,1.0020718232
451719,451725,454488,6,2763,2,18000,1.00217155266
451734,451740,454463,6,2723,2,18000,1.00220345207
451794,451800,454612,6,2812,2,18000,1.00213371266
451795,451806,454712,11,2906,2,18000,1.00378527185
451812,451818,454568,6,2750,2,18000,1.00218181818
451828,451833,454696,5,2863,2,18000,1.00174641984
451843,451849,454548,6,2699,2,18000,1.00222304557
451883,451889,454546,6,2657,2,18000,1.00225818592
451930,451936,454720,6,2784,2,18000,1.00215517241
451979,451986,454584,7,2598,2,18000,1.00269438029
452001,452007,454776,6,2769,2,18000,1.00216684724
452016,452022,454823,6,2801,2,18000,1.00214209211
452090,452096,454906,6,2810,2,18000,1.00213523132
453276,453282,453320,6,38,1,1800,1.15789473684
453632,453638,453707,6,69,1,1800,1.08695652174
454464,454471,457242,7,2771,2,18000,1.00252616384
454466,454477,457146,11,2669,2,18000,1.00412139378
454491,454497,457250,6,2753,2,18000,1.00217944061
454548,454554,457291,6,2737,2,18000,1.00219218122
454550,454560,457343,10,2783,2,18000,1.0035932447
454573,454578,457373,5,2795,2,18000,1.00178890877
454574,454585,457392,11,2807,2,18000,1.00391877449
454580,454591,454849,11,258,1,1800,1.04263565891
454589,454597,457509,8,2912,2,18000,1.00274725275
454614,454620,457406,6,2786,2,18000,1.00215362527
454701,454707,457396,6,2689,2,18000,1.00223131276
454716,454722,457382,6,2660,2,18000,1.0022556391
454732,454738,457592,6,2854,2,18000,1.00210231254
454779,454786,457450,7,2664,2,18000,1.00262762763
454824,454830,457635,6,2805,2,18000,1.00213903743
454910,454915,457616,5,2701,2,18000,1.00185116623
457152,457158,460003,6,2845,2,18000,1.00210896309
457245,457251,460046,6,2795,2,18000,1.00214669052
457260,457266,460076,6,2810,2,18000,1.00213523132
457294,457300,460145,6,2845,2,18000,1.00210896309
457347,457353,460187,6,2834,2,18000,1.00211714891
457375,457381,460203,6,2822,2,18000,1.00212615167
457391,457397,460173,6,2776,2,18000,1.00216138329
457407,457413,460301,6,2888,2,18000,1.00207756233
457408,457419,460099,11,2680,2,18000,1.00410447761
457410,457424,460285,14,2861,2,18000,1.00489339392
457454,457460,460135,6,2675,2,18000,1.00224299065
457510,457516,460197,6,2681,2,18000,1.00223797091
457594,457600,460459,6,2859,2,18000,1.00209863589
457619,457625,460327,6,2702,2,18000,1.00222057735
457639,457645,460472,6,2827,2,18000,1.00212239123
460005,460011,460738,6,727,2,18000,1.00825309491
460048,460054,460738,6,684,2,18000,1.00877192982
460078,460085,460738,7,653,2,18000,1.01071975498
460100,460106,460738,6,632,2,18000,1.00949367089
460137,460143,460738,6,595,2,18000,1.01008403361
460152,460158,460738,6,580,2,18000,1.01034482759
460174,460180,460738,6,558,2,18000,1.01075268817
460189,460195,460738,6,543,2,18000,1.01104972376
460205,460211,460739,6,528,2,18000,1.01136363636
460206,460217,460739,11,522,2,18000,1.02107279693
460286,460292,460739,6,447,2,18000,1.01342281879
460312,460318,460739,6,421,2,18000,1.01425178147
460331,460337,460739,6,402,2,18000,1.01492537313
460462,460468,460739,6,271,2,18000,1.0221402214
460477,460483,460739,6,256,2,18000,1.0234375
460479,460489,460739,10,250,2,18000,1.04
460493,460499,460739,6,240,2,18000,1.025
460514,460520,460739,6,219,2,18000,1.02739726027
460515,460526,460739,11,213,2,18000,1.05164319249
460516,460531,460739,15,208,2,18000,1.07211538462
460518,460536,460739,18,203,2,18000,1.08866995074
460519,460541,460739,22,198,2,18000,1.11111111111
460521,460548,460739,27,191,2,18000,1.14136125654
460522,460553,460739,31,186,2,18000,1.16666666667
460524,460558,460739,34,181,2,18000,1.18784530387
460525,460563,460739,38,176,2,18000,1.21590909091
460526,460568,460739,42,171,2,18000,1.24561403509
460527,460573,460739,46,166,2,18000,1.27710843373
460529,460579,460739,50,160,2,18000,1.3125
460530,460584,460739,54,155,2,18000,1.34838709677
460545,460590,460739,45,149,2,18000,1.30201342282
460546,460595,460739,49,144,2,18000,1.34027777778
460547,460600,460739,53,139,2,18000,1.38129496403
460562,460605,460739,43,134,2,18000,1.32089552239
460586,460611,460650,25,39,1,1800,1.64102564103
460940,460946,461017,6,71,1,1800,1.08450704225
461468,461474,464287,6,2813,2,18000,1.00213295414
461469,461480,464235,11,2755,2,18000,1.00399274047
461471,461485,464252,14,2767,2,18000,1.00505963137
461472,461490,464251,18,2761,2,18000,1.00651937704
461474,461495,464254,21,2759,2,18000,1.00761145343
461475,461501,464397,26,2896,2,18000,1.00897790055
461476,461506,464290,30,2784,2,18000,1.01077586207
461477,461511,464284,34,2773,2,18000,1.01226108907
461479,461516,464391,37,2875,2,18000,1.01286956522
461480,461521,464356,41,2835,2,18000,1.01446208113
461481,461526,464390,45,2864,2,18000,1.0157122905
461483,461532,464384,49,2852,2,18000,1.01718092567
461484,461537,464380,53,2843,2,18000,1.01864227928
461485,461542,464391,57,2849,2,18000,1.02000702001
461487,461547,464192,60,2645,2,18000,1.02268431002
461488,461552,464189,64,2637,2,18000,1.02427000379
461489,461557,464357,68,2800,2,18000,1.02428571429
461490,461562,464368,72,2806,2,18000,1.0256593015
461492,461568,464408,76,2840,2,18000,1.02676056338
461494,461573,464387,79,2814,2,18000,1.02807391613
461495,461578,464413,83,2835,2,18000,1.02927689594
461496,461584,464404,88,2820,2,18000,1.03120567376
461498,461589,464326,91,2737,2,18000,1.03324808184
461499,461594,464343,95,2749,2,18000,1.0345580211
461500,461599,464283,99,2684,2,18000,1.0368852459
461502,461609,464343,107,2734,2,18000,1.0391367959
461503,461614,464465,111,2851,2,18000,1.03893370747
461504,461619,464428,115,2809,2,18000,1.04093983624
461505,461624,464496,119,2872,2,18000,1.04143454039
461507,461629,464541,122,2912,2,18000,1.0418956044
461508,461635,464415,127,2780,2,18000,1.04568345324
461509,461640,464296,131,2656,2,18000,1.04932228916
461510,461645,464513,135,2868,2,18000,1.04707112971
461512,461650,464586,138,2936,2,18000,1.0470027248
461513,461655,464457,142,2802,2,18000,1.05067808708
461514,461660,464376,146,2716,2,18000,1.05375552283
461516,461665,464344,149,2679,2,18000,1.05561776782
461517,461670,464231,153,2561,2,18000,1.05974228817
461518,461676,464399,158,2723,2,18000,1.05802423797
461520,461681,464584,161,2903,2,18000,1.0554598691
461535,461686,461908,151,222,1,1800,1.68018018018
462239,462245,464585,6,2340,27,7140,1.00256410256
462847,462853,463638,6,785,2,1200,1.0076433121
462951,462957,463053,6,96,1,3600,1.0625
463060,463066,490351,6,27285,4,540000,1.00021990104
463157,463163,463254,6,91,1,3600,1.06593406593
463164,463170,463270,6,100,1,3600,1.06
463170,463177,463310,7,133,1,3600,1.05263157895
463193,463199,490351,6,27152,4,360000,1.0002209782
463263,463269,463298,6,29,1,1800,1.20689655172
463460,463466,463694,6,228,2,1200,1.02631578947
463595,463601,463669,6,68,1,1800,1.08823529412
464193,464204,466746,11,2542,2,18000,1.00432730134
464195,464210,466856,15,2646,2,18000,1.00566893424
464231,464246,467023,15,2777,2,18000,1.00540151242
464246,464252,467058,6,2806,2,18000,1.00213827512
464261,464266,466951,5,2685,2,18000,1.00186219739
464262,464272,466936,10,2664,2,18000,1.00375375375
464263,464277,466929,14,2652,2,18000,1.00527903469
464282,464298,466898,16,2600,2,18000,1.00615384615
464296,464304,467158,8,2854,2,18000,1.00280308339
464298,464309,467223,11,2914,2,18000,1.00377487989
464299,464315,466974,16,2659,2,18000,1.00601729974
464300,464320,466999,20,2679,2,18000,1.00746547219
464327,464342,467146,15,2804,2,18000,1.00534950071
464346,464358,467257,12,2899,2,18000,1.0041393584
464347,464363,467181,16,2818,2,18000,1.00567778566
464348,464368,467106,20,2738,2,18000,1.0073046019
464380,464386,467171,6,2785,2,18000,1.00215439856
464382,464392,467044,10,2652,2,18000,1.00377073906
464383,464397,467141,14,2744,2,18000,1.00510204082
464384,464402,467182,18,2780,2,18000,1.00647482014
464386,464409,467153,23,2744,2,18000,1.0083819242
464396,464430,464558,34,128,1,1800,1.265625
464401,464414,467276,13,2862,2,18000,1.00454227813
464402,464420,467080,18,2660,2,18000,1.00676691729
464403,464425,467161,22,2736,2,18000,1.00804093567
464405,464436,467300,31,2864,2,18000,1.01082402235
464406,464441,467209,35,2768,2,18000,1.01264450867
464407,464446,467296,39,2850,2,18000,1.01368421053
464408,464452,467280,44,2828,2,18000,1.01555869873
464423,464457,467156,34,2699,2,18000,1.01259725824
464425,464462,467334,37,2872,2,18000,1.01288300836
464426,464467,467083,41,2616,2,18000,1.01567278287
464427,464472,467342,45,2870,2,18000,1.01567944251
464442,464478,467251,36,2773,2,18000,1.01298232961
464457,464484,467279,27,2795,2,18000,1.00966010733
464472,464490,467363,18,2873,2,18000,1.00626522798
464499,464511,467206,12,2695,2,18000,1.00445269017
464514,464528,467024,14,2496,2,18000,1.00560897436
464542,464556,467369,14,2813,2,18000,1.004976893
464582,464588,464594,6,6,1,900,1.2
464584,464599,467415,15,2816,2,18000,1.00532670455
464599,464604,467477,5,2873,2,18000,1.00174034111
466749,466757,469537,8,2780,2,18000,1.00287769784
466858,466867,469649,9,2782,2,18000,1.00323508267
466901,466910,469686,9,2776,2,18000,1.00324207493
466931,466940,469655,9,2715,2,18000,1.00331491713
466946,466952,469809,6,2857,2,18000,1.00210010501
466961,466967,469591,6,2624,2,18000,1.00228658537
466976,466985,469799,9,2814,2,18000,1.00319829424
467000,467010,469871,10,2861,2,18000,1.00349528137
467024,467034,469866,10,2832,2,18000,1.00353107345
467025,467040,469808,15,2768,2,18000,1.00541907514
467036,467046,469390,10,2344,27,8940,1.0042662116
467047,467055,469893,8,2838,2,18000,1.00281888654
467061,467069,469685,8,2616,2,18000,1.00305810398
467079,467091,469758,12,2667,2,18000,1.00449943757
467094,467100,469794,6,2694,2,18000,1.00222717149
467143,467152,469863,9,2711,2,18000,1.00331980819
467158,467164,469992,6,2828,2,18000,1.00212164074
467160,467170,469987,10,2817,2,18000,1.00354987575
467161,467175,469991,14,2816,2,18000,1.00497159091
467162,467180,470022,18,2842,2,18000,1.00633356791
467178,467186,469832,8,2646,2,18000,1.00302343159
467179,467191,469860,12,2669,2,18000,1.00449606594
467194,467200,470034,6,2834,2,18000,1.00211714891
467195,467206,469845,11,2639,2,18000,1.00416824555
467210,467217,469929,7,2712,2,18000,1.00258112094
467211,467223,470006,12,2783,2,18000,1.00431189364
467253,467262,469775,9,2513,2,18000,1.00358137684
467268,467274,469893,6,2619,2,18000,1.00229095074
467283,467288,470062,5,2774,2,18000,1.00180245133
467284,467294,470051,10,2757,2,18000,1.00362713094
467285,467299,469954,14,2655,2,18000,1.00527306968
467301,467307,470100,6,2793,2,18000,1.00214822771
467315,467321,470086,6,2765,2,18000,1.00216998192
467336,467346,470067,10,2721,2,18000,1.00367511944
467351,467357,470110,6,2753,2,18000,1.00217944061
467366,467374,470096,8,2722,2,18000,1.00293901543
467380,467386,470058,6,2672,2,18000,1.00224550898
467416,467426,470298,10,2872,2,18000,1.00348189415
467477,467488,470304,11,2816,2,18000,1.00390625
467621,467627,467761,6,134,2,1200,1.0447761194
468043,468049,468536,6,487,64,900,1.01232032854
468126,468132,473251,6,5119,16,57600,1.00117210393
469384,469391,469397,7,6,1,900,1.3
469394,492132,492138,22738,6,27,8940,2274.4
469542,469548,472423,6,2875,2,18000,1.00208695652
469545,469554,469687,9,133,2,1200,1.06766917293
469594,491720,494403,22126,2683,2,18000,9.24673872531
469650,491725,494543,22075,2818,2,18000,8.83356990774
469665,491730,494558,22065,2828,2,18000,8.80233380481
469689,491796,494687,22107,2891,2,18000,8.64683500519
469691,469697,472434,6,2737,2,18000,1.00219218122
469765,491801,494660,22036,2859,2,18000,8.70759006646
469781,491806,494515,22025,2709,2,18000,9.13030638612
469796,491811,494611,22015,2800,2,18000,8.8625
469811,491816,494485,22005,2669,2,18000,9.24466092169
469813,491821,494612,22008,2791,2,18000,8.88534575421
469814,469820,472588,6,2768,2,18000,1.00216763006
469833,491826,494644,21993,2818,2,18000,8.80447125621
469848,491832,494492,21984,2660,2,18000,9.26466165414
469865,491837,494395,21972,2558,2,18000,9.58952306489
469867,491842,494540,21975,2698,2,18000,9.14492216457
469883,491847,494545,21964,2698,2,18000,9.14084507042
469884,491913,494797,22029,2884,2,18000,8.63834951456
469899,491918,494503,22019,2585,2,18000,9.51798839458
469900,491923,494680,22023,2757,2,18000,8.9880304679
469931,491928,494636,21997,2708,2,18000,9.1229689808
469955,491933,494685,21978,2752,2,18000,8.98619186047
469994,470000,472695,6,2695,2,18000,1.00222634508
469995,491938,494854,21943,2916,2,18000,8.52503429355
469996,491944,494732,21948,2788,2,18000,8.87230989957
469998,470017,470065,19,48,2,1200,1.39583333333
469998,491949,494810,21951,2861,2,18000,8.67249213562
470013,491954,494703,21941,2749,2,18000,8.9814477992
470028,491959,494562,21931,2603,2,18000,9.42527852478
470043,491964,494770,21921,2806,2,18000,8.81218816821
470058,491969,494758,21911,2789,2,18000,8.85622086769
470060,491974,494632,21914,2658,2,18000,9.2445447705
470078,491980,494619,21902,2639,2,18000,9.2993558166
470079,492046,494782,21967,2736,2,18000,9.02887426901
470099,492051,494907,21952,2856,2,18000,8.6862745098
470100,492056,494902,21956,2846,2,18000,8.71468728039
470116,492122,494895,22006,2773,2,18000,8.9358095925
470118,492127,494805,22009,2678,2,18000,9.21844660194
470133,491684,494360,21551,2676,2,18000,9.05343796712
470299,490730,493601,20431,2871,2,18000,8.11633577151
470314,490736,493513,20422,2777,2,18000,8.35397911415
470431,490766,490921,20335,155,2,1200,132.193548387
471800,490761,652502,18961,161741,12,345600,1.11723063416
472429,490741,493511,18312,2770,2,18000,7.61083032491
472444,490746,493508,18302,2762,2,18000,7.6263577118
472590,490751,493367,18161,2616,2,18000,7.94227828746
472696,490756,493606,18060,2850,2,18000,7.33684210526
494970,494976,494982,6,6,1,900,1.2
495873,495879,495883,6,4,1,57600,1.0
495947,495953,495958,6,5,1,57600,1.1
496377,496383,516818,6,20435,4,172800,1.0002936139
496413,496419,507133,6,10714,4,360000,1.00056001493
496430,496436,514980,6,18544,4,360000,1.00032355479
496445,496451,520323,6,23872,4,259200,1.00025134048
496450,496457,518394,7,21937,4,259200,1.00031909559
496454,496463,548598,9,52135,4,259200,1.00017262875
496843,496849,1101667,6,604818,3,604800,1.00000992034
496864,496870,1101676,6,604806,3,604800,1.00000992054
496893,496899,1101726,6,604827,3,604800,1.00000992019
497022,497028,677895,6,180867,1,259200,1.00003317355
497035,497041,678483,6,181442,1,259200,1.00003306842
497041,497047,756297,6,259250,1,259200,1.00002314368
497050,497056,756297,6,259241,1,259200,1.00002314449
497067,497073,756305,6,259232,1,259200,1.00002314529
497361,497367,857376,6,360009,10,360000,1.00001666625
498373,498379,498381,6,2,1,57600,1.0
498759,498765,506222,6,7457,32,43200,1.00080461312
500833,500839,761864,6,261025,1,432000,1.0000229863
504116,504122,504123,6,1,2,300,1.0
507156,507162,540161,6,32999,4,360000,1.00018182369
507651,507657,507661,6,4,2,300,1.0
507670,507676,507706,6,30,2,300,1.2
507842,507848,508099,6,251,2,300,1.02390438247
508107,508114,508135,7,21,2,300,1.33333333333
508142,508148,508190,6,42,2,300,1.14285714286
508185,508191,509156,6,965,16,21600,1.00621761658
508197,508203,508243,6,40,2,300,1.15
508251,508257,508568,6,311,2,300,1.0192926045
508582,508588,508943,6,355,2,360,1.01690140845
508957,508963,509263,6,300,2,360,1.02
509183,509189,509879,6,690,16,21600,1.00869565217
510410,510416,510450,6,34,16,21600,1.17647058824
510467,510474,510508,7,34,16,21600,1.20588235294
510515,510521,510535,6,14,16,21600,1.42857142857
510550,510556,510572,6,16,16,21600,1.375
510670,510676,532382,6,21706,16,21600,1.00027642127
514234,514240,517015,6,2775,2,18000,1.00216216216
514235,514246,517101,11,2855,2,18000,1.00385288967
514237,514251,517063,14,2812,2,18000,1.00497866287
514238,514256,517091,18,2835,2,18000,1.00634920635
514239,514261,517161,22,2900,2,18000,1.0075862069
514241,514266,516906,25,2640,2,18000,1.00946969697
514242,514272,517013,30,2741,2,18000,1.01094491062
514243,514277,516875,34,2598,2,18000,1.01308698999
514245,514282,517054,37,2772,2,18000,1.01334776335
514246,514287,516927,41,2640,2,18000,1.01553030303
514247,514292,517130,45,2838,2,18000,1.01585623679
514249,514297,516966,48,2669,2,18000,1.01798426377
514250,514306,517160,56,2854,2,18000,1.01962158374
514251,514311,517101,60,2790,2,18000,1.02150537634
514253,514317,517156,64,2839,2,18000,1.022543149
514254,514322,517078,68,2756,2,18000,1.02467343977
514255,514327,516975,72,2648,2,18000,1.02719033233
514256,514332,516943,76,2611,2,18000,1.0291076216
514258,514337,517089,79,2752,2,18000,1.02870639535
514259,514343,517152,84,2809,2,18000,1.02990388038
514260,514348,517216,88,2868,2,18000,1.03068340307
514262,514353,517065,91,2712,2,18000,1.03355457227
514263,514358,517120,95,2762,2,18000,1.03439536568
514264,514363,517169,99,2806,2,18000,1.03528153956
514265,514368,517005,103,2637,2,18000,1.03905953735
514267,514373,517206,106,2833,2,18000,1.03741616661
514268,514379,517149,111,2770,2,18000,1.04007220217
514269,514384,517074,115,2690,2,18000,1.04275092937
514270,514389,517206,119,2817,2,18000,1.04224352148
514272,514394,517163,122,2769,2,18000,1.04405922716
514273,514399,517216,126,2817,2,18000,1.0447284345
514274,514404,517076,130,2672,2,18000,1.04865269461
514276,514410,517215,134,2805,2,18000,1.04777183601
514277,514415,517294,138,2879,2,18000,1.04793331018
514278,514420,517227,142,2807,2,18000,1.05058781617
514279,514425,517292,146,2867,2,18000,1.05092431113
514281,514430,517234,149,2804,2,18000,1.05313837375
514282,514435,517184,153,2749,2,18000,1.0556566024
514283,514440,517122,157,2682,2,18000,1.05853840418
514284,514446,517276,162,2830,2,18000,1.05724381625
516875,516886,519650,11,2764,2,18000,1.00397973951
516908,516918,519707,10,2789,2,18000,1.00358551452
516929,516938,519778,9,2840,2,18000,1.00316901408
516943,516954,519818,11,2864,2,18000,1.00384078212
516967,516977,519819,10,2842,2,18000,1.00351864884
516982,516988,519676,6,2688,2,18000,1.00223214286
517008,517017,519756,9,2739,2,18000,1.00328587076
517023,517029,519740,6,2711,2,18000,1.00221320546
517024,517035,519848,11,2813,2,18000,1.00391041593
517055,517065,519657,10,2592,2,18000,1.00385802469
517070,517076,519954,6,2878,2,18000,1.0020847811
517071,517082,519588,11,2506,2,18000,1.00438946528
517085,517092,520040,7,2948,2,18000,1.00237449118
517087,517098,519927,11,2829,2,18000,1.00388829975
517088,517103,519953,15,2850,2,18000,1.00526315789
517102,517109,519921,7,2812,2,18000,1.00248933144
517104,517114,519938,10,2824,2,18000,1.00354107649
517105,517120,519910,15,2790,2,18000,1.00537634409
517106,517125,519876,19,2751,2,18000,1.00690657943
517121,517131,519916,10,2785,2,18000,1.00359066427
517135,517141,520004,6,2863,2,18000,1.00209570381
517136,517147,519854,11,2707,2,18000,1.00406353897
517151,517160,520098,9,2938,2,18000,1.00306330837
517166,517171,519872,5,2701,2,18000,1.00185116623
517167,517177,519857,10,2680,2,18000,1.00373134328
517168,517182,519830,14,2648,2,18000,1.00528700906
517169,517187,520014,18,2827,2,18000,1.00636717368
517171,517192,520054,21,2862,2,18000,1.00733752621
517185,517198,519898,13,2700,2,18000,1.00481481481
517186,517203,519794,17,2591,2,18000,1.00656117329
517207,517217,519899,10,2682,2,18000,1.00372856078
517208,517222,519840,14,2618,2,18000,1.00534759358
517223,517229,520134,6,2905,2,18000,1.00206540448
517224,517235,520101,11,2866,2,18000,1.00383810188
517225,517240,520047,15,2807,2,18000,1.0053437834
517240,517246,520073,6,2827,2,18000,1.00212239123
517241,517252,520060,11,2808,2,18000,1.00391737892
517277,517287,520094,10,2807,2,18000,1.00356252227
517294,517309,520111,15,2802,2,18000,1.00535331906
517295,517303,520041,8,2738,2,18000,1.00292184076
518645,518651,518713,6,62,2,3540,1.09677419355
519591,519599,522478,8,2879,2,18000,1.00277874262
519651,519662,522309,11,2647,2,18000,1.0041556479
519666,519672,522452,6,2780,2,18000,1.00215827338
519681,519687,522429,6,2742,2,18000,1.00218818381
519704,519718,522383,14,2665,2,18000,1.0052532833
519743,519751,522426,8,2675,2,18000,1.00299065421
519758,519768,522497,10,2729,2,18000,1.00366434591
519778,519789,522420,11,2631,2,18000,1.0041809198
519796,519805,522637,9,2832,2,18000,1.0031779661
519819,519829,522523,10,2694,2,18000,1.00371195249
519821,519835,522530,14,2695,2,18000,1.00519480519
519835,519841,522652,6,2811,2,18000,1.00213447172
519850,519856,522468,6,2612,2,18000,1.00229709035
519851,519862,522618,11,2756,2,18000,1.00399129173
519866,519872,522558,6,2686,2,18000,1.00223380491
519867,519878,522562,11,2684,2,18000,1.00409836066
519882,519887,522654,5,2767,2,18000,1.0018070112
519883,519893,522752,10,2859,2,18000,1.00349772648
519900,519909,522782,9,2873,2,18000,1.00313261399
519902,519915,522789,13,2874,2,18000,1.00452331246
519916,519921,522704,5,2783,2,18000,1.00179662235
519917,519928,522789,11,2861,2,18000,1.00384480951
519932,519938,522712,6,2774,2,18000,1.0021629416
519933,519944,522597,11,2653,2,18000,1.00414624953
519948,519954,522540,6,2586,2,18000,1.00232018561
519962,519969,522762,7,2793,2,18000,1.00250626566
519964,519974,522763,10,2789,2,18000,1.00358551452
520005,520016,522701,11,2685,2,18000,1.00409683426
520020,520026,522817,6,2791,2,18000,1.00214976711
520041,520051,522861,10,2810,2,18000,1.00355871886
520055,520061,522786,6,2725,2,18000,1.00220183486
520057,520067,522907,10,2840,2,18000,1.00352112676
520058,520072,522913,14,2841,2,18000,1.00492784231
520073,520078,522669,5,2591,2,18000,1.00192975685
520087,520093,522789,6,2696,2,18000,1.00222551929
520102,520108,522646,6,2538,2,18000,1.00236406619
520103,520114,522812,11,2698,2,18000,1.00407709414
520104,520119,522880,15,2761,2,18000,1.0054328142
520119,520125,522966,6,2841,2,18000,1.00211193242
520137,520145,523080,8,2935,2,18000,1.00272572402
522311,522320,525040,9,2720,2,18000,1.00330882353
522385,522394,525203,9,2809,2,18000,1.00320398718
522423,522432,525133,9,2701,2,18000,1.00333209922
522438,522444,525220,6,2776,2,18000,1.00216138329
522439,522450,525378,11,2928,2,18000,1.0037568306
522454,522463,525215,9,2752,2,18000,1.00327034884
522469,522480,525242,11,2762,2,18000,1.00398262129
522484,522490,525374,6,2884,2,18000,1.00208044383
522499,522508,525330,9,2822,2,18000,1.0031892275
522523,522534,525048,11,2514,2,18000,1.00437549722
522539,522545,525350,6,2805,2,18000,1.00213903743
522554,522560,525415,6,2855,2,18000,1.00210157618
522569,522576,525411,7,2835,2,18000,1.0024691358
522571,522582,525261,11,2679,2,18000,1.00410600971
522600,522608,525443,8,2835,2,18000,1.00282186949
522619,522630,525514,11,2884,2,18000,1.00381414702
522639,522648,525226,9,2578,2,18000,1.00349107836
522655,522661,525496,6,2835,2,18000,1.00211640212
522656,522667,525561,11,2894,2,18000,1.00380096752
522658,522672,525429,14,2757,2,18000,1.00507798332
522673,522680,525478,7,2798,2,18000,1.00250178699
522706,522712,525602,6,2890,2,18000,1.00207612457
522707,522718,525504,11,2786,2,18000,1.00394831299
522723,522729,525586,6,2857,2,18000,1.00210010501
522752,522763,525507,11,2744,2,18000,1.00400874636
522768,522774,525627,6,2853,2,18000,1.00210304942
522769,522780,525453,11,2673,2,18000,1.00411522634
522786,522793,525488,7,2695,2,18000,1.0025974026
522806,522813,525614,7,2801,2,18000,1.00249910746
522808,522819,525524,11,2705,2,18000,1.00406654344
522809,522824,525614,15,2790,2,18000,1.00537634409
522810,522829,525692,19,2863,2,18000,1.00663639539
522825,522835,525469,10,2634,2,18000,1.00379650721
522827,522840,525653,13,2813,2,18000,1.00462140064
522864,522872,525724,8,2852,2,18000,1.00280504909
522882,522891,525647,9,2756,2,18000,1.00326560232
522909,522918,525695,9,2777,2,18000,1.00324090745
522924,522930,525547,6,2617,2,18000,1.00229270157
522969,522978,525831,9,2853,2,18000,1.00315457413
523081,523091,525859,10,2768,2,18000,1.00361271676
525040,525051,527860,11,2809,2,18000,1.00391598434
525055,525061,527881,6,2820,2,18000,1.00212765957
525134,525144,527861,10,2717,2,18000,1.00368053
525204,525214,527895,10,2681,2,18000,1.00372995151
525219,525226,527836,7,2610,2,18000,1.00268199234
525234,525240,528132,6,2892,2,18000,1.0020746888
525235,525246,528032,11,2786,2,18000,1.00394831299
525250,525256,528014,6,2758,2,18000,1.00217548949
525265,525272,528077,7,2805,2,18000,1.00249554367
525333,525342,527980,9,2638,2,18000,1.00341167551
525354,525362,528104,8,2742,2,18000,1.00291757841
525374,525385,527932,11,2547,2,18000,1.00431880644
525389,525395,528274,6,2879,2,18000,1.00208405696
525413,525422,528267,9,2845,2,18000,1.00316344464
525428,525434,528258,6,2824,2,18000,1.00212464589
525443,525449,528205,6,2756,2,18000,1.00217706821
525444,525455,528175,11,2720,2,18000,1.00404411765
525459,525465,528218,6,2753,2,18000,1.00217944061
525474,525479,528207,5,2728,2,18000,1.00183284457
525492,525498,528296,6,2798,2,18000,1.00214438885
525493,525504,528271,11,2767,2,18000,1.00397542465
525508,525514,528393,6,2879,2,18000,1.00208405696
525510,525520,528331,10,2811,2,18000,1.00355745286
525511,525525,528247,14,2722,2,18000,1.005143277
525525,525531,528415,6,2884,2,18000,1.00208044383
525527,525537,528334,10,2797,2,18000,1.00357525921
525548,525558,528285,10,2727,2,18000,1.00366703337
525563,525573,528355,10,2782,2,18000,1.0035945363
525587,525597,528319,10,2722,2,18000,1.00367376929
525605,525613,528478,8,2865,2,18000,1.00279232112
525620,525626,528429,6,2803,2,18000,1.00214056368
525621,525632,528424,11,2792,2,18000,1.00393982808
525636,525642,528378,6,2736,2,18000,1.00219298246
525651,525657,528433,6,2776,2,18000,1.00216138329
525666,525672,528464,6,2792,2,18000,1.00214899713
525693,525703,528466,10,2763,2,18000,1.00361925443
525708,525714,528527,6,2813,2,18000,1.00213295414
525726,525735,528577,9,2842,2,18000,1.00316678395
525832,525842,528584,10,2742,2,18000,1.00364697301
525862,525870,528661,8,2791,2,18000,1.00286635614
527288,527294,527410,6,116,32,43200,1.05172413793
527547,527553,527626,6,73,32,43200,1.08219178082
527837,527847,530602,10,2755,2,18000,1.00362976407
527860,527871,530626,11,2755,2,18000,1.00399274047
527875,527881,530544,6,2663,2,18000,1.00225309801
527890,527896,530649,6,2753,2,18000,1.00217944061
527904,527910,530591,6,2681,2,18000,1.00223797091
527934,527943,530759,9,2816,2,18000,1.00319602273
527983,527991,530791,8,2800,2,18000,1.00285714286
528020,528025,530861,5,2836,2,18000,1.00176304654
528035,528043,530706,8,2663,2,18000,1.00300413068
528079,528088,530887,9,2799,2,18000,1.00321543408
528106,528115,530794,9,2679,2,18000,1.00335946249
528130,528137,529466,7,1329,16,36000,1.00526711813
528133,528143,530846,10,2703,2,18000,1.00369959304
528176,528186,531009,10,2823,2,18000,1.00354233085
528206,528216,531068,10,2852,2,18000,1.00350631136
528221,528227,531076,6,2849,2,18000,1.00210600211
528222,528233,530984,11,2751,2,18000,1.00399854598
528249,528258,530861,9,2603,2,18000,1.00345754898
528264,528270,530989,6,2719,2,18000,1.00220669364
528279,528285,531019,6,2734,2,18000,1.00219458669
528280,528291,531073,11,2782,2,18000,1.00395398994
528282,528296,531203,14,2907,2,18000,1.00481596147
528297,528302,531060,5,2758,2,18000,1.0018129079
528298,528308,531084,10,2776,2,18000,1.00360230548
528322,528330,531129,8,2799,2,18000,1.00285816363
528337,528343,531050,6,2707,2,18000,1.0022164758
528338,528349,531151,11,2802,2,18000,1.00392576731
528356,528366,531059,10,2693,2,18000,1.00371333086
528380,528389,531157,9,2768,2,18000,1.00325144509
528395,528405,531052,10,2647,2,18000,1.00377786173
528418,528427,531126,9,2699,2,18000,1.00333456836
528434,528440,531250,6,2810,2,18000,1.00213523132
528435,528446,531190,11,2744,2,18000,1.00400874636
528437,528451,531174,14,2723,2,18000,1.00514138817
528467,528474,531353,7,2879,2,18000,1.00243139979
528469,528480,531176,11,2696,2,18000,1.00408011869
528484,528490,531341,6,2851,2,18000,1.00210452473
528530,528538,531376,8,2838,2,18000,1.00281888654
528578,528589,531283,11,2694,2,18000,1.00408314774
528593,528599,531288,6,2689,2,18000,1.00223131276
528663,528672,531322,9,2650,2,18000,1.00339622642
530549,530555,533211,6,2656,2,18000,1.00225903614
530592,530602,533255,10,2653,2,18000,1.00376931775
530607,530613,533370,6,2757,2,18000,1.00217627856
530629,530637,533497,8,2860,2,18000,1.0027972028
530653,530661,533215,8,2554,2,18000,1.00313234143
530708,530717,533566,9,2849,2,18000,1.00315900316
530760,530770,533573,10,2803,2,18000,1.00356760614
530793,530802,533641,9,2839,2,18000,1.00317013033
530808,530814,533651,6,2837,2,18000,1.00211491012
530847,530857,533687,10,2830,2,18000,1.0035335689
530863,530871,533728,8,2857,2,18000,1.00280014001
530864,530877,533603,13,2726,2,18000,1.00476889215
530888,530898,533783,10,2885,2,18000,1.00346620451
530986,530996,533852,10,2856,2,18000,1.00350140056
531001,531007,533648,6,2641,2,18000,1.00227186672
531017,531023,533711,6,2688,2,18000,1.00223214286
531032,531038,533840,6,2802,2,18000,1.00214132762
531053,531063,533853,10,2790,2,18000,1.00358422939
531055,531068,533701,13,2633,2,18000,1.00493733384
531070,531077,533745,7,2668,2,18000,1.00262368816
531072,531082,533920,10,2838,2,18000,1.00352360817
531073,531088,533917,15,2829,2,18000,1.00530222694
531088,531094,533889,6,2795,2,18000,1.00214669052
531089,531100,533846,11,2746,2,18000,1.00400582666
531091,531105,533871,14,2766,2,18000,1.00506146059
531127,531137,533903,10,2766,2,18000,1.00361532899
531145,531151,533770,6,2619,2,18000,1.00229095074
531160,531166,534031,6,2865,2,18000,1.00209424084
531161,531172,534010,11,2838,2,18000,1.00387596899
531176,531185,533805,9,2620,2,18000,1.0034351145
531177,531191,533986,14,2795,2,18000,1.00500894454
531193,531201,534016,8,2815,2,18000,1.00284191829
531208,531213,533934,5,2721,2,18000,1.00183755972
531250,531261,534068,11,2807,2,18000,1.00391877449
531285,531294,534105,9,2811,2,18000,1.00320170758
531300,531306,533973,6,2667,2,18000,1.00224971879
531324,531334,534080,10,2746,2,18000,1.0036416606
531342,531352,534017,10,2665,2,18000,1.00375234522
531357,531364,534055,7,2691,2,18000,1.00260126347
531378,531387,534273,9,2886,2,18000,1.00311850312
533219,533225,536060,6,2835,2,18000,1.00211640212
533220,533231,535971,11,2740,2,18000,1.00401459854
533257,533266,536046,9,2780,2,18000,1.00323741007
533372,533381,536109,9,2728,2,18000,1.00329912023
533501,533508,536342,7,2834,2,18000,1.00247000706
533568,533577,536296,9,2719,2,18000,1.00331004046
533583,533589,536261,6,2672,2,18000,1.00224550898
533607,533615,536383,8,2768,2,18000,1.00289017341
533644,533652,536488,8,2836,2,18000,1.00282087447
533659,533664,536098,5,2434,2,18000,1.00205423172
533660,533670,536328,10,2658,2,18000,1.00376222724
533688,533698,536365,10,2667,2,18000,1.00374953131
533703,533712,536382,9,2670,2,18000,1.00337078652
533718,533725,536661,7,2936,2,18000,1.00238419619
533734,533739,536507,5,2768,2,18000,1.00180635838
533749,533756,536546,7,2790,2,18000,1.00250896057
533773,533781,536547,8,2766,2,18000,1.0028922632
533788,533793,536563,5,2770,2,18000,1.00180505415
533810,533815,536614,5,2799,2,18000,1.00178635227
533844,533851,536638,7,2787,2,18000,1.00251166128
533860,533866,536697,6,2831,2,18000,1.00211939244
533861,533872,536664,11,2792,2,18000,1.00393982808
533862,533877,536712,15,2835,2,18000,1.00529100529
533877,533883,536713,6,2830,2,18000,1.00212014134
533892,533900,536774,8,2874,2,18000,1.0027835769
533907,533913,536701,6,2788,2,18000,1.00215208034
533923,533929,536683,6,2754,2,18000,1.00217864924
533924,533935,536781,11,2846,2,18000,1.00386507379
533939,533945,536773,6,2828,2,18000,1.00212164074
533976,533984,536845,8,2861,2,18000,1.0027962251
533991,533996,536849,5,2853,2,18000,1.00175254118
534012,534021,536774,9,2753,2,18000,1.00326916092
534027,534033,536835,6,2802,2,18000,1.00214132762
534028,534039,536806,11,2767,2,18000,1.00397542465
534043,534049,536932,6,2883,2,18000,1.00208116545
534058,534066,536864,8,2798,2,18000,1.00285918513
534073,534079,536898,6,2819,2,18000,1.00212841433
534089,534095,536945,6,2850,2,18000,1.00210526316
534108,534116,536749,8,2633,2,18000,1.00303835929
534275,534284,536979,9,2695,2,18000,1.00333951763
535979,535985,538762,6,2777,2,18000,1.00216060497
536050,536057,538822,7,2765,2,18000,1.00253164557
536065,536071,538831,6,2760,2,18000,1.00217391304
536102,536110,538853,8,2743,2,18000,1.00291651476
536117,536123,538867,6,2744,2,18000,1.00218658892
536263,536272,539069,9,2797,2,18000,1.00321773329
536297,536308,539121,11,2813,2,18000,1.00391041593
536330,536339,539054,9,2715,2,18000,1.00331491713
536345,536354,539050,9,2696,2,18000,1.00333827893
536367,536376,539190,9,2814,2,18000,1.00319829424
536385,536393,539234,8,2841,2,18000,1.00281590989
536386,536399,539035,13,2636,2,18000,1.00493171472
536402,536408,536506,6,98,1,1800,1.0612244898
536490,536499,539315,9,2816,2,18000,1.00319602273
536509,536518,539356,9,2838,2,18000,1.00317124736
536549,536557,539284,8,2727,2,18000,1.0029336267
536551,536563,539305,12,2742,2,18000,1.00437636761
536565,536574,539213,9,2639,2,18000,1.00341038272
536618,536625,539265,7,2640,2,18000,1.00265151515
536639,536649,539374,10,2725,2,18000,1.00366972477
536664,536672,539470,8,2798,2,18000,1.00285918513
536680,536686,539499,6,2813,2,18000,1.00213295414
536694,536701,539469,7,2768,2,18000,1.00252890173
536710,536716,539517,6,2801,2,18000,1.00214209211
536711,536722,539347,11,2625,2,18000,1.00419047619
536726,536732,539375,6,2643,2,18000,1.00227014756
536727,536738,539556,11,2818,2,18000,1.00390347764
536751,536760,539477,9,2717,2,18000,1.003312477
536776,536784,539448,8,2664,2,18000,1.003003003
536777,536790,539472,13,2682,2,18000,1.00484712901
536778,536795,539573,17,2778,2,18000,1.00611951044
536793,536801,539500,8,2699,2,18000,1.00296406076
536796,536807,536909,11,102,1,1800,1.10784313725
536808,536818,539633,10,2815,2,18000,1.00355239787
536836,536846,539537,10,2691,2,18000,1.00371609067
536852,536858,539643,6,2785,2,18000,1.00215439856
536854,536864,539657,10,2793,2,18000,1.00358037952
536868,536875,539588,7,2713,2,18000,1.00258016955
536899,536909,539629,10,2720,2,18000,1.00367647059
536933,536943,539805,10,2862,2,18000,1.0034940601
536948,536957,539469,9,2512,2,18000,1.00358280255
536982,536990,539776,8,2786,2,18000,1.00287150036
537505,537511,538005,6,494,1,1800,1.01214574899
538769,538775,541441,6,2666,2,18000,1.00225056264
538829,538835,541471,6,2636,2,18000,1.00227617602
538844,538850,541646,6,2796,2,18000,1.00214592275
538859,538865,541586,6,2721,2,18000,1.00220507166
538874,538880,541703,6,2823,2,18000,1.00212539851
539038,539046,541780,8,2734,2,18000,1.00292611558
539053,539061,541859,8,2798,2,18000,1.00285918513
539067,539073,541826,6,2753,2,18000,1.00217944061
539082,539088,541913,6,2825,2,18000,1.00212389381
539121,539132,541829,11,2697,2,18000,1.00407860586
539191,539202,541941,11,2739,2,18000,1.00401606426
539215,539224,541825,9,2601,2,18000,1.00346020761
539237,539245,542173,8,2928,2,18000,1.00273224044
539267,539276,541937,9,2661,2,18000,1.00338218715
539285,539295,542032,10,2737,2,18000,1.00365363537
539306,539316,542096,10,2780,2,18000,1.0035971223
539321,539327,542076,6,2749,2,18000,1.00218261186
539348,539358,541933,10,2575,2,18000,1.00388349515
539363,539369,542127,6,2758,2,18000,1.00217548949
539378,539385,542014,7,2629,2,18000,1.00266260936
539379,539391,542048,12,2657,2,18000,1.00451637185
539449,539459,542194,10,2735,2,18000,1.00365630713
539471,539480,542117,9,2637,2,18000,1.00341296928
539472,539486,542181,14,2695,2,18000,1.00519480519
539474,539491,542287,17,2796,2,18000,1.00608011445
539475,539496,542047,21,2551,2,18000,1.00823206586
539490,539502,542205,12,2703,2,18000,1.00443951165
539504,539510,542141,6,2631,2,18000,1.00228050171
539506,539516,542354,10,2838,2,18000,1.00352360817
539521,539528,542315,7,2787,2,18000,1.00251166128
539539,539549,542415,10,2866,2,18000,1.00348918353
539557,539567,542341,10,2774,2,18000,1.00360490267
539575,539584,542425,9,2841,2,18000,1.00316789863
539590,539599,542276,9,2677,2,18000,1.00336197236
539629,539640,542495,11,2855,2,18000,1.00385288967
539644,539654,542603,10,2949,2,18000,1.00339097999
539646,539659,542278,13,2619,2,18000,1.00496372661
539661,539668,542417,7,2749,2,18000,1.0025463805
539705,539711,539748,6,37,1,1800,1.16216216216
539784,539790,542727,6,2937,2,18000,1.00204290092
539808,539816,542621,8,2805,2,18000,1.00285204991
540059,540066,540132,7,66,1,1800,1.10606060606
540971,540977,541222,6,245,1,1800,1.02448979592
541450,541456,544360,6,2904,2,18000,1.0020661157
541475,541482,544334,7,2852,2,18000,1.00245441795
541587,541598,544374,11,2776,2,18000,1.00396253602
541650,541657,544086,7,2429,2,18000,1.00288184438
541705,541714,544471,9,2757,2,18000,1.00326441785
541781,541792,544594,11,2802,2,18000,1.00392576731
541828,541836,544520,8,2684,2,18000,1.00298062593
541829,541842,544456,13,2614,2,18000,1.00497322112
541844,541850,544447,6,2597,2,18000,1.00231035811
541862,541870,544598,8,2728,2,18000,1.00293255132
541914,541924,544596,10,2672,2,18000,1.00374251497
541936,541945,544666,9,2721,2,18000,1.0033076075
541937,541951,544771,14,2820,2,18000,1.00496453901
541952,541958,544722,6,2764,2,18000,1.002170767
542017,542027,544674,10,2647,2,18000,1.00377786173
542034,542043,544825,9,2782,2,18000,1.00323508267
542049,542058,544875,9,2817,2,18000,1.00319488818
542051,542064,544868,13,2804,2,18000,1.00463623395
542078,542087,544973,9,2886,2,18000,1.00311850312
542099,542107,544818,8,2711,2,18000,1.00295094061
542120,542128,544945,8,2817,2,18000,1.0028399006
542135,542141,544981,6,2840,2,18000,1.00211267606
542150,542157,544988,7,2831,2,18000,1.00247262451
542175,542184,544924,9,2740,2,18000,1.00328467153
542190,542196,545058,6,2862,2,18000,1.00209643606
542205,542211,544978,6,2767,2,18000,1.00216841344
542206,542217,544932,11,2715,2,18000,1.00405156538
542277,542287,544978,10,2691,2,18000,1.00371609067
542292,542298,544762,6,2464,2,18000,1.00243506494
542293,542304,545008,11,2704,2,18000,1.00406804734
542318,542326,545103,8,2777,2,18000,1.00288080663
542342,542352,545195,10,2843,2,18000,1.00351741119
542357,542365,545136,8,2771,2,18000,1.00288704439
542418,542427,545157,9,2730,2,18000,1.0032967033
542419,542433,545235,14,2802,2,18000,1.00499643112
542435,542441,545242,6,2801,2,18000,1.00214209211
542495,542506,545336,11,2830,2,18000,1.0038869258
542606,542614,545298,8,2684,2,18000,1.00298062593
542625,542632,545312,7,2680,2,18000,1.0026119403
542729,542738,545416,9,2678,2,18000,1.00336071695
544088,544097,546748,9,2651,2,18000,1.0033949453
544336,544345,547024,9,2679,2,18000,1.00335946249
544364,544371,547124,7,2753,2,18000,1.00254268071
544381,544387,547186,6,2799,2,18000,1.00214362272
544449,544458,547267,9,2809,2,18000,1.00320398718
544465,544471,547208,6,2737,2,18000,1.00219218122
544479,544485,547321,6,2836,2,18000,1.00211565585
544522,544531,547292,9,2761,2,18000,1.00325968852
544595,544606,547377,11,2771,2,18000,1.00396968603
544597,544612,547249,15,2637,2,18000,1.00568828214
544612,544618,547402,6,2784,2,18000,1.00215517241
544669,544677,547535,8,2858,2,18000,1.00279916025
544685,544691,547467,6,2776,2,18000,1.00216138329
544726,544734,547509,8,2775,2,18000,1.00288288288
544765,544773,547587,8,2814,2,18000,1.00284292822
544781,544787,547471,6,2684,2,18000,1.00223546945
544826,544832,547669,6,2837,2,18000,1.00211491012
544827,544838,547579,11,2741,2,18000,1.00401313389
544870,544879,547707,9,2828,2,18000,1.0031824611
544885,544891,547747,6,2856,2,18000,1.00210084034
544925,544935,547622,10,2687,2,18000,1.00372162263
544940,544946,547622,6,2676,2,18000,1.00224215247
544955,544961,547610,6,2649,2,18000,1.00226500566
544977,544984,547523,7,2539,2,18000,1.00275699094
544992,544998,547817,6,2819,2,18000,1.00212841433
544993,545004,547577,11,2573,2,18000,1.00427516518
544994,545009,547816,15,2807,2,18000,1.0053437834
544995,545014,547786,19,2772,2,18000,1.00685425685
545011,545020,547685,9,2665,2,18000,1.00337711069
545060,545070,547890,10,2820,2,18000,1.00354609929
545105,545114,547830,9,2716,2,18000,1.00331369661
545139,545147,547925,8,2778,2,18000,1.00287976962
545160,545168,547990,8,2822,2,18000,1.00283486889
545196,545206,548123,10,2917,2,18000,1.00342817964
545239,545247,547989,8,2742,2,18000,1.00291757841
545254,545260,548097,6,2837,2,18000,1.00211491012
545299,545309,548084,10,2775,2,18000,1.0036036036
545314,545323,548213,9,2890,2,18000,1.00311418685
545338,545347,547946,9,2599,2,18000,1.00346287033
545418,545427,548227,9,2800,2,18000,1.00321428571
546752,546760,549521,8,2761,2,18000,1.00289750091
546976,546982,547019,6,37,1,1800,1.16216216216
547027,547035,549956,8,2921,2,18000,1.00273878809
547127,547135,549970,8,2835,2,18000,1.00282186949
547188,547197,550006,9,2809,2,18000,1.00320398718
547209,547220,550003,11,2783,2,18000,1.00395256917
547252,547260,549813,8,2553,2,18000,1.00313356835
547270,547279,550065,9,2786,2,18000,1.0032304379
547288,547294,547364,6,70,1,1800,1.08571428571
547295,547303,550185,8,2882,2,18000,1.0027758501
547322,547332,550132,10,2800,2,18000,1.00357142857
547380,547389,550159,9,2770,2,18000,1.00324909747
547404,547413,550096,9,2683,2,18000,1.00335445397
547468,547478,550236,10,2758,2,18000,1.00362581581
547483,547489,550171,6,2682,2,18000,1.00223713647
547510,547520,550353,10,2833,2,18000,1.00352982704
547525,547534,550356,9,2822,2,18000,1.0031892275
547540,547546,550286,6,2740,2,18000,1.00218978102
547580,547590,550440,10,2850,2,18000,1.00350877193
547582,547595,550152,13,2557,2,18000,1.00508408291
547597,547603,550406,6,2803,2,18000,1.00214056368
547612,547621,550317,9,2696,2,18000,1.00333827893
547627,547633,550432,6,2799,2,18000,1.00214362272
547628,547639,550484,11,2845,2,18000,1.00386643234
547671,547681,550343,10,2662,2,18000,1.003756574
547686,547696,550384,10,2688,2,18000,1.0037202381
547710,547718,550480,8,2762,2,18000,1.00289645185
547751,547758,550407,7,2649,2,18000,1.00264250661
547787,547797,550589,10,2792,2,18000,1.00358166189
547818,547833,550639,15,2806,2,18000,1.00534568781
547819,547827,550487,8,2660,2,18000,1.0030075188
547834,547841,550510,7,2669,2,18000,1.00262270513
547862,547868,548094,6,226,1,1800,1.02654867257
547892,547902,550717,10,2815,2,18000,1.00355239787
547928,547936,550777,8,2841,2,18000,1.00281590989
547949,547958,550692,9,2734,2,18000,1.00329188003
547992,548001,550830,9,2829,2,18000,1.00318133616
547994,548006,550621,12,2615,2,18000,1.00458891013
548086,548095,550862,9,2767,2,18000,1.00325262017
548100,548108,550811,8,2703,2,18000,1.00295967444
548125,548134,550822,9,2688,2,18000,1.00334821429
548217,548224,551020,7,2796,2,18000,1.00250357654
548232,548238,550996,6,2758,2,18000,1.00217548949
549381,549387,549410,6,23,1,1800,1.26086956522
549522,549532,552290,10,2758,2,18000,1.00362581581
549703,549709,549761,6,52,1,1800,1.11538461538
549815,549825,552401,10,2576,2,18000,1.00388198758
549958,549967,552519,9,2552,2,18000,1.00352664577
549974,549981,552856,7,2875,2,18000,1.00243478261
550004,550014,552875,10,2861,2,18000,1.00349528137
550019,550025,552881,6,2856,2,18000,1.00210084034
550068,550076,552890,8,2814,2,18000,1.00284292822
550099,550107,552993,8,2886,2,18000,1.00277200277
550135,550143,552835,8,2692,2,18000,1.0029717682
550154,550164,552897,10,2733,2,18000,1.0036589828
550169,550175,553099,6,2924,2,18000,1.00205198358
550183,550190,552857,7,2667,2,18000,1.00262467192
550198,550205,552818,7,2613,2,18000,1.00267891313
550238,550247,553032,9,2785,2,18000,1.00323159785
550286,550297,552928,11,2631,2,18000,1.0041809198
550320,550328,553134,8,2806,2,18000,1.0028510335
550344,550354,553077,10,2723,2,18000,1.00367242012
550359,550365,553180,6,2815,2,18000,1.00213143872
550360,550371,553102,11,2731,2,18000,1.00402782863
550387,550395,553157,8,2762,2,18000,1.00289645185
550409,550423,552970,14,2547,2,18000,1.00549666274
550410,550417,553147,7,2730,2,18000,1.00256410256
550435,550443,553271,8,2828,2,18000,1.00282885431
550450,550456,553350,6,2894,2,18000,1.00207325501
550480,550486,550606,6,120,1,1800,1.05
550484,550492,553282,8,2790,2,18000,1.00286738351
550485,550498,553220,13,2722,2,18000,1.00477590007
550500,550507,553351,7,2844,2,18000,1.00246132208
550515,550521,553303,6,2782,2,18000,1.00215672178
550592,550600,553446,8,2846,2,18000,1.00281096275
550623,550632,553428,9,2796,2,18000,1.00321888412
550641,550650,553476,9,2826,2,18000,1.00318471338
550693,550703,553334,10,2631,2,18000,1.00380083618
550722,550727,553475,5,2748,2,18000,1.00181950509
550779,550788,553582,9,2794,2,18000,1.00322118826
550813,550822,553591,9,2769,2,18000,1.00325027086
550828,550834,553548,6,2714,2,18000,1.00221075903
550843,550849,553764,6,2915,2,18000,1.00205831904
550864,550873,553549,9,2676,2,18000,1.0033632287
550998,551007,553753,9,2746,2,18000,1.00327749454
551022,551031,553926,9,2895,2,18000,1.00310880829
552292,552302,554974,10,2672,2,18000,1.00374251497
552402,552412,555088,10,2676,2,18000,1.00373692078
552522,552530,555243,8,2713,2,18000,1.0029487652
552820,552830,555724,10,2894,2,18000,1.00345542502
552838,552846,555652,8,2806,2,18000,1.0028510335
552859,552868,555681,9,2813,2,18000,1.00319943121
552861,552873,555626,12,2753,2,18000,1.00435888122
552879,552886,555627,7,2741,2,18000,1.00255381248
552894,552900,555680,6,2780,2,18000,1.00215827338
552895,552906,555722,11,2816,2,18000,1.00390625
552910,552916,555777,6,2861,2,18000,1.00209716882
552933,552939,555739,6,2800,2,18000,1.00214285714
552973,552981,555759,8,2778,2,18000,1.00287976962
552994,553005,555823,11,2818,2,18000,1.00390347764
553034,553043,555874,9,2831,2,18000,1.00317908866
553080,553088,555675,8,2587,2,18000,1.003092385
553101,553110,555910,9,2800,2,18000,1.00321428571
553116,553123,555877,7,2754,2,18000,1.00254175744
553138,553146,555889,8,2743,2,18000,1.00291651476
553153,553159,555913,6,2754,2,18000,1.00217864924
553168,553174,555825,6,2651,2,18000,1.00226329687
553183,553192,555838,9,2646,2,18000,1.00340136054
553223,553231,556015,8,2784,2,18000,1.00287356322
553275,553282,556078,7,2796,2,18000,1.00250357654
553290,553296,556043,6,2747,2,18000,1.00218420095
553305,553314,556167,9,2853,2,18000,1.00315457413
553336,553346,556192,10,2846,2,18000,1.00351370344
553354,553361,556014,7,2653,2,18000,1.00263852243
553355,553367,556153,12,2786,2,18000,1.00430725054
553432,553439,556298,7,2859,2,18000,1.00244840853
553447,553457,556291,10,2834,2,18000,1.00352858151
553478,553492,556214,14,2722,2,18000,1.005143277
553479,553486,556149,7,2663,2,18000,1.00262861434
553549,553559,556212,10,2653,2,18000,1.00376931775
553551,553565,556452,14,2887,2,18000,1.00484932456
553585,553593,556428,8,2835,2,18000,1.00282186949
553600,553606,556478,6,2872,2,18000,1.00208913649
553756,553764,556655,8,2891,2,18000,1.00276720858
553772,553778,556626,6,2848,2,18000,1.00210674157
553928,553937,556736,9,2799,2,18000,1.00321543408
554977,554985,557723,8,2738,2,18000,1.00292184076
555091,555100,557853,9,2753,2,18000,1.00326916092
555245,555255,558062,10,2807,2,18000,1.00356252227
555630,555638,558274,8,2636,2,18000,1.00303490137
555631,555643,558438,12,2795,2,18000,1.00429338104
555655,555664,558420,9,2756,2,18000,1.00326560232
555677,555686,558394,9,2708,2,18000,1.00332348597
555692,555698,558368,6,2670,2,18000,1.00224719101
555693,555704,558536,11,2832,2,18000,1.00388418079
555723,555733,558538,10,2805,2,18000,1.00356506239
555739,555745,558549,6,2804,2,18000,1.00213980029
555740,555751,558620,11,2869,2,18000,1.00383408853
555761,555770,558565,9,2795,2,18000,1.00322003578
555779,555789,558601,10,2812,2,18000,1.00355618777
555825,555834,558715,9,2881,2,18000,1.00312391531
555840,555846,558621,6,2775,2,18000,1.00216216216
555841,555852,558574,11,2722,2,18000,1.00404114622
555875,555885,558598,10,2713,2,18000,1.00368595651
555890,555896,558693,6,2797,2,18000,1.00214515552
555891,555902,558640,11,2738,2,18000,1.00401753104
555914,555924,558741,10,2817,2,18000,1.00354987575
555915,555929,558686,14,2757,2,18000,1.00507798332
556016,556025,558895,9,2870,2,18000,1.0031358885
556017,556031,558847,14,2816,2,18000,1.00497159091
556045,556055,558904,10,2849,2,18000,1.00351000351
556081,556089,558874,8,2785,2,18000,1.00287253142
556152,556161,558946,9,2785,2,18000,1.00323159785
556167,556174,558929,7,2755,2,18000,1.00254083485
556169,556180,558953,11,2773,2,18000,1.00396682294
556193,556203,559073,10,2870,2,18000,1.00348432056
556214,556223,559021,9,2798,2,18000,1.00321658327
556216,556229,558967,13,2738,2,18000,1.00474799123
556293,556302,559169,9,2867,2,18000,1.00313916986
556308,556314,559154,6,2840,2,18000,1.00211267606
556431,556439,559223,8,2784,2,18000,1.00287356322
556455,556463,559111,8,2648,2,18000,1.00302114804
556480,556489,559269,9,2780,2,18000,1.00323741007
556629,556637,559416,8,2779,2,18000,1.00287873336
556657,556667,559459,10,2792,2,18000,1.00358166189
556739,556747,559467,8,2720,2,18000,1.00294117647
557726,557735,560518,9,2783,2,18000,1.00323392023
557855,557865,560587,10,2722,2,18000,1.00367376929
558065,558073,560837,8,2764,2,18000,1.00289435601
558276,558285,561064,9,2779,2,18000,1.00323857503
558371,558379,561081,8,2702,2,18000,1.0029607698
558395,558406,561140,11,2734,2,18000,1.00402340892
558423,558432,561257,9,2825,2,18000,1.00318584071
558441,558450,561172,9,2722,2,18000,1.00330639236
558540,558549,561336,9,2787,2,18000,1.00322927879
558541,558554,561361,13,2807,2,18000,1.00463127895
558556,558562,561304,6,2742,2,18000,1.00218818381
558571,558577,561337,6,2760,2,18000,1.00217391304
558587,558593,561257,6,2664,2,18000,1.00225225225
558604,558611,561308,7,2697,2,18000,1.00259547646
558606,558617,561458,11,2841,2,18000,1.0038718761
558621,558631,561535,10,2904,2,18000,1.00344352617
558635,558642,561332,7,2690,2,18000,1.00260223048
558651,558657,561225,6,2568,2,18000,1.0023364486
558687,558697,561409,10,2712,2,18000,1.00368731563
558702,558709,561553,7,2844,2,18000,1.00246132208
558717,558726,561335,9,2609,2,18000,1.00344959755
558742,558752,561449,10,2697,2,18000,1.00370782351
558849,558858,561633,9,2775,2,18000,1.00324324324
558876,558886,561790,10,2904,2,18000,1.00344352617
558897,558906,561713,9,2807,2,18000,1.00320627004
558913,558919,561770,6,2851,2,18000,1.00210452473
558931,558941,561719,10,2778,2,18000,1.00359971202
558949,558957,561837,8,2880,2,18000,1.00277777778
558964,558970,561853,6,2883,2,18000,1.00208116545
558979,558985,561765,6,2780,2,18000,1.00215827338
559022,559032,561760,10,2728,2,18000,1.00366568915
559077,559084,561962,7,2878,2,18000,1.00243224461
559114,559122,561575,8,2453,2,18000,1.00326131268
559157,559165,561863,8,2698,2,18000,1.00296515938
559173,559180,562026,7,2846,2,18000,1.00245959241
559225,559235,562072,10,2837,2,18000,1.00352485019
559270,559280,562008,10,2728,2,18000,1.00366568915
559417,559427,562159,10,2732,2,18000,1.00366032211
559463,559470,562262,7,2792,2,18000,1.00250716332
559478,559484,562340,6,2856,2,18000,1.00210084034
560520,560529,563193,9,2664,2,18000,1.00337837838
560590,560598,563410,8,2812,2,18000,1.00284495021
560840,560848,563419,8,2571,2,18000,1.00311162972
561066,561075,563791,9,2716,2,18000,1.00331369661
561084,561092,563784,8,2692,2,18000,1.0029717682
561142,561151,563933,9,2782,2,18000,1.00323508267
561173,561183,563967,10,2784,2,18000,1.00359195402
561228,561236,563871,8,2635,2,18000,1.00303605313
561258,561268,564068,10,2800,2,18000,1.00357142857
561259,561273,564066,14,2793,2,18000,1.00501253133
561305,561315,564095,10,2780,2,18000,1.0035971223
561320,561326,564121,6,2795,2,18000,1.00214669052
561336,561346,564107,10,2761,2,18000,1.00362187613
561337,561351,564062,14,2711,2,18000,1.00516414607
561353,561359,564157,6,2798,2,18000,1.00214438885
561354,561365,564165,11,2800,2,18000,1.00392857143
561369,561376,563992,7,2616,2,18000,1.00267584098
561410,561420,564156,10,2736,2,18000,1.00365497076
561452,561460,564256,8,2796,2,18000,1.00286123033
561468,561474,564148,6,2674,2,18000,1.00224382947
561483,561489,561490,6,1,1,10,1.0
561539,561547,564293,8,2746,2,18000,1.00291332848
561554,561564,564251,10,2687,2,18000,1.00372162263
561576,561586,564230,10,2644,2,18000,1.00378214826
561593,561599,565227,6,3628,32,43200,1.00165380375
561634,561644,564536,10,2892,2,18000,1.00345781466
561716,561724,564509,8,2785,2,18000,1.00287253142
561731,561737,564586,6,2849,2,18000,1.00210600211
561761,561772,564626,11,2854,2,18000,1.00385423966
561777,561783,564593,6,2810,2,18000,1.00213523132
561779,561789,564655,10,2866,2,18000,1.00348918353
561796,561803,564572,7,2769,2,18000,1.00252798844
561839,561848,564619,9,2771,2,18000,1.00324792494
561854,561865,564604,11,2739,2,18000,1.00401606426
561870,561876,564499,6,2623,2,18000,1.00228745711
561966,561973,564771,7,2798,2,18000,1.00250178699
562011,562020,564857,9,2837,2,18000,1.00317236517
562029,562038,564907,9,2869,2,18000,1.00313698153
562075,562083,564951,8,2868,2,18000,1.00278940028
562160,562171,564873,11,2702,2,18000,1.00407105848
562265,562274,565041,9,2767,2,18000,1.00325262017
562342,562351,565176,9,2825,2,18000,1.00318584071
562522,562528,562599,6,71,16,36000,1.08450704225
562796,562802,562805,6,3,16,36000,1.0
562868,562874,562981,6,107,16,36000,1.05607476636
562907,562913,599022,6,36109,16,36000,1.00016616356
563195,563204,565845,9,2641,2,18000,1.00340780008
563411,563421,566127,10,2706,2,18000,1.0036954915
563426,563432,566271,6,2839,2,18000,1.00211342022
563787,563796,566614,9,2818,2,18000,1.00319375444
563802,563808,566573,6,2765,2,18000,1.00216998192
563872,563883,566607,11,2724,2,18000,1.00403817915
563934,563944,566764,10,2820,2,18000,1.00354609929
563970,563979,566731,9,2752,2,18000,1.00327034884
563995,564003,566839,8,2836,2,18000,1.00282087447
564063,564073,566902,10,2829,2,18000,1.00353481796
564078,564084,566875,6,2791,2,18000,1.00214976711
564079,564090,566658,11,2568,2,18000,1.0042834891
564098,564106,566752,8,2646,2,18000,1.00302343159
564113,564119,566762,6,2643,2,18000,1.00227014756
564128,564134,566821,6,2687,2,18000,1.00223297358
564149,564159,566759,10,2600,2,18000,1.00384615385
564164,564170,566908,6,2738,2,18000,1.00219138057
564165,564175,567016,10,2841,2,18000,1.00351988736
564180,564186,566997,6,2811,2,18000,1.00213447172
564232,564242,567119,10,2877,2,18000,1.00347584289
564253,564262,567070,9,2808,2,18000,1.00320512821
564268,564274,566846,6,2572,2,18000,1.00233281493
564296,564304,567090,8,2786,2,18000,1.00287150036
564500,564510,567327,10,2817,2,18000,1.00354987575
564516,564522,567438,6,2916,2,18000,1.00205761317
564537,564547,567408,10,2861,2,18000,1.00349528137
564574,564584,567432,10,2848,2,18000,1.00351123596
564590,564597,567406,7,2809,2,18000,1.00249199003
564606,564612,567556,6,2944,2,18000,1.00203804348
564607,564618,567431,11,2813,2,18000,1.00391041593
564623,564630,567409,7,2779,2,18000,1.00251889169
564638,564644,567364,6,2720,2,18000,1.00220588235
564657,564666,567443,9,2777,2,18000,1.00324090745
564773,564782,567581,9,2799,2,18000,1.00321543408
564860,564868,567606,8,2738,2,18000,1.00292184076
564876,564884,567596,8,2712,2,18000,1.00294985251
564910,564919,567714,9,2795,2,18000,1.00322003578
564952,564962,567755,10,2793,2,18000,1.00358037952
565044,565053,567762,9,2709,2,18000,1.00332225914
565177,565187,567874,10,2687,2,18000,1.00372162263
565846,565856,568556,10,2700,2,18000,1.0037037037
566131,566139,568785,8,2646,2,18000,1.00302343159
566274,566283,569077,9,2794,2,18000,1.00322118826
566577,566585,569379,8,2794,2,18000,1.00286327845
566610,566618,569409,8,2791,2,18000,1.00286635614
566626,566632,569490,6,2858,2,18000,1.00209937019
566660,566669,569382,9,2713,2,18000,1.00331736086
566733,566742,569557,9,2815,2,18000,1.00319715808
566755,566763,569435,8,2672,2,18000,1.00299401198
566770,566776,569428,6,2652,2,18000,1.00226244344
566771,566782,569632,11,2850,2,18000,1.00385964912
566772,566787,569567,15,2780,2,18000,1.00539568345
566825,566832,569505,7,2673,2,18000,1.0026187804
566840,566850,569453,10,2603,2,18000,1.00384172109
566855,566861,569564,6,2703,2,18000,1.00221975583
566876,566886,569452,10,2566,2,18000,1.00389711613
566903,566914,569662,11,2748,2,18000,1.00400291121
566918,566924,569730,6,2806,2,18000,1.00213827512
566999,567008,569800,9,2792,2,18000,1.0032234957
567017,567027,569786,10,2759,2,18000,1.00362450163
567072,567082,569794,10,2712,2,18000,1.00368731563
567090,567101,569792,11,2691,2,18000,1.00408769974
567121,567131,569928,10,2797,2,18000,1.00357525921
567329,567338,569949,9,2611,2,18000,1.00344695519
567365,567375,570242,10,2867,2,18000,1.00348796652
567405,567417,569909,12,2492,2,18000,1.00481540931
567419,567426,570248,7,2822,2,18000,1.00248051028
567421,567432,570170,11,2738,2,18000,1.00401753104
567436,567441,570195,5,2754,2,18000,1.00181554103
567437,567448,570291,11,2843,2,18000,1.0038691523
567452,567458,570274,6,2816,2,18000,1.00213068182
567454,567464,570370,10,2906,2,18000,1.00344115623
567557,567567,570408,10,2841,2,18000,1.00351988736
567582,567592,570368,10,2776,2,18000,1.00360230548
567600,567608,570349,8,2741,2,18000,1.00291864283
567615,567621,570430,6,2809,2,18000,1.00213599146
567716,567726,570373,10,2647,2,18000,1.00377786173
567756,567766,570624,10,2858,2,18000,1.00349895031
567771,567777,570555,6,2778,2,18000,1.00215982721
567875,567886,570708,11,2822,2,18000,1.00389794472
568557,568567,571289,10,2722,2,18000,1.00367376929
568788,568796,571634,8,2838,2,18000,1.00281888654
569079,569088,571831,9,2743,2,18000,1.00328107911
569380,569390,572060,10,2670,2,18000,1.00374531835
569395,569401,571983,6,2582,2,18000,1.00232378002
569413,569421,572247,8,2826,2,18000,1.00283085633
569431,569439,572243,8,2804,2,18000,1.00285306705
569447,569453,572221,6,2768,2,18000,1.00216763006
569462,569468,572429,6,2961,2,18000,1.00202634245
569463,569474,572326,11,2852,2,18000,1.0038569425
569493,569501,572238,8,2737,2,18000,1.00292290829
569509,569517,572316,8,2799,2,18000,1.00285816363
569561,569568,572421,7,2853,2,18000,1.00245355766
569576,569582,572406,6,2824,2,18000,1.00212464589
569577,569588,572477,11,2889,2,18000,1.00380754586
569635,569644,572474,9,2830,2,18000,1.00318021201
569666,569674,572457,8,2783,2,18000,1.00287459576
569733,569741,572497,8,2756,2,18000,1.00290275762
569788,569798,572591,10,2793,2,18000,1.00358037952
569804,569810,572567,6,2757,2,18000,1.00217627856
569805,569816,572667,11,2851,2,18000,1.00385829533
569806,569821,572597,15,2776,2,18000,1.00540345821
569841,569847,574698,6,4851,32,43200,1.00123685838
569910,569920,572549,10,2629,2,18000,1.00380372765
569931,569939,572675,8,2736,2,18000,1.00292397661
569952,569960,572622,8,2662,2,18000,1.0030052592
570171,570182,573042,11,2860,2,18000,1.00384615385
570195,570206,572977,11,2771,2,18000,1.00396968603
570245,570253,572898,8,2645,2,18000,1.00302457467
570260,570266,573053,6,2787,2,18000,1.00215285253
570275,570285,572945,10,2660,2,18000,1.0037593985
570293,570302,572991,9,2689,2,18000,1.00334696913
570352,570360,573199,8,2839,2,18000,1.00281789362
570370,570379,573191,9,2812,2,18000,1.00320056899
570371,570385,573181,14,2796,2,18000,1.00500715308
570387,570393,573198,6,2805,2,18000,1.00213903743
570412,570419,573251,7,2832,2,18000,1.00247175141
570433,570441,573089,8,2648,2,18000,1.00302114804
570557,570566,573400,9,2834,2,18000,1.00317572336
570625,570636,573435,11,2799,2,18000,1.00392997499
570711,570720,573579,9,2859,2,18000,1.00314795383
571291,571300,573953,9,2653,2,18000,1.00339238598
571636,571645,574362,9,2717,2,18000,1.003312477
571833,571842,574634,9,2792,2,18000,1.0032234957
571986,571994,574753,8,2759,2,18000,1.0028996013
572063,572071,574776,8,2705,2,18000,1.00295748614
572222,572232,575034,10,2802,2,18000,1.00356887937
572240,572249,575115,9,2866,2,18000,1.00314026518
572255,572262,574998,7,2736,2,18000,1.00255847953
572257,572267,575015,10,2748,2,18000,1.00363901019
572318,572327,575157,9,2830,2,18000,1.00318021201
572333,572339,574967,6,2628,2,18000,1.00228310502
572407,572417,575020,10,2603,2,18000,1.00384172109
572422,572433,575163,11,2730,2,18000,1.00402930403
572438,572444,575253,6,2809,2,18000,1.00213599146
572459,572468,575430,9,2962,2,18000,1.00303848751
572477,572488,575214,11,2726,2,18000,1.00403521643
572479,572493,575177,14,2684,2,18000,1.00521609538
572500,572508,575316,8,2808,2,18000,1.00284900285
572552,572560,575372,8,2812,2,18000,1.00284495021
572570,572578,575359,8,2781,2,18000,1.00287666307
572595,572603,575415,8,2812,2,18000,1.00284495021
572610,572616,575260,6,2644,2,18000,1.00226928896
572625,572633,575297,8,2664,2,18000,1.003003003
572668,572678,575494,10,2816,2,18000,1.00355113636
572683,572689,575402,6,2713,2,18000,1.0022115739
572900,572909,575789,9,2880,2,18000,1.003125
572943,572956,575873,13,2917,2,18000,1.00445663353
572980,572988,575832,8,2844,2,18000,1.00281293952
572995,573002,575597,7,2595,2,18000,1.00269749518
573044,573053,575839,9,2786,2,18000,1.0032304379
573059,573065,575726,6,2661,2,18000,1.00225479143
573090,573100,575907,10,2807,2,18000,1.00356252227
573184,573193,575887,9,2694,2,18000,1.00334075724
573199,573205,576096,6,2891,2,18000,1.00207540643
573200,573211,576099,11,2888,2,18000,1.00380886427
573201,573216,575990,15,2774,2,18000,1.005407354
573254,573262,576100,8,2838,2,18000,1.00281888654
573404,573412,576128,8,2716,2,18000,1.0029455081
573438,573447,576289,9,2842,2,18000,1.00316678395
573583,573591,576436,8,2845,2,18000,1.00281195079
573953,573964,576588,11,2624,2,18000,1.00419207317
574365,574374,577172,9,2798,2,18000,1.00321658327
574638,574646,577377,8,2731,2,18000,1.00292932992
574757,574765,577634,8,2869,2,18000,1.00278842802
574779,574787,577653,8,2866,2,18000,1.00279134682
574971,574978,577589,7,2611,2,18000,1.00268096515
575002,575010,577806,8,2796,2,18000,1.00286123033
575017,575027,577882,10,2855,2,18000,1.00350262697
575032,575038,577841,6,2803,2,18000,1.00214056368
575047,575053,577954,6,2901,2,18000,1.00206825233
575117,575126,577858,9,2732,2,18000,1.0032942899
575160,575168,577903,8,2735,2,18000,1.0029250457
575175,575181,577767,6,2586,2,18000,1.00232018561
575190,575197,577812,7,2615,2,18000,1.00267686424
575218,575226,577966,8,2740,2,18000,1.00291970803
575255,575264,577944,9,2680,2,18000,1.00335820896
575270,575276,578191,6,2915,2,18000,1.00205831904
575300,575308,578051,8,2743,2,18000,1.00291651476
575318,575327,578167,9,2840,2,18000,1.00316901408
575363,575370,578160,7,2790,2,18000,1.00250896057
575379,575385,578206,6,2821,2,18000,1.00212690535
575406,575413,578144,7,2731,2,18000,1.00256316368
575421,575427,578233,6,2806,2,18000,1.00213827512
575436,575443,578133,7,2690,2,18000,1.00260223048
575495,575505,578235,10,2730,2,18000,1.00366300366
575599,575608,578284,9,2676,2,18000,1.0033632287
575729,575737,578457,8,2720,2,18000,1.00294117647
575793,575800,578601,7,2801,2,18000,1.00249910746
575833,575843,578637,10,2794,2,18000,1.00357909807
575848,575854,578661,6,2807,2,18000,1.00213751336
575876,575884,578583,8,2699,2,18000,1.00296406076
575891,575899,578657,8,2758,2,18000,1.00290065265
575910,575918,578712,8,2794,2,18000,1.00286327845
575993,576001,578718,8,2717,2,18000,1.002944424
576100,576107,578813,7,2706,2,18000,1.00258684405
576101,576113,578794,12,2681,2,18000,1.00447594181
576117,576123,578962,6,2839,2,18000,1.00211342022
576132,576139,578781,7,2642,2,18000,1.00264950795
576292,576300,578857,8,2557,2,18000,1.00312866641
576438,576447,579145,9,2698,2,18000,1.0033358043
576590,576600,579245,10,2645,2,18000,1.00378071834
577174,577183,579980,9,2797,2,18000,1.00321773329
577378,577388,580078,10,2690,2,18000,1.00371747212
577592,577601,580281,9,2680,2,18000,1.00335820896
577635,577645,580283,10,2638,2,18000,1.00379075057
577657,577664,580457,7,2793,2,18000,1.00250626566
577771,577779,580608,8,2829,2,18000,1.00282785437
577808,577817,580619,9,2802,2,18000,1.00321199143
577822,577829,580531,7,2702,2,18000,1.00259067358
577844,577852,580592,8,2740,2,18000,1.00291970803
577862,577870,580713,8,2843,2,18000,1.00281392895
577883,577894,580779,11,2885,2,18000,1.00381282496
577905,577915,580720,10,2805,2,18000,1.00356506239
577947,577956,580602,9,2646,2,18000,1.00340136054
577963,577969,580734,6,2765,2,18000,1.00216998192
577978,577984,580873,6,2889,2,18000,1.0020768432
578055,578062,580829,7,2767,2,18000,1.00252981568
578136,578144,580856,8,2712,2,18000,1.00294985251
578152,578158,580923,6,2765,2,18000,1.00216998192
578167,578173,581052,6,2879,2,18000,1.00208405696
578168,578179,581085,11,2906,2,18000,1.00378527185
578193,578202,581031,9,2829,2,18000,1.00318133616
578208,578217,581032,9,2815,2,18000,1.00319715808
578235,578244,581083,9,2839,2,18000,1.00317013033
578236,578250,581046,14,2796,2,18000,1.00500715308
578286,578295,580893,9,2598,2,18000,1.00346420323
578460,578468,581370,8,2902,2,18000,1.0027567195
578586,578594,581356,8,2762,2,18000,1.00289645185
578604,578612,581315,8,2703,2,18000,1.00295967444
578640,578648,581407,8,2759,2,18000,1.0028996013
578659,578668,581458,9,2790,2,18000,1.00322580645
578674,578681,581319,7,2638,2,18000,1.0026535254
578714,578723,581310,9,2587,2,18000,1.00347893313
578729,578735,581532,6,2797,2,18000,1.00214515552
578784,578793,581599,9,2806,2,18000,1.00320741269
578800,578805,581464,5,2659,2,18000,1.00188040617
578815,578824,581628,9,2804,2,18000,1.00320970043
578861,578868,581617,7,2749,2,18000,1.0025463805
578965,578973,581766,8,2793,2,18000,1.00286430362
579146,579156,581934,10,2778,2,18000,1.00359971202
579247,579257,581983,10,2726,2,18000,1.00366837858
579981,579991,582795,10,2804,2,18000,1.00356633381
580080,580089,582724,9,2635,2,18000,1.00341555977
580282,580293,583078,11,2785,2,18000,1.0039497307
580298,580304,583092,6,2788,2,18000,1.00215208034
580460,580469,583225,9,2756,2,18000,1.00326560232
580501,580508,580634,7,126,8,36000,1.05555555556
580535,580542,583200,7,2658,2,18000,1.00263355907
580593,580603,583493,10,2890,2,18000,1.00346020761
580608,580615,583442,7,2827,2,18000,1.0024761231
580610,580621,583475,11,2854,2,18000,1.00385423966
580625,580630,583328,5,2698,2,18000,1.00185322461
580714,580724,583454,10,2730,2,18000,1.00366300366
580730,580736,583406,6,2670,2,18000,1.00224719101
580745,580751,583381,6,2630,2,18000,1.00228136882
580781,580790,583645,9,2855,2,18000,1.00315236427
580832,580840,583683,8,2843,2,18000,1.00281392895
580857,580867,583501,10,2634,2,18000,1.00379650721
580876,580884,583723,8,2839,2,18000,1.00281789362
580895,580904,583656,9,2752,2,18000,1.00327034884
580925,580934,583732,9,2798,2,18000,1.00321658327
580962,580969,580975,7,6,8,36000,1.3
581032,581042,583749,10,2707,2,18000,1.00369412634
581033,581048,583843,15,2795,2,18000,1.0053667263
581054,581060,583990,6,2930,2,18000,1.00204778157
581055,581066,583834,11,2768,2,18000,1.00397398844
581086,581100,583900,14,2800,2,18000,1.005
581088,581094,583941,6,2847,2,18000,1.00210748156
581314,581321,584149,7,2828,2,18000,1.00247524752
581329,581336,584053,7,2717,2,18000,1.002576371
581331,581341,584200,10,2859,2,18000,1.00349772648
581358,581367,584248,9,2881,2,18000,1.00312391531
581374,581381,584033,7,2652,2,18000,1.00263951735
581410,581418,584237,8,2819,2,18000,1.00283788578
581460,581469,584292,9,2823,2,18000,1.00318809777
581475,581481,584178,6,2697,2,18000,1.0022246941
581536,581544,584170,8,2626,2,18000,1.00304645849
581600,581610,584425,10,2815,2,18000,1.00355239787
581619,581628,584325,9,2697,2,18000,1.00333704116
581634,581640,584461,6,2821,2,18000,1.00212690535
581769,581777,584558,8,2781,2,18000,1.00287666307
581935,581945,584632,10,2687,2,18000,1.00372162263
581984,581995,584670,11,2675,2,18000,1.00411214953
582726,582735,585611,9,2876,2,18000,1.00312934631
582796,582806,585609,10,2803,2,18000,1.00356760614
582881,582888,761809,7,178921,1,432000,1.00003912341
583080,583089,585845,9,2756,2,18000,1.00326560232
583095,583104,585951,9,2847,2,18000,1.00316122234
583203,583211,585898,8,2687,2,18000,1.0029772981
583227,583236,585983,9,2747,2,18000,1.00327630142
583331,583339,586083,8,2744,2,18000,1.0029154519
583383,583392,586149,9,2757,2,18000,1.00326441785
583408,583418,586147,10,2729,2,18000,1.00366434591
583445,583453,586310,8,2857,2,18000,1.00280014001
583460,583467,586402,7,2935,2,18000,1.00238500852
583479,583486,586279,7,2793,2,18000,1.00250626566
583494,583504,586305,10,2801,2,18000,1.00357015352
583509,583516,586238,7,2722,2,18000,1.0025716385
583647,583656,586416,9,2760,2,18000,1.00326086957
583663,583669,586315,6,2646,2,18000,1.0022675737
583684,583694,586438,10,2744,2,18000,1.00364431487
583724,583734,586519,10,2785,2,18000,1.00359066427
583740,583746,586596,6,2850,2,18000,1.00210526316
583755,583761,586601,6,2840,2,18000,1.00211267606
583835,583845,586635,10,2790,2,18000,1.00358422939
583851,583857,586506,6,2649,2,18000,1.00226500566
583903,583911,586463,8,2552,2,18000,1.00313479624
583943,583952,586770,9,2818,2,18000,1.00319375444
583992,584001,586800,9,2799,2,18000,1.00321543408
584036,584044,586797,8,2753,2,18000,1.00290592081
584056,584064,586898,8,2834,2,18000,1.00282286521
584151,584160,586773,9,2613,2,18000,1.00344431688
584173,584181,586770,8,2589,2,18000,1.00308999614
584188,584194,586886,6,2692,2,18000,1.00222882615
584203,584212,586878,9,2666,2,18000,1.00337584396
584241,584248,586947,7,2699,2,18000,1.00259355317
584256,584262,587181,6,2919,2,18000,1.00205549846
584294,584304,586976,10,2672,2,18000,1.00374251497
584329,584336,587245,7,2909,2,18000,1.0024063252
584428,584436,587250,8,2814,2,18000,1.00284292822
584465,584473,587170,8,2697,2,18000,1.00296625881
584561,584569,587498,8,2929,2,18000,1.00273130761
584634,584643,587476,9,2833,2,18000,1.00317684433
584671,584681,587533,10,2852,2,18000,1.00350631136
585611,585626,588308,15,2682,2,18000,1.00559284116
585612,585620,588288,8,2668,2,18000,1.00299850075
585848,585856,588627,8,2771,2,18000,1.00288704439
585901,585909,588704,8,2795,2,18000,1.00286225403
585952,585962,588703,10,2741,2,18000,1.00364830354
585986,585994,588890,8,2896,2,18000,1.00276243094
586086,586094,588980,8,2886,2,18000,1.00277200277
586149,586165,588978,16,2813,2,18000,1.00568787771
586150,586159,589091,9,2932,2,18000,1.00306957708
586241,586249,588992,8,2743,2,18000,1.00291651476
586283,586290,589093,7,2803,2,18000,1.0024973243
586308,586316,589154,8,2838,2,18000,1.00281888654
586324,586330,589030,6,2700,2,18000,1.00222222222
586325,586336,589131,11,2795,2,18000,1.00393559928
586405,586414,589107,9,2693,2,18000,1.00334199777
586421,586427,589198,6,2771,2,18000,1.00216528329
586442,586449,589091,7,2642,2,18000,1.00264950795
586466,586474,589215,8,2741,2,18000,1.00291864283
586509,586517,589291,8,2774,2,18000,1.00288392213
586526,586532,589320,6,2788,2,18000,1.00215208034
586599,586607,589288,8,2681,2,18000,1.00298396121
586615,586621,589428,6,2807,2,18000,1.00213751336
586637,586646,589462,9,2816,2,18000,1.00319602273
586773,586781,589469,8,2688,2,18000,1.00297619048
586775,586787,589514,12,2727,2,18000,1.00440044004
586776,586792,589710,16,2918,2,18000,1.00548320768
586798,586808,589502,10,2694,2,18000,1.00371195249
586814,586820,589391,6,2571,2,18000,1.00233372229
586879,586889,589691,10,2802,2,18000,1.00356887937
586895,586901,589607,6,2706,2,18000,1.0022172949
586910,586916,589661,6,2745,2,18000,1.00218579235
586946,586958,589650,12,2692,2,18000,1.0044576523
586977,586987,589761,10,2774,2,18000,1.00360490267
587172,587181,589898,9,2717,2,18000,1.003312477
587187,587193,589913,6,2720,2,18000,1.00220588235
587247,587256,590085,9,2829,2,18000,1.00318133616
587262,587268,589975,6,2707,2,18000,1.0022164758
587479,587487,590357,8,2870,2,18000,1.00278745645
587500,587509,590282,9,2773,2,18000,1.0032455824
587534,587544,590214,10,2670,2,18000,1.00374531835
588290,588299,591007,9,2708,2,18000,1.00332348597
588312,588319,591089,7,2770,2,18000,1.00252707581
588631,588638,591411,7,2773,2,18000,1.00252434187
588704,588720,591586,16,2866,2,18000,1.00558269365
588705,588714,591604,9,2890,2,18000,1.00311418685
588892,588902,591615,10,2713,2,18000,1.00368595651
588981,588990,591835,9,2845,2,18000,1.00316344464
588982,588996,591744,14,2748,2,18000,1.00509461426
588998,589004,591751,6,2747,2,18000,1.00218420095
589032,589042,591946,10,2904,2,18000,1.00344352617
589094,589103,591815,9,2712,2,18000,1.00331858407
589096,589108,591871,12,2763,2,18000,1.00434310532
589097,589114,591855,17,2741,2,18000,1.00620211602
589113,589120,592018,7,2898,2,18000,1.00241545894
589134,589142,591771,8,2629,2,18000,1.00304298212
589156,589166,591939,10,2773,2,18000,1.00360620267
589199,589209,591863,10,2654,2,18000,1.00376789751
589217,589226,592046,9,2820,2,18000,1.00319148936
589291,589299,592148,8,2849,2,18000,1.00280800281
589306,589312,592041,6,2729,2,18000,1.00219860755
589321,589331,591850,10,2519,2,18000,1.0039698293
589392,589402,592256,10,2854,2,18000,1.00350385424
589429,589439,592185,10,2746,2,18000,1.0036416606
589466,589480,592224,14,2744,2,18000,1.00510204082
589467,589485,592381,18,2896,2,18000,1.00621546961
589504,589513,592239,9,2726,2,18000,1.00330154072
589520,589526,592372,6,2846,2,18000,1.00210822207
589609,589618,592402,9,2784,2,18000,1.00323275862
589652,589662,592354,10,2692,2,18000,1.00371471025
589667,589673,592444,6,2771,2,18000,1.00216528329
589695,589702,592383,7,2681,2,18000,1.00261096606
589713,589721,592520,8,2799,2,18000,1.00285816363
589765,589773,592576,8,2803,2,18000,1.00285408491
589899,589910,592709,11,2799,2,18000,1.00392997499
589915,589924,592697,9,2773,2,18000,1.0032455824
589976,589986,592834,10,2848,2,18000,1.00351123596
590086,590096,592890,10,2794,2,18000,1.00357909807
590216,590226,593102,10,2876,2,18000,1.00347705146
590284,590294,593045,10,2751,2,18000,1.0036350418
590361,590368,593220,7,2852,2,18000,1.00245441795
590593,590599,590600,6,1,2,300,1.0
591011,591018,593905,7,2887,2,18000,1.00242466228
591091,591101,593935,10,2834,2,18000,1.00352858151
591415,591422,594337,7,2915,2,18000,1.00240137221
591587,591597,594277,10,2680,2,18000,1.00373134328
591605,591615,594460,10,2845,2,18000,1.00351493849
591620,591626,594458,6,2832,2,18000,1.00211864407
591747,591755,594353,8,2598,2,18000,1.00307929176
591762,591769,594530,7,2761,2,18000,1.00253531329
591778,591784,594578,6,2794,2,18000,1.00214745884
591818,591826,594665,8,2839,2,18000,1.00281789362
591839,591847,594537,8,2690,2,18000,1.0029739777
591854,591861,594486,7,2625,2,18000,1.00266666667
591870,591876,594523,6,2647,2,18000,1.00226671704
591871,591882,594483,11,2601,2,18000,1.00422914264
591886,591892,594700,6,2808,2,18000,1.00213675214
591941,591951,594602,10,2651,2,18000,1.00377216145
591957,591963,594603,6,2640,2,18000,1.00227272727
591984,591990,628096,6,36106,1,36000,1.00016617737
592022,592030,594879,8,2849,2,18000,1.00280800281
592043,592052,594610,9,2558,2,18000,1.00351837373
592058,592064,594881,6,2817,2,18000,1.00212992545
592150,592160,595008,10,2848,2,18000,1.00351123596
592186,592196,594866,10,2670,2,18000,1.00374531835
592226,592235,595060,9,2825,2,18000,1.00318584071
592243,592251,595079,8,2828,2,18000,1.00282885431
592258,592268,595081,10,2813,2,18000,1.00355492357
592356,592365,595033,9,2668,2,18000,1.00337331334
592374,592383,595162,9,2779,2,18000,1.00323857503
592389,592396,595307,7,2911,2,18000,1.00240467193
592391,592402,595030,11,2628,2,18000,1.00418569254
592406,592413,595211,7,2798,2,18000,1.00250178699
592419,592425,592426,6,1,2,3600,1.0
592419,592430,592431,11,1,2,3600,1.2
592420,592435,592436,15,1,2,3600,1.6
592420,592440,592441,20,1,2,3600,2.1
592420,592446,592447,26,1,2,3600,2.7
592420,592451,592452,31,1,2,3600,3.2
592420,592456,592457,36,1,2,3600,3.7
592420,592461,592462,41,1,2,3600,4.2
592420,592466,592467,46,1,2,3600,4.7
592421,592471,592473,50,2,2,3600,5.2
592421,592487,592488,66,1,2,3600,6.7
592421,592482,592483,61,1,2,3600,6.2
592421,592492,592493,71,1,2,3600,7.2
592421,592497,592498,76,1,2,3600,7.7
592421,592502,592504,81,2,2,3600,8.3
592421,592507,592509,86,2,2,3600,8.8
592421,592477,592478,56,1,2,3600,5.7
592422,592513,592514,91,1,2,3600,9.2
592422,592518,592519,96,1,2,3600,9.7
592422,592528,592529,106,1,2,3600,10.7
592422,592538,592540,116,2,2,3600,11.8
592422,592523,592702,101,179,2,3600,1.56424581006
592422,592533,592534,111,1,2,3600,11.2
592423,592543,592546,120,3,2,3600,12.3
592423,592548,592551,125,3,2,3600,12.8
592423,592554,592556,131,2,2,3600,13.3
592423,592559,592560,136,1,2,3600,13.7
592423,592564,592565,141,1,2,3600,14.2
592446,592571,595281,125,2710,2,18000,1.04612546125
592522,592576,595385,54,2809,2,18000,1.0192239231
592577,592588,595351,11,2763,2,18000,1.00398117988
592700,592708,595493,8,2785,2,18000,1.00287253142
592716,592722,595561,6,2839,2,18000,1.00211342022
592835,592845,595544,10,2699,2,18000,1.00370507595
592843,592850,592851,7,1,1,3600,1.0
592844,592913,592914,69,1,1,3600,7.0
592844,592871,592872,27,1,1,3600,2.8
592844,592892,592893,48,1,1,3600,4.9
592845,592918,592919,73,1,1,3600,7.4
592845,592939,592940,94,1,1,3600,9.5
592845,592956,592957,111,1,1,3600,11.2
592846,592961,592962,115,1,1,3600,11.6
592847,592992,592993,145,1,1,3600,14.6
592847,592997,592998,150,1,1,3600,15.1
592891,592951,595597,60,2646,2,18000,1.02267573696
593049,593057,595927,8,2870,2,18000,1.00278745645
593088,593094,593106,6,12,8,3600,1.5
593089,593099,593112,10,13,8,3600,1.76923076923
593089,593104,593118,15,14,8,3600,2.07142857143
593089,593109,593123,20,14,8,3600,2.42857142857
593089,593125,593140,36,15,8,3600,3.4
593089,593140,593155,51,15,8,3600,4.4
593089,593146,593161,57,15,8,3600,4.8
593089,593135,593152,46,17,8,3600,3.70588235294
593089,593120,593611,31,491,8,3600,1.06313645621
593089,593130,593144,41,14,8,3600,3.92857142857
593090,593156,593172,66,16,8,3600,5.125
593090,593151,593166,61,15,8,3600,5.06666666667
593090,593197,593214,107,17,8,3600,7.29411764706
593090,593192,593208,102,16,8,3600,7.375
593090,593176,593192,86,16,8,3600,6.375
593090,593181,593198,91,17,8,3600,6.35294117647
593090,593171,593189,81,18,8,3600,5.5
593090,593166,593182,76,16,8,3600,5.75
593090,593161,593177,71,16,8,3600,5.4375
593090,593187,593203,97,16,8,3600,7.0625
593091,593202,593218,111,16,8,3600,7.9375
593091,593219,593234,128,15,8,3600,9.53333333333
593091,593224,593239,133,15,8,3600,9.86666666667
593091,593229,593244,138,15,8,3600,10.2
593091,593234,593250,143,16,8,3600,9.9375
593091,593239,593254,148,15,8,3600,10.8666666667
593091,593245,593260,154,15,8,3600,11.2666666667
593091,593250,593263,159,13,8,3600,13.2307692308
593091,593214,593228,123,14,8,3600,9.78571428571
593092,593209,593223,117,14,8,3600,9.35714285714
593104,593115,595776,11,2661,2,18000,1.00413378429
593221,593256,596067,35,2811,2,18000,1.01245108502
593634,593640,593654,6,14,8,3600,1.42857142857
593908,593917,596770,9,2853,2,18000,1.00315457413
593939,593946,596764,7,2818,2,18000,1.00248403123
594081,594102,594103,21,1,1,3600,2.2
594081,594097,594098,16,1,1,3600,1.7
594082,594149,594150,67,1,1,3600,6.8
594082,594108,594109,26,1,1,3600,2.7
594082,594113,594114,31,1,1,3600,3.2
594082,594118,594119,36,1,1,3600,3.7
594082,594123,594124,41,1,1,3600,4.2
594082,594154,594155,72,1,1,3600,7.3
594082,594144,594145,62,1,1,3600,6.3
594083,594159,594160,76,1,1,3600,7.7
594083,594175,594176,92,1,1,3600,9.3
594083,594180,594181,97,1,1,3600,9.8
594083,594185,594186,102,1,1,3600,10.3
594083,594201,594202,118,1,1,3600,11.9
594084,594221,594222,137,1,1,3600,13.8
594084,594211,594212,127,1,1,3600,12.8
594084,594216,594217,132,1,1,3600,13.3
594084,594206,594207,122,1,1,3600,12.3
594280,594288,597032,8,2744,2,18000,1.0029154519
594338,594348,597032,10,2684,2,18000,1.00372578241
594357,594364,597302,7,2938,2,18000,1.00238257318
594459,594469,597284,10,2815,2,18000,1.00355239787
594475,594481,597315,6,2834,2,18000,1.00211714891
594490,594496,597159,6,2663,2,18000,1.00225309801
594491,594502,597407,11,2905,2,18000,1.00378657487
594525,594534,597342,9,2808,2,18000,1.00320512821
594541,594547,597280,6,2733,2,18000,1.00219538968
594542,594553,597386,11,2833,2,18000,1.00388280974
594582,594589,597240,7,2651,2,18000,1.00264051301
594585,594595,594598,10,3,2,300,1.3
594603,594612,597419,9,2807,2,18000,1.00320627004
594604,594624,597304,20,2680,2,18000,1.00746268657
594607,594617,594634,10,17,2,300,1.58823529412
594620,594631,597336,11,2705,2,18000,1.00406654344
594641,594647,594680,6,33,2,360,1.18181818182
594667,594677,597359,10,2682,2,18000,1.00372856078
594688,594694,594831,6,137,2,360,1.04379562044
594704,594712,597512,8,2800,2,18000,1.00285714286
594780,594791,594873,11,82,1,3600,1.13414634146
594780,594796,594875,16,79,1,3600,1.20253164557
594780,594802,594876,22,74,1,3600,1.2972972973
594780,594785,594858,5,73,1,3600,1.06849315068
594781,594807,594880,26,73,1,3600,1.35616438356
594781,594812,594899,31,87,1,3600,1.35632183908
594781,594827,594898,46,71,1,3600,1.64788732394
594781,594817,594889,36,72,1,3600,1.5
594781,594822,594893,41,71,1,3600,1.57746478873
594782,594853,594931,71,78,1,3600,1.91025641026
594782,594833,594904,51,71,1,3600,1.71830985915
594782,594838,594911,56,73,1,3600,1.76712328767
594782,594843,594913,61,70,1,3600,1.87142857143
594782,594848,594923,66,75,1,3600,1.88
594782,594858,594932,76,74,1,3600,2.02702702703
594783,594863,594937,80,74,1,3600,2.08108108108
594783,594868,594939,85,71,1,3600,2.19718309859
594783,594874,594944,91,70,1,3600,2.3
594783,594879,594949,96,70,1,3600,2.37142857143
594784,594884,594961,100,77,1,3600,2.2987012987
594784,594889,594964,105,75,1,3600,2.4
594784,594894,594965,110,71,1,3600,2.54929577465
594784,594899,594981,115,82,1,3600,2.40243902439
594784,594904,594989,120,85,1,3600,2.41176470588
594785,594915,594986,130,71,1,3600,2.83098591549
594785,594910,594982,125,72,1,3600,2.73611111111
594785,594925,594996,140,71,1,3600,2.97183098592
594785,594952,595023,167,71,1,3600,3.35211267606
594785,594920,594994,135,74,1,3600,2.82432432432
594786,594958,595028,172,70,1,3600,3.45714285714
594841,594947,594957,106,10,2,300,11.6
594867,594932,597755,65,2823,2,18000,1.02302515055
594882,594937,597742,55,2805,2,18000,1.01960784314
594884,594942,597533,58,2591,2,18000,1.02238517947
594964,594971,594998,7,27,2,300,1.25925925926
595006,595012,595039,6,27,2,300,1.22222222222
595009,595019,597794,10,2775,2,18000,1.0036036036
595034,595041,597837,7,2796,2,18000,1.00250357654
595035,595047,597815,12,2768,2,18000,1.00433526012
595048,595053,595365,5,312,2,300,1.01602564103
595063,595071,597855,8,2784,2,18000,1.00287356322
595083,595090,597985,7,2895,2,18000,1.002417962
595085,595096,597801,11,2705,2,18000,1.00406654344
595165,595173,597800,8,2627,2,18000,1.00304529882
595214,595222,598140,8,2918,2,18000,1.00274160384
595285,595292,598111,7,2819,2,18000,1.00248315005
595309,595318,598036,9,2718,2,18000,1.00331125828
595329,595345,595364,16,19,1,3600,1.84210526316
595329,595350,595369,21,19,1,3600,2.10526315789
595329,595355,595374,26,19,1,3600,2.36842105263
595329,595361,595380,32,19,1,3600,2.68421052632
595329,595366,595385,37,19,1,3600,2.94736842105
595329,595376,595395,47,19,1,3600,3.47368421053
595329,595371,595390,42,19,1,3600,3.21052631579
595329,595339,595359,10,20,1,3600,1.5
595329,595334,595355,5,21,1,3600,1.2380952381
595330,595381,595401,51,20,1,3600,3.55
595330,595387,595406,57,19,1,3600,4.0
595330,595392,595411,62,19,1,3600,4.26315789474
595330,595397,595416,67,19,1,3600,4.52631578947
595330,595402,595421,72,19,1,3600,4.78947368421
595330,595407,595426,77,19,1,3600,5.05263157895
595330,595412,595431,82,19,1,3600,5.31578947368
595330,595418,595437,88,19,1,3600,5.63157894737
595331,595459,595479,128,20,1,3600,7.4
595331,595428,595447,97,19,1,3600,6.10526315789
595331,595423,595442,92,19,1,3600,5.84210526316
595331,595454,595473,123,19,1,3600,7.47368421053
595331,595449,595468,118,19,1,3600,7.21052631579
595331,595444,595463,113,19,1,3600,6.94736842105
595331,595438,595458,107,20,1,3600,6.35
595331,595433,595453,102,20,1,3600,6.1
595332,595475,595494,143,19,1,3600,8.52631578947
595332,595469,595489,137,20,1,3600,7.85
595332,595485,595504,153,19,1,3600,9.05263157895
595332,595480,595500,148,20,1,3600,8.4
595332,595464,595484,132,20,1,3600,7.6
595352,595492,598225,140,2733,2,18000,1.05122575924
595386,595497,598316,111,2819,2,18000,1.03937566513
595494,595504,598173,10,2669,2,18000,1.00374672162
595543,595555,598371,12,2816,2,18000,1.00426136364
595565,595573,598458,8,2885,2,18000,1.0027729636
595598,595609,598433,11,2824,2,18000,1.00389518414
595772,595778,595835,6,57,1,3600,1.10526315789
595773,595799,595855,26,56,1,3600,1.46428571429
595773,595783,595813,10,30,1,3600,1.33333333333
595773,595804,595860,31,56,1,3600,1.55357142857
595773,595809,595865,36,56,1,3600,1.64285714286
595773,595815,595872,42,57,1,3600,1.73684210526
595773,595820,595878,47,58,1,3600,1.81034482759
595773,595788,595845,15,57,1,3600,1.26315789474
595773,595830,595886,57,56,1,3600,2.01785714286
595773,595825,595881,52,56,1,3600,1.92857142857
595774,595846,595903,72,57,1,3600,2.26315789474
595774,595835,595893,61,58,1,3600,2.05172413793
595774,595876,595907,102,31,1,3600,4.29032258065
595774,595866,595922,92,56,1,3600,2.64285714286
595774,595871,595929,97,58,1,3600,2.6724137931
595774,595856,595910,82,54,1,3600,2.51851851852
595774,595861,595916,87,55,1,3600,2.58181818182
595774,595840,595897,66,57,1,3600,2.15789473684
595774,595851,595908,77,57,1,3600,2.35087719298
595775,595918,595974,143,56,1,3600,3.55357142857
595775,595902,595960,127,58,1,3600,3.18965517241
595775,595913,595969,138,56,1,3600,3.46428571429
595775,595892,595948,117,56,1,3600,3.08928571429
595775,595887,595944,112,57,1,3600,2.9649122807
595775,595882,595940,107,58,1,3600,2.84482758621
595775,595907,595938,132,31,1,3600,5.25806451613
595775,595923,595953,148,30,1,3600,5.93333333333
595775,595897,595953,122,56,1,3600,3.17857142857
595776,595930,595985,154,55,1,3600,3.8
595776,595935,595992,159,57,1,3600,3.78947368421
595778,595794,598525,16,2731,2,18000,1.00585865983
595928,595941,598740,13,2799,2,18000,1.0046445159
596068,596078,598855,10,2777,2,18000,1.00360100828
596765,596775,599605,10,2830,2,18000,1.0035335689
596780,596786,599520,6,2734,2,18000,1.00219458669
597033,597043,599839,10,2796,2,18000,1.00357653791
597034,597048,599803,14,2755,2,18000,1.00508166969
597160,597171,599933,11,2762,2,18000,1.00398262129
597244,597250,600057,6,2807,2,18000,1.00213751336
597282,597291,600007,9,2716,2,18000,1.00331369661
597297,597303,600081,6,2778,2,18000,1.00215982721
597312,597318,600066,6,2748,2,18000,1.00218340611
597313,597324,600116,11,2792,2,18000,1.00393982808
597328,597334,600075,6,2741,2,18000,1.00218898212
597344,597350,600174,6,2824,2,18000,1.00212464589
597345,597356,600145,11,2789,2,18000,1.00394406597
597361,597370,600246,9,2876,2,18000,1.00312934631
597389,597397,600180,8,2783,2,18000,1.00287459576
597410,597418,600204,8,2786,2,18000,1.00287150036
597426,597432,600159,6,2727,2,18000,1.00220022002
597515,597523,600236,8,2713,2,18000,1.0029487652
597538,597544,600406,6,2862,2,18000,1.00209643606
597745,597753,600564,8,2811,2,18000,1.00284596229
597760,597766,600506,6,2740,2,18000,1.00218978102
597797,597805,600709,8,2904,2,18000,1.00275482094
597812,597818,600595,6,2777,2,18000,1.00216060497
597813,597824,600580,11,2756,2,18000,1.00399129173
597829,597835,600627,6,2792,2,18000,1.00214899713
597844,597850,600576,6,2726,2,18000,1.00220102715
597859,597867,600451,8,2584,2,18000,1.00309597523
597886,597892,597954,6,62,4,3540,1.09677419355
597988,597996,600764,8,2768,2,18000,1.00289017341
598037,598047,600784,10,2737,2,18000,1.00365363537
598115,598122,600773,7,2651,2,18000,1.00264051301
598143,598151,601026,8,2875,2,18000,1.0027826087
598176,598185,601023,9,2838,2,18000,1.00317124736
598229,598237,600842,8,2605,2,18000,1.00307101727
598318,598327,601191,9,2864,2,18000,1.0031424581
598373,598382,601107,9,2725,2,18000,1.00330275229
598435,598444,601074,9,2630,2,18000,1.00342205323
598460,598469,601295,9,2826,2,18000,1.00318471338
598528,598537,601220,9,2683,2,18000,1.00335445397
598741,598751,601532,10,2781,2,18000,1.00359582884
598857,598866,601656,9,2790,2,18000,1.00322580645
599523,599531,602363,8,2832,2,18000,1.00282485876
599609,599616,602491,7,2875,2,18000,1.00243478261
599807,599815,602647,8,2832,2,18000,1.00282485876
599842,599850,602603,8,2753,2,18000,1.00290592081
599938,599944,602787,6,2843,2,18000,1.00211044671
600009,600019,602658,10,2639,2,18000,1.00378931413
600058,600068,602643,10,2575,2,18000,1.00388349515
600075,600081,602979,6,2898,2,18000,1.00207039337
600091,600097,602973,6,2876,2,18000,1.00208623088
600093,600103,602749,10,2646,2,18000,1.00377928949
600118,600128,602934,10,2806,2,18000,1.00356379187
600147,600157,602891,10,2734,2,18000,1.00365764448
600163,600171,602910,8,2739,2,18000,1.00292077401
600179,600185,602997,6,2812,2,18000,1.00213371266
600195,600201,602887,6,2686,2,18000,1.00223380491
600211,600217,602935,6,2718,2,18000,1.00220750552
600240,600247,603063,7,2816,2,18000,1.00248579545
600255,600262,603054,7,2792,2,18000,1.00250716332
600408,600417,603160,9,2743,2,18000,1.00328107911
600455,600462,603384,7,2922,2,18000,1.00239561944
600510,600517,603303,7,2786,2,18000,1.00251256281
600565,600575,603357,10,2782,2,18000,1.0035945363
600580,600591,603433,11,2842,2,18000,1.00387051372
600581,600596,603490,15,2894,2,18000,1.00518313753
600596,600606,603340,10,2734,2,18000,1.00365764448
600630,600638,603423,8,2785,2,18000,1.00287253142
600711,600720,603346,9,2626,2,18000,1.0034272658
600767,600775,603588,8,2813,2,18000,1.00284393886
600784,600790,603627,6,2837,2,18000,1.00211491012
600799,600805,603517,6,2712,2,18000,1.00221238938
600846,600853,603708,7,2855,2,18000,1.00245183888
601025,601035,603902,10,2867,2,18000,1.00348796652
601041,601047,603772,6,2725,2,18000,1.00220183486
601079,601085,603910,6,2825,2,18000,1.00212389381
601111,601118,603836,7,2718,2,18000,1.00257542311
601195,601203,603984,8,2781,2,18000,1.00287666307
601223,601231,603995,8,2764,2,18000,1.00289435601
601299,601306,604089,7,2783,2,18000,1.00251527129
601533,601543,604271,10,2728,2,18000,1.00366568915
601658,601667,604310,9,2643,2,18000,1.00340522134
602366,602374,605148,8,2774,2,18000,1.00288392213
602492,602503,605282,11,2779,2,18000,1.00395825837
602605,602614,605392,9,2778,2,18000,1.00323974082
602645,602654,605469,9,2815,2,18000,1.00319715808
602662,602668,605367,6,2699,2,18000,1.00222304557
602663,602674,605365,11,2691,2,18000,1.00408769974
602751,602760,605590,9,2830,2,18000,1.00318021201
602789,602798,605509,9,2711,2,18000,1.00331980819
602890,602899,605698,9,2799,2,18000,1.00321543408
602906,602912,605784,6,2872,2,18000,1.00208913649
602921,602928,605580,7,2652,2,18000,1.00263951735
602937,602945,605614,8,2669,2,18000,1.00299737729
602938,602951,605583,13,2632,2,18000,1.00493920973
602976,602985,605776,9,2791,2,18000,1.00322465066
602991,602997,605728,6,2731,2,18000,1.00219699744
603007,603013,605896,6,2883,2,18000,1.00208116545
603057,603066,605780,9,2714,2,18000,1.00331613854
603072,603079,605742,7,2663,2,18000,1.00262861434
603165,603171,605902,6,2731,2,18000,1.00219699744
603307,603315,606101,8,2786,2,18000,1.00287150036
603341,603351,606047,10,2696,2,18000,1.00370919881
603357,603363,606256,6,2893,2,18000,1.00207397166
603372,603378,606072,6,2694,2,18000,1.00222717149
603388,603395,606158,7,2763,2,18000,1.0025334781
603425,603434,606207,9,2773,2,18000,1.0032455824
603441,603447,606241,6,2794,2,18000,1.00214745884
603493,603502,606264,9,2762,2,18000,1.00325850833
603522,603528,606433,6,2905,2,18000,1.00206540448
603590,603600,606505,10,2905,2,18000,1.00344234079
603628,603638,606327,10,2689,2,18000,1.00371885459
603711,603720,606536,9,2816,2,18000,1.00319602273
603776,603783,606643,7,2860,2,18000,1.00244755245
603839,603847,606456,8,2609,2,18000,1.00306630893
603905,603913,606564,8,2651,2,18000,1.00301772916
603921,603927,606711,6,2784,2,18000,1.00215517241
603986,603995,606746,9,2751,2,18000,1.00327153762
604002,604008,606883,6,2875,2,18000,1.00208695652
604091,604100,606889,9,2789,2,18000,1.00322696307
604274,604282,607029,8,2747,2,18000,1.00291226793
604313,604321,607055,8,2734,2,18000,1.00292611558
