SubmitTime,StartTime,EndTime,QueuedTime,RunTime,NodesRequested,walltime,bslowdown
41,47,3437,6,3390,2,7200,1.0017699115
360,366,3697,6,3331,2,7200,1.00180126088
397,403,3787,6,3384,2,7200,1.00177304965
412,418,3659,6,3241,2,7200,1.00185128047
427,434,3825,7,3391,2,7200,1.00206428782
516,522,3712,6,3190,2,7200,1.00188087774
607,613,3815,6,3202,2,7200,1.00187382886
641,647,3714,6,3067,2,7200,1.0019563091
738,745,3920,7,3175,2,7200,1.00220472441
797,803,4275,6,3472,2,7200,1.0017281106
885,893,4018,8,3125,2,7200,1.00256
946,953,4274,7,3321,2,7200,1.00210779886
1056,1062,4424,6,3362,2,7200,1.00178465199
1071,1077,4228,6,3151,2,7200,1.00190415741
1111,1118,4491,7,3373,2,7200,1.00207530388
1127,1133,4395,6,3262,2,7200,1.00183936235
1191,1197,4392,6,3195,2,7200,1.00187793427
1249,1255,4562,6,3307,2,7200,1.00181433323
1292,1298,4623,6,3325,2,7200,1.00180451128
1407,1413,4621,6,3208,2,7200,1.00187032419
1423,1430,4789,7,3359,2,7200,1.00208395356
1536,1542,4637,6,3095,2,7200,1.00193861066
1777,1783,5086,6,3303,2,7200,1.00181653043
1905,1911,5141,6,3230,2,7200,1.00185758514
1948,1955,5330,7,3375,2,7200,1.00207407407
2042,2048,5392,6,3344,2,7200,1.00179425837
2179,2185,5410,6,3225,2,7200,1.00186046512
2224,2231,5507,7,3276,2,7200,1.00213675214
2341,2348,5680,7,3332,2,7200,1.00210084034
2541,2547,5756,6,3209,2,7200,1.00186974135
2562,2568,5672,6,3104,2,7200,1.00193298969
3008,3015,6374,7,3359,2,7200,1.00208395356
3048,3054,6595,6,3541,2,7200,1.0016944366
3118,3124,6448,6,3324,2,7200,1.00180505415
3136,3142,6190,6,3048,2,7200,1.00196850394
3151,3158,6554,7,3396,2,7200,1.00206124853
3170,3176,6762,6,3586,2,7200,1.00167317345
3361,3367,6598,6,3231,2,7200,1.00185701021
3395,3401,6792,6,3391,2,7200,1.00176938956
3416,3422,6544,6,3122,2,7200,1.00192184497
3438,3444,6891,6,3447,2,7200,1.00174064404
3661,3667,7162,6,3495,2,7200,1.0017167382
3698,3704,7248,6,3544,2,7200,1.00169300226
3713,3720,7237,7,3517,2,7200,1.00199033267
3715,3728,7098,13,3370,2,7200,1.00385756677
3785,3791,6902,6,3111,2,7200,1.00192864031
3813,3819,7151,6,3332,2,7200,1.00180072029
3828,3835,7116,7,3281,2,7200,1.00213349589
3921,3928,7279,7,3351,2,7200,1.00208892868
4018,4024,7455,6,3431,2,7200,1.00174876129
4228,4234,7494,6,3260,2,7200,1.0018404908
4274,4281,7743,7,3462,2,7200,1.00202195263
4275,4288,7575,13,3287,2,7200,1.00395497414
4394,4400,7765,6,3365,2,7200,1.00178306092
4395,4407,7772,12,3365,2,7200,1.00356612184
4426,4432,7674,6,3242,2,7200,1.00185070944
4493,4499,7483,6,2984,2,7200,1.00201072386
4564,4571,7832,7,3261,2,7200,1.0021465808
4622,4628,7947,6,3319,2,7200,1.00180777343
4623,4634,7866,11,3232,2,7200,1.00340346535
4638,4644,7775,6,3131,2,7200,1.00191632066
4790,4796,8277,6,3481,2,7200,1.00172364263
5088,5094,8464,6,3370,2,7200,1.00178041543
5140,5146,8527,6,3381,2,7200,1.00177462289
5331,5338,8688,7,3350,2,7200,1.00208955224
5395,5401,8687,6,3286,2,7200,1.00182592818
5414,5421,8889,7,3468,2,7200,1.00201845444
5506,5512,9088,6,3576,2,7200,1.00167785235
5674,5680,9157,6,3477,2,7200,1.00172562554
5689,5696,8839,7,3143,2,7200,1.00222717149
5756,5762,9171,6,3409,2,7200,1.00176004693
6191,6197,9678,6,3481,2,7200,1.00172364263
6374,6381,9841,7,3460,2,7200,1.00202312139
6450,6456,9832,6,3376,2,7200,1.00177725118
6544,6550,10065,6,3515,2,7200,1.00170697013
6559,6565,9956,6,3391,2,7200,1.00176938956
6596,6603,9948,7,3345,2,7200,1.00209267564
6598,6609,9959,11,3350,2,7200,1.00328358209
6765,6771,9899,6,3128,2,7200,1.00191815857
6793,6799,10144,6,3345,2,7200,1.00179372197
6891,6897,10034,6,3137,2,7200,1.0019126554
6906,6912,10092,6,3180,2,7200,1.00188679245
7100,7106,10524,6,3418,2,7200,1.00175541252
7116,7122,10545,6,3423,2,7200,1.00175284838
7153,7159,10802,6,3643,2,7200,1.00164699424
7168,7175,10666,7,3491,2,7200,1.00200515612
7239,7245,10539,6,3294,2,7200,1.00182149362
7254,7260,10568,6,3308,2,7200,1.00181378476
7279,7286,10511,7,3225,2,7200,1.00217054264
7456,7463,10788,7,3325,2,7200,1.00210526316
7484,7490,10701,6,3211,2,7200,1.00186857677
7499,7505,11107,6,3602,2,7200,1.00166574125
7576,7582,10939,6,3357,2,7200,1.0017873101
7676,7683,10787,7,3104,2,7200,1.00225515464
7743,7749,11016,6,3267,2,7200,1.00183654729
7765,7772,10881,7,3109,2,7200,1.00225152782
7780,7788,10920,8,3132,2,7200,1.00255427842
7782,7794,11114,12,3320,2,7200,1.00361445783
7831,7837,10902,6,3065,2,7200,1.00195758564
7867,7873,11062,6,3189,2,7200,1.00188146754
7950,7956,11296,6,3340,2,7200,1.00179640719
8277,8284,11638,7,3354,2,7200,1.00208706023
8465,8472,11831,7,3359,2,7200,1.00208395356
8529,8535,12038,6,3503,2,7200,1.00171281758
8687,8693,12257,6,3564,2,7200,1.00168350168
8689,8700,11936,11,3236,2,7200,1.00339925834
8841,8847,12209,6,3362,2,7200,1.00178465199
8890,8896,12075,6,3179,2,7200,1.00188738597
9089,9095,12259,6,3164,2,7200,1.00189633375
9160,9167,12534,7,3367,2,7200,1.00207900208
9175,9181,12426,6,3245,2,7200,1.00184899846
9678,9685,13009,7,3324,2,7200,1.00210589651
9833,9841,13178,8,3337,2,7200,1.0023973629
9849,9855,13036,6,3181,2,7200,1.00188619931
9901,9907,13042,6,3135,2,7200,1.0019138756
9950,9957,13051,7,3094,2,7200,1.00226244344
9965,9972,13182,7,3210,2,7200,1.00218068536
9967,9978,13490,11,3512,2,7200,1.00313211845
10037,10043,13277,6,3234,2,7200,1.00185528757
10064,10071,13614,7,3543,2,7200,1.00197572679
10095,10101,13373,6,3272,2,7200,1.00183374083
10144,10150,13508,6,3358,2,7200,1.00178677784
10512,10519,14055,7,3536,2,7200,1.00197963801
10527,10533,13860,6,3327,2,7200,1.00180342651
10542,10548,14211,6,3663,2,7200,1.00163800164
10558,10565,13803,7,3238,2,7200,1.00216182829
10573,10579,13851,6,3272,2,7200,1.00183374083
10668,10674,13901,6,3227,2,7200,1.00185931205
10701,10708,14037,7,3329,2,7200,1.00210273355
10790,10797,14073,7,3276,2,7200,1.00213675214
10791,10803,14071,12,3268,2,7200,1.00367197062
10807,10813,14200,6,3387,2,7200,1.00177147919
10883,10890,14196,7,3306,2,7200,1.00211736237
10905,10911,13973,6,3062,2,7200,1.00195950359
10920,10926,14446,6,3520,2,7200,1.00170454545
10939,10945,14189,6,3244,2,7200,1.00184956843
11015,11021,14348,6,3327,2,7200,1.00180342651
11064,11071,14053,7,2982,2,7200,1.00234741784
11108,11114,14326,6,3212,2,7200,1.00186799502
11123,11129,14403,6,3274,2,7200,1.00183262065
11297,11303,14788,6,3485,2,7200,1.00172166428
11638,11644,14682,6,3038,2,7200,1.00197498354
11833,11839,15355,6,3516,2,7200,1.00170648464
12025,12031,15550,6,3519,2,7200,1.00170502984
12158,12164,15556,6,3392,2,7200,1.00176886792
12160,12170,15864,10,3694,2,7200,1.00270709258
12256,12263,15664,7,3401,2,7200,1.00205821817
12258,12269,15446,11,3177,2,7200,1.0034623859
12273,12280,15748,7,3468,2,7200,1.00201845444
12427,12433,15618,6,3185,2,7200,1.00188383046
12533,12540,15914,7,3374,2,7200,1.0020746888
13012,13018,16071,6,3053,2,7200,1.00196528005
13036,13042,16393,6,3351,2,7200,1.0017905103
13052,13058,16446,6,3388,2,7200,1.00177095632
13053,13065,16709,12,3644,2,7200,1.00329308452
13178,13184,16745,6,3561,2,7200,1.00168491997
13193,13199,16634,6,3435,2,7200,1.00174672489
13279,13285,16834,6,3549,2,7200,1.00169061708
13374,13380,16524,6,3144,2,7200,1.00190839695
13493,13500,16718,7,3218,2,7200,1.00217526414
13511,13517,16862,6,3345,2,7200,1.00179372197
13615,13621,16907,6,3286,2,7200,1.00182592818
13805,13811,17146,6,3335,2,7200,1.00179910045
13851,13857,17175,6,3318,2,7200,1.00180831826
13866,13872,17178,6,3306,2,7200,1.00181488203
13900,13906,17210,6,3304,2,7200,1.00181598063
13976,13983,17349,7,3366,2,7200,1.00207961973
14038,14045,17228,7,3183,2,7200,1.00219918316
14053,14059,17260,6,3201,2,7200,1.00187441425
14069,14075,17489,6,3414,2,7200,1.00175746924
14084,14090,17379,6,3289,2,7200,1.00182426269
14085,14097,17483,12,3386,2,7200,1.00354400473
14189,14195,17725,6,3530,2,7200,1.00169971671
14205,14211,17351,6,3140,2,7200,1.00191082803
14206,14217,17189,11,2972,2,7200,1.00370121131
14221,14228,17565,7,3337,2,7200,1.00209769254
14325,14331,17736,6,3405,2,7200,1.00176211454
14350,14357,17733,7,3376,2,7200,1.00207345972
14406,14412,17515,6,3103,2,7200,1.00193361263
14449,14455,17808,6,3353,2,7200,1.00178944229
14721,14727,18048,6,3321,2,7200,1.00180668473
14788,14795,18193,7,3398,2,7200,1.00206003531
15354,15360,18609,6,3249,2,7200,1.00184672207
15445,15451,18614,6,3163,2,7200,1.00189693329
15549,15556,18885,7,3329,2,7200,1.00210273355
15564,15570,18800,6,3230,2,7200,1.00185758514
15616,15623,18834,7,3211,2,7200,1.00218000623
15666,15672,18835,6,3163,2,7200,1.00189693329
15749,15755,18983,6,3228,2,7200,1.00185873606
15865,15871,19582,6,3711,2,7200,1.00161681487
15917,15923,19289,6,3366,2,7200,1.00178253119
16073,16080,19277,7,3197,2,7200,1.00218955271
16393,16399,19789,6,3390,2,7200,1.0017699115
16445,16451,19795,6,3344,2,7200,1.00179425837
16524,16531,19953,7,3422,2,7200,1.00204558738
16638,16644,19897,6,3253,2,7200,1.00184445128
16711,16717,20049,6,3332,2,7200,1.00180072029
16726,16732,19997,6,3265,2,7200,1.00183767228
16745,16751,20257,6,3506,2,7200,1.00171135197
16833,16841,20185,8,3344,2,7200,1.0023923445
16861,16867,20207,6,3340,2,7200,1.00179640719
16908,16914,20232,6,3318,2,7200,1.00180831826
17147,17153,20411,6,3258,2,7200,1.00184162063
17175,17181,20464,6,3283,2,7200,1.00182759671
17190,17197,20647,7,3450,2,7200,1.00202898551
17192,17205,20718,13,3513,2,7200,1.00370054085
17210,17217,20545,7,3328,2,7200,1.00210336538
17229,17235,20406,6,3171,2,7200,1.00189214759
17263,17269,20543,6,3274,2,7200,1.00183262065
17349,17357,20499,8,3142,2,7200,1.00254614895
17351,17362,20695,11,3333,2,7200,1.00330033003
17381,17387,20604,6,3217,2,7200,1.0018650917
17483,17490,20859,7,3369,2,7200,1.00207776788
17498,17504,20547,6,3043,2,7200,1.00197173842
17516,17524,20857,8,3333,2,7200,1.00240024002
17566,17572,20878,6,3306,2,7200,1.00181488203
17728,17734,21226,6,3492,2,7200,1.00171821306
17743,17749,20912,6,3163,2,7200,1.00189693329
17745,17757,21052,12,3295,2,7200,1.00364188164
17809,17816,21189,7,3373,2,7200,1.00207530388
18049,18056,21473,7,3417,2,7200,1.00204858063
18194,18200,21527,6,3327,2,7200,1.00180342651
18612,18618,21602,6,2984,2,7200,1.00201072386
18627,18633,21908,6,3275,2,7200,1.00183206107
18801,18807,22010,6,3203,2,7200,1.00187324383
18835,18841,22080,6,3239,2,7200,1.00185242359
18836,18848,22352,12,3504,2,7200,1.00342465753
18886,18892,21971,6,3079,2,7200,1.00194868464
18984,18990,22205,6,3215,2,7200,1.00186625194
19278,19285,22687,7,3402,2,7200,1.00205761317
19294,19300,22686,6,3386,2,7200,1.00177200236
19582,19589,22777,7,3188,2,7200,1.002195734
19792,19798,23016,6,3218,2,7200,1.00186451212
19808,19814,23223,6,3409,2,7200,1.00176004693
19897,19903,23010,6,3107,2,7200,1.00193112327
19955,19961,23066,6,3105,2,7200,1.00193236715
19998,20004,23307,6,3303,2,7200,1.00181653043
20050,20056,23169,6,3113,2,7200,1.00192740122
20185,20192,23345,7,3153,2,7200,1.00222010783
20210,20216,23463,6,3247,2,7200,1.00184785956
20234,20240,23531,6,3291,2,7200,1.00182315406
20259,20265,23492,6,3227,2,7200,1.00185931205
20409,20415,23625,6,3210,2,7200,1.00186915888
20424,20430,23845,6,3415,2,7200,1.00175695461
20464,20470,23667,6,3197,2,7200,1.00187675946
20501,20508,23737,7,3229,2,7200,1.00216785382
20543,20549,24092,6,3543,2,7200,1.0016934801
20558,20570,24091,12,3521,2,7200,1.00340812269
20559,20576,24039,17,3463,2,7200,1.00490903841
20606,20612,24090,6,3478,2,7200,1.00172512938
20646,20652,24175,6,3523,2,7200,1.00170309395
20698,20704,23903,6,3199,2,7200,1.00187558612
20720,20726,24247,6,3521,2,7200,1.00170406135
20858,20864,24088,6,3224,2,7200,1.00186104218
20859,20870,24198,11,3328,2,7200,1.00330528846
20878,20884,24227,6,3343,2,7200,1.00179479509
20912,20918,24245,6,3327,2,7200,1.00180342651
21053,21059,24409,6,3350,2,7200,1.00179104478
21191,21198,24440,7,3242,2,7200,1.00215916101
21225,21231,24620,6,3389,2,7200,1.00177043376
21474,21480,24848,6,3368,2,7200,1.00178147268
21526,21533,24910,7,3377,2,7200,1.00207284572
21604,21610,24788,6,3178,2,7200,1.00188797986
21908,21914,25199,6,3285,2,7200,1.00182648402
21973,21979,25319,6,3340,2,7200,1.00179640719
22010,22016,25503,6,3487,2,7200,1.0017206768
22084,22090,25685,6,3595,2,7200,1.0016689847
22206,22213,25610,7,3397,2,7200,1.00206064174
22352,22359,25637,7,3278,2,7200,1.00213544844
22688,22694,26012,6,3318,2,7200,1.00180831826
22689,22701,25853,12,3152,2,7200,1.0038071066
22778,22784,26092,6,3308,2,7200,1.00181378476
23013,23019,26418,6,3399,2,7200,1.00176522507
23028,23036,26330,8,3294,2,7200,1.00242865817
23068,23076,26222,8,3146,2,7200,1.00254291163
23169,23175,26592,6,3417,2,7200,1.00175592625
23224,23230,26643,6,3413,2,7200,1.00175798418
23306,23313,26806,7,3493,2,7200,1.00200400802
23346,23353,26726,7,3373,2,7200,1.00207530388
23463,23470,26833,7,3363,2,7200,1.00208147487
23491,23497,26964,6,3467,2,7200,1.00173060283
23531,23537,26829,6,3292,2,7200,1.00182260024
23626,23632,27090,6,3458,2,7200,1.001735107
23669,23675,26976,6,3301,2,7200,1.00181763102
23736,23742,27190,6,3448,2,7200,1.00174013921
23881,23887,27420,6,3533,2,7200,1.00169827342
23908,23914,27389,6,3475,2,7200,1.00172661871
24083,24091,27362,8,3271,2,7200,1.00244573525
24100,24106,27650,6,3544,2,7200,1.00169300226
24101,24112,27578,11,3466,2,7200,1.00317368725
24102,24118,27391,16,3273,2,7200,1.00488848152
24104,24123,27708,19,3585,2,7200,1.00529986053
24175,24181,27317,6,3136,2,7200,1.00191326531
24200,24206,27491,6,3285,2,7200,1.00182648402
24227,24234,27515,7,3281,2,7200,1.00213349589
24246,24252,27506,6,3254,2,7200,1.00184388445
24248,24260,27656,12,3396,2,7200,1.0035335689
24413,24420,27660,7,3240,2,7200,1.00216049383
24440,24447,28078,7,3631,2,7200,1.00192784357
24621,24627,28290,6,3663,2,7200,1.00163800164
24789,24796,28210,7,3414,2,7200,1.00205038079
24848,24854,28196,6,3342,2,7200,1.00179533214
24912,24918,28090,6,3172,2,7200,1.00189155107
25200,25206,28302,6,3096,2,7200,1.0019379845
25320,25326,28712,6,3386,2,7200,1.00177200236
25505,25511,28782,6,3271,2,7200,1.00183430144
25612,25618,28928,6,3310,2,7200,1.00181268882
25640,25646,29037,6,3391,2,7200,1.00176938956
25686,25692,29019,6,3327,2,7200,1.00180342651
25854,25860,29332,6,3472,2,7200,1.0017281106
26012,26018,29319,6,3301,2,7200,1.00181763102
26094,26101,29684,7,3583,2,7200,1.00195367011
26223,26228,29584,5,3356,2,7200,1.00148986889
26329,26336,29169,7,2833,2,7200,1.00247087893
26421,26427,29987,6,3560,2,7200,1.00168539326
26595,26602,30099,7,3497,2,7200,1.00200171576
26644,26650,30097,6,3447,2,7200,1.00174064404
26727,26733,30141,6,3408,2,7200,1.00176056338
26807,26813,30145,6,3332,2,7200,1.00180072029
26829,26835,30050,6,3215,2,7200,1.00186625194
26845,26851,30075,6,3224,2,7200,1.00186104218
26965,26971,30372,6,3401,2,7200,1.001764187
26980,26986,30135,6,3149,2,7200,1.00190536678
27090,27097,30178,7,3081,2,7200,1.00227198961
27191,27198,30647,7,3449,2,7200,1.00202957379
27317,27323,30737,6,3414,2,7200,1.00175746924
27363,27369,30691,6,3322,2,7200,1.00180614088
27391,27397,30706,6,3309,2,7200,1.00181323663
27393,27403,30763,10,3360,2,7200,1.00297619048
27420,27427,30788,7,3361,2,7200,1.00208271348
27495,27501,30803,6,3302,2,7200,1.00181708056
27510,27517,30708,7,3191,2,7200,1.0021936697
27526,27532,30831,6,3299,2,7200,1.00181873295
27578,27585,30911,7,3326,2,7200,1.00210463019
27653,27659,31021,6,3362,2,7200,1.00178465199
27669,27675,31180,6,3505,2,7200,1.00171184023
27670,27682,31169,12,3487,2,7200,1.0034413536
27710,27716,31027,6,3311,2,7200,1.00181214135
27834,27841,28837,7,996,1,36000,1.00702811245
27874,27880,27893,6,13,1,36000,1.46153846154
28077,28085,31367,8,3282,2,7200,1.00243753809
28093,28099,31691,6,3592,2,7200,1.00167037862
28197,28203,31259,6,3056,2,7200,1.00196335079
28212,28219,31847,7,3628,2,7200,1.00192943771
28290,28296,31378,6,3082,2,7200,1.0019467878
28305,28311,31692,6,3381,2,7200,1.00177462289
28714,28721,32029,7,3308,2,7200,1.00211608222
28785,28791,32021,6,3230,2,7200,1.00185758514
28891,28897,31095,6,2198,1,36000,1.00272975432
28929,28935,32345,6,3410,2,7200,1.00175953079
29018,29024,32119,6,3095,2,7200,1.00193861066
29037,29043,32428,6,3385,2,7200,1.00177252585
29168,29174,32540,6,3366,2,7200,1.00178253119
29322,29329,32666,7,3337,2,7200,1.00209769254
29337,29343,33033,6,3690,2,7200,1.00162601626
29585,29592,32919,7,3327,2,7200,1.0021039976
29687,29694,33059,7,3365,2,7200,1.00208023774
29988,29994,33236,6,3242,2,7200,1.00185070944
30052,30058,33386,6,3328,2,7200,1.00180288462
30077,30083,33198,6,3115,2,7200,1.00192616372
30095,30101,33444,6,3343,2,7200,1.00179479509
30111,30118,33505,7,3387,2,7200,1.00206672572
30136,30143,33708,7,3565,2,7200,1.00196353436
30151,30157,33798,6,3641,2,7200,1.00164789893
30153,30164,33234,11,3070,2,7200,1.00358306189
30180,30187,33206,7,3019,2,7200,1.00231864856
30374,30381,33598,7,3217,2,7200,1.00217594032
30648,30656,33935,8,3279,2,7200,1.00243976822
30692,30699,34199,7,3500,2,7200,1.002
30708,30714,34185,6,3471,2,7200,1.00172860847
30709,30720,33944,11,3224,2,7200,1.00341191067
30737,30743,33877,6,3134,2,7200,1.00191448628
30765,30772,33998,7,3226,2,7200,1.00216986981
30787,30793,34042,6,3249,2,7200,1.00184672207
30802,30810,34104,8,3294,2,7200,1.00242865817
30830,30836,34506,6,3670,2,7200,1.00163487738
30913,30919,34194,6,3275,2,7200,1.00183206107
31016,31022,31165,6,143,16,610,1.04195804196
31023,31029,34277,6,3248,2,7200,1.00184729064
31038,31044,34509,6,3465,2,7200,1.00173160173
31131,31138,32569,7,1431,1,36000,1.00489168414
31183,31189,34457,6,3268,2,7200,1.00183598531
31184,31196,34444,12,3248,2,7200,1.00369458128
31272,31278,34606,6,3328,2,7200,1.00180288462
31371,31377,34810,6,3433,2,7200,1.0017477425
31395,31401,34591,6,3190,2,7200,1.00188087774
31825,31832,34980,7,3148,2,7200,1.00222363405
31826,31838,35164,12,3326,2,7200,1.00360793746
31847,31853,35394,6,3541,2,7200,1.0016944366
32031,32037,35468,6,3431,2,7200,1.00174876129
32032,32043,35384,11,3341,2,7200,1.00329242742
32081,32088,32262,7,174,16,610,1.04022988506
32121,32127,35530,6,3403,2,7200,1.00176315016
32397,32403,35802,6,3399,2,7200,1.00176522507
32435,32441,35629,6,3188,2,7200,1.00188205772
32541,32547,36001,6,3454,2,7200,1.00173711639
32628,32635,32756,7,121,1,36000,1.05785123967
32667,32673,35948,6,3275,2,7200,1.00183206107
32805,32811,54388,6,21577,1,36000,1.00027807387
32922,32928,36243,6,3315,2,7200,1.00180995475
33035,33042,36170,7,3128,2,7200,1.00223785166
33060,33066,36460,6,3394,2,7200,1.00176782557
33198,33204,36483,6,3279,2,7200,1.00182982617
33213,33219,36502,6,3283,2,7200,1.00182759671
33232,33238,36631,6,3393,2,7200,1.0017683466
33233,33244,36758,11,3514,2,7200,1.0031303358
33388,33395,36640,7,3245,2,7200,1.00215716487
33444,33450,36845,6,3395,2,7200,1.00176730486
33506,33512,36784,6,3272,2,7200,1.00183374083
33527,53123,125173,19596,72050,1,72000,1.2719777932
33527,53176,125214,19649,72038,1,72000,1.27275882173
33528,53381,125431,19853,72050,1,72000,1.27554476058
33540,53386,161428,19846,108042,1,108000,1.18368782511
33540,54400,162425,20860,108025,1,108000,1.19310344828
33541,55223,163236,21682,108013,1,108000,1.2007350967
33598,33605,37363,7,3758,2,7200,1.00186269292
33709,33715,36908,6,3193,2,7200,1.00187911055
33802,33809,36897,7,3088,2,7200,1.00226683938
33879,33885,37217,6,3332,2,7200,1.00180072029
33935,33941,37133,6,3192,2,7200,1.00187969925
33950,33956,37243,6,3287,2,7200,1.00182537268
33999,34006,36998,7,2992,2,7200,1.00233957219
34043,34049,37260,6,3211,2,7200,1.00186857677
34105,34112,37275,7,3163,2,7200,1.00221308884
34189,34195,37707,6,3512,2,7200,1.00170842825
34205,34211,37618,6,3407,2,7200,1.00176108013
34207,34218,37582,11,3364,2,7200,1.00326991677
34278,34284,37847,6,3563,2,7200,1.00168397418
34446,34453,37669,7,3216,2,7200,1.00217661692
34462,34468,38101,6,3633,2,7200,1.00165152766
34506,34512,38097,6,3585,2,7200,1.00167364017
34521,34528,37752,7,3224,2,7200,1.00217121588
34592,34598,37778,6,3180,2,7200,1.00188679245
34608,34614,38118,6,3504,2,7200,1.00171232877
34811,34817,38190,6,3373,2,7200,1.0017788319
34963,34970,35137,7,167,16,610,1.04191616766
34982,34988,38198,6,3210,2,7200,1.00186915888
35166,35172,38570,6,3398,2,7200,1.00176574456
35386,35392,38825,6,3433,2,7200,1.0017477425
35401,35409,39062,8,3653,2,7200,1.00218998084
35466,35472,39022,6,3550,2,7200,1.00169014085
35531,35538,39045,7,3507,2,7200,1.00199600798
35629,35636,39243,7,3607,2,7200,1.00194067092
35639,55872,55874,20233,2,1,259200,2023.5
35801,35807,38992,6,3185,2,7200,1.00188383046
35826,35833,36149,7,316,16,610,1.02215189873
35948,35955,39277,7,3322,2,7200,1.00210716436
36000,36007,39355,7,3348,2,7200,1.00209080048
36169,36176,39801,7,3625,2,7200,1.00193103448
36243,36249,39536,6,3287,2,7200,1.00182537268
36461,36467,39832,6,3365,2,7200,1.00178306092
36486,36492,39802,6,3310,2,7200,1.00181268882
36504,36511,39851,7,3340,2,7200,1.00209580838
36630,36637,39861,7,3224,2,7200,1.00217121588
36645,36651,39883,6,3232,2,7200,1.00185643564
36680,55913,56751,19233,838,1,36000,23.9510739857
36758,36764,39878,6,3114,2,7200,1.00192678227
36786,36792,40437,6,3645,2,7200,1.00164609053
36845,36851,40158,6,3307,2,7200,1.00181433323
36900,36906,40316,6,3410,2,7200,1.00175953079
36915,36922,40289,7,3367,2,7200,1.00207900208
36999,37005,40471,6,3466,2,7200,1.00173110214
37133,37139,40530,6,3391,2,7200,1.00176938956
37183,37189,37277,6,88,16,610,1.06818181818
37216,37222,40318,6,3096,2,7200,1.0019379845
37244,37250,40494,6,3244,2,7200,1.00184956843
37262,37269,40535,7,3266,2,7200,1.00214329455
37277,37284,40640,7,3356,2,7200,1.00208581645
37364,37371,40847,7,3476,2,7200,1.00201380898
37582,37588,40791,6,3203,2,7200,1.00187324383
37616,37622,41029,6,3407,2,7200,1.00176108013
37668,37674,41062,6,3388,2,7200,1.00177095632
37708,37715,41160,7,3445,2,7200,1.00203193033
37752,37758,41107,6,3349,2,7200,1.00179157958
37780,37786,41247,6,3461,2,7200,1.001733603
37848,37855,41473,7,3618,2,7200,1.00193477059
38098,38104,41390,6,3286,2,7200,1.00182592818
38113,38119,41748,6,3629,2,7200,1.00165334803
38128,38134,41535,6,3401,2,7200,1.001764187
38189,38196,41490,7,3294,2,7200,1.0021250759
38208,38214,41883,6,3669,2,7200,1.00163532298
38437,38443,38519,6,76,16,610,1.07894736842
38570,38578,41904,8,3326,2,7200,1.00240529164
38826,38832,42398,6,3566,2,7200,1.00168255749
38993,38999,42272,6,3273,2,7200,1.00183318057
39021,39027,42384,6,3357,2,7200,1.0017873101
39046,39052,42556,6,3504,2,7200,1.00171232877
39064,39070,42476,6,3406,2,7200,1.00176159718
39242,39249,42540,7,3291,2,7200,1.00212701307
39279,39286,42616,7,3330,2,7200,1.0021021021
39356,39363,42845,7,3482,2,7200,1.00201033889
39537,39543,42917,6,3374,2,7200,1.00177830468
39801,39807,42853,6,3046,2,7200,1.00196979645
39802,39814,43130,12,3316,2,7200,1.00361881785
39833,39840,43175,7,3335,2,7200,1.00209895052
39852,39858,43032,6,3174,2,7200,1.00189035917
39867,39874,43089,7,3215,2,7200,1.00217729393
39883,39890,43378,7,3488,2,7200,1.00200688073
39884,39897,43377,13,3480,2,7200,1.00373563218
39904,39910,39918,6,8,16,300,1.4
39990,39996,40002,6,6,16,300,1.2
40077,40084,40089,7,5,16,300,1.2
40159,40167,43546,8,3379,2,7200,1.00236756437
40272,56767,60061,16495,3294,1,36000,6.00758955677
40291,40297,43536,6,3239,2,7200,1.00185242359
40316,40322,43580,6,3258,2,7200,1.00184162063
40317,40329,43755,12,3426,2,7200,1.00350262697
40437,40444,43644,7,3200,2,7200,1.0021875
40474,40480,44021,6,3541,2,7200,1.0016944366
40495,40502,43767,7,3265,2,7200,1.002143951
40498,40509,40514,11,5,16,300,1.6
40532,40539,43945,7,3406,2,7200,1.00205519671
40548,40554,43670,6,3116,2,7200,1.00192554557
40643,40649,44025,6,3376,2,7200,1.00177725118
40739,40746,40751,7,5,16,300,1.2
40792,40798,44162,6,3364,2,7200,1.00178359096
40848,40855,44496,7,3641,2,7200,1.00192254875
41030,41036,44380,6,3344,2,7200,1.00179425837
41064,41070,44421,6,3351,2,7200,1.0017905103
41099,41106,41110,7,4,16,300,1.1
41106,41114,44467,8,3353,2,7200,1.00238592305
41162,41168,44345,6,3177,2,7200,1.00188857413
41248,41254,44465,6,3211,2,7200,1.00186857677
41393,41400,44573,7,3173,2,7200,1.00220611409
41474,41481,44818,7,3337,2,7200,1.00209769254
41489,41496,44941,7,3445,2,7200,1.00203193033
41536,41543,44736,7,3193,2,7200,1.00219229565
41562,41569,41651,7,82,16,610,1.08536585366
41750,41756,45093,6,3337,2,7200,1.00179802218
41884,41891,45106,7,3215,2,7200,1.00217729393
41905,41912,45230,7,3318,2,7200,1.00210970464
42275,42282,45794,7,3512,2,7200,1.00199316629
42385,42392,45461,7,3069,2,7200,1.00228087325
42400,42406,45837,6,3431,2,7200,1.00174876129
42477,42483,45713,6,3230,2,7200,1.00185758514
42513,42519,42614,6,95,16,610,1.06315789474
42542,42548,45757,6,3209,2,7200,1.00186974135
42557,42565,45933,8,3368,2,7200,1.00237529691
42619,42625,45882,6,3257,2,7200,1.00184218606
42845,42851,46372,6,3521,2,7200,1.00170406135
42860,42867,46302,7,3435,2,7200,1.00203784571
42920,42927,46352,7,3425,2,7200,1.00204379562
42921,42934,46197,13,3263,2,7200,1.00398406375
42922,42939,46338,17,3399,2,7200,1.00500147102
42923,42944,46031,21,3087,2,7200,1.00680272109
42925,42949,46348,24,3399,2,7200,1.00706090026
42926,42955,46226,29,3271,2,7200,1.00886579028
42927,42960,46392,33,3432,2,7200,1.00961538462
42929,42966,46185,37,3219,2,7200,1.01149425287
42930,42972,46642,42,3670,2,7200,1.01144414169
42931,42977,46391,46,3414,2,7200,1.01347393087
42933,42982,46287,49,3305,2,7200,1.01482602118
42934,42987,46055,53,3068,2,7200,1.01727509778
42935,42992,46239,57,3247,2,7200,1.01755466585
42937,42998,46214,61,3216,2,7200,1.01896766169
42938,43003,46210,65,3207,2,7200,1.02026816339
42939,43008,46456,69,3448,2,7200,1.02001160093
42941,43013,46385,72,3372,2,7200,1.02135231317
42942,43019,46350,77,3331,2,7200,1.02311618133
42943,43024,46315,81,3291,2,7200,1.02461257976
42945,43029,46399,84,3370,2,7200,1.02492581602
42946,43034,46620,88,3586,2,7200,1.0245398773
42947,43040,46448,93,3408,2,7200,1.02728873239
42949,43046,46379,97,3333,2,7200,1.02910291029
42950,43051,46280,101,3229,2,7200,1.03127903376
42951,43057,46246,106,3189,2,7200,1.03323925996
42953,43062,46584,109,3522,2,7200,1.03094832482
42954,43067,46052,113,2985,2,7200,1.0378559464
42955,43072,46276,117,3204,2,7200,1.03651685393
42957,43077,46739,120,3662,2,7200,1.0327689787
42958,43083,46567,125,3484,2,7200,1.0358783008
42959,43088,46487,129,3399,2,7200,1.03795233892
42961,43093,46252,132,3159,2,7200,1.04178537512
42962,43100,46414,138,3314,2,7200,1.04164152082
42963,43105,46640,142,3535,2,7200,1.04016973126
42965,43110,46473,145,3363,2,7200,1.04311626524
42966,43115,46319,149,3204,2,7200,1.04650436954
42967,43121,46387,154,3266,2,7200,1.0471524801
42969,43126,46355,157,3229,2,7200,1.04862186435
42970,43131,46263,161,3132,2,7200,1.05140485313
42971,43136,46384,165,3248,2,7200,1.05080049261
42973,43141,46727,168,3586,2,7200,1.04684885666
42974,43147,46549,173,3402,2,7200,1.05085243974
42975,43152,46373,177,3221,2,7200,1.0549518783
42977,43157,46414,180,3257,2,7200,1.05526558182
42978,43162,46345,184,3183,2,7200,1.05780710022
42979,43168,46569,189,3401,2,7200,1.05557189062
42981,43173,46654,192,3481,2,7200,1.05515656421
42982,43178,46530,196,3352,2,7200,1.0584725537
42983,43183,46617,200,3434,2,7200,1.05824111823
42985,43189,46708,204,3519,2,7200,1.05797101449
42986,43194,46598,208,3404,2,7200,1.06110458284
43033,43199,46451,166,3252,2,7200,1.05104551046
43089,43204,46490,115,3286,2,7200,1.03499695679
43130,43211,46347,81,3136,2,7200,1.02582908163
43176,43216,46836,40,3620,2,7200,1.01104972376
43379,43387,46603,8,3216,2,7200,1.00248756219
43381,43392,46895,11,3503,2,7200,1.00314016557
43538,43545,46712,7,3167,2,7200,1.00221029365
43554,43561,46510,7,2949,2,7200,1.002373686
43582,43588,47056,6,3468,2,7200,1.00173010381
43647,43653,47091,6,3438,2,7200,1.0017452007
43672,43678,47119,6,3441,2,7200,1.00174367916
43758,43765,47057,7,3292,2,7200,1.00212636695
43773,43781,46713,8,2932,2,7200,1.00272851296
43945,43952,47324,7,3372,2,7200,1.00207591934
44022,44028,47527,6,3499,2,7200,1.00171477565
44037,44043,47352,6,3309,2,7200,1.00181323663
44163,44170,47451,7,3281,2,7200,1.00213349589
44346,44352,47876,6,3524,2,7200,1.00170261067
44380,44388,47539,8,3151,2,7200,1.00253887655
44425,44432,47840,7,3408,2,7200,1.00205399061
44465,44471,47797,6,3326,2,7200,1.00180396873
44481,44487,47794,6,3307,2,7200,1.00181433323
44497,44504,47615,7,3111,2,7200,1.00225008036
44578,44585,48058,7,3473,2,7200,1.00201554852
44737,44744,48183,7,3439,2,7200,1.00203547543
44820,44827,48331,7,3504,2,7200,1.00199771689
44943,44949,48165,6,3216,2,7200,1.00186567164
45026,60242,239165,15216,178923,18,288000,1.08504216898
45095,45103,48569,8,3466,2,7200,1.00230813618
45111,45117,48164,6,3047,2,7200,1.00196914998
45231,45238,48524,7,3286,2,7200,1.00213024954
45433,45895,46007,462,112,16,610,5.125
45462,45469,48834,7,3365,2,7200,1.00208023774
45716,45722,48990,6,3268,2,7200,1.00183598531
45756,45763,49075,7,3312,2,7200,1.00211352657
45796,45803,49164,7,3361,2,7200,1.00208271348
45839,45847,49238,8,3391,2,7200,1.00235918608
45885,45945,49157,60,3212,2,7200,1.01867995019
45935,46020,49419,85,3399,2,7200,1.0250073551
46033,46040,49318,7,3278,2,7200,1.00213544844
46054,46061,49260,7,3199,2,7200,1.00218818381
46056,46068,49333,12,3265,2,7200,1.00367534456
46184,46192,49662,8,3470,2,7200,1.0023054755
46200,46206,49752,6,3546,2,7200,1.00169204738
46216,46223,49660,7,3437,2,7200,1.00203665988
46217,46230,49709,13,3479,2,7200,1.00373670595
46233,46240,49610,7,3370,2,7200,1.00207715134
46249,46255,49535,6,3280,2,7200,1.00182926829
46250,46262,49704,12,3442,2,7200,1.00348634515
46267,46274,49815,7,3541,2,7200,1.0019768427
46268,46281,49696,13,3415,2,7200,1.00380673499
46269,46375,46486,106,111,16,610,1.95495495495
46284,46292,49591,8,3299,2,7200,1.00242497727
46286,46299,49652,13,3353,2,7200,1.00387712496
46301,46308,49432,7,3124,2,7200,1.00224071703
46303,46315,49484,12,3169,2,7200,1.0037866835
46319,46326,49416,7,3090,2,7200,1.00226537217
46320,46332,49583,12,3251,2,7200,1.00369117195
46339,46346,49826,7,3480,2,7200,1.00201149425
46355,46363,49702,8,3339,2,7200,1.00239592692
46356,46368,49569,12,3201,2,7200,1.00374882849
46358,46380,49746,22,3366,2,7200,1.00653594771
46359,46385,49803,26,3418,2,7200,1.0076067876
46360,46391,49657,31,3266,2,7200,1.00949173301
46362,46398,50137,36,3739,2,7200,1.00962824285
46378,46404,49602,26,3198,2,7200,1.0081300813
46380,46409,49708,29,3299,2,7200,1.00879054259
46396,46416,49346,20,2930,2,7200,1.00682593857
46398,46421,49632,23,3211,2,7200,1.00716287761
46399,46427,49879,28,3452,2,7200,1.00811123986
46401,46432,49872,31,3440,2,7200,1.00901162791
46402,46437,49641,35,3204,2,7200,1.01092384519
46404,46442,49917,38,3475,2,7200,1.0109352518
46420,46449,49637,29,3188,2,7200,1.0090966123
46421,46454,49683,33,3229,2,7200,1.01021988232
46423,46461,49676,38,3215,2,7200,1.01181959565
46448,46468,49963,20,3495,2,7200,1.00572246066
46463,46475,49647,12,3172,2,7200,1.00378310214
46465,46485,49837,20,3352,2,7200,1.00596658711
46480,46498,49756,18,3258,2,7200,1.00552486188
46496,46505,49783,9,3278,2,7200,1.00274557657
46497,46510,49755,13,3245,2,7200,1.00400616333
46513,46519,50016,6,3497,2,7200,1.00171575636
46532,46538,49829,6,3291,2,7200,1.00182315406
46551,46557,49875,6,3318,2,7200,1.00180831826
46569,46577,50051,8,3474,2,7200,1.00230282096
46571,46582,49771,11,3189,2,7200,1.00344935717
46586,46592,49873,6,3281,2,7200,1.00182871076
46602,46609,49726,7,3117,2,7200,1.00224574912
46603,46616,50183,13,3567,2,7200,1.0036445192
46619,46626,50093,7,3467,2,7200,1.00201903663
46621,46633,50094,12,3461,2,7200,1.00346720601
46639,46647,49756,8,3109,2,7200,1.00257317465
46641,46654,49826,13,3172,2,7200,1.00409836066
46657,46664,50012,7,3348,2,7200,1.00209080048
46709,46716,50087,7,3371,2,7200,1.00207653515
46725,46731,49999,6,3268,2,7200,1.00183598531
46726,46737,50054,11,3317,2,7200,1.00331624962
46743,46750,50177,7,3427,2,7200,1.00204260286
46744,46757,49979,13,3222,2,7200,1.00403476102
46837,46844,50277,7,3433,2,7200,1.00203903292
46896,46902,50336,6,3434,2,7200,1.00174723355
47059,47066,50313,7,3247,2,7200,1.00215583616
47060,47073,50367,13,3294,2,7200,1.00394656952
47091,47099,50609,8,3510,2,7200,1.00227920228
47122,47129,50332,7,3203,2,7200,1.00218545114
47169,47807,47898,638,91,16,610,8.01098901099
47170,47909,47996,739,87,16,610,9.49425287356
47171,48008,48080,837,72,16,610,12.625
47172,48093,48154,921,61,16,610,16.0983606557
47325,47331,50356,6,3025,2,7200,1.00198347107
47353,47360,50710,7,3350,2,7200,1.00208955224
47452,47459,50887,7,3428,2,7200,1.002042007
47528,47536,50843,8,3307,2,7200,1.00241911098
47544,47551,50897,7,3346,2,7200,1.00209205021
47615,47622,51019,7,3397,2,7200,1.00206064174
47797,47915,51326,118,3411,2,7200,1.03459396072
47798,47920,51350,122,3430,2,7200,1.03556851312
47842,47925,51302,83,3377,2,7200,1.02457802784
47879,48098,51437,219,3339,2,7200,1.06558849955
48060,48166,51483,106,3317,2,7200,1.03195658728
48166,48173,51502,7,3329,2,7200,1.00210273355
48167,48180,51833,13,3653,2,7200,1.00355871886
48186,48193,51442,7,3249,2,7200,1.00215450908
48333,48340,51781,7,3441,2,7200,1.00203429236
48527,48533,52117,6,3584,2,7200,1.00167410714
48570,48576,51993,6,3417,2,7200,1.00175592625
48619,49169,49303,550,134,16,610,5.10447761194
48620,49315,49430,695,115,16,610,7.04347826087
48643,60534,65802,11891,5268,1,36000,3.25721336371
48836,48846,52269,10,3423,2,7200,1.00292141396
48992,49003,52337,11,3334,2,7200,1.00329934013
49075,49087,52467,12,3380,2,7200,1.00355029586
49159,49176,52548,17,3372,2,7200,1.00504151839
49175,49250,52470,75,3220,2,7200,1.02329192547
49239,49320,52893,81,3573,2,7200,1.02267002519
49262,49330,52920,68,3590,2,7200,1.01894150418
49321,49346,52608,25,3262,2,7200,1.00766400981
49337,49358,52725,21,3367,2,7200,1.00623700624
49352,49427,52646,75,3219,2,7200,1.02329916123
49417,49434,52725,17,3291,2,7200,1.00516560316
49433,49442,52614,9,3172,2,7200,1.00283732661
49435,49447,53061,12,3614,2,7200,1.00332042059
49487,49493,52806,6,3313,2,7200,1.00181104739
49537,49544,52411,7,2867,2,7200,1.00244157656
49571,49578,52812,7,3234,2,7200,1.00216450216
49586,49594,52887,8,3293,2,7200,1.00242939569
49602,49608,52765,6,3157,2,7200,1.00190053849
49603,49615,52860,12,3245,2,7200,1.00369799692
49619,49626,52926,7,3300,2,7200,1.00212121212
49635,49642,53001,7,3359,2,7200,1.00208395356
49651,49658,53110,7,3452,2,7200,1.00202780997
49652,49665,52968,13,3303,2,7200,1.00393581592
49654,49670,52886,16,3216,2,7200,1.00497512438
49655,49675,53216,20,3541,2,7200,1.005648122
49671,49683,52890,12,3207,2,7200,1.00374181478
49673,49688,52740,15,3052,2,7200,1.00491480996
49674,49693,53358,19,3665,2,7200,1.00518417462
49690,49700,53111,10,3411,2,7200,1.00293169159
49691,49705,53123,14,3418,2,7200,1.00409596255
49707,49713,53266,6,3553,2,7200,1.00168871376
49709,49720,53069,11,3349,2,7200,1.00328456256
49710,49726,52881,16,3155,2,7200,1.00507131537
49711,49731,53057,20,3326,2,7200,1.0060132291
49713,49737,53054,24,3317,2,7200,1.00723545372
49729,49744,53132,15,3388,2,7200,1.00442739079
49748,49754,52930,6,3176,2,7200,1.00188916877
49765,49771,52866,6,3095,2,7200,1.00193861066
49766,49777,53160,11,3383,2,7200,1.00325155188
49767,49782,53297,15,3515,2,7200,1.00426742532
49769,49788,53157,19,3369,2,7200,1.00563965568
49784,49794,53112,10,3318,2,7200,1.00301386377
49786,49800,53103,14,3303,2,7200,1.004238571
49805,49811,53116,6,3305,2,7200,1.00181543116
49820,49827,52923,7,3096,2,7200,1.00226098191
49837,49843,53164,6,3321,2,7200,1.00180668473
49838,49850,53221,12,3371,2,7200,1.00355977455
49840,49855,53284,15,3429,2,7200,1.00437445319
49841,49860,53181,19,3321,2,7200,1.00572116832
49873,49880,53166,7,3286,2,7200,1.00213024954
49874,49887,53113,13,3226,2,7200,1.00402975821
49890,49897,53369,7,3472,2,7200,1.00201612903
49892,49904,53166,12,3262,2,7200,1.00367872471
49920,49926,53453,6,3527,2,7200,1.00170116246
49966,49972,53138,6,3166,2,7200,1.00189513582
49981,49988,53212,7,3224,2,7200,1.00217121588
50000,50007,53383,7,3376,2,7200,1.00207345972
50016,50022,53301,6,3279,2,7200,1.00182982617
50017,50029,53244,12,3215,2,7200,1.00373250389
50054,50061,53148,7,3087,2,7200,1.0022675737
50056,50068,53209,12,3141,2,7200,1.00382043935
50091,50097,53384,6,3287,2,7200,1.00182537268
50106,50113,53483,7,3370,2,7200,1.00207715134
50108,50120,53346,12,3226,2,7200,1.00371977681
50139,50145,53625,6,3480,2,7200,1.00172413793
50178,50184,53570,6,3386,2,7200,1.00177200236
50193,50200,53487,7,3287,2,7200,1.00212960146
50279,50285,53581,6,3296,2,7200,1.00182038835
50313,50320,53862,7,3542,2,7200,1.00197628458
50332,50338,53403,6,3065,2,7200,1.00195758564
50348,50355,53708,7,3353,2,7200,1.00208768267
50364,50370,53625,6,3255,2,7200,1.00184331797
50379,50386,53930,7,3544,2,7200,1.0019751693
50460,51451,51550,991,99,16,610,11.0101010101
50611,50617,53843,6,3226,2,7200,1.00185988841
50713,50720,54023,7,3303,2,7200,1.0021192855
50845,50853,54383,8,3530,2,7200,1.00226628895
50888,50894,54045,6,3151,2,7200,1.00190415741
50904,50910,54270,6,3360,2,7200,1.00178571429
51021,51027,54615,6,3588,2,7200,1.0016722408
51305,51312,54564,7,3252,2,7200,1.00215252153
51330,51337,54527,7,3190,2,7200,1.00219435737
51351,51358,54864,7,3506,2,7200,1.0019965773
51438,51445,54668,7,3223,2,7200,1.00217188954
51453,51461,54660,8,3199,2,7200,1.00250078149
51484,51490,54775,6,3285,2,7200,1.00182648402
51502,51509,54591,7,3082,2,7200,1.00227125243
51783,51789,54948,6,3159,2,7200,1.00189933523
51836,51842,55165,6,3323,2,7200,1.00180559735
51995,52002,55201,7,3199,2,7200,1.00218818381
52120,52126,55451,6,3325,2,7200,1.00180451128
52271,52277,55742,6,3465,2,7200,1.00173160173
52338,52345,55438,7,3093,2,7200,1.00226317491
52412,52420,55498,8,3078,2,7200,1.00259909032
52468,52474,55689,6,3215,2,7200,1.00186625194
52470,52481,55671,11,3190,2,7200,1.00344827586
52550,52556,55764,6,3208,2,7200,1.00187032419
52609,52616,55856,7,3240,2,7200,1.00216049383
52624,52630,56130,6,3500,2,7200,1.00171428571
52649,52655,56112,6,3457,2,7200,1.00173560891
52729,52737,55957,8,3220,2,7200,1.00248447205
52731,52743,55947,12,3204,2,7200,1.00374531835
52746,52754,56081,8,3327,2,7200,1.00240456868
52768,52774,56090,6,3316,2,7200,1.00180940893
52805,52812,56172,7,3360,2,7200,1.00208333333
52821,52828,55965,7,3137,2,7200,1.0022314313
52860,52867,56391,7,3524,2,7200,1.00198637911
52876,52882,56192,6,3310,2,7200,1.00181268882
52893,52899,56197,6,3298,2,7200,1.00181928441
52894,52906,56180,12,3274,2,7200,1.0036652413
52895,52911,56240,16,3329,2,7200,1.00480624812
52897,52916,56107,19,3191,2,7200,1.00595424632
52898,52922,56004,24,3082,2,7200,1.0077871512
52920,52928,56299,8,3371,2,7200,1.00237318303
52937,52944,56100,7,3156,2,7200,1.00221799747
52938,52950,56309,12,3359,2,7200,1.00357249181
52940,52955,56233,15,3278,2,7200,1.00457596095
52971,52978,56361,7,3383,2,7200,1.00206916938
53002,53008,56247,6,3239,2,7200,1.00185242359
53054,53061,56465,7,3404,2,7200,1.00205640423
53070,53077,56513,7,3436,2,7200,1.00203725262
53072,53084,56191,12,3107,2,7200,1.00386224654
53073,53089,56553,16,3464,2,7200,1.00461893764
53104,53111,56412,7,3301,2,7200,1.00212056952
53121,53130,56409,9,3279,2,7200,1.00274473925
53123,53135,56478,12,3343,2,7200,1.00358959019
53124,53142,56561,18,3419,2,7200,1.00526469728
53125,53147,56623,22,3476,2,7200,1.00632911392
53127,53152,56606,25,3454,2,7200,1.00723798494
53143,53159,56439,16,3280,2,7200,1.00487804878
53145,53164,56436,19,3272,2,7200,1.00580684597
53146,53169,56390,23,3221,2,7200,1.00714063955
53162,53182,56475,20,3293,2,7200,1.00607348922
53163,53187,56543,24,3356,2,7200,1.00715137068
53165,53192,56546,27,3354,2,7200,1.00805008945
53181,53199,56477,18,3278,2,7200,1.00549115314
53182,53204,56593,22,3389,2,7200,1.00649159044
53184,53209,56347,25,3138,2,7200,1.00796685787
53199,53216,56647,17,3431,2,7200,1.00495482367
53215,53223,56681,8,3458,2,7200,1.002313476
53217,53228,56705,11,3477,2,7200,1.00316364682
53218,53235,56793,17,3558,2,7200,1.00477796515
53234,53242,56708,8,3466,2,7200,1.00230813618
53249,53256,56401,7,3145,2,7200,1.00222575517
53268,53274,56820,6,3546,2,7200,1.00169204738
53284,53290,56706,6,3416,2,7200,1.00175644028
53299,53307,56629,8,3322,2,7200,1.00240818784
53315,53321,56937,6,3616,2,7200,1.00165929204
53349,53356,56520,7,3164,2,7200,1.00221238938
53364,53372,56719,8,3347,2,7200,1.00239020018
53380,53392,56589,12,3197,2,7200,1.00375351892
53396,53402,56855,6,3453,2,7200,1.00173761946
53397,53408,57054,11,3646,2,7200,1.00301700494
53413,53420,56886,7,3466,2,7200,1.00201961916
53456,53462,56837,6,3375,2,7200,1.00177777778
53484,53491,56821,7,3330,2,7200,1.0021021021
53500,53507,57024,7,3517,2,7200,1.00199033267
53571,53578,56748,7,3170,2,7200,1.00220820189
53586,53593,56894,7,3301,2,7200,1.00212056952
53626,53634,56893,8,3259,2,7200,1.00245474072
53628,53639,57067,11,3428,2,7200,1.00320886814
53633,55218,55333,1585,115,16,610,14.7826086957
53634,55345,55443,1711,98,16,610,18.4591836735
53635,55456,55572,1821,116,16,610,16.6982758621
53635,55584,55691,1949,107,16,610,19.214953271
53636,55703,55818,2067,115,16,610,18.9739130435
53708,53714,56911,6,3197,2,7200,1.00187675946
53844,53851,57181,7,3330,2,7200,1.0021021021
53862,53870,57220,8,3350,2,7200,1.0023880597
53931,53937,57365,6,3428,2,7200,1.00175029172
54027,54035,57224,8,3189,2,7200,1.00250862339
54048,54056,57371,8,3315,2,7200,1.002413273
54271,54277,57602,6,3325,2,7200,1.00180451128
54387,54393,57742,6,3349,2,7200,1.00179157958
54529,54536,57931,7,3395,2,7200,1.00206185567
54563,54569,57650,6,3081,2,7200,1.00194741967
54593,54601,57973,8,3372,2,7200,1.00237247924
54618,54625,58046,7,3421,2,7200,1.00204618533
54662,54669,58409,7,3740,2,7200,1.00187165775
54677,54684,58133,7,3449,2,7200,1.00202957379
54776,54782,58131,6,3349,2,7200,1.00179157958
54866,54872,58316,6,3444,2,7200,1.00174216028
54952,54959,58234,7,3275,2,7200,1.00213740458
55167,55173,58287,6,3114,2,7200,1.00192678227
55204,55211,58433,7,3222,2,7200,1.00217256363
55439,55445,58770,6,3325,2,7200,1.00180451128
55454,55463,58696,9,3233,2,7200,1.00278379214
55500,55511,58726,11,3215,2,7200,1.0034214619
55671,55679,59176,8,3497,2,7200,1.00228767515
55690,55696,58765,6,3069,2,7200,1.00195503421
55745,55751,59086,6,3335,2,7200,1.00179910045
55767,55774,59145,7,3371,2,7200,1.00207653515
55859,55865,59186,6,3321,2,7200,1.00180668473
55948,55954,59044,6,3090,2,7200,1.00194174757
55964,55971,59351,7,3380,2,7200,1.00207100592
55979,55986,59299,7,3313,2,7200,1.00211288862
56004,56010,59260,6,3250,2,7200,1.00184615385
56081,56087,59552,6,3465,2,7200,1.00173160173
56097,56103,59420,6,3317,2,7200,1.00180886343
56112,56119,59562,7,3443,2,7200,1.00203311066
56114,56126,59775,12,3649,2,7200,1.00328857221
56115,56131,59271,16,3140,2,7200,1.0050955414
56131,56138,59456,7,3318,2,7200,1.00210970464
56174,56182,59499,8,3317,2,7200,1.00241181791
56190,56197,59446,7,3249,2,7200,1.00215450908
56192,56204,59380,12,3176,2,7200,1.00377833753
56208,56214,59719,6,3505,2,7200,1.00171184023
56209,56220,59658,11,3438,2,7200,1.00319953461
56234,56241,59617,7,3376,2,7200,1.00207345972
56249,56255,59538,6,3283,2,7200,1.00182759671
56250,56262,59768,12,3506,2,7200,1.00342270394
56300,56306,59846,6,3540,2,7200,1.00169491525
56315,56322,59703,7,3381,2,7200,1.00207039337
56349,56356,59601,7,3245,2,7200,1.00215716487
56365,56372,59874,7,3502,2,7200,1.0019988578
56393,56399,59619,6,3220,2,7200,1.00186335404
56394,56406,59837,12,3431,2,7200,1.00349752259
56410,56416,59886,6,3470,2,7200,1.00172910663
56412,56423,59530,11,3107,2,7200,1.00354039266
56427,56433,59711,6,3278,2,7200,1.00183038438
56443,56450,59613,7,3163,2,7200,1.00221308884
56444,56457,59924,13,3467,2,7200,1.00374963946
56466,56472,59813,6,3341,2,7200,1.0017958695
56482,56489,59806,7,3317,2,7200,1.00211034067
56484,56496,59810,12,3314,2,7200,1.00362100181
56485,56501,59848,16,3347,2,7200,1.00478040036
56516,56523,59815,7,3292,2,7200,1.00212636695
56531,56539,59847,8,3308,2,7200,1.00241837969
56548,56555,59545,7,2990,2,7200,1.00234113712
56549,56562,59668,13,3106,2,7200,1.00418544752
56565,56571,59577,6,3006,2,7200,1.00199600798
56566,56579,60087,13,3508,2,7200,1.00370581528
56592,56599,59826,7,3227,2,7200,1.0021691974
56593,56606,59880,13,3274,2,7200,1.00397067807
56609,56616,59901,7,3285,2,7200,1.00213089802
56625,56632,59902,7,3270,2,7200,1.00214067278
56641,56647,59717,6,3070,2,7200,1.00195439739
56657,56663,60162,6,3499,2,7200,1.00171477565
56682,56688,60017,6,3329,2,7200,1.00180234305
56709,56716,60130,7,3414,2,7200,1.00205038079
56710,56723,60302,13,3579,2,7200,1.00363229953
56711,56728,60626,17,3898,2,7200,1.00436121088
56727,56735,59922,8,3187,2,7200,1.00251019768
56779,56786,56821,7,35,2,7200,1.2
56795,56802,60090,7,3288,2,7200,1.00212895377
56820,56827,60497,7,3670,2,7200,1.00190735695
56821,56834,60092,13,3258,2,7200,1.00399017802
56837,56844,59841,7,2997,2,7200,1.002335669
56839,56851,60231,12,3380,2,7200,1.00355029586
56857,56863,59981,6,3118,2,7200,1.00192431046
56888,56894,60365,6,3471,2,7200,1.00172860847
56904,56910,60178,6,3268,2,7200,1.00183598531
56905,56916,60257,11,3341,2,7200,1.00329242742
56921,56927,60158,6,3231,2,7200,1.00185701021
56937,60074,61266,3137,1192,1,44100,3.6317114094
56937,56943,60256,6,3313,2,7200,1.00181104739
56947,60098,61305,3151,1207,1,44100,3.6106048053
56956,60104,64922,3148,4818,1,44100,1.65338314653
56967,60141,61376,3174,1235,1,44100,3.57004048583
56975,60147,61674,3172,1527,1,44100,3.07727570399
56985,60247,63487,3262,3240,1,44100,2.00679012346
56994,60253,79708,3259,19455,1,44100,1.16751477769
57003,60258,92543,3255,32285,1,44100,1.10082081462
57011,60263,94895,3252,34632,1,44100,1.0939015939
57017,60269,96092,3252,35823,1,44100,1.09077966669
57026,57032,60021,6,2989,2,7200,1.00200736032
57057,57064,60199,7,3135,2,7200,1.00223285486
57072,57080,60471,8,3391,2,7200,1.00235918608
57182,57189,60987,7,3798,2,7200,1.0018430753
57223,57230,60422,7,3192,2,7200,1.00219298246
57224,57237,60582,13,3345,2,7200,1.00388639761
57369,57376,60713,7,3337,2,7200,1.00209769254
57384,57390,61091,6,3701,2,7200,1.00162118346
57604,57610,60705,6,3095,2,7200,1.00193861066
57653,57659,60837,6,3178,2,7200,1.00188797986
57661,57668,57796,7,128,16,610,1.0546875
57742,57749,61346,7,3597,2,7200,1.00194606617
57754,60539,68547,2785,8008,1,36000,1.34777722278
57933,57940,61416,7,3476,2,7200,1.00201380898
57973,57980,61082,7,3102,2,7200,1.00225660864
58047,58054,61419,7,3365,2,7200,1.00208023774
58133,58139,61455,6,3316,2,7200,1.00180940893
58148,58156,61288,8,3132,2,7200,1.00255427842
58237,58243,61742,6,3499,2,7200,1.00171477565
58286,58294,61517,8,3223,2,7200,1.00248215948
58317,58325,61737,8,3412,2,7200,1.00234466589
58412,58419,61558,7,3139,2,7200,1.00223000956
58433,58440,61692,7,3252,2,7200,1.00215252153
58683,58690,58719,7,29,1,610,1.24137931034
58698,58705,61780,7,3075,2,7200,1.00227642276
58729,58735,61981,6,3246,2,7200,1.00184842884
58766,58773,61960,7,3187,2,7200,1.00219642297
58781,58787,62011,6,3224,2,7200,1.00186104218
58800,58807,58877,7,70,1,610,1.1
59047,59853,63351,806,3498,2,7200,1.23041738136
59087,59912,63263,825,3351,2,7200,1.24619516562
59145,59919,63370,774,3451,2,7200,1.22428281657
59179,59993,63348,814,3355,2,7200,1.24262295082
59195,60029,63511,834,3482,2,7200,1.23951751867
59263,60035,63437,772,3402,2,7200,1.22692533804
59278,60111,63446,833,3335,2,7200,1.24977511244
59300,60116,63284,816,3168,2,7200,1.25757575758
59351,60170,63615,819,3445,2,7200,1.23773584906
59382,60177,63338,795,3161,2,7200,1.25150268902
59423,60190,63333,767,3143,2,7200,1.24403436207
59447,60210,63535,763,3325,2,7200,1.22947368421
59463,60274,63662,811,3388,2,7200,1.2393742621
59500,60279,63633,779,3354,2,7200,1.23225998807
59532,60284,63948,752,3664,2,7200,1.20524017467
59548,60290,63620,742,3330,2,7200,1.22282282282
59549,60295,63664,746,3369,2,7200,1.2214306916
59565,60303,63707,738,3404,2,7200,1.21680376028
59566,60309,63790,743,3481,2,7200,1.21344441253
59582,60314,63534,732,3220,2,7200,1.22732919255
59601,60319,63549,718,3230,2,7200,1.22229102167
59617,60324,63656,707,3332,2,7200,1.21218487395
59619,60330,63866,711,3536,2,7200,1.20107466063
59634,60335,63757,701,3422,2,7200,1.20485096435
59659,60340,63557,681,3217,2,7200,1.21168790799
59675,60345,63588,670,3243,2,7200,1.20659882825
59703,60351,63776,648,3425,2,7200,1.18919708029
59719,60356,63578,637,3222,2,7200,1.19770328988
59720,60361,63724,641,3363,2,7200,1.19060362771
59721,60366,63896,645,3530,2,7200,1.18271954674
59768,60372,63612,604,3240,2,7200,1.18641975309
59783,60377,63674,594,3297,2,7200,1.18016378526
59809,60382,63884,573,3502,2,7200,1.16362078812
59810,60387,63826,577,3439,2,7200,1.16778133178
59826,60392,63803,566,3411,2,7200,1.16593374377
59828,60398,63646,570,3248,2,7200,1.17549261084
59829,60403,63720,574,3317,2,7200,1.17304793488
59845,60408,63675,563,3267,2,7200,1.17232935415
59847,60414,63649,567,3235,2,7200,1.17527047913
59848,60419,63626,571,3207,2,7200,1.17804801996
59864,60424,63549,560,3125,2,7200,1.1792
59865,60429,63850,564,3421,2,7200,1.16486407483
59881,60434,63826,553,3392,2,7200,1.16303066038
59882,60440,63898,558,3458,2,7200,1.16136495084
59898,60445,63773,547,3328,2,7200,1.16436298077
59913,60450,63705,537,3255,2,7200,1.16497695853
59915,60455,63992,540,3537,2,7200,1.15267175573
59930,60461,64045,531,3584,2,7200,1.14815848214
59932,60466,63732,534,3266,2,7200,1.16350275566
59981,60471,63770,490,3299,2,7200,1.14852985753
60018,60476,63545,458,3069,2,7200,1.14923427827
60034,60482,63686,448,3204,2,7200,1.13982521848
60088,60487,63875,399,3388,2,7200,1.11776859504
60090,60492,64040,402,3548,2,7200,1.11330326945
60091,60497,63900,406,3403,2,7200,1.11930649427
60132,60503,63755,371,3252,2,7200,1.11408364084
60160,60508,63782,348,3274,2,7200,1.10629199756
60175,60513,64004,338,3491,2,7200,1.0968203953
60191,60518,63897,327,3379,2,7200,1.09677419355
60206,60524,63867,318,3343,2,7200,1.09512413999
60228,60529,63719,301,3190,2,7200,1.09435736677
60257,60547,63995,290,3448,2,7200,1.08410672854
60258,60552,63822,294,3270,2,7200,1.08990825688
60305,60557,63862,252,3305,2,7200,1.07624810893
60367,60562,64048,195,3486,2,7200,1.05593803787
60423,60568,63585,145,3017,2,7200,1.04806098774
60470,60573,63853,103,3280,2,7200,1.03140243902
60498,60578,63892,80,3314,2,7200,1.02414001207
60582,60588,63989,6,3401,2,7200,1.001764187
60628,60635,63969,7,3334,2,7200,1.00209958008
60705,60711,63889,6,3178,2,7200,1.00188797986
60721,60727,64140,6,3413,2,7200,1.00175798418
60838,60844,64093,6,3249,2,7200,1.00184672207
60840,63788,63928,2948,140,16,610,22.0571428571
60989,60995,64217,6,3222,2,7200,1.00186219739
61081,61088,64253,7,3165,2,7200,1.00221169036
61097,61103,64134,6,3031,2,7200,1.0019795447
61180,63590,64112,2410,522,2,18000,5.61685823755
61291,61297,64655,6,3358,2,7200,1.00178677784
61349,61356,64458,7,3102,2,7200,1.00225660864
61418,61425,64636,7,3211,2,7200,1.00218000623
61419,61432,64439,13,3007,2,7200,1.00432324576
61457,61464,64713,7,3249,2,7200,1.00215450908
61519,61525,64831,6,3306,2,7200,1.00181488203
61559,61566,64962,7,3396,2,7200,1.00206124853
61694,61701,65273,7,3572,2,7200,1.00195968645
61737,61743,65044,6,3301,2,7200,1.00181763102
61752,61758,64861,6,3103,2,7200,1.00193361263
61780,61786,64901,6,3115,2,7200,1.00192616372
61960,61967,65190,7,3223,2,7200,1.00217188954
61981,61987,65424,6,3437,2,7200,1.00174570847
62012,62018,65584,6,3566,2,7200,1.00168255749
63265,63273,66707,8,3434,2,7200,1.00232964473
63287,63293,66717,6,3424,2,7200,1.00175233645
63333,63340,66654,7,3314,2,7200,1.00211225106
63349,63356,66601,7,3245,2,7200,1.00215716487
63351,63363,66740,12,3377,2,7200,1.00355344981
63352,63368,66580,16,3212,2,7200,1.00498132005
63371,63378,66624,7,3246,2,7200,1.00215650031
63439,63445,67063,6,3618,2,7200,1.00165837479
63455,63461,66553,6,3092,2,7200,1.00194049159
63513,63519,66696,6,3177,2,7200,1.00188857413
63535,63542,66903,7,3361,2,7200,1.00208271348
63537,63549,66750,12,3201,2,7200,1.00374882849
63553,63559,67048,6,3489,2,7200,1.00171969046
63554,63565,66875,11,3310,2,7200,1.00332326284
63556,63570,67057,14,3487,2,7200,1.00401491253
63571,63577,66811,6,3234,2,7200,1.00185528757
63587,63596,66944,9,3348,2,7200,1.00268817204
63588,63601,66919,13,3318,2,7200,1.00391802291
63590,63606,66963,16,3357,2,7200,1.00476616026
63612,63618,66819,6,3201,2,7200,1.00187441425
63628,63634,66941,6,3307,2,7200,1.00181433323
63630,63642,67105,12,3463,2,7200,1.00346520358
63631,63647,66704,16,3057,2,7200,1.00523388943
63647,63653,66706,6,3053,2,7200,1.00196528005
63648,63661,66852,13,3191,2,7200,1.00407395801
63650,63667,66607,17,2940,2,7200,1.00578231293
63667,63673,67232,6,3559,2,7200,1.00168586682
63668,63679,67046,11,3367,2,7200,1.00326700327
63669,63685,67293,16,3608,2,7200,1.0044345898
63685,63691,66881,6,3190,2,7200,1.00188087774
63686,63697,67109,11,3412,2,7200,1.00322391559
63688,63703,67173,15,3470,2,7200,1.00432276657
63707,63713,66873,6,3160,2,7200,1.00189873418
63709,63719,66889,10,3170,2,7200,1.00315457413
63725,63732,66884,7,3152,2,7200,1.00222081218
63726,63739,67007,13,3268,2,7200,1.00397796818
63728,63744,66939,16,3195,2,7200,1.00500782473
63743,63750,67125,7,3375,2,7200,1.00207407407
63759,63765,66787,6,3022,2,7200,1.00198544011
63760,63772,67274,12,3502,2,7200,1.00342661336
63781,63794,66978,13,3184,2,7200,1.00408291457
63783,63803,67095,20,3292,2,7200,1.00607533414
63784,63815,66929,31,3114,2,7200,1.00995504175
63785,63833,67120,48,3287,2,7200,1.01460298144
63801,63840,67290,39,3450,2,7200,1.01130434783
63817,63845,67041,28,3196,2,7200,1.00876095119
63833,63862,67188,29,3326,2,7200,1.0087191822
63834,63868,67398,34,3530,2,7200,1.00963172805
63835,63876,67257,41,3381,2,7200,1.01212658977
63851,63882,67401,31,3519,2,7200,1.00880932083
63868,63888,67143,20,3255,2,7200,1.00614439324
63869,63894,67304,25,3410,2,7200,1.0073313783
63871,63902,67301,31,3399,2,7200,1.00912032951
63872,63907,67137,35,3230,2,7200,1.01083591331
63888,63914,67295,26,3381,2,7200,1.00769003253
63890,63919,67557,29,3638,2,7200,1.00797141286
63906,63924,67231,18,3307,2,7200,1.0054429997
63908,63930,67785,22,3855,2,7200,1.00570687419
63909,63935,67267,26,3332,2,7200,1.00780312125
63910,63943,67482,33,3539,2,7200,1.00932466799
63912,63948,67495,36,3547,2,7200,1.01014942205
63913,63953,67064,40,3111,2,7200,1.01285760206
63951,63960,67559,9,3599,2,7200,1.00250069464
63972,63980,67256,8,3276,2,7200,1.00244200244
63991,63998,67401,7,3403,2,7200,1.00205700852
63992,64004,67370,12,3366,2,7200,1.00356506239
64008,64014,67444,6,3430,2,7200,1.00174927114
64010,64021,67135,11,3114,2,7200,1.00353243417
64041,64048,67053,7,3005,2,7200,1.00232945092
64056,64062,67371,6,3309,2,7200,1.00181323663
64058,64068,67323,10,3255,2,7200,1.00307219662
64095,64102,67374,7,3272,2,7200,1.0021393643
64135,64141,67563,6,3422,2,7200,1.00175336061
64150,64158,67504,8,3346,2,7200,1.00239091452
64218,64224,67497,6,3273,2,7200,1.00183318057
64255,64261,67667,6,3406,2,7200,1.00176159718
64440,64447,68027,7,3580,2,7200,1.00195530726
64459,64465,67826,6,3361,2,7200,1.00178518298
64637,64643,68303,6,3660,2,7200,1.00163934426
64656,64662,67991,6,3329,2,7200,1.00180234305
64714,64720,68036,6,3316,2,7200,1.00180940893
64834,64841,68095,7,3254,2,7200,1.00215119852
64862,64868,68383,6,3515,2,7200,1.00170697013
64903,64909,68423,6,3514,2,7200,1.00170745589
64964,64970,68269,6,3299,2,7200,1.00181873295
65044,65051,68304,7,3253,2,7200,1.00215185982
65191,65197,68405,6,3208,2,7200,1.00187032419
65275,65282,68610,7,3328,2,7200,1.00210336538
65326,65814,70089,488,4275,1,36000,1.11415204678
65423,65429,68835,6,3406,2,7200,1.00176159718
65587,65594,68789,7,3195,2,7200,1.00219092332
66120,66889,66895,769,6,16,130,77.5
66556,66562,69932,6,3370,2,7200,1.00178041543
66580,66586,69901,6,3315,2,7200,1.00180995475
66602,66609,69716,7,3107,2,7200,1.00225297715
66617,66625,69930,8,3305,2,7200,1.00242057489
66633,66639,69818,6,3179,2,7200,1.00188738597
66655,66662,70042,7,3380,2,7200,1.00207100592
66694,66701,73905,7,7204,2,7200,1.0009716824
66711,66718,69995,7,3277,2,7200,1.00213610009
66712,66725,70327,13,3602,2,7200,1.00360910605
66713,66730,69785,17,3055,2,7200,1.00556464812
66729,66737,70016,8,3279,2,7200,1.00243976822
66745,66752,73962,7,7210,2,7200,1.00097087379
66760,66767,74013,7,7246,2,7200,1.00096605023
66788,66794,70295,6,3501,2,7200,1.00171379606
66813,66819,70210,6,3391,2,7200,1.00176938956
66828,66834,70510,6,3676,2,7200,1.00163220892
66853,66859,74097,6,7238,2,7200,1.00082895828
66875,66882,70352,7,3470,2,7200,1.00201729107
66876,66894,70308,18,3414,2,7200,1.00527240773
66892,66900,70257,8,3357,2,7200,1.00238308013
66893,66906,70571,13,3665,2,7200,1.00354706685
66895,66913,70305,18,3392,2,7200,1.00530660377
66911,66919,74144,8,7225,2,7200,1.00110726644
66926,66932,70429,6,3497,2,7200,1.00171575636
66942,66950,70200,8,3250,2,7200,1.00246153846
66944,66956,70350,12,3394,2,7200,1.00353565115
66945,66962,70288,17,3326,2,7200,1.00511124474
66946,66967,70378,21,3411,2,7200,1.00615655233
66966,66973,70291,7,3318,2,7200,1.00210970464
66981,66988,70497,7,3509,2,7200,1.00199487033
67009,67015,70521,6,3506,2,7200,1.00171135197
67043,67049,70381,6,3332,2,7200,1.00180072029
67059,67065,70435,6,3370,2,7200,1.00178041543
67061,67072,70535,11,3463,2,7200,1.00317643662
67062,67077,70218,15,3141,2,7200,1.00477554919
67063,67082,70328,19,3246,2,7200,1.00585335798
67079,67088,70325,9,3237,2,7200,1.00278035218
67080,67094,70534,14,3440,2,7200,1.00406976744
67096,67102,70247,6,3145,2,7200,1.00190779014
67112,67118,70491,6,3373,2,7200,1.0017788319
67113,67124,70357,11,3233,2,7200,1.00340241262
67130,67136,70238,6,3102,2,7200,1.00193423598
67131,67142,70234,11,3092,2,7200,1.00355756792
67147,67154,70537,7,3383,2,7200,1.00206916938
67149,67160,70331,11,3171,2,7200,1.00346893724
67150,67166,70304,16,3138,2,7200,1.00509878904
67168,67278,67284,110,6,16,130,11.6
67175,67182,70431,7,3249,2,7200,1.00215450908
67191,67198,70507,7,3309,2,7200,1.00211544273
67232,67239,70559,7,3320,2,7200,1.00210843373
67233,67246,70520,13,3274,2,7200,1.00397067807
67258,67265,70494,7,3229,2,7200,1.00216785382
67260,67271,70470,11,3199,2,7200,1.00343857455
67275,67284,70594,9,3310,2,7200,1.00271903323
67277,67290,70855,13,3565,2,7200,1.00364656381
67292,67299,70831,7,3532,2,7200,1.00198187995
67294,67306,70561,12,3255,2,7200,1.00368663594
67295,67311,70740,16,3429,2,7200,1.00466608341
67312,67318,70913,6,3595,2,7200,1.0016689847
67313,67324,70603,11,3279,2,7200,1.00335468131
67329,67336,70612,7,3276,2,7200,1.00213675214
67373,67380,70518,7,3138,2,7200,1.0022307202
67374,67386,70379,12,2993,2,7200,1.00400935516
67390,67397,71031,7,3634,2,7200,1.00192625206
67406,67412,70773,6,3361,2,7200,1.00178518298
67407,67418,70737,11,3319,2,7200,1.00331425128
67409,67424,70877,15,3453,2,7200,1.00434404865
67446,67452,70917,6,3465,2,7200,1.00173160173
67481,67487,68548,6,1061,1,36000,1.00565504241
67483,67493,70931,10,3438,2,7200,1.00290866783
67499,67506,70605,7,3099,2,7200,1.00225879316
67501,67512,70677,11,3165,2,7200,1.00347551343
67516,67522,70924,6,3402,2,7200,1.00176366843
67560,67566,70938,6,3372,2,7200,1.00177935943
67561,67574,70792,13,3218,2,7200,1.00403977626
67577,67583,70759,6,3176,2,7200,1.00188916877
67669,67675,70955,6,3280,2,7200,1.00182926829
67690,67799,67810,109,11,16,130,10.9090909091
67786,67792,71062,6,3270,2,7200,1.00183486239
67826,67832,71349,6,3517,2,7200,1.00170599943
67992,67998,71251,6,3253,2,7200,1.00184445128
68029,68036,71549,7,3513,2,7200,1.00199259892
68044,68050,71359,6,3309,2,7200,1.00181323663
68090,68096,68107,6,11,16,130,1.54545454545
68096,68103,71436,7,3333,2,7200,1.00210021002
68269,68276,71509,7,3233,2,7200,1.00216517167
68304,68310,71421,6,3111,2,7200,1.00192864031
68305,68317,71636,12,3319,2,7200,1.00361554685
68386,68392,71942,6,3550,2,7200,1.00169014085
68408,68414,71868,6,3454,2,7200,1.00173711639
68426,68432,71617,6,3185,2,7200,1.00188383046
68811,68817,70106,6,1289,1,36000,1.00465477114
68846,68852,70092,6,1240,1,36000,1.00483870968
68865,68872,76422,7,7550,1,36000,1.00092715232
69365,70249,70259,884,10,16,130,89.4
70216,70222,77297,6,7075,1,36000,1.00084805654
70223,70230,70519,7,289,1,36000,1.02422145329
70230,70237,76402,7,6165,1,36000,1.00113544201
72899,72905,72907,6,2,2,3540,1.0
73748,73755,79651,7,5896,4,7200,1.00118724559
76013,76019,79351,6,3332,2,7200,1.00180072029
76014,76025,79121,11,3096,2,7200,1.00355297158
76016,76030,79091,14,3061,2,7200,1.00457366874
76017,76036,79311,19,3275,2,7200,1.00580152672
76018,76041,79279,23,3238,2,7200,1.00710315009
76020,76046,79299,26,3253,2,7200,1.00799262219
76021,76052,79175,31,3123,2,7200,1.00992635287
76022,76057,79531,35,3474,2,7200,1.01007484168
76024,76063,79172,39,3109,2,7200,1.01254422644
76025,76068,79407,43,3339,2,7200,1.01287810722
76026,76073,79505,47,3432,2,7200,1.01369463869
76028,76079,79436,51,3357,2,7200,1.01519213584
76029,76084,79290,55,3206,2,7200,1.01715533375
76030,76089,79210,59,3121,2,7200,1.01890419737
76032,76094,79307,62,3213,2,7200,1.01929660753
76033,76100,79470,67,3370,2,7200,1.01988130564
76034,76105,79439,71,3334,2,7200,1.02129574085
76036,76110,79419,74,3309,2,7200,1.02236325174
76037,76115,79499,78,3384,2,7200,1.02304964539
76039,76121,79371,82,3250,2,7200,1.02523076923
76040,76126,79468,86,3342,2,7200,1.02573309396
76041,76131,79734,90,3603,2,7200,1.02497918401
76043,76136,79627,93,3491,2,7200,1.02663993125
76044,76142,79340,98,3198,2,7200,1.0306441526
76045,76147,79481,102,3334,2,7200,1.03059388122
76047,76152,79610,105,3458,2,7200,1.03036437247
76048,76158,79584,110,3426,2,7200,1.03210741389
76049,76163,79504,114,3341,2,7200,1.0341215205
76051,76169,79713,118,3544,2,7200,1.03329571106
76052,76174,79510,122,3336,2,7200,1.03657074341
76053,76179,79497,126,3318,2,7200,1.03797468354
76055,76184,79605,129,3421,2,7200,1.03770827243
76056,76190,79603,134,3413,2,7200,1.03926164665
76057,76195,79314,138,3119,2,7200,1.0442449503
76059,76200,79277,141,3077,2,7200,1.0458238544
76060,76205,79835,145,3630,2,7200,1.03994490358
76061,76211,79540,150,3329,2,7200,1.04505857615
76063,76216,79595,153,3379,2,7200,1.04527966854
76064,76221,79621,157,3400,2,7200,1.04617647059
76065,76226,79557,161,3331,2,7200,1.04833383368
76067,76232,79618,165,3386,2,7200,1.04873006497
76068,76237,79544,169,3307,2,7200,1.05110371938
76069,76242,79536,173,3294,2,7200,1.05251973285
76071,76247,79598,176,3351,2,7200,1.05252163533
76072,76252,79533,180,3281,2,7200,1.05486132277
76073,76258,79459,185,3201,2,7200,1.05779443924
76075,76263,79633,188,3370,2,7200,1.05578635015
76076,76268,79840,192,3572,2,7200,1.05375139978
76077,76273,79541,196,3268,2,7200,1.0599755202
76079,76279,79630,200,3351,2,7200,1.05968367651
76080,76284,79457,204,3173,2,7200,1.0642924677
76081,76289,79614,208,3325,2,7200,1.06255639098
76082,76294,79582,212,3288,2,7200,1.06447688564
76084,76300,79350,216,3050,2,7200,1.07081967213
76085,76305,79786,220,3481,2,7200,1.06320022982
76086,76310,79607,224,3297,2,7200,1.06794055202
76088,76315,79716,227,3401,2,7200,1.06674507498
76089,76321,79573,232,3252,2,7200,1.07134071341
76090,76326,79743,236,3417,2,7200,1.06906643254
76092,76331,79716,239,3385,2,7200,1.070605613
76093,76336,80007,243,3671,2,7200,1.06619449741
76094,76342,79491,248,3149,2,7200,1.07875516037
76096,76347,79563,251,3216,2,7200,1.07804726368
76097,76352,79694,255,3342,2,7200,1.0763016158
76098,76357,79612,259,3255,2,7200,1.07956989247
76100,76363,79616,263,3253,2,7200,1.08084844759
76101,76368,79556,267,3188,2,7200,1.08375156838
76102,76373,79908,271,3535,2,7200,1.07666195191
76104,76378,79634,274,3256,2,7200,1.08415233415
76105,76384,79652,279,3268,2,7200,1.08537331701
76106,76391,76395,285,4,2,7200,28.9
76108,76396,76401,288,5,2,7200,29.3
76109,76401,76404,292,3,2,7200,29.5
76111,76407,76410,296,3,2,7200,29.9
76112,76412,79658,300,3246,2,7200,1.09242144177
76113,76417,76454,304,37,2,7200,9.21621621622
76115,76422,79502,307,3080,2,7200,1.09967532468
76116,76428,76463,312,35,2,7200,9.91428571429
76117,76433,79915,316,3482,2,7200,1.09075244113
76118,76438,76475,320,37,2,7200,9.64864864865
76120,76443,76480,323,37,2,7200,9.72972972973
76121,76449,76483,328,34,2,7200,10.6470588235
76123,76454,79842,331,3388,2,7200,1.09769775679
76125,76459,79626,334,3167,2,7200,1.10546258289
76127,76464,79926,337,3462,2,7200,1.09734257655
76457,76471,79763,14,3292,2,7200,1.0042527339
76473,76479,79991,6,3512,2,7200,1.00170842825
76474,76485,79705,11,3220,2,7200,1.00341614907
76492,76498,79850,6,3352,2,7200,1.00178997613
76493,76504,79686,11,3182,2,7200,1.00345694532
76608,76614,82293,6,5679,1,36000,1.00105652404
77809,77815,107345,6,29530,1,36000,1.0002031832
79095,79101,82380,6,3279,2,7200,1.00182982617
79123,79129,82370,6,3241,2,7200,1.00185128047
79172,79178,82425,6,3247,2,7200,1.00184785956
79188,79195,82438,7,3243,2,7200,1.00215849522
79212,79219,82715,7,3496,2,7200,1.00200228833
79282,79289,82902,7,3613,2,7200,1.0019374481
79284,79295,86520,11,7225,2,7200,1.00152249135
79299,79305,82596,6,3291,2,7200,1.00182315406
79301,79311,86551,10,7240,2,7200,1.00138121547
79317,79323,86550,6,7227,2,7200,1.00083022001
79319,79329,82697,10,3368,2,7200,1.00296912114
79320,79335,82645,15,3310,2,7200,1.00453172205
79342,79348,82991,6,3643,2,7200,1.00164699424
79358,79364,86602,6,7238,2,7200,1.00082895828
79359,79370,82540,11,3170,2,7200,1.00347003155
79375,79381,86603,6,7222,2,7200,1.00083079479
79410,79416,82565,6,3149,2,7200,1.00190536678
79426,79431,86658,5,7227,2,7200,1.00069185001
79441,79447,82653,6,3206,2,7200,1.00187149095
79443,79453,86699,10,7246,2,7200,1.00138007176
79459,79465,86692,6,7227,2,7200,1.00083022001
79460,79471,82494,11,3023,2,7200,1.00363876943
79476,79482,82812,6,3330,2,7200,1.0018018018
79478,79488,82887,10,3399,2,7200,1.00294204178
79494,79500,86740,6,7240,2,7200,1.00082872928
79495,79506,82785,11,3279,2,7200,1.00335468131
79516,79521,82812,5,3291,2,7200,1.00151929505
79517,79528,86742,11,7214,2,7200,1.00152481286
79518,79533,82818,15,3285,2,7200,1.00456621005
79520,79539,86776,19,7237,2,7200,1.00262539726
79521,79544,82778,23,3234,2,7200,1.00711193568
79522,79549,86789,27,7240,2,7200,1.00372928177
79539,79556,82688,17,3132,2,7200,1.00542784163
79540,79561,86769,21,7208,2,7200,1.00291342952
79542,79566,82668,24,3102,2,7200,1.00773694391
79543,79571,83282,28,3711,2,7200,1.00754513608
79561,79577,82642,16,3065,2,7200,1.00522022838
79563,79583,82779,20,3196,2,7200,1.00625782228
79564,79588,86814,24,7226,2,7200,1.00332133961
79565,79593,86823,28,7230,2,7200,1.00387275242
79567,79598,83183,31,3585,2,7200,1.00864714086
79584,79604,86826,20,7222,2,7200,1.00276931598
79585,79610,86824,25,7214,2,7200,1.00346548378
79586,79615,86861,29,7246,2,7200,1.00400220811
79603,79621,86830,18,7209,2,7200,1.0024968789
79605,79626,86872,21,7246,2,7200,1.0028981507
79606,79632,83186,26,3554,2,7200,1.00731570062
79607,79637,86866,30,7229,2,7200,1.00414995158
79626,79644,86873,18,7229,2,7200,1.00248997095
79627,79649,86874,22,7225,2,7200,1.0030449827
79629,79654,86874,25,7220,2,7200,1.00346260388
79630,79660,82798,30,3138,2,7200,1.00956022945
79631,79665,86869,34,7204,2,7200,1.00471960022
79633,79670,82773,37,3103,2,7200,1.01192394457
79635,79675,83296,40,3621,2,7200,1.01104667219
79636,79681,82928,45,3247,2,7200,1.01385894672
79638,79686,82843,48,3157,2,7200,1.01520430789
79639,79693,86929,54,7236,2,7200,1.00746268657
79656,79698,86921,42,7223,2,7200,1.00581475841
79657,79703,86910,46,7207,2,7200,1.0063826835
79658,79708,86914,50,7206,2,7200,1.00693866223
79660,79714,83264,54,3550,2,7200,1.01521126761
79685,79719,86956,34,7237,2,7200,1.00469807931
79701,79726,83278,25,3552,2,7200,1.00703828829
79717,79731,86969,14,7238,2,7200,1.00193423598
79718,79736,86961,18,7225,2,7200,1.00249134948
79719,79741,86960,22,7219,2,7200,1.00304751351
79721,79748,86967,27,7219,2,7200,1.00374013021
79736,79753,86961,17,7208,2,7200,1.00235849057
79752,79759,86961,7,7202,2,7200,1.00097195224
79767,79773,83226,6,3453,2,7200,1.00173761946
79786,79793,83193,7,3400,2,7200,1.00205882353
79837,79843,83213,6,3370,2,7200,1.00178041543
79852,79859,82944,7,3085,2,7200,1.00226904376
79854,79865,83236,11,3371,2,7200,1.00326312667
79855,79871,87081,16,7210,2,7200,1.00221914008
79909,79915,83268,6,3353,2,7200,1.00178944229
79924,79930,83257,6,3327,2,7200,1.00180342651
79925,79936,83228,11,3292,2,7200,1.00334143378
79995,80001,83184,6,3183,2,7200,1.00188501414
80010,80016,83396,6,3380,2,7200,1.00177514793
82373,82379,82381,6,2,2,7200,1.0
82419,82425,85579,6,3154,2,7200,1.00190234623
82434,82440,85651,6,3211,2,7200,1.00186857677
82497,82503,85726,6,3223,2,7200,1.00186161961
82540,82546,85657,6,3111,2,7200,1.00192864031
82565,82571,85780,6,3209,2,7200,1.00186974135
82599,82605,82606,6,1,2,7200,1.0
82643,82649,85960,6,3311,2,7200,1.00181214135
82658,82664,85991,6,3327,2,7200,1.00180342651
82660,82670,86058,10,3388,2,7200,1.00295159386
82675,82681,85931,6,3250,2,7200,1.00184615385
82691,82697,85963,6,3266,2,7200,1.00183710961
82706,82713,82715,7,2,2,7200,1.0
82721,82728,82729,7,1,2,7200,1.0
82775,82781,82815,6,34,2,7200,1.17647058824
82791,82797,82833,6,36,2,7200,1.16666666667
82792,82803,82838,11,35,2,7200,1.31428571429
82794,82809,82845,15,36,2,7200,1.41666666667
82809,82815,82816,6,1,2,7200,1.0
87441,87447,87460,6,13,3,345600,1.46153846154
87562,87568,194199,6,106631,3,345600,1.00005626881
88459,88466,90987,7,2521,64,3600,1.00277667592
88836,88842,88862,6,20,1,600,1.3
88884,88890,88927,6,37,1,600,1.16216216216
89355,89361,89403,6,42,2,600,1.14285714286
89361,89367,89412,6,45,4,600,1.13333333333
89367,89373,89426,6,53,8,600,1.11320754717
90128,90134,90551,6,417,14,2460,1.01438848921
91199,91205,94334,6,3129,64,3600,1.00191754554
94718,94724,94726,6,2,2,3540,1.0
96117,96124,99846,7,3722,64,5400,1.0018807093
108897,108903,108911,6,8,5,600,1.4
108922,108928,202607,6,93679,12,172800,1.00006404851
113156,113162,113210,6,48,32,600,1.125
113528,113534,114142,6,608,128,600,1.00986842105
115237,115243,115330,6,87,32,600,1.06896551724
115463,115469,118493,6,3024,2,7200,1.00198412698
115464,115475,118987,11,3512,2,7200,1.00313211845
115466,115480,118817,14,3337,2,7200,1.00419538508
115467,115486,118839,19,3353,2,7200,1.00566656725
115468,115491,119033,23,3542,2,7200,1.00649350649
115470,115496,119022,26,3526,2,7200,1.00737379467
115471,115502,118824,31,3322,2,7200,1.00933172787
115472,115507,118508,35,3001,2,7200,1.01166277907
115474,115512,118955,38,3443,2,7200,1.01103688644
115475,115518,118926,43,3408,2,7200,1.01261737089
115476,115523,118780,47,3257,2,7200,1.01443045748
115478,115528,118866,50,3338,2,7200,1.01497902936
115479,115533,118749,54,3216,2,7200,1.01679104478
115480,115539,118648,59,3109,2,7200,1.01897716307
115482,115544,118697,62,3153,2,7200,1.01966381224
115483,115549,118646,66,3097,2,7200,1.02131094608
115484,115554,118835,70,3281,2,7200,1.02133495885
115486,115560,118672,74,3112,2,7200,1.02377892031
115487,115565,118808,78,3243,2,7200,1.02405180389
115488,115570,118985,82,3415,2,7200,1.02401171303
115489,115575,118767,86,3192,2,7200,1.02694235589
115491,115581,118902,90,3321,2,7200,1.027100271
115492,115586,118642,94,3056,2,7200,1.0307591623
115493,115591,118990,98,3399,2,7200,1.02883200941
115495,115597,118854,102,3257,2,7200,1.03131716303
115496,115602,118889,106,3287,2,7200,1.03224825068
115497,115608,118798,111,3190,2,7200,1.03479623824
115499,115613,118850,114,3237,2,7200,1.03521779425
115500,115619,119026,119,3407,2,7200,1.03492808923
115501,115624,119028,123,3404,2,7200,1.03613396005
115503,115629,119128,126,3499,2,7200,1.03601028865
115504,115635,119174,131,3539,2,7200,1.03701610624
115505,115645,119092,140,3447,2,7200,1.04061502756
115507,115650,119191,143,3541,2,7200,1.0403840723
115508,115655,119145,147,3490,2,7200,1.04212034384
115509,115661,118961,152,3300,2,7200,1.04606060606
115511,115666,119038,155,3372,2,7200,1.04596678529
115512,115671,119073,159,3402,2,7200,1.0467372134
116857,116863,119807,6,2944,8,18000,1.00203804348
117017,117023,117066,6,43,2,14400,1.13953488372
117254,117260,117302,6,42,2,7200,1.14285714286
117626,117632,117670,6,38,2,7200,1.15789473684
117867,117874,117881,7,7,2,3600,1.4
118046,118052,174479,6,56427,1,259200,1.00010633208
118068,118074,248533,6,130459,1,259200,1.00004599146
118086,118092,377308,6,259216,1,259200,1.00002314672
118237,118243,118248,6,5,16,300,1.1
118494,118500,122001,6,3501,2,7200,1.00171379606
118509,118515,121873,6,3358,2,7200,1.00178677784
118644,118650,121926,6,3276,2,7200,1.00183150183
118645,118656,122175,11,3519,2,7200,1.00312588804
118661,118668,122028,7,3360,2,7200,1.00208333333
118677,118683,121973,6,3290,2,7200,1.00182370821
118699,118705,121903,6,3198,2,7200,1.00187617261
118748,118754,121847,6,3093,2,7200,1.00193986421
118767,118773,122321,6,3548,2,7200,1.00169109357
118782,118788,122181,6,3393,2,7200,1.0017683466
118798,118804,122176,6,3372,2,7200,1.00177935943
118813,118819,121992,6,3173,2,7200,1.00189095493
118829,118835,122054,6,3219,2,7200,1.0018639329
118830,118841,122146,11,3305,2,7200,1.00332829047
118846,118852,122077,6,3225,2,7200,1.00186046512
118847,118858,122010,11,3152,2,7200,1.00348984772
118863,118869,122048,6,3179,2,7200,1.00188738597
118865,118875,122276,10,3401,2,7200,1.00294031167
118880,118886,122372,6,3486,2,7200,1.0017211704
118896,118901,122280,5,3379,2,7200,1.00147972773
118911,118917,122464,6,3547,2,7200,1.00169157034
118930,118936,122659,6,3723,2,7200,1.00161160355
118954,118960,122330,6,3370,2,7200,1.00178041543
118970,118976,122306,6,3330,2,7200,1.0018018018
118985,118991,122432,6,3441,2,7200,1.00174367916
118987,118997,122379,10,3382,2,7200,1.00295683028
119002,119008,122182,6,3174,2,7200,1.00189035917
119021,119027,122447,6,3420,2,7200,1.00175438596
119039,119044,122526,5,3482,2,7200,1.00143595635
119040,119051,122392,11,3341,2,7200,1.00329242742
119041,119057,122291,16,3234,2,7200,1.00494743352
119043,119062,122419,19,3357,2,7200,1.00565981531
119074,119080,122184,6,3104,2,7200,1.00193298969
119093,119099,122123,6,3024,2,7200,1.00198412698
119126,119132,122460,6,3328,2,7200,1.00180288462
119145,119151,122550,6,3399,2,7200,1.00176522507
119157,119163,119534,6,371,16,1210,1.01617250674
119163,119169,119174,6,5,16,300,1.1
119176,119182,122370,6,3188,2,7200,1.00188205772
119191,119198,122381,7,3183,2,7200,1.00219918316
119414,119420,120533,6,1113,4,86400,1.00539083558
119709,119716,120599,7,883,4,86400,1.00792751982
119944,119950,120623,6,673,4,86400,1.00891530461
120205,120211,130366,6,10155,6,360000,1.00059084195
120547,120553,120958,6,405,14,2460,1.01481481481
120548,120559,203083,11,82524,8,86400,1.00013329456
120603,120609,203601,6,82992,8,86400,1.00007229612
120627,120633,203226,6,82593,8,86400,1.00007264538
120653,120659,153153,6,32494,4,43200,1.00018464947
120701,120707,120722,6,15,2,3600,1.4
121267,121273,121672,6,399,14,2460,1.01503759398
121849,121855,125342,6,3487,2,7200,1.0017206768
121874,121880,125237,6,3357,2,7200,1.0017873101
121905,121911,125182,6,3271,2,7200,1.00183430144
121930,121936,125123,6,3187,2,7200,1.00188264826
121977,121983,125005,6,3022,2,7200,1.00198544011
121992,121998,125367,6,3369,2,7200,1.0017809439
122008,122014,125253,6,3239,2,7200,1.00185242359
122023,122029,125377,6,3348,2,7200,1.0017921147
122038,122044,125529,6,3485,2,7200,1.00172166428
122054,122061,125386,7,3325,2,7200,1.00210526316
122056,122067,125268,11,3201,2,7200,1.00343642612
122078,122084,125383,6,3299,2,7200,1.00181873295
122125,122131,125512,6,3381,2,7200,1.00177462289
122142,122148,124615,6,2467,14,2460,1.00243210377
122147,122154,125466,7,3312,2,7200,1.00211352657
122175,122181,125607,6,3426,2,7200,1.00175131349
122176,122187,125834,11,3647,2,7200,1.00301617768
122193,122199,125649,6,3450,2,7200,1.00173913043
122194,122205,125366,11,3161,2,7200,1.00347991142
122196,122211,125511,15,3300,2,7200,1.00454545455
122277,122283,125609,6,3326,2,7200,1.00180396873
122292,122298,125716,6,3418,2,7200,1.00175541252
122294,122305,125873,11,3568,2,7200,1.00308295964
122309,122315,125651,6,3336,2,7200,1.00179856115
122324,122331,125609,7,3278,2,7200,1.00213544844
122340,122346,125827,6,3481,2,7200,1.00172364263
122371,122377,125681,6,3304,2,7200,1.00181598063
122372,122383,125740,11,3357,2,7200,1.00327673518
122388,122394,125519,6,3125,2,7200,1.00192
122389,122400,125592,11,3192,2,7200,1.00344611529
122405,122412,125881,7,3469,2,7200,1.00201787259
122421,122427,125900,6,3473,2,7200,1.00172761301
122436,122442,125681,6,3239,2,7200,1.00185242359
122452,122458,125537,6,3079,2,7200,1.00194868464
122467,122473,126156,6,3683,2,7200,1.00162910671
122469,122479,125851,10,3372,2,7200,1.00296559905
122530,122536,126003,6,3467,2,7200,1.00173060283
122552,122558,126062,6,3504,2,7200,1.00171232877
122659,122665,126086,6,3421,2,7200,1.00175387314
122676,122682,123055,6,373,14,2460,1.01608579088
123057,123063,123292,6,229,1,3600,1.02620087336
123123,123129,123145,6,16,2,3600,1.375
123138,123145,123149,7,4,1,310,1.1
123222,123228,123633,6,405,14,2460,1.01481481481
123387,123393,123408,6,15,1,310,1.4
123460,123466,299984,6,176518,6,604800,1.00003399087
123534,123540,492740,6,369200,6,604800,1.00001625135
123575,123581,123586,6,5,1,310,1.1
123594,123600,123610,6,10,2,3600,1.6
123667,123673,130979,6,7306,1,7200,1.00082124281
123775,123781,123796,6,15,1,310,1.4
123811,123817,128625,6,4808,6,604800,1.00124792013
123912,123921,123932,9,11,2,3600,1.81818181818
124042,124049,128509,7,4460,8,604800,1.00156950673
124178,124184,124305,6,121,8,604800,1.04958677686
124183,124642,124738,459,96,1,310,5.78125
124254,124632,124644,378,12,2,3600,32.5
124269,124316,129252,47,4936,8,604800,1.00952188006
124295,124626,130222,331,5596,8,604800,1.05914939242
124610,124637,124646,27,9,2,3600,3.6
125008,125014,128248,6,3234,2,7200,1.00185528757
125114,125120,125204,6,84,1,310,1.07142857143
125126,125132,128407,6,3275,2,7200,1.00183206107
125186,125192,128540,6,3348,2,7200,1.0017921147
125238,125244,125256,6,12,2,3600,1.5
125241,125250,128665,9,3415,2,7200,1.00263543192
125258,125264,128474,6,3210,2,7200,1.00186915888
125275,125281,128633,6,3352,2,7200,1.00178997613
125345,125351,128420,6,3069,2,7200,1.00195503421
125367,125373,128669,6,3296,2,7200,1.00182038835
125368,125379,128653,11,3274,2,7200,1.00335980452
125371,125385,125463,14,78,1,310,1.17948717949
125384,125391,128414,7,3023,2,7200,1.00231558055
125386,125396,128441,10,3045,2,7200,1.00328407225
125387,125403,128554,16,3151,2,7200,1.00507775309
125465,125472,128638,7,3166,2,7200,1.00221099179
125511,125517,128929,6,3412,2,7200,1.00175849941
125512,125523,128886,11,3363,2,7200,1.00327088909
125529,125535,128725,6,3190,2,7200,1.00188087774
125530,125541,128667,11,3126,2,7200,1.00351887396
125532,125547,125595,15,48,1,300,1.3125
125542,125554,125570,12,16,2,72000,1.75
125546,125559,129061,13,3502,2,7200,1.00371216448
125563,125569,125657,6,88,2,300,1.06818181818
125587,125594,125685,7,91,4,600,1.07692307692
125593,125600,128959,7,3359,2,7200,1.00208395356
125612,125618,129068,6,3450,2,7200,1.00173913043
125612,125624,125720,12,96,8,300,1.125
125613,125630,128826,17,3196,2,7200,1.00531914894
125615,125635,128830,20,3195,2,7200,1.00625978091
125651,125657,128919,6,3262,2,7200,1.00183936235
125652,125663,128842,11,3179,2,7200,1.00346020761
125657,125733,125858,76,125,16,300,1.608
125683,125690,128877,7,3187,2,7200,1.00219642297
125684,125702,129031,18,3329,2,7200,1.00540702914
125686,125696,125709,10,13,2,3600,1.76923076923
125695,125888,126034,193,146,32,300,2.32191780822
125718,125724,128882,6,3158,2,7200,1.00189993667
125740,125746,128808,6,3062,2,7200,1.00195950359
125773,125912,341937,139,216025,1,216000,1.00064344405
125773,125918,341927,145,216009,1,216000,1.00067126833
125774,126019,342069,245,216050,1,216000,1.00113399676
125804,125895,169326,91,43431,2,72000,1.00209527757
125827,125834,128885,7,3051,2,7200,1.00229432973
125844,125850,128808,6,2958,2,7200,1.00202839757
125860,125867,129123,7,3256,2,7200,1.00214987715
125875,125882,128945,7,3063,2,7200,1.00228534117
125891,125901,129073,10,3172,2,7200,1.00315258512
125908,125924,129367,16,3443,2,7200,1.00464711008
126007,126013,129449,6,3436,2,7200,1.00174621653
126066,126072,129475,6,3403,2,7200,1.00176315016
126079,126085,126099,6,14,2,3600,1.42857142857
126088,126094,129269,6,3175,2,7200,1.00188976378
126156,126162,129515,6,3353,2,7200,1.00178944229
126371,126377,133178,6,6801,4,345600,1.0008822232
126411,126418,179178,7,52760,4,345600,1.00013267627
126462,126468,126478,6,10,4,345600,1.6
126563,126569,126585,6,16,1,310,1.375
126597,126604,127016,7,412,14,2460,1.01699029126
126709,126715,126728,6,13,4,345600,1.46153846154
126714,126721,126732,7,11,2,3600,1.63636363636
126811,126817,126825,6,8,4,345600,1.4
126836,126842,326409,6,199567,4,345600,1.00003006509
127142,127148,127164,6,16,2,3600,1.375
127300,127306,127488,6,182,16,1210,1.03296703297
127560,128486,128939,926,453,32,900,3.04415011038
127577,127583,127961,6,378,14,2460,1.01587301587
127603,127610,127643,7,33,2,20,1.21212121212
127651,127657,127736,6,79,2,1200,1.07594936709
127668,128524,128529,856,5,4,18000,86.1
127701,127710,127726,9,16,2,3600,1.5625
128111,128117,128126,6,9,2,3600,1.5
128259,128266,130682,7,2416,2,7200,1.00289735099
128416,128422,130682,6,2260,2,7200,1.00265486726
128417,128429,130682,12,2253,2,7200,1.00532623169
128441,128447,130682,6,2235,2,7200,1.00268456376
128443,128454,130682,11,2228,2,7200,1.00493716338
128446,128660,129273,214,613,14,2460,1.34910277325
128477,128539,162311,62,33772,8,108000,1.00183584034
128484,128493,130682,9,2189,2,7200,1.00411146642
128717,128723,130683,6,1960,2,7200,1.00306122449
128718,128729,130682,11,1953,2,7200,1.00563236047
128720,128734,130682,14,1948,2,7200,1.00718685832
128721,128740,130682,19,1942,2,7200,1.00978372812
128723,128745,130682,22,1937,2,7200,1.01135776975
128724,128751,130682,27,1931,2,7200,1.01398239254
128726,128757,130682,31,1925,2,7200,1.0161038961
128727,128762,130683,35,1921,2,7200,1.01821967725
128863,128869,130682,6,1813,2,7200,1.00330943188
128864,128875,130682,11,1807,2,7200,1.00608743774
128866,128881,130682,15,1801,2,7200,1.00832870627
128867,128886,130682,19,1796,2,7200,1.01057906459
128875,128892,130682,17,1790,2,7200,1.0094972067
128877,128898,130682,21,1784,2,7200,1.01177130045
128900,128907,130686,7,1779,2,7200,1.00393479483
128902,128913,130686,11,1773,2,7200,1.00620417372
128903,128918,130688,15,1770,2,7200,1.00847457627
128904,128924,130688,20,1764,2,7200,1.01133786848
128930,128936,130688,6,1752,2,7200,1.00342465753
128931,128942,130688,11,1746,2,7200,1.00630011455
128942,128951,129110,9,159,1,300,1.05660377358
128948,128957,129233,9,276,2,300,1.03260869565
128953,128963,130688,10,1725,2,7200,1.00579710145
128955,128968,129228,13,260,4,600,1.05
128961,128979,129224,18,245,8,300,1.07346938776
128968,128974,129213,6,239,16,300,1.02510460251
128974,128986,130689,12,1703,2,7200,1.00704638873
128975,129244,129509,269,265,32,300,2.01509433962
129040,129047,130689,7,1642,2,7200,1.00426309379
129067,129072,130689,5,1617,2,7200,1.00309214595
129089,129095,130689,6,1594,2,7200,1.00376411543
129091,129101,130689,10,1588,2,7200,1.00629722922
129128,129134,130689,6,1555,2,7200,1.0038585209
129274,129280,130689,6,1409,2,7200,1.00425833925
129369,129375,130689,6,1314,2,7200,1.00456621005
129452,129458,130689,6,1231,2,7200,1.00487408611
129476,129482,130689,6,1207,2,7200,1.00497100249
129519,129525,130689,6,1164,2,7200,1.00515463918
129696,129702,129723,6,21,2,3600,1.28571428571
129820,129826,129837,6,11,4,345600,1.54545454545
129824,129832,130166,8,334,8,604800,1.02395209581
130188,130194,135994,6,5800,8,108000,1.00103448276
130215,130221,215011,6,84790,8,108000,1.00007076306
130408,130414,130433,6,19,6,360000,1.31578947368
130411,130420,226271,9,95851,4,108000,1.00009389573
130427,130433,411904,6,281471,4,345600,1.00002131658
130449,130455,136790,6,6335,8,360000,1.00094711918
130545,130552,140295,7,9743,12,86400,1.00071846454
130661,130667,130684,6,17,1,310,1.35294117647
130741,130747,132501,6,1754,2,7200,1.00342075257
130742,130753,132501,11,1748,2,7200,1.00629290618
130743,130758,132501,15,1743,2,7200,1.00860585198
130745,130764,132501,19,1737,2,7200,1.01093839954
130746,130769,132501,23,1732,2,7200,1.01327944573
130747,130774,132501,27,1727,2,7200,1.01563404748
130749,130780,132501,31,1721,2,7200,1.01801278327
130751,130785,132501,34,1716,2,7200,1.01981351981
130752,130791,132501,39,1710,2,7200,1.02280701754
130754,130796,132501,42,1705,2,7200,1.02463343109
130756,130801,132501,45,1700,2,7200,1.02647058824
130757,130806,132501,49,1695,2,7200,1.02890855457
130759,130812,132501,53,1689,2,7200,1.03137951451
130760,130817,132501,57,1684,2,7200,1.033847981
130762,130822,132501,60,1679,2,7200,1.03573555688
130763,130827,132501,64,1674,2,7200,1.03823178017
130765,130833,132501,68,1668,2,7200,1.04076738609
130766,130838,132501,72,1663,2,7200,1.04329524955
130768,130843,132501,75,1658,2,7200,1.04523522316
130770,130848,132501,78,1653,2,7200,1.04718693285
130771,130854,132501,83,1647,2,7200,1.05039465695
130773,130859,132501,86,1642,2,7200,1.05237515225
130775,130865,132501,90,1636,2,7200,1.05501222494
130777,130870,132501,93,1631,2,7200,1.05702023299
130778,130875,132501,97,1626,2,7200,1.05965559656
130780,130881,132501,101,1620,2,7200,1.06234567901
130781,130886,132501,105,1615,2,7200,1.06501547988
130783,130891,132501,108,1610,2,7200,1.06708074534
130784,130896,132501,112,1605,2,7200,1.06978193146
130786,130902,132501,116,1599,2,7200,1.07254534084
130787,130907,132504,120,1597,2,7200,1.07514088917
130789,130912,132504,123,1592,2,7200,1.07726130653
130791,130917,132504,126,1587,2,7200,1.07939508507
130792,130923,132504,131,1581,2,7200,1.08285895003
130794,130928,132504,134,1576,2,7200,1.08502538071
130795,130933,132504,138,1571,2,7200,1.08784213877
130796,130938,132504,142,1566,2,7200,1.09067688378
130798,130944,132504,146,1560,2,7200,1.09358974359
130799,130949,132504,150,1555,2,7200,1.09646302251
130801,130954,132504,153,1550,2,7200,1.09870967742
130803,130959,132504,156,1545,2,7200,1.10097087379
130805,130965,132504,160,1539,2,7200,1.10396361274
130806,130970,132504,164,1534,2,7200,1.10691003911
130808,130975,132504,167,1529,2,7200,1.10922171354
130809,130980,132504,171,1524,2,7200,1.11220472441
130811,130986,132504,175,1518,2,7200,1.11528326746
130812,130991,132504,179,1513,2,7200,1.11830799736
130814,130996,132504,182,1508,2,7200,1.12068965517
130815,131001,132504,186,1503,2,7200,1.12375249501
130817,131006,132504,189,1498,2,7200,1.1261682243
130818,131012,132504,194,1492,2,7200,1.13002680965
130819,131017,132504,198,1487,2,7200,1.13315400134
130821,131022,132504,201,1482,2,7200,1.13562753036
130822,131027,132504,205,1477,2,7200,1.13879485443
130824,131033,132504,209,1471,2,7200,1.14208021754
130826,131038,132504,212,1466,2,7200,1.1446111869
130828,131043,132504,215,1461,2,7200,1.14715947981
130829,131048,132504,219,1456,2,7200,1.15041208791
130831,131054,132504,223,1450,2,7200,1.15379310345
130832,131059,132504,227,1445,2,7200,1.15709342561
130834,131064,132504,230,1440,2,7200,1.15972222222
130836,131069,132504,233,1435,2,7200,1.16236933798
130837,131075,132504,238,1429,2,7200,1.16655003499
130838,131278,132504,440,1226,2,7200,1.35889070147
130840,131284,132504,444,1220,2,7200,1.36393442623
130841,131289,132504,448,1215,2,7200,1.36872427984
131242,131249,131271,7,22,1,310,1.31818181818
131398,137702,138089,6304,387,64,900,17.2894056848
131657,215713,216178,84056,465,128,900,181.765591398
133588,133594,133838,6,244,16,1210,1.02459016393
133701,133707,137423,6,3716,2,7200,1.0016146394
133702,133714,137055,12,3341,2,7200,1.003591739
133703,133720,137105,17,3385,2,7200,1.00502215657
133705,133725,137005,20,3280,2,7200,1.00609756098
133706,133730,137183,24,3453,2,7200,1.00695047785
133707,133735,137138,28,3403,2,7200,1.00822803409
133708,133741,137102,33,3361,2,7200,1.0098185064
133710,133747,137257,37,3510,2,7200,1.01054131054
133711,133752,137176,41,3424,2,7200,1.01197429907
133712,133757,137110,45,3353,2,7200,1.01342081718
133714,133762,137161,48,3399,2,7200,1.01412180053
133715,133768,137103,53,3335,2,7200,1.01589205397
133716,133773,137187,57,3414,2,7200,1.01669595782
133718,133778,137170,60,3392,2,7200,1.01768867925
133719,133783,137199,64,3416,2,7200,1.018735363
133720,133789,137237,69,3448,2,7200,1.02001160093
133721,133794,137246,73,3452,2,7200,1.02114716107
133723,133799,137268,76,3469,2,7200,1.02190833093
133724,133804,137100,80,3296,2,7200,1.02427184466
133725,133810,137250,85,3440,2,7200,1.02470930233
133727,133815,137165,88,3350,2,7200,1.02626865672
133728,133820,137114,92,3294,2,7200,1.02792956891
133729,133825,137232,96,3407,2,7200,1.02817728207
133731,133831,137340,100,3509,2,7200,1.02849814762
133732,133836,137050,104,3214,2,7200,1.03235843186
133733,133841,137256,108,3415,2,7200,1.03162518302
133735,133846,137242,111,3396,2,7200,1.03268551237
133736,133852,137304,116,3452,2,7200,1.033603708
133737,133857,137339,120,3482,2,7200,1.03446295233
133738,133862,137089,124,3227,2,7200,1.03842578246
133740,133867,137212,127,3345,2,7200,1.0379671151
133741,133872,137255,131,3383,2,7200,1.0387230269
133742,133879,137117,137,3238,2,7200,1.04231006794
133744,133885,137433,141,3548,2,7200,1.03974069899
133745,133890,136955,145,3065,2,7200,1.04730831974
133746,133895,137202,149,3307,2,7200,1.04505594194
133748,133900,137338,152,3438,2,7200,1.04421175102
133749,133905,137365,156,3460,2,7200,1.0450867052
133750,133911,137282,161,3371,2,7200,1.04776030851
133752,133916,137304,164,3388,2,7200,1.04840613932
134499,137111,137520,2612,409,14,2460,7.38630806846
135148,137184,137659,2036,475,16,1210,5.28631578947
135374,135380,139049,6,3669,2,7200,1.00163532298
135375,135387,138628,12,3241,2,7200,1.00370256094
135377,135392,138756,15,3364,2,7200,1.00445897741
135378,135397,138770,19,3373,2,7200,1.00563296768
135379,135402,138912,23,3510,2,7200,1.00655270655
135381,135407,138700,26,3293,2,7200,1.00789553599
135382,135413,138897,31,3484,2,7200,1.0088978186
135383,135419,138862,36,3443,2,7200,1.01045599768
135385,135424,138928,39,3504,2,7200,1.01113013699
135386,135429,138799,43,3370,2,7200,1.01275964392
135387,135434,138650,47,3216,2,7200,1.01461442786
135389,135439,138848,50,3409,2,7200,1.01466705779
135390,135445,138772,55,3327,2,7200,1.01653140968
135391,135450,138960,59,3510,2,7200,1.01680911681
135393,135455,138846,62,3391,2,7200,1.01828369213
135394,135460,138890,66,3430,2,7200,1.01924198251
135395,135466,138930,71,3464,2,7200,1.0204965358
135397,135471,138672,74,3201,2,7200,1.0231177757
135398,135476,139029,78,3553,2,7200,1.02195327892
135399,135481,139047,82,3566,2,7200,1.02299495233
135401,135487,138808,86,3321,2,7200,1.02589581451
135402,135492,138831,90,3339,2,7200,1.0269541779
135404,135497,138806,93,3309,2,7200,1.02810516772
135405,135502,138813,97,3311,2,7200,1.02929628511
135406,135508,138973,102,3465,2,7200,1.02943722944
135408,135513,138917,105,3404,2,7200,1.03084606345
135409,135519,138899,110,3380,2,7200,1.0325443787
135410,135525,138963,115,3438,2,7200,1.03344968005
135412,137062,140589,1650,3527,2,7200,1.46781967678
135413,137102,140403,1689,3301,2,7200,1.51166313238
135793,216656,225648,80863,8992,8,108000,9.99277135231
136346,136912,138133,566,1221,2,1200,1.46355446355
136705,136907,136913,202,6,2,3600,20.8
136956,137126,140659,170,3533,2,7200,1.04811774696
136977,136984,136989,7,5,2,3600,1.2
137006,137178,140596,172,3418,2,7200,1.05032182563
137051,137224,140784,173,3560,2,7200,1.04859550562
137066,137244,140417,178,3173,2,7200,1.05609832966
137091,137254,140834,163,3580,2,7200,1.04553072626
137107,137266,140633,159,3367,2,7200,1.04722304722
137108,137273,140365,165,3092,2,7200,1.05336351876
137109,137316,140736,207,3420,2,7200,1.06052631579
137110,137351,140502,241,3151,2,7200,1.07648365598
137126,137358,140720,232,3362,2,7200,1.06900654372
137127,137708,141199,581,3491,2,7200,1.16642795761
137129,137713,141262,584,3549,2,7200,1.16455339532
137144,137718,141060,574,3342,2,7200,1.17175344105
137162,138101,141286,939,3185,2,7200,1.29481946625
137178,138107,141591,929,3484,2,7200,1.26664753157
137180,138112,141510,932,3398,2,7200,1.27427898764
137181,138117,141592,936,3475,2,7200,1.26935251799
137197,138122,141788,925,3666,2,7200,1.25231860338
137198,138128,141701,930,3573,2,7200,1.26028547439
137213,138133,141669,920,3536,2,7200,1.26018099548
137214,138138,141658,924,3520,2,7200,1.2625
137215,138143,141518,928,3375,2,7200,1.27496296296
137231,138149,141479,918,3330,2,7200,1.27567567568
137246,138154,141716,908,3562,2,7200,1.25491297024
137247,138159,141635,912,3476,2,7200,1.26237054085
137248,138164,141675,916,3511,2,7200,1.2608943321
137264,138169,141413,905,3244,2,7200,1.27897657213
137265,138175,141847,910,3672,2,7200,1.24782135076
137267,138180,141607,913,3427,2,7200,1.26641377298
137268,138185,141653,917,3468,2,7200,1.26441753172
137283,138190,141513,907,3323,2,7200,1.27294613301
137285,138196,141834,911,3638,2,7200,1.25041231446
137306,138201,141600,895,3399,2,7200,1.26331273904
137308,138206,141663,898,3457,2,7200,1.25976280012
137310,137322,137330,12,8,2,600,2.0
137342,138211,141604,869,3393,2,7200,1.25611553198
137343,138217,141469,874,3252,2,7200,1.26875768758
137345,138222,141594,877,3372,2,7200,1.26008303677
137366,138227,141660,861,3433,2,7200,1.25080104865
137424,138232,141787,808,3555,2,7200,1.22728551336
137439,138238,141589,799,3351,2,7200,1.23843628768
137540,137547,137554,7,7,2,600,1.4
138053,138243,138372,190,129,1,1500,2.47286821705
138178,138250,160217,72,21967,2,43200,1.00327764374
138452,140693,142162,2241,1469,16,3010,2.52552756978
138545,138552,139134,7,582,2,1200,1.01202749141
139336,140306,140681,970,375,14,2460,3.58666666667
139477,139484,140053,7,569,2,2460,1.01230228471
140004,140011,141404,7,1393,2,2460,1.00502512563
140679,140687,140693,8,6,1,900,1.4
140688,141415,142870,727,1455,14,2460,1.49965635739
141119,141126,141308,7,182,1,2100,1.03846153846
141150,141156,141335,6,179,2,14400,1.03351955307
141402,141408,141412,6,4,1,900,1.0
141412,141424,143135,12,1711,2,2460,1.00701344243
141433,141601,151345,168,9744,12,86400,1.01724137931
141543,141608,141963,65,355,2,14400,1.18309859155
141704,141710,142114,6,404,14,2460,1.01485148515
142112,142119,142221,7,102,1,900,1.06862745098
142126,142132,143567,6,1435,14,2460,1.00418118467
142166,142172,142428,6,256,2,14400,1.0234375
142465,142471,149328,6,6857,2,18000,1.00087501823
142705,142711,142920,6,209,2,14400,1.02870813397
142743,142749,147996,6,5247,16,7810,1.00114351058
142879,142885,143254,6,369,14,2460,1.0162601626
143145,143151,143558,6,407,2,2460,1.01474201474
143252,143260,143265,8,5,1,900,1.3
143260,143266,144749,6,1483,14,2460,1.004045853
143565,143571,143577,6,6,1,900,1.2
143575,143582,145059,7,1477,14,2460,1.00473933649
143988,143995,234032,7,90037,1,90000,1.00007774582
144277,144283,144527,6,244,1,3600,1.02459016393
144439,144445,145526,6,1081,2,1800,1.00555041628
144487,144493,144505,6,12,2,7200,1.5
144488,144500,144505,12,5,2,7200,1.7
144490,144506,144507,16,1,2,7200,1.7
144491,144511,144512,20,1,2,7200,2.1
144492,144516,144517,24,1,2,7200,2.5
144493,144521,144522,28,1,2,7200,2.9
144624,144630,148310,6,3680,2,7200,1.00163043478
144625,144638,148092,13,3454,2,7200,1.00376375217
144626,144643,148127,17,3484,2,7200,1.00487944891
144628,144648,147959,20,3311,2,7200,1.00604047116
144629,144653,148166,24,3513,2,7200,1.00683176772
144629,144669,162696,40,18027,2,18000,1.00221889388
144630,144659,147975,29,3316,2,7200,1.00874547648
144632,144664,147919,32,3255,2,7200,1.00983102919
144633,144676,147908,43,3232,2,7200,1.01330445545
144634,144681,148168,47,3487,2,7200,1.01347863493
144636,144686,148005,50,3319,2,7200,1.01506477855
144637,144691,148201,54,3510,2,7200,1.01538461538
144638,144697,148132,59,3435,2,7200,1.01717612809
144639,144702,148028,63,3326,2,7200,1.01894167168
144641,144707,148169,66,3462,2,7200,1.01906412478
144642,144712,148131,70,3419,2,7200,1.02047382276
144643,144718,147920,75,3202,2,7200,1.02342286071
144645,144723,148212,78,3489,2,7200,1.02235597592
144646,144728,148288,82,3560,2,7200,1.02303370787
144647,144733,148118,86,3385,2,7200,1.02540620384
144649,144739,148231,90,3492,2,7200,1.02577319588
144650,144744,148072,94,3328,2,7200,1.02824519231
144651,144749,148125,98,3376,2,7200,1.02902843602
144653,144754,148259,101,3505,2,7200,1.02881597718
144654,144760,147978,106,3218,2,7200,1.03293971411
144655,144765,148148,110,3383,2,7200,1.03251551877
144657,144770,148092,113,3322,2,7200,1.03401565322
144658,144775,148156,117,3381,2,7200,1.03460514641
144659,144781,147981,122,3200,2,7200,1.038125
144661,144786,148200,125,3414,2,7200,1.03661394259
144662,144791,148129,129,3338,2,7200,1.03864589575
144663,144796,147990,133,3194,2,7200,1.04164057608
144665,144802,148354,137,3552,2,7200,1.03856981982
144666,144807,148163,141,3356,2,7200,1.04201430274
144667,144812,148280,145,3468,2,7200,1.04181084198
144669,144817,147906,148,3089,2,7200,1.04791194561
144670,144830,148142,160,3312,2,7200,1.04830917874
144671,144835,148118,164,3283,2,7200,1.04995431008
144673,144840,148146,167,3306,2,7200,1.05051421658
144674,144846,148321,172,3475,2,7200,1.04949640288
144675,144851,148207,176,3356,2,7200,1.05244338498
144677,144856,148003,179,3147,2,7200,1.05687956784
144678,144861,148527,183,3666,2,7200,1.04991816694
144679,144866,148377,187,3511,2,7200,1.05326117915
144681,144872,148257,191,3385,2,7200,1.0564254062
144682,144877,148387,195,3510,2,7200,1.05555555556
144683,144882,148039,199,3157,2,7200,1.06303452645
144685,144887,148359,202,3472,2,7200,1.0581797235
144686,144893,148405,207,3512,2,7200,1.05894077449
144687,144898,148324,211,3426,2,7200,1.06158785756
144689,144903,148341,214,3438,2,7200,1.06224549156
144690,145076,148480,386,3404,2,7200,1.1133960047
144691,145081,148333,390,3252,2,7200,1.11992619926
144693,145086,148514,393,3428,2,7200,1.11464410735
144694,145092,148232,398,3140,2,7200,1.12675159236
144695,145097,148458,402,3361,2,7200,1.11960725974
144697,145102,148601,405,3499,2,7200,1.11574735639
144699,145538,148793,839,3255,2,7200,1.25775729647
144700,146669,150047,1969,3378,2,7200,1.5828892836
144702,147919,151136,3217,3217,2,7200,2.0
144703,147926,151234,3223,3308,2,7200,1.97430471584
144704,147933,151461,3229,3528,2,7200,1.91524943311
144706,147938,151485,3232,3547,2,7200,1.91119255709
144707,147970,151355,3263,3385,2,7200,1.96395864106
144708,147988,151220,3280,3232,2,7200,2.01485148515
144710,147995,151421,3285,3426,2,7200,1.9588441331
144711,148000,151413,3289,3413,2,7200,1.96366832699
144713,148007,151237,3294,3230,2,7200,2.01981424149
144714,148019,151660,3305,3641,2,7200,1.90771765998
144715,148036,151670,3321,3634,2,7200,1.91386901486
144717,148044,151646,3327,3602,2,7200,1.92365352582
144749,145107,145113,358,6,1,900,36.4
144760,144825,145196,65,371,14,2460,1.17520215633
144886,194208,367029,49322,172821,1,172800,1.2853935575
144886,148026,320828,3140,172802,1,172800,1.01817108598
144886,148031,320873,3145,172842,1,172800,1.01819580889
144887,199288,372122,54401,172834,1,172800,1.31475867017
144887,199283,372086,54396,172803,1,172800,1.31478620163
144887,202625,375459,57738,172834,1,172800,1.33406621382
144887,202619,375453,57732,172834,1,172800,1.33403149843
144887,145071,173454,184,28383,1,43200,1.00648275376
144888,202636,375452,57748,172816,1,172800,1.33415887418
144888,202630,375450,57742,172820,1,172800,1.33411642171
144888,202641,375449,57753,172808,1,172800,1.33420327763
144889,205992,378824,61103,172832,1,172800,1.35353985373
144889,205997,378827,61108,172830,1,172800,1.35357287508
144889,206002,378841,61113,172839,1,172800,1.35358339264
144889,209785,382612,64896,172827,1,172800,1.37549688417
144890,215024,387870,70134,172846,1,172800,1.40576004073
144890,209790,382612,64900,172822,1,172800,1.37553089306
144890,215029,387831,70139,172802,1,172800,1.40589229291
144890,209795,382620,64905,172825,1,172800,1.37555330537
144891,215042,387873,70151,172831,1,172800,1.40589361862
144891,215037,387836,70146,172799,1,172800,1.40593984919
145057,145124,145129,67,5,1,900,7.2
145072,145208,146592,136,1384,14,2460,1.09826589595
145195,145202,145203,7,1,1,900,1.0
145597,145604,189742,7,44138,1,44100,1.0001585935
145608,146610,190729,1002,44119,1,44100,1.02271130352
145616,146615,151181,999,4566,1,44100,1.21879106439
145625,146620,190744,995,44124,1,44100,1.02255008612
145632,146625,190737,993,44112,1,44100,1.02251088139
145640,146631,151228,991,4597,1,44100,1.21557537524
145648,146636,151251,988,4615,1,44100,1.21408450704
145655,146643,190778,988,44135,1,44100,1.02238586156
145663,146648,190778,985,44130,1,44100,1.02232041695
145672,146653,152280,981,5627,1,44100,1.17433801315
145677,146659,157828,982,11169,1,44100,1.08792192676
145982,146604,146612,622,8,8,72000,63.0
146124,158277,176283,12153,18006,2,18000,1.6749416861
146301,158293,176304,11992,18011,2,18000,1.66581533507
146590,146664,146668,74,4,1,900,7.8
146601,148013,149345,1412,1332,14,2460,2.06006006006
146617,158299,176308,11682,18009,2,18000,1.64867566217
146718,148491,213011,1773,64520,8,72000,1.02747985121
146744,146751,146753,7,2,1,1200,1.0
146772,158334,176344,11562,18010,2,18000,1.64197667962
146904,146911,147266,7,355,1,1200,1.01971830986
147090,147096,147173,6,77,1,3600,1.07792207792
147279,151390,187420,4111,36030,16,36000,1.11409936164
147293,147300,167039,7,19739,1,36000,1.00035462789
147326,147333,148577,7,1244,1,1200,1.00562700965
147543,163248,199271,15705,36023,16,36000,1.43597146268
147892,151377,151498,3485,121,2,14400,29.8016528926
147906,148050,151418,144,3368,2,7200,1.04275534442
147921,148084,151456,163,3372,2,7200,1.04833926453
147922,148104,151641,182,3537,2,7200,1.05145603619
147924,148109,151642,185,3533,2,7200,1.05236343051
147957,148130,151448,173,3318,2,7200,1.05213984328
147962,216661,223331,68699,6670,2,86400,11.2997001499
147974,148135,151526,161,3391,2,7200,1.04747861988
147989,148141,151712,152,3571,2,7200,1.04256510781
147991,148147,151664,156,3517,2,7200,1.04435598521
147992,148152,151633,160,3481,2,7200,1.0459638035
148007,148159,151438,152,3279,2,7200,1.04635559622
148008,148164,151559,156,3395,2,7200,1.04594992636
148026,148169,151637,143,3468,2,7200,1.04123414072
148041,148175,151654,134,3479,2,7200,1.03851681518
148071,148182,151621,111,3439,2,7200,1.03227682466
148095,148187,151868,92,3681,2,7200,1.02499320837
148096,148192,151690,96,3498,2,7200,1.02744425386
148117,148197,151455,80,3258,2,7200,1.02455494168
148133,148203,151441,70,3238,2,7200,1.02161828289
148134,148208,151719,74,3511,2,7200,1.02107661635
148135,148215,151576,80,3361,2,7200,1.02380243975
148137,148220,151544,83,3324,2,7200,1.02496991576
148138,148227,151684,89,3457,2,7200,1.02574486549
148139,148232,151611,93,3379,2,7200,1.02752293578
148154,148243,151656,89,3413,2,7200,1.02607676531
148156,148270,151741,114,3471,2,7200,1.03284356093
148157,148277,151436,120,3159,2,7200,1.03798670465
148172,148292,151770,120,3478,2,7200,1.03450258769
148174,148301,151428,127,3127,2,7200,1.04061400704
148175,148334,151600,159,3266,2,7200,1.04868340478
148176,148341,151573,165,3232,2,7200,1.0510519802
148177,148353,151727,176,3374,2,7200,1.05216360403
148202,148366,151784,164,3418,2,7200,1.0479812756
148203,148373,151862,170,3489,2,7200,1.04872456291
148218,148390,151911,172,3521,2,7200,1.04884975859
148219,148399,152010,180,3611,2,7200,1.04984768762
148234,148417,151983,183,3566,2,7200,1.05131800337
148236,148503,151803,267,3300,2,7200,1.08090909091
148257,148539,151988,282,3449,2,7200,1.08176282981
148258,149368,152865,1110,3497,2,7200,1.31741492708
148282,149373,152641,1091,3268,2,7200,1.33384332925
148296,150059,153447,1763,3388,2,7200,1.52036599764
148305,149363,222596,1058,73233,4,73200,1.0144470389
148311,151148,154563,2837,3415,2,7200,1.83074670571
148326,151193,154726,2867,3533,2,7200,1.81149165016
148328,151232,154770,2904,3538,2,7200,1.8208027134
148342,151246,154765,2904,3519,2,7200,1.8252344416
148344,151253,154442,2909,3189,2,7200,1.91219818125
148359,151264,154590,2905,3326,2,7200,1.87342152736
148360,151356,154721,2996,3365,2,7200,1.89034175334
148378,151362,154757,2984,3395,2,7200,1.87893961708
148392,151367,154907,2975,3540,2,7200,1.84039548023
148407,151372,154825,2965,3453,2,7200,1.85867361714
148458,151383,154831,2925,3448,2,7200,1.84831786543
148479,151425,154728,2946,3303,2,7200,1.8919164396
148511,149357,149517,846,160,14,960,6.2875
148515,151432,155042,2917,3610,2,7200,1.808033241
148529,151439,154912,2910,3473,2,7200,1.83789231212
148604,151446,154978,2842,3532,2,7200,1.80464326161
148795,151452,154666,2657,3214,2,7200,1.82669570629
149335,149342,149478,7,136,1,900,1.05147058824
149347,149529,150997,182,1468,14,2460,1.12397820163
149506,149513,149629,7,116,1,900,1.06034482759
149527,151009,151353,1482,344,14,960,5.30813953488
149582,216666,366156,67084,149490,2,172800,1.44875242491
150033,151476,151639,1443,163,2,14400,9.8527607362
150046,151457,154855,1411,3398,2,7200,1.41524426133
150286,151510,151687,1224,177,2,14400,7.91525423729
150488,151634,151891,1146,257,2,14400,5.45914396887
150658,216671,221058,66013,4387,2,86400,16.0474128106
150682,151651,151912,969,261,2,14400,4.71264367816
150866,151663,151953,797,290,2,14400,3.74827586207
151136,151464,154761,328,3297,2,7200,1.09948437974
151222,151469,154984,247,3515,2,7200,1.07027027027
151237,151481,155077,244,3596,2,7200,1.06785317019
151238,151486,155170,248,3684,2,7200,1.06731813246
151351,152293,152299,942,6,1,900,94.8
151356,151498,154638,142,3140,2,7200,1.04522292994
151358,162708,162848,11350,140,14,960,82.0714285714
151413,151538,154986,125,3448,2,7200,1.03625290023
151428,151557,155083,129,3526,2,7200,1.03658536585
151429,151571,155138,142,3567,2,7200,1.03980936361
151430,151586,154937,156,3351,2,7200,1.04655326768
151446,151593,155160,147,3567,2,7200,1.04121110177
151447,151613,154988,166,3375,2,7200,1.04918518519
151448,151624,154895,176,3271,2,7200,1.05380617548
151463,151644,155191,181,3547,2,7200,1.05102903862
151465,151656,155222,191,3566,2,7200,1.05356141335
151466,151668,155098,202,3430,2,7200,1.05889212828
151467,151673,155209,206,3536,2,7200,1.05825791855
151485,151680,154967,195,3287,2,7200,1.05932461211
151527,151685,155157,158,3472,2,7200,1.04550691244
151544,151690,155178,146,3488,2,7200,1.04185779817
151559,151695,155113,136,3418,2,7200,1.0397893505
151574,151703,155294,129,3591,2,7200,1.03592314119
151589,151708,154871,119,3163,2,7200,1.03762251028
151603,151713,155227,110,3514,2,7200,1.031303358
151618,151718,155084,100,3366,2,7200,1.02970885324
151633,151726,154975,93,3249,2,7200,1.02862419206
151633,154733,154919,3100,186,2,14400,17.6666666667
151634,151733,155133,99,3400,2,7200,1.02911764706
151650,151740,155159,90,3419,2,7200,1.0263234864
151651,151754,155190,103,3436,2,7200,1.02997671711
151652,151783,155357,131,3574,2,7200,1.0366536094
151654,151796,154953,142,3157,2,7200,1.04497941083
151669,151815,155120,146,3305,2,7200,1.04417549168
151670,151874,155296,204,3422,2,7200,1.05961426067
151671,151880,155438,209,3558,2,7200,1.05874086565
151673,151903,155246,230,3343,2,7200,1.06880047861
151674,151923,155318,249,3395,2,7200,1.07334315169
151689,151929,155472,240,3543,2,7200,1.06773920406
151690,151965,155332,275,3367,2,7200,1.08167508168
151714,151996,155269,282,3273,2,7200,1.08615948671
151729,152003,155437,274,3434,2,7200,1.07979033197
151730,152022,155348,292,3326,2,7200,1.08779314492
151745,152653,156055,908,3402,2,7200,1.26690182246
151772,152878,156421,1106,3543,2,7200,1.31216483206
151786,153165,156487,1379,3322,2,7200,1.41511137869
151804,153170,156476,1366,3306,2,7200,1.41318814277
151861,153459,156685,1598,3226,2,7200,1.49535027898
151876,154455,157908,2579,3453,2,7200,1.74688676513
151912,154576,158011,2664,3435,2,7200,1.77554585153
151981,154602,158103,2621,3501,2,7200,1.74864324479
151996,154650,157944,2654,3294,2,7200,1.80570734669
152010,154678,157950,2668,3272,2,7200,1.81540342298
152641,154739,158022,2098,3283,2,7200,1.63904964971
152864,154744,158186,1880,3442,2,7200,1.54619407321
153447,154769,158098,1322,3329,2,7200,1.39711625113
154444,154775,158009,331,3234,2,7200,1.10235003092
154561,154782,157933,221,3151,2,7200,1.07013646461
154588,154788,158115,200,3327,2,7200,1.06011421701
154639,154838,158264,199,3426,2,7200,1.05808523059
154666,154845,158323,179,3478,2,7200,1.05146635998
154720,154867,158377,147,3510,2,7200,1.04188034188
154735,154883,158364,148,3481,2,7200,1.04251651824
154736,154907,158316,171,3409,2,7200,1.05016133764
154757,154919,158286,162,3367,2,7200,1.04811404811
154772,154926,158447,154,3521,2,7200,1.04373757455
154773,154933,158280,160,3347,2,7200,1.04780400359
154775,154949,158242,174,3293,2,7200,1.05283935621
154826,154966,158627,140,3661,2,7200,1.03824091778
154841,154980,158514,139,3534,2,7200,1.03933220147
154855,154986,158365,131,3379,2,7200,1.03876886653
154870,154994,158417,124,3423,2,7200,1.03622553316
154897,155001,158814,104,3813,2,7200,1.02727511146
154912,155006,158630,94,3624,2,7200,1.02593818985
154927,155011,158344,84,3333,2,7200,1.02520252025
154941,155053,158309,112,3256,2,7200,1.0343980344
154956,155089,158604,133,3515,2,7200,1.03783783784
154971,155096,158520,125,3424,2,7200,1.03650700935
154986,155103,158542,117,3439,2,7200,1.03402151788
154987,155110,158638,123,3528,2,7200,1.03486394558
154989,155125,158434,136,3309,2,7200,1.04110003022
154990,155131,158607,141,3476,2,7200,1.04056386651
155005,155146,158366,141,3220,2,7200,1.04378881988
155044,155153,158458,109,3305,2,7200,1.03298033283
155077,155169,158499,92,3330,2,7200,1.02762762763
155092,155176,158598,84,3422,2,7200,1.02454704851
155093,155181,158430,88,3249,2,7200,1.027085257
155108,155188,158894,80,3706,2,7200,1.0215866163
155123,155194,158710,71,3516,2,7200,1.02019340159
155124,155203,158517,79,3314,2,7200,1.02383826192
155139,155208,158433,69,3225,2,7200,1.02139534884
155141,155222,158440,81,3218,2,7200,1.02517091361
155155,155234,158754,79,3520,2,7200,1.02244318182
155157,155240,158645,83,3405,2,7200,1.02437591777
155172,155258,158635,86,3377,2,7200,1.02546639029
155173,155281,158534,108,3253,2,7200,1.03320012296
155189,155306,158625,117,3319,2,7200,1.0352515818
155190,155313,158768,123,3455,2,7200,1.03560057887
155205,155331,158721,126,3390,2,7200,1.03716814159
155220,155343,158643,123,3300,2,7200,1.03727272727
155221,155361,158805,140,3444,2,7200,1.0406504065
155236,155369,158666,133,3297,2,7200,1.04033970276
155251,155450,158820,199,3370,2,7200,1.0590504451
155269,155457,158733,188,3276,2,7200,1.05738705739
155293,155484,158715,191,3231,2,7200,1.05911482513
155307,156068,159510,761,3442,2,7200,1.22109238815
155322,156433,159701,1111,3268,2,7200,1.33996328029
155337,156489,159812,1152,3323,2,7200,1.34667469154
155351,156499,159821,1148,3322,2,7200,1.34557495485
155366,156698,159884,1332,3186,2,7200,1.41807909605
155438,157846,161438,2408,3592,2,7200,1.67037861915
155440,157920,161515,2480,3595,2,7200,1.68984700974
155473,157945,161435,2472,3490,2,7200,1.70830945559
156056,157957,161404,1901,3447,2,7200,1.5514940528
156420,157964,161537,1544,3573,2,7200,1.43212986286
156477,158021,161522,1544,3501,2,7200,1.44101685233
156492,158028,161519,1536,3491,2,7200,1.43998854197
156688,158035,161473,1347,3438,2,7200,1.39179755672
157909,158110,161524,201,3414,2,7200,1.05887521968
157933,158116,161439,183,3323,2,7200,1.05507071923
157948,158128,161606,180,3478,2,7200,1.05175388154
157962,158199,161752,237,3553,2,7200,1.06670419364
158011,158255,161815,244,3560,2,7200,1.06853932584
158026,158321,161674,295,3353,2,7200,1.08798091262
158027,158327,161779,300,3452,2,7200,1.08690614137
158099,158356,161861,257,3505,2,7200,1.07332382311
158114,158377,161819,263,3442,2,7200,1.0764090645
158128,161687,164909,3559,3222,2,7200,2.10459342024
158185,161792,165182,3607,3390,2,7200,2.06401179941
158242,161831,165198,3589,3367,2,7200,2.06593406593
158263,161873,165040,3610,3167,2,7200,2.13988001263
158281,164921,168517,6640,3596,2,7200,2.84649610679
158296,165052,168483,6756,3431,2,7200,2.96910521714
158311,165195,168667,6884,3472,2,7200,2.98271889401
158326,165211,168828,6885,3617,2,7200,2.90351119712
158327,168496,171719,10169,3223,2,7200,4.15513496742
158342,168530,171889,10188,3359,2,7200,4.03304554927
158366,168678,172091,10312,3413,2,7200,4.0213888075
158367,168840,172371,10473,3531,2,7200,3.96601529312
158368,171731,175145,13363,3414,2,7200,4.91417691857
158383,171902,175284,13519,3382,2,7200,4.99733885275
158417,172104,175645,13687,3541,2,7200,4.86529229031
158432,172383,175713,13951,3330,2,7200,5.18948948949
158447,158454,161912,7,3458,2,7200,1.0020242915
158448,158461,161646,13,3185,2,7200,1.00408163265
158450,158466,161772,16,3306,2,7200,1.00483968542
158451,158471,161834,20,3363,2,7200,1.00594707107
158466,175157,178684,16691,3527,2,7200,5.73235043947
158502,175297,178763,16795,3466,2,7200,5.84564339296
158517,175657,178876,17140,3219,2,7200,6.32463497981
158518,175726,179339,17208,3613,2,7200,5.7628009964
158533,158539,161889,6,3350,2,7200,1.00179104478
158548,158555,161782,7,3227,2,7200,1.0021691974
158549,158562,162188,13,3626,2,7200,1.00358521787
158600,178697,182102,20097,3405,2,7200,6.90220264317
158615,158622,162172,7,3550,2,7200,1.00197183099
158616,158629,161891,13,3262,2,7200,1.0039852851
158632,178775,182218,20143,3443,2,7200,6.85042114435
158633,178888,182273,20255,3385,2,7200,6.98375184638
158635,179350,182555,20715,3205,2,7200,7.46333853354
158650,158657,162067,7,3410,2,7200,1.00205278592
158651,158663,162000,12,3337,2,7200,1.00359604435
158652,158670,161955,18,3285,2,7200,1.00547945205
158654,158675,161894,21,3219,2,7200,1.00652376514
158669,182113,185717,23444,3604,2,7200,7.50499445061
158711,182230,185857,23519,3627,2,7200,7.48442238765
158725,182286,185384,23561,3098,2,7200,8.60522918012
158727,182567,185982,23840,3415,2,7200,7.98096632504
158741,158747,161926,6,3179,2,7200,1.00188738597
158756,185397,188760,26641,3363,2,7200,8.92179601546
158771,158778,161929,7,3151,2,7200,1.00222151698
158804,185729,189031,26925,3302,2,7200,9.15414900061
158818,158825,161974,7,3149,2,7200,1.00222292791
158833,158839,162222,6,3383,2,7200,1.00177357375
158896,185869,189202,26973,3333,2,7200,9.09270927093
159375,159522,159524,147,2,2,3540,14.9
159509,185993,189249,26484,3256,2,7200,9.13390663391
159702,159709,163277,7,3568,2,7200,1.00196188341
159813,188772,192142,28959,3370,2,7200,9.59317507418
159828,159834,163248,6,3414,2,7200,1.00175746924
159885,189042,192466,29157,3424,2,7200,9.51547897196
160376,160383,179301,7,18918,1,36000,1.00037001797
161406,161412,164719,6,3307,2,7200,1.00181433323
161436,189214,192629,27778,3415,2,7200,9.13411420205
161437,189260,192530,27823,3270,2,7200,9.50856269113
161452,161459,164845,7,3386,2,7200,1.00206733609
161473,161480,164998,7,3518,2,7200,1.00198976691
161515,192154,195672,30639,3518,2,7200,9.70920977828
161530,161537,164866,7,3329,2,7200,1.00210273355
161532,161544,164903,12,3359,2,7200,1.00357249181
161533,161549,164840,16,3291,2,7200,1.00486174415
161534,161554,164977,20,3423,2,7200,1.00584282793
161607,192479,195991,30872,3512,2,7200,9.79043280182
161648,192541,196065,30893,3524,2,7200,9.76645856981
161675,192641,196107,30966,3466,2,7200,9.93421811887
161754,195684,199124,33930,3440,2,7200,10.863372093
161772,196002,199186,34230,3184,2,7200,11.7506281407
161786,161799,165275,13,3476,2,7200,1.00373993096
161788,196078,199592,34290,3514,2,7200,10.7581104155
161815,196119,199646,34304,3527,2,7200,10.7261128438
161829,199136,202509,37307,3373,2,7200,12.0604802846
161844,199198,202700,37354,3502,2,7200,11.6664762993
161862,199604,202977,37742,3373,2,7200,12.1894455974
161889,199658,202900,37769,3242,2,7200,12.6499074645
161890,202520,205814,40630,3294,2,7200,13.3345476624
161905,161912,165426,7,3514,2,7200,1.00199203187
161920,161927,165148,7,3221,2,7200,1.00217323812
161935,202712,206226,40777,3514,2,7200,12.6041548093
161936,161944,165343,8,3399,2,7200,1.00235363342
161957,202913,206313,40956,3400,2,7200,13.0458823529
161975,202989,206583,41014,3594,2,7200,12.4117974402
162003,162009,165332,6,3323,2,7200,1.00180559735
162069,162075,165749,6,3674,2,7200,1.00163309744
162171,205827,209150,43656,3323,2,7200,14.1375263316
162186,162193,165630,7,3437,2,7200,1.00203665988
162222,206239,209815,44017,3576,2,7200,13.3090044743
162846,162852,162853,6,1,1,900,1.0
163247,163256,166742,9,3486,2,7200,1.00258175559
163277,206325,209755,43048,3430,2,7200,13.5504373178
163703,165642,165914,1939,272,16,610,8.12867647059
164720,164727,168170,7,3443,2,7200,1.00203311066
164843,206595,210259,41752,3664,2,7200,12.3951965066
164844,209161,212696,44317,3535,2,7200,13.5366336634
164868,164875,168369,7,3494,2,7200,1.00200343446
164902,164908,168303,6,3395,2,7200,1.00176730486
164917,209769,212910,44852,3141,2,7200,15.2795288125
164977,209826,213097,44849,3271,2,7200,14.7110975237
164997,210271,213558,45274,3287,2,7200,14.7736537876
165039,165045,168480,6,3435,2,7200,1.00174672489
165148,212708,216124,47560,3416,2,7200,14.9227166276
165180,212923,216241,47743,3318,2,7200,15.3890898131
165201,213108,216492,47907,3384,2,7200,15.1569148936
165276,213570,216688,48294,3118,2,7200,16.4887748557
165333,216136,219454,50803,3318,2,7200,16.3113321278
165348,216254,219754,50906,3500,2,7200,15.5445714286
165427,165434,168673,7,3239,2,7200,1.00216116085
165629,216504,220005,50875,3501,2,7200,15.5315624107
165749,165756,169113,7,3357,2,7200,1.00208519511
166647,166653,167167,6,514,16,1210,1.01167315175
166740,216789,220121,50049,3332,2,7200,16.0207082833
167652,167659,167851,7,192,14,960,1.03645833333
167755,167863,168255,108,392,16,1210,1.27551020408
167849,167856,167865,7,9,1,900,1.6
168170,168176,171664,6,3488,2,7200,1.00172018349
168241,169167,170684,926,1517,16,2410,1.61041529334
168302,219467,222651,51165,3184,2,7200,17.0694095477
168371,168379,171773,8,3394,2,7200,1.00235710077
168479,219766,223284,51287,3518,2,7200,15.5784536669
168494,220018,223370,51524,3352,2,7200,16.3711217184
168518,220134,223681,51616,3547,2,7200,15.552015788
168666,222664,225976,53998,3312,2,7200,17.3037439614
168681,223295,226684,54614,3389,2,7200,17.1150781942
168828,223382,226943,54554,3561,2,7200,16.3198539736
169114,223697,226953,54583,3256,2,7200,17.7638206388
170030,170037,187087,7,17050,2,18000,1.00041055718
171234,171241,176246,7,5005,16,7210,1.0013986014
171663,225989,229208,54326,3219,2,7200,17.8766697732
171717,226695,230277,54978,3582,2,7200,16.3484087102
171771,226956,230197,55185,3241,2,7200,18.0271521135
171888,171895,175306,7,3411,2,7200,1.00205218411
172090,226966,230422,54876,3456,2,7200,16.8784722222
172370,229223,232595,56853,3372,2,7200,17.8603202847
175146,230210,233562,55064,3352,2,7200,17.4272076372
175284,230294,233457,55010,3163,2,7200,18.3917167246
175305,230434,233925,55129,3491,2,7200,16.7917502148
175645,232607,236118,56962,3511,2,7200,17.2238678439
175711,233470,236883,57759,3413,2,7200,17.9232346909
178684,233581,237118,54897,3537,2,7200,16.5207803223
178762,233936,237466,55174,3530,2,7200,16.6300283286
178873,236130,239551,57257,3421,2,7200,17.7369190295
179337,236896,240211,57559,3315,2,7200,18.3631975867
179596,216200,324244,36604,108044,1,108000,1.33878790123
179596,216750,324793,37154,108043,1,108000,1.3438816027
179597,216756,324793,37159,108037,1,108000,1.34394698113
181260,181267,181268,7,1,2,3540,1.0
182100,182107,182279,7,172,1,3600,1.04069767442
182101,237134,240577,55033,3443,2,7200,16.9840255591
182218,237479,240796,55261,3317,2,7200,17.659933675
182237,216650,216653,34413,3,40,259200,3441.6
182272,239562,243215,57290,3653,2,7200,16.6830002737
182452,182458,182808,6,350,1,3600,1.01714285714
182552,240223,243550,57671,3327,2,7200,18.3342350466
183158,183164,184003,6,839,1,3600,1.00715137068
185057,185063,188875,6,3812,1,14400,1.00157397692
185217,185224,185340,7,116,1,3600,1.06034482759
185384,240592,243911,55208,3319,2,7200,17.6339258813
185521,185528,185843,7,315,1,3600,1.02222222222
185539,216745,231305,31206,14560,3,108000,3.14326923077
185577,185584,209772,7,24188,3,36000,1.0002893997
185597,185603,188914,6,3311,3,7200,1.00181214135
185648,185655,185834,7,179,1,3600,1.03910614525
185716,240808,244404,55092,3596,2,7200,16.3203559511
185857,243227,246564,57370,3337,2,7200,18.1920887024
185984,243563,247188,57579,3625,2,7200,16.883862069
186012,186018,186373,6,355,1,3600,1.01690140845
186230,216761,216764,30531,3,3,259200,3053.4
186335,186343,186959,8,616,1,3600,1.01298701299
186740,186746,187591,6,845,1,3600,1.00710059172
186767,186774,193013,7,6239,2,14400,1.00112197468
188761,243934,247309,55173,3375,2,7200,17.3475555556
188847,188854,188968,7,114,1,3600,1.06140350877
189029,244415,247736,55386,3321,2,7200,17.6775067751
189140,189148,189464,8,316,1,3600,1.0253164557
189200,246577,249863,57377,3286,2,7200,18.4610468655
189248,247206,250615,57958,3409,2,7200,18.0014667058
189367,189373,189485,6,112,1,1800,1.05357142857
189768,189775,189886,7,111,1,1800,1.06306306306
189906,189913,190522,7,609,1,3600,1.01149425287
190549,190556,191137,7,581,1,1800,1.01204819277
192144,247322,250889,55178,3567,2,7200,16.4690215868
192466,247748,251299,55282,3551,2,7200,16.5680090115
192529,249876,253039,57347,3163,2,7200,19.1305722415
192628,250627,254256,57999,3629,2,7200,16.9820887297
192892,192898,192948,6,50,1,1800,1.12
193018,193025,197584,7,4559,2,14400,1.00153542444
193066,193072,193188,6,116,1,1800,1.05172413793
193263,193269,193347,6,78,1,1800,1.07692307692
193510,193517,193631,7,114,1,1800,1.06140350877
194273,194282,194573,9,291,1,1800,1.03092783505
194334,194343,194918,9,575,1,1800,1.01565217391
195672,250903,254231,55231,3328,2,7200,17.5958533654
195992,251311,254534,55319,3223,2,7200,18.1638225256
196067,253051,256183,56984,3132,2,7200,19.1941251596
196109,254244,257690,58135,3446,2,7200,17.8702843877
196828,196836,196883,8,47,1,1800,1.17021276596
197220,197226,197297,6,71,1,1800,1.08450704225
200033,226537,230312,26504,3775,4,32400,8.02092715232
201733,201739,202056,6,317,8,14400,1.01892744479
201779,201786,201789,7,3,16,1800,1.0
201936,201942,202181,6,239,1,3600,1.02510460251
202100,202108,202307,8,199,8,14400,1.04020100503
202331,202337,202340,6,3,16,1800,1.0
202466,202472,202522,6,50,8,14400,1.12
202550,202556,202680,6,124,8,14400,1.04838709677
202605,202611,203058,6,447,16,900,1.01342281879
202630,216189,216638,13559,449,128,900,31.1982182628
203144,216767,275002,13623,58235,8,86400,1.2339314845
203166,203172,203209,6,37,8,14400,1.16216216216
203212,203220,207568,8,4348,1,14400,1.0018399264
203416,216773,291004,13357,74231,8,86400,1.17993830071
203593,216778,290950,13185,74172,8,86400,1.17776249798
203799,203805,204051,6,246,2,14400,1.0243902439
204019,204025,205843,6,1818,4,1800,1.00330033003
205305,273292,385598,67987,112306,4,345600,1.60537282069
205342,205348,205548,6,200,2,14400,1.03
205500,205507,211134,7,5627,16,7210,1.00124400213
206049,206055,206215,6,160,2,14400,1.0375
206249,236576,388279,30327,151703,3,604800,1.19991035115
206371,216795,216944,10424,149,2,14400,70.9597315436
206506,216677,217153,10171,476,4,88200,22.3676470588
206520,216682,217172,10162,490,4,88200,21.7387755102
206528,216687,217194,10159,507,4,88200,21.0374753452
206537,216692,217614,10155,922,4,88200,12.0140997831
206544,216698,218060,10154,1362,4,88200,8.45521292217
206554,216703,223084,10149,6381,4,88200,2.59050305595
206562,216708,226977,10146,10269,4,88200,1.98802220275
206585,216713,227925,10128,11212,4,88200,1.90331787371
206591,216719,228923,10128,12204,4,88200,1.82989183874
206601,216724,229229,10123,12505,4,88200,1.80951619352
206611,216729,229834,10118,13105,4,88200,1.77207172835
206652,216955,217074,10303,119,2,14400,87.5798319328
207049,217086,217260,10037,174,2,14400,58.683908046
207288,226543,236348,19255,9805,12,86400,2.96379398266
207554,217480,217637,9926,157,2,14400,64.2229299363
207692,207698,207700,6,2,14,960,1.0
207714,207721,207856,7,135,14,960,1.05185185185
207789,217648,217833,9859,185,2,14400,54.2918918919
207854,207861,207868,7,7,1,900,1.4
207862,207869,208163,7,294,14,960,1.02380952381
207989,217844,218032,9855,188,2,14400,53.420212766
208160,208168,208175,8,7,1,900,1.5
208170,208177,208311,7,134,14,960,1.05223880597
208194,254268,257482,46074,3214,2,7200,15.3354075918
208195,254546,257663,46351,3117,2,7200,15.8703881938
208196,256196,259140,48000,2944,2,7200,17.3043478261
208198,257493,260966,49295,3473,2,7200,15.1937805931
208199,257674,261094,49475,3420,2,7200,15.466374269
208200,257703,260969,49503,3266,2,7200,16.157072872
208202,259152,262460,50950,3308,2,7200,16.4020556227
208203,260981,264190,52778,3209,2,7200,17.4468681832
208204,260986,264230,52782,3244,2,7200,17.2706535142
208206,261106,264681,52900,3575,2,7200,15.7972027972
208207,262471,265652,54264,3181,2,7200,18.0587865451
208208,264202,267629,55994,3427,2,7200,17.3390720747
208309,208316,208317,7,1,1,900,1.0
208527,208533,208649,6,116,14,960,1.05172413793
208647,208654,208659,7,5,1,900,1.2
208655,208661,208982,6,321,14,960,1.01869158879
208734,226288,229204,17554,2916,2,43200,7.01989026063
208762,216195,249043,7433,32848,1,36000,1.22628470531
208980,208987,208993,7,6,1,900,1.3
208989,208996,209374,7,378,14,960,1.01851851852
209153,264241,267714,55088,3473,2,7200,16.8617909588
209373,209379,209385,6,6,1,900,1.2
209384,209390,209781,6,391,14,960,1.01534526854
209616,273297,359720,63681,86423,4,86400,1.73685245826
209757,209763,209894,6,131,14,960,1.04580152672
209757,264693,268053,54936,3360,2,7200,17.35
209811,265663,269320,55852,3657,2,7200,16.272627837
209892,209899,209905,7,6,1,900,1.3
209900,209905,210169,5,264,14,960,1.01893939394
210070,210076,210214,6,138,14,960,1.04347826087
210168,210175,210181,7,6,1,900,1.3
210178,210184,210556,6,372,14,960,1.01612903226
210212,210219,210227,7,8,1,900,1.5
210220,210226,210570,6,344,14,960,1.01744186047
210261,267642,270615,57381,2973,2,7200,20.3007063572
210346,273302,273305,62956,3,8,108000,6295.9
210568,210575,210582,7,7,1,900,1.4
210578,210585,210959,7,374,14,960,1.01871657754
210901,273286,316373,62385,43087,12,172800,2.44788451273
210957,210963,210970,6,7,1,900,1.3
210971,210977,211351,6,374,14,960,1.01604278075
211130,216783,230949,5653,14166,16,36000,1.39905407313
211186,216890,221685,5704,4795,16,36000,2.18957247132
211214,217739,218083,6525,344,16,36000,19.9680232558
211281,218995,232417,7714,13422,16,36000,1.57472805841
211385,211391,211527,6,136,14,960,1.04411764706
211418,222598,232439,11180,9841,16,36000,2.13606340819
211526,211533,211539,7,6,1,900,1.3
211533,211539,211730,6,191,14,960,1.03141361257
211765,211772,213285,7,1513,16,2410,1.00462656973
211940,211947,212087,7,140,14,960,1.05
212085,212091,212100,6,9,1,900,1.5
212093,212101,212356,8,255,14,960,1.03137254902
212354,212362,212370,8,8,1,900,1.6
212361,212368,212484,7,116,14,960,1.06034482759
212458,218045,236095,5587,18050,2,18000,1.30952908587
212482,212488,212489,6,1,1,900,1.0
212698,267725,271049,55027,3324,2,7200,17.5544524669
212910,268065,271386,55155,3321,2,7200,17.6079494128
213000,226761,235974,13761,9213,2,18000,2.49365027678
213096,269332,272706,56236,3374,2,7200,17.6674570243
213111,213117,213155,6,38,2,1200,1.15789473684
213140,216734,268840,3594,52106,8,73200,1.06897478217
213411,227289,249557,13878,22268,2,43200,1.62322615412
213512,213519,213556,7,37,2,1200,1.18918918919
213559,270629,273820,57070,3191,2,7200,18.8846756503
213722,213729,214244,7,515,16,1210,1.01359223301
213804,213810,213853,6,43,2,1200,1.13953488372
213823,226766,236653,12943,9887,2,18000,2.30909274805
214159,226772,244782,12613,18010,2,18000,1.70033314825
214338,214344,214379,6,35,2,1200,1.17142857143
214432,214438,214539,6,101,14,960,1.05940594059
214463,214469,215707,6,1238,2,1200,1.00484652666
214537,214544,214548,7,4,1,900,1.1
214545,214553,214680,8,127,14,960,1.06299212598
214678,214684,214690,6,6,1,900,1.2
214687,214693,214830,6,137,14,960,1.04379562044
214904,214910,215040,6,130,14,960,1.04615384615
215131,216740,216879,1609,139,14,960,12.5755395683
215199,273321,286158,58122,12837,2,86400,5.52769338631
216067,229241,301267,13174,72026,2,72000,1.18290617277
216125,271061,274847,54936,3786,2,7200,15.5103011094
216243,271398,274870,55155,3472,2,7200,16.885656682
216493,272718,276085,56225,3367,2,7200,17.6988416988
216688,273832,277203,57144,3371,2,7200,17.9516463957
216717,227410,256248,10693,28838,2,28800,1.37079547819
216868,269752,298621,52884,28869,3,345600,2.83186116596
216877,216884,216894,7,10,1,900,1.7
216888,217272,217468,384,196,14,960,2.95918367347
217466,217473,217481,7,8,1,900,1.5
217474,217625,217728,151,103,14,960,2.46601941748
217558,227415,232297,9857,4882,2,28800,3.01904956985
217706,226282,226526,8576,244,16,1210,36.1475409836
218082,230961,232497,12879,1536,16,36000,9.384765625
218886,227937,256753,9051,28816,2,28800,1.31409633537
219166,227942,257041,8776,29099,2,57600,1.30159111997
219233,228935,260930,9702,31995,2,43200,1.30323488045
219455,274859,278158,55404,3299,2,7200,17.7941800546
219649,226989,230276,7340,3287,4,57600,3.23303924551
219755,274882,278070,55127,3188,2,7200,18.2920326223
220005,276096,279525,56091,3429,2,7200,17.3578302712
220122,277215,280878,57093,3663,2,7200,16.5864045864
221690,2656355,2657272,2434665,917,256,900,2656.03271538
221922,221929,222309,7,380,2,960,1.01842105263
222288,222321,222993,33,672,2,960,1.04910714286
222650,278082,281642,55432,3560,2,7200,16.5707865169
222983,222991,222997,8,6,1,900,1.4
223003,223010,223320,7,310,2,960,1.02258064516
223286,278169,281650,54883,3481,2,7200,16.7664464234
223339,223347,223554,8,207,2,960,1.038647343
223373,279538,282819,56165,3281,2,7200,18.1182566291
223561,223568,223876,7,308,2,960,1.02272727273
223723,280889,284193,57166,3304,2,7200,18.3020581114
223902,223909,224222,7,313,2,960,1.02236421725
224288,224295,225337,7,1042,2,960,1.00671785029
225161,225168,225420,7,252,1,900,1.02777777778
225451,228941,272156,3490,43215,2,43200,1.08075899572
225700,229847,273076,4147,43229,6,43200,1.09593097226
225978,281654,284987,55676,3333,2,7200,17.704470447
226146,236135,254953,9989,18818,2,86400,1.53082155383
226384,273336,313318,46952,39982,4,108000,2.1743284478
226506,273315,321712,46809,48397,8,108000,1.96718804885
226509,230289,273529,3780,43240,6,43200,1.08741905643
226683,281664,284949,54981,3285,2,7200,17.7369863014
226720,233330,234081,6610,751,16,1800,9.80159786951
226743,236360,236565,9617,205,32,1800,47.912195122
226787,226793,227276,6,483,2,960,1.01242236025
226787,257779,257862,30992,83,64,1800,374.397590361
226824,273087,273275,46263,188,128,1800,247.079787234
226942,282832,286451,55890,3619,2,7200,16.4434926775
226957,284205,287545,57248,3340,2,7200,18.1401197605
227476,273310,381736,45834,108426,4,432000,1.42272148747
227813,229216,229704,1403,488,2,960,3.875
228034,236365,345682,8331,109317,2,172800,1.0762095557
229211,284961,288185,55750,3224,2,7200,18.2921836228
229703,229710,229714,7,4,1,900,1.1
229715,229721,229913,6,192,2,960,1.03125
230197,284998,288452,54801,3454,2,7200,16.8659525188
230276,286464,289727,56188,3263,2,7200,18.2197364389
230359,230366,248377,7,18011,2,18000,1.00038865138
230420,287557,290727,57137,3170,2,7200,19.0242902208
231005,233351,269401,2346,36050,16,36000,1.06507628294
231069,232310,232875,1241,565,4,57600,3.19646017699
231083,232887,235849,1804,2962,4,57600,1.60904794058
231558,231565,231711,7,146,2,14400,1.04794520548
231860,231867,231871,7,4,2,14400,1.1
232305,232317,232356,12,39,1,480,1.30769230769
232356,232367,232431,11,64,1,480,1.171875
232391,233415,233425,1024,10,16,36000,103.4
232500,233442,233979,942,537,2,14400,2.75418994413
232596,288197,291966,55601,3769,2,7200,15.7521889095
233208,233576,233628,368,52,2,14400,8.07692307692
233318,233437,233683,119,246,14,480,1.4837398374
233343,233695,233814,352,119,14,480,3.95798319328
233453,233923,269927,470,36004,16,36000,1.0130541051
233458,288464,291665,55006,3201,2,7200,18.1840049984
233560,289738,293204,56178,3466,2,7200,17.2083092902
233573,234093,234098,520,5,16,36000,52.5
233658,233666,233911,8,245,1,900,1.03265306122
233924,290739,293914,56815,3175,2,7200,18.894488189
234066,234110,234208,44,98,14,660,1.44897959184
234206,234213,234217,7,4,1,900,1.1
234214,234221,234383,7,162,14,660,1.04320987654
234349,234355,237091,6,2736,2,21600,1.00219298246
234380,234388,234396,8,8,1,900,1.6
234390,234396,234583,6,187,14,660,1.0320855615
234581,234588,234594,7,6,1,900,1.3
234589,234596,234790,7,194,14,660,1.03608247423
234789,234795,234802,6,7,1,900,1.3
234797,234805,234993,8,188,14,660,1.04255319149
234991,234997,235004,6,7,1,900,1.3
235001,235007,235245,6,238,14,660,1.02521008403
235172,273352,276229,38180,2877,4,108000,14.2707681613
235244,235250,235257,6,7,1,900,1.3
235251,235257,235356,6,99,14,660,1.06060606061
235353,235359,235360,6,1,1,900,1.0
236118,291682,294892,55564,3210,2,7200,18.3096573209
236682,236689,236825,7,136,14,660,1.05147058824
236819,236825,236831,6,6,1,900,1.2
236826,236833,236977,7,144,14,660,1.04861111111
236886,291977,295460,55091,3483,2,7200,16.8171116853
236975,236982,236989,7,7,1,900,1.4
236983,236991,237125,8,134,14,660,1.05970149254
237119,293217,296448,56098,3231,2,7200,18.3624264933
237121,237127,237133,6,6,1,900,1.2
237129,237141,237327,12,186,14,660,1.06451612903
237325,237332,237340,7,8,1,900,1.5
237335,237342,237528,7,186,14,660,1.0376344086
237465,293927,297164,56462,3237,2,7200,18.4426938523
237526,237532,237540,6,8,1,900,1.4
237534,237542,237730,8,188,14,660,1.04255319149
237728,237735,237742,7,7,1,900,1.4
237737,237743,237932,6,189,14,660,1.03174603175
237930,237936,237943,6,7,1,900,1.3
237939,237945,238138,6,193,14,660,1.0310880829
238136,238143,238148,7,5,1,900,1.2
238144,238152,238341,8,189,14,660,1.04232804233
238339,238346,238351,7,5,1,900,1.2
238347,238355,238544,8,189,14,660,1.04232804233
238375,238381,239174,6,793,4,57600,1.00756620429
238542,238549,238554,7,5,1,900,1.2
238550,238558,238745,8,187,14,660,1.04278074866
238743,238749,238756,6,7,1,900,1.3
238752,238758,238951,6,193,14,660,1.0310880829
238949,238955,238961,6,6,1,900,1.2
238957,238965,239152,8,187,14,660,1.04278074866
239151,239158,239165,7,7,1,900,1.4
239159,239167,239356,8,189,14,660,1.04232804233
239355,239361,239367,6,6,1,900,1.2
239363,239371,239566,8,195,14,660,1.04102564103
239552,294905,298093,55353,3188,2,7200,18.362923463
239564,239571,239577,7,6,1,900,1.3
239574,239580,239770,6,190,14,660,1.03157894737
239769,239776,239782,7,6,1,900,1.3
239777,239785,239975,8,190,14,660,1.04210526316
239972,239979,239985,7,6,1,900,1.3
239981,239988,240175,7,187,14,660,1.03743315508
240173,240179,240186,6,7,1,900,1.3
240181,240188,240376,7,188,14,660,1.03723404255
240211,295472,298813,55261,3341,2,7200,17.540257408
240374,240380,240387,6,7,1,900,1.3
240384,240391,240580,7,189,14,660,1.03703703704
240576,296460,299877,55884,3417,2,7200,17.3546971027
240578,240585,240591,7,6,1,900,1.3
240587,240598,240875,11,277,14,660,1.03971119134
240796,297189,300328,56393,3139,2,7200,18.9652755655
240869,240874,240881,5,7,1,900,1.2
240877,240884,241021,7,137,14,660,1.05109489051
241015,241022,241027,7,5,1,900,1.2
241023,241030,241166,7,136,14,660,1.05147058824
241164,241170,241176,6,6,1,900,1.2
241173,241179,241310,6,131,14,660,1.04580152672
241308,241315,241321,7,6,1,900,1.3
241317,241323,241447,6,124,14,660,1.04838709677
241446,241452,241456,6,4,1,900,1.0
241454,241462,241592,8,130,14,660,1.06153846154
241590,241596,241601,6,5,1,900,1.1
241599,241606,241736,7,130,14,660,1.05384615385
241734,241741,241746,7,5,1,900,1.2
241743,241749,241879,6,130,14,660,1.04615384615
241877,241883,241888,6,5,1,900,1.1
241886,241892,242023,6,131,14,660,1.04580152672
242021,242029,242034,8,5,1,900,1.3
242030,242038,242168,8,130,14,660,1.06153846154
242166,242172,242177,6,5,1,900,1.1
242174,242181,242313,7,132,14,660,1.05303030303
242311,242318,242322,7,4,1,900,1.1
242319,242326,242455,7,129,14,660,1.05426356589
242453,242460,242464,7,4,1,900,1.1
242462,242469,242596,7,127,14,660,1.05511811024
242563,242569,244352,6,1783,18,21600,1.00336511497
242595,242601,242608,6,7,1,900,1.3
242604,242610,242739,6,129,14,660,1.04651162791
242737,242745,242749,8,4,1,900,1.2
242746,242754,242888,8,134,14,660,1.05970149254
242886,242893,242898,7,5,1,900,1.2
242896,242903,243034,7,131,14,660,1.0534351145
243032,243038,243045,6,7,1,900,1.3
243036,243047,243381,11,334,16,310,1.03293413174
243041,243056,243188,15,132,14,660,1.11363636364
243166,243200,243332,34,132,14,660,1.25757575758
243186,243398,243403,212,5,1,900,21.7
243195,243344,243478,149,134,14,660,2.11194029851
243216,298106,301527,54890,3421,2,7200,17.0450160772
243330,243403,243409,73,6,1,900,7.9
243338,243392,243522,54,130,14,660,1.41538461538
243476,243482,243488,6,6,1,900,1.2
243487,243494,243616,7,122,14,660,1.05737704918
243520,243527,243533,7,6,1,900,1.3
243529,243535,243656,6,121,14,660,1.04958677686
243551,298831,302459,55280,3628,2,7200,16.237045204
243614,243622,243627,8,5,1,900,1.3
243625,243631,243767,6,136,14,660,1.04411764706
243655,243662,243666,7,4,1,900,1.1
243663,243671,243825,8,154,14,660,1.05194805195
243765,243772,243778,7,6,1,900,1.3
243777,243783,243916,6,133,14,660,1.04511278195
243822,243929,244282,107,353,16,310,1.30311614731
243823,243830,243836,7,6,1,900,1.3
243834,243840,244027,6,187,14,660,1.0320855615
243909,299889,303105,55980,3216,2,7200,18.4067164179
243914,243922,243927,8,5,1,900,1.3
243925,244039,244172,114,133,14,660,1.85714285714
244026,244032,244039,6,7,1,900,1.3
244035,244184,244373,149,189,14,660,1.78835978836
244170,244177,244183,7,6,1,900,1.3
244179,244294,244392,115,98,14,660,2.17346938776
244370,244378,244384,8,6,1,900,1.4
244382,244388,244581,6,193,14,660,1.0310880829
244390,244397,244403,7,6,1,900,1.3
244399,244407,244505,8,98,14,660,1.08163265306
244403,300347,303436,55944,3089,2,7200,19.1107154419
244504,244511,244518,7,7,1,900,1.4
244514,244520,244652,6,132,14,660,1.04545454545
244579,244586,244593,7,7,1,900,1.4
244589,244596,244783,7,187,14,660,1.03743315508
244650,244657,244663,7,6,1,900,1.3
244661,244667,244801,6,134,14,660,1.0447761194
244782,244788,244793,6,5,1,900,1.1
244793,244800,245021,7,221,14,660,1.03167420814
244799,244806,244812,7,6,1,900,1.3
244810,244817,245005,7,188,14,660,1.03723404255
245002,245009,245014,7,5,1,900,1.2
245013,245019,245148,6,129,14,660,1.04651162791
245019,245025,245032,6,7,1,900,1.3
245030,245036,245225,6,189,14,660,1.03174603175
245147,245154,245159,7,5,1,900,1.2
245157,245163,245258,6,95,14,660,1.06315789474
245223,245229,245237,6,8,1,900,1.4
245233,245240,245430,7,190,14,660,1.03684210526
245256,245263,245267,7,4,1,900,1.1
245268,245275,245404,7,129,14,660,1.05426356589
245329,245336,245372,7,36,16,310,1.19444444444
245402,245408,245413,6,5,1,900,1.1
245413,245420,245608,7,188,14,660,1.03723404255
245429,245436,245441,7,5,1,900,1.2
245439,245445,245633,6,188,14,660,1.03191489362
245606,245612,245619,6,7,1,900,1.3
245617,245624,245810,7,186,14,660,1.0376344086
245632,245639,245646,7,7,1,900,1.4
245642,245648,245838,6,190,14,660,1.03157894737
245697,245704,245833,7,129,14,660,1.05426356589
245809,245816,245822,7,6,1,900,1.3
245821,245828,246014,7,186,14,660,1.0376344086
245822,245833,245834,11,1,2,3540,1.2
245832,245840,245846,8,6,1,900,1.4
245836,245851,245858,15,7,1,900,2.2
245840,245846,245976,6,130,14,660,1.04615384615
245847,245859,246045,12,186,14,660,1.06451612903
245974,245981,245986,7,5,1,900,1.2
245984,245990,246177,6,187,14,660,1.0320855615
246012,246019,246025,7,6,1,900,1.3
246025,246031,246216,6,185,14,660,1.03243243243
246044,246050,246058,6,8,1,900,1.4
246055,246062,246251,7,189,14,660,1.03703703704
246175,246181,246189,6,8,1,900,1.4
246189,246197,246383,8,186,14,660,1.04301075269
246214,246221,246227,7,6,1,900,1.3
246226,246233,246417,7,184,14,660,1.03804347826
246250,246257,246265,7,8,1,900,1.5
246260,246266,246488,6,222,14,660,1.02702702703
246381,246388,246395,7,7,1,900,1.4
246392,246398,246584,6,186,14,660,1.03225806452
246415,246421,246428,6,7,1,900,1.3
246428,246434,246608,6,174,14,660,1.03448275862
246486,246493,246499,7,6,1,900,1.3
246498,246505,246696,7,191,14,660,1.03664921466
246564,301540,304778,54976,3238,2,7200,17.9783817171
246582,246589,246595,7,6,1,900,1.3
246595,246602,246793,7,191,14,660,1.03664921466
246607,246613,246621,6,8,1,900,1.4
246620,246626,246812,6,186,14,660,1.03225806452
246694,246702,246709,8,7,1,900,1.5
246709,246715,246904,6,189,14,660,1.03174603175
246791,246798,246804,7,6,1,900,1.3
246803,246809,247000,6,191,14,660,1.03141361257
246810,246817,246824,7,7,1,900,1.4
246821,246828,247014,7,186,14,660,1.0376344086
246902,246908,246915,6,7,1,900,1.3
246915,246923,247108,8,185,14,660,1.04324324324
246998,247005,247011,7,6,1,900,1.3
247012,247018,247241,6,223,14,660,1.0269058296
247012,247024,247030,12,6,1,900,1.8
247025,247031,247186,6,155,14,660,1.03870967742
247107,247113,247120,6,7,1,900,1.3
247121,247127,247319,6,192,14,660,1.03125
247185,247191,247198,6,7,1,900,1.3
247190,302472,305993,55282,3521,2,7200,16.7006532235
247194,247200,247298,6,98,14,660,1.0612244898
247239,247246,247251,7,5,1,900,1.2
247253,247259,247447,6,188,14,660,1.03191489362
247295,247302,247306,7,4,1,900,1.1
247307,247313,247509,6,196,14,660,1.0306122449
247310,303117,306849,55807,3732,2,7200,15.9536441586
247317,247328,247338,11,10,1,900,2.1
247329,247336,247525,7,189,14,660,1.03703703704
247445,247452,247458,7,6,1,900,1.3
247457,247463,247651,6,188,14,660,1.03191489362
247507,247515,247520,8,5,1,900,1.3
247517,247523,247620,6,97,14,660,1.0618556701
247523,247530,247537,7,7,1,900,1.4
247534,247540,247700,6,160,14,660,1.0375
247649,247655,247661,6,6,1,900,1.2
247661,247668,247856,7,188,14,660,1.03723404255
247698,247704,247712,6,8,1,900,1.4
247707,247713,247901,6,188,14,660,1.03191489362
247735,303448,306665,55713,3217,2,7200,18.3183089835
247854,247861,247865,7,4,1,900,1.1
247864,247870,248057,6,187,14,660,1.0320855615
247899,247906,247912,7,6,1,900,1.3
247909,247916,248112,7,196,14,660,1.03571428571
248056,248062,248068,6,6,1,900,1.2
248070,248076,248263,6,187,14,660,1.0320855615
248106,248113,248119,7,6,1,900,1.3
248117,248124,248312,7,188,14,660,1.03723404255
248182,248190,248460,8,270,16,310,1.02962962963
248261,248268,248274,7,6,1,900,1.3
248273,248279,248470,6,191,14,660,1.03141361257
248310,248317,248323,7,6,1,900,1.3
248320,248328,248513,8,185,14,660,1.04324324324
248468,248474,248483,6,9,1,900,1.5
248480,248487,248679,7,192,14,660,1.03645833333
248511,248518,248526,7,8,1,900,1.5
248521,248527,248683,6,156,14,660,1.03846153846
248678,248684,248690,6,6,1,900,1.2
248681,248692,248698,11,6,1,900,1.7
248689,248699,248887,10,188,14,660,1.05319148936
248691,248704,249016,13,312,14,660,1.04166666667
248886,248892,248898,6,6,1,900,1.2
248897,248903,249089,6,186,14,660,1.03225806452
249014,249021,249027,7,6,1,900,1.3
249025,249031,249316,6,285,14,660,1.02105263158
249087,249094,249100,7,6,1,900,1.3
249099,249105,249291,6,186,14,660,1.03225806452
249289,249296,249303,7,7,1,900,1.4
249300,249307,249492,7,185,14,660,1.03783783784
249314,249320,249326,6,6,1,900,1.2
249325,249331,249615,6,284,14,660,1.02112676056
249490,249497,249504,7,7,1,900,1.4
249502,249509,249695,7,186,14,660,1.0376344086
249613,249620,249627,7,7,1,900,1.4
249623,249630,249911,7,281,14,660,1.02491103203
249694,249700,249706,6,6,1,900,1.2
249705,249711,249841,6,130,14,660,1.04615384615
249840,249847,249852,7,5,1,900,1.2
249849,249856,250046,7,190,14,660,1.03684210526
249865,304791,308213,54926,3422,2,7200,17.0508474576
249910,249916,249923,6,7,1,900,1.3
249921,249928,250052,7,124,14,660,1.0564516129
250044,250051,250060,7,9,1,900,1.6
250051,250057,250063,6,6,1,900,1.2
250056,250064,250254,8,190,14,660,1.04210526316
250061,250071,250262,10,191,14,660,1.05235602094
250253,250260,250268,7,8,1,900,1.5
250260,250267,250273,7,6,1,900,1.3
250263,250274,250532,11,258,14,660,1.04263565891
250271,250281,250471,10,190,14,660,1.05263157895
250469,250476,250482,7,6,1,900,1.3
250479,250486,250677,7,191,14,660,1.03664921466
250530,250537,250544,7,7,1,900,1.4
250542,250549,250738,7,189,14,660,1.03703703704
250611,306005,309437,55394,3432,2,7200,17.1404428904
250675,250682,250688,7,6,1,900,1.3
250686,250692,250882,6,190,14,660,1.03157894737
250736,250744,250750,8,6,1,900,1.4
250747,250754,250941,7,187,14,660,1.03743315508
250880,250886,250892,6,6,1,900,1.2
250885,306678,310146,55793,3468,2,7200,17.0879469435
250890,250896,251252,6,356,14,660,1.01685393258
250939,250945,250952,6,7,1,900,1.3
250949,250955,251299,6,344,14,660,1.01744186047
251251,251258,251300,7,42,1,900,1.16666666667
251264,251271,251719,7,448,14,660,1.015625
251296,251304,251314,8,10,1,900,1.8
251298,306871,310511,55573,3640,2,7200,16.2673076923
251306,251317,251683,11,366,14,660,1.03005464481
251629,251636,251783,7,147,1,900,1.04761904762
251721,251728,251772,7,44,1,900,1.15909090909
251724,251735,251960,11,225,14,660,1.04888888889
251743,251751,251970,8,219,14,660,1.03652968037
251958,251965,251974,7,9,1,900,1.6
251968,251974,251981,6,7,1,900,1.3
251970,251981,252290,11,309,14,660,1.0355987055
251978,251987,252177,9,190,14,660,1.04736842105
252173,252179,252186,6,7,1,900,1.3
252183,252190,252463,7,273,14,660,1.02564102564
252288,252295,252301,7,6,1,900,1.3
252300,252308,252555,8,247,14,660,1.03238866397
252462,252469,252475,7,6,1,900,1.3
252473,252480,252697,7,217,14,660,1.03225806452
252554,252560,252567,6,7,1,900,1.3
252564,252571,252764,7,193,14,660,1.03626943005
252695,252703,252709,8,6,1,900,1.4
252706,252712,252904,6,192,14,660,1.03125
252759,252765,252773,6,8,1,900,1.4
252768,252774,252963,6,189,14,660,1.03174603175
252902,252908,252915,6,7,1,900,1.3
252913,252921,253110,8,189,14,660,1.04232804233
252961,252967,252974,6,7,1,900,1.3
252973,252980,253169,7,189,14,660,1.03703703704
253038,308226,311390,55188,3164,2,7200,18.4424778761
253108,253115,253121,7,6,1,900,1.3
253119,253125,253313,6,188,14,660,1.03191489362
253167,253173,253182,6,9,1,900,1.5
253178,253185,253436,7,251,14,660,1.02788844622
253311,253317,253324,6,7,1,900,1.3
253322,253328,253519,6,191,14,660,1.03141361257
253434,253440,253447,6,7,1,900,1.3
253445,253451,253642,6,191,14,660,1.03141361257
253517,253523,253530,6,7,1,900,1.3
253529,253535,253691,6,156,14,660,1.03846153846
253640,253646,253653,6,7,1,900,1.3
253650,253656,253845,6,189,14,660,1.03174603175
253689,253695,253702,6,7,1,900,1.3
253700,253707,253892,7,185,14,660,1.03783783784
253843,253850,253856,7,6,1,900,1.3
253854,253860,254046,6,186,14,660,1.03225806452
253890,253896,253905,6,9,1,900,1.5
253900,253907,254092,7,185,14,660,1.03783783784
254045,254051,254058,6,7,1,900,1.3
254056,254063,254349,7,286,14,660,1.02447552448
254090,254096,254103,6,7,1,900,1.3
254101,254107,254358,6,251,14,660,1.02390438247
254232,309451,312737,55219,3286,2,7200,17.8043213634
254256,310159,313614,55903,3455,2,7200,17.1803183792
254347,254354,254363,7,9,1,900,1.6
254356,254363,254370,7,7,1,900,1.4
254359,254369,254667,10,298,14,660,1.03355704698
254366,254376,254632,10,256,14,660,1.0390625
254534,310525,313992,55991,3467,2,7200,17.1496971445
254630,254637,254644,7,7,1,900,1.4
254642,254648,254877,6,229,14,660,1.02620087336
254665,254671,254678,6,7,1,900,1.3
254678,254684,255037,6,353,14,660,1.01699716714
254870,254876,254883,6,7,1,900,1.3
254881,254887,255085,6,198,14,660,1.0303030303
255035,255041,255048,6,7,1,900,1.3
255048,255055,255214,7,159,14,660,1.04402515723
255083,255089,255096,6,7,1,900,1.3
255093,255099,255290,6,191,14,660,1.03141361257
255212,255219,255224,7,5,1,900,1.2
255223,255229,255419,6,190,14,660,1.03157894737
255289,255296,255303,7,7,1,900,1.4
255298,255306,255494,8,188,14,660,1.04255319149
255417,255424,255430,7,6,1,900,1.3
255430,255436,255627,6,191,14,660,1.03141361257
255492,255499,255505,7,6,1,900,1.3
255502,255509,255789,7,280,14,660,1.025
255625,255631,255638,6,7,1,900,1.3
255636,255643,255832,7,189,14,660,1.03703703704
255787,255793,255800,6,7,1,900,1.3
255798,255804,255997,6,193,14,660,1.0310880829
255830,255837,255841,7,4,1,900,1.1
255842,255849,256036,7,187,14,660,1.03743315508
255995,256002,256008,7,6,1,900,1.3
256006,256013,256252,7,239,14,660,1.02928870293
256035,256042,256047,7,5,1,900,1.2
256044,256051,256238,7,187,14,660,1.03743315508
256184,311404,314819,55220,3415,2,7200,17.1698389458
256236,256243,256249,7,6,1,900,1.3
256245,256252,256259,7,7,1,900,1.4
256247,256258,256504,11,246,14,660,1.04471544715
256258,256265,256545,7,280,14,660,1.025
256502,256508,256515,6,7,1,900,1.3
256513,256519,256789,6,270,14,660,1.02222222222
256543,256549,256556,6,7,1,900,1.3
256554,256560,256841,6,281,14,660,1.02135231317
256787,256794,256801,7,7,1,900,1.4
256799,256805,257066,6,261,14,660,1.02298850575
256839,256846,256853,7,7,1,900,1.4
256849,256856,257168,7,312,14,660,1.02243589744
257053,273342,314409,16289,41067,6,43200,1.39664450776
257064,257071,257078,7,7,1,900,1.4
257076,257082,257386,6,304,14,660,1.01973684211
257165,257171,257177,6,6,1,900,1.2
257177,257183,257478,6,295,14,660,1.02033898305
257297,273347,297068,16050,23721,6,43200,1.67661565701
257385,257392,257397,7,5,1,900,1.2
257394,257400,257496,6,96,14,660,1.0625
257470,257477,257484,7,7,1,900,1.4
257480,257486,257768,6,282,14,660,1.02127659574
257481,312748,316373,55267,3625,2,7200,16.2460689655
257665,313628,316700,55963,3072,2,7200,19.2171223958
257692,314006,317220,56314,3214,2,7200,18.521468575
257766,257773,257778,7,5,1,900,1.2
257777,257874,258164,97,290,14,660,1.33448275862
258157,258164,258171,7,7,1,900,1.4
258166,258172,258450,6,278,14,660,1.02158273381
258448,258455,258463,7,8,1,900,1.5
258458,258464,258775,6,311,14,660,1.0192926045
258773,258779,258787,6,8,1,900,1.4
258781,258787,259085,6,298,14,660,1.02013422819
259083,259091,259097,8,6,1,900,1.4
259093,259100,259380,7,280,14,660,1.025
259140,314838,317979,55698,3141,2,7200,18.7325692455
259378,259385,259391,7,6,1,900,1.3
259387,259394,259690,7,296,14,660,1.02364864865
259688,259696,259702,8,6,1,900,1.4
259698,259705,259986,7,281,14,660,1.02491103203
259984,259990,259997,6,7,1,900,1.3
259993,260000,260279,7,279,14,660,1.02508960573
260277,260285,260289,8,4,1,900,1.2
260285,260291,260419,6,128,14,660,1.046875
260850,260856,260960,6,104,14,660,1.05769230769
260958,260965,260967,7,2,1,900,1.0
260967,316385,319639,55418,3254,2,7200,18.0307314075
260967,260974,261167,7,193,14,660,1.03626943005
260982,316712,320098,55730,3386,2,7200,17.4589486119
261097,317233,320260,56136,3027,2,7200,19.5450941526
261166,261172,261176,6,4,1,900,1.0
261174,261180,261366,6,186,14,660,1.03225806452
261364,261370,261373,6,3,1,900,1.0
261373,261379,261602,6,223,14,660,1.0269058296
261601,261607,261614,6,7,1,900,1.3
261609,261615,261803,6,188,14,660,1.03191489362
261801,261808,261815,7,7,1,900,1.4
261810,261816,262008,6,192,14,660,1.03125
262006,262013,262022,7,9,1,900,1.6
262016,262023,262209,7,186,14,660,1.0376344086
262207,262214,262218,7,4,1,900,1.1
262216,262222,262412,6,190,14,660,1.03157894737
262410,262418,262422,8,4,1,900,1.2
262419,262425,262612,6,187,14,660,1.0320855615
262460,317990,321288,55530,3298,2,7200,17.8374772589
262610,262617,262622,7,5,1,900,1.2
262620,262627,262809,7,182,14,660,1.03846153846
262807,262815,262822,8,7,1,900,1.5
262816,262823,263010,7,187,14,660,1.03743315508
263008,263015,263019,7,4,1,900,1.1
263017,263024,263209,7,185,14,660,1.03783783784
263208,263213,263218,5,5,1,900,1.0
263216,263222,263426,6,204,14,660,1.02941176471
263424,263430,263433,6,3,1,900,1.0
263433,263440,263625,7,185,14,660,1.03783783784
263623,263629,263635,6,6,1,900,1.2
263631,263637,263832,6,195,14,660,1.03076923077
263830,263837,263841,7,4,1,900,1.1
263839,263846,264035,7,189,14,660,1.03703703704
264033,264040,264046,7,6,1,900,1.3
264042,264048,264236,6,188,14,660,1.03191489362
264189,319650,323096,55461,3446,2,7200,17.0943122461
264231,320111,323629,55880,3518,2,7200,16.8840250142
264234,264247,264253,13,6,1,900,1.9
264243,264253,264442,10,189,14,660,1.05291005291
264440,264447,264451,7,4,1,900,1.1
264449,264455,264645,6,190,14,660,1.03157894737
264643,264651,264658,8,7,1,900,1.5
264652,264660,264847,8,187,14,660,1.04278074866
264677,320272,323873,55595,3601,2,7200,16.4387670092
264845,264851,264855,6,4,1,900,1.0
264854,264860,265048,6,188,14,660,1.03191489362
265047,265053,265057,6,4,1,900,1.0
265055,265061,265248,6,187,14,660,1.0320855615
265247,265253,265257,6,4,1,900,1.0
265256,265263,265450,7,187,14,660,1.03743315508
265448,265455,265458,7,3,1,900,1.0
265457,265463,265651,6,188,14,660,1.03191489362
265649,265657,265664,8,7,1,900,1.5
265654,321300,324721,55646,3421,2,7200,17.2660040924
265658,265671,265861,13,190,14,660,1.06842105263
265859,265865,265871,6,6,1,900,1.2
265868,265874,266063,6,189,14,660,1.03174603175
266062,266068,266075,6,7,1,900,1.3
266070,266078,266269,8,191,14,660,1.04188481675
266109,266116,266465,7,349,1,7200,1.02005730659
266165,266172,266318,7,146,1,7200,1.04794520548
266267,266273,266280,6,7,1,900,1.3
266276,266282,266469,6,187,14,660,1.0320855615
266467,266473,266482,6,9,1,900,1.5
266476,266484,266668,8,184,14,660,1.04347826087
266666,266673,266680,7,7,1,900,1.4
266676,266682,266867,6,185,14,660,1.03243243243
266865,266871,266875,6,4,1,900,1.0
266874,266881,267071,7,190,14,660,1.03684210526
267068,267075,267079,7,4,1,900,1.1
267077,267085,267308,8,223,14,660,1.03587443946
267277,267285,267316,8,31,1,900,1.25806451613
267290,267297,267574,7,277,14,660,1.02527075812
267542,267549,267550,7,1,2,3540,1.0
267572,267579,267585,7,6,1,900,1.3
267581,267587,267780,6,193,14,660,1.0310880829
267631,323109,326724,55478,3615,2,7200,16.3466113416
267713,323642,326866,55929,3224,2,7200,18.3477047146
267778,267785,267791,7,6,1,900,1.3
267787,267793,268078,6,285,14,660,1.02105263158
268053,323885,327107,55832,3222,2,7200,18.3283674736
268076,268083,268091,7,8,1,900,1.5
268086,268092,268282,6,190,14,660,1.03157894737
268280,268286,268294,6,8,1,900,1.4
268289,268296,268481,7,185,14,660,1.03783783784
268480,268487,268495,7,8,1,900,1.5
268488,268495,268686,7,191,14,660,1.03664921466
268684,268691,268699,7,8,1,900,1.5
268693,268700,268890,7,190,14,660,1.03684210526
268888,268896,268902,8,6,1,900,1.4
268897,268904,269093,7,189,14,660,1.03703703704
269091,269097,269103,6,6,1,900,1.2
269100,269107,269397,7,290,14,660,1.02413793103
269324,324734,327727,55410,2993,2,7200,19.5131974607
269395,269401,269409,6,8,1,900,1.4
269403,269410,269599,7,189,14,660,1.03703703704
269597,269603,269612,6,9,1,900,1.5
269606,269612,269799,6,187,14,660,1.0320855615
269797,269803,269811,6,8,1,900,1.4
269806,269812,269999,6,187,14,660,1.0320855615
269997,270004,270012,7,8,1,900,1.5
270007,270013,270337,6,324,14,660,1.01851851852
270337,270344,270432,7,88,1,900,1.07954545455
270347,270353,270608,6,255,14,660,1.02352941176
270382,273326,295105,2944,21779,8,180000,1.13517608706
270606,270614,270619,8,5,1,900,1.3
270616,270622,270811,6,189,14,660,1.03174603175
270616,326736,330234,56120,3498,2,7200,17.0434534019
270809,270816,270823,7,7,1,900,1.4
270819,270825,271049,6,224,14,660,1.02678571429
271047,271054,271060,7,6,1,900,1.3
271051,326878,330360,55827,3482,2,7200,17.033026996
271056,271068,271258,12,190,14,660,1.06315789474
271256,271263,271271,7,8,1,900,1.5
271265,271271,271493,6,222,14,660,1.02702702703
271386,327119,330688,55733,3569,2,7200,16.615858784
271491,271498,271504,7,6,1,900,1.3
271501,271507,271792,6,285,14,660,1.02105263158
271790,271796,271804,6,8,1,900,1.4
271798,271805,272062,7,257,14,660,1.02723735409
272055,272062,272070,7,8,1,900,1.5
272065,272072,272353,7,281,14,660,1.02491103203
272351,273357,273364,1006,7,1,900,101.3
272360,272366,272657,6,291,14,660,1.0206185567
272655,273363,273372,708,9,1,900,71.7
272664,273331,273631,667,300,14,660,3.22333333333
272704,327739,330794,55035,3055,2,7200,19.0147299509
272814,273368,287886,554,14518,1,14400,1.03815952611
273612,273618,288029,6,14411,2,14400,1.00041634862
273629,273635,273644,6,9,1,900,1.5
273639,273645,273926,6,281,14,660,1.02135231317
273822,330245,333847,56423,3602,2,7200,16.6643531371
273924,273932,273937,8,5,1,900,1.3
273934,273940,274247,6,307,14,660,1.01954397394
274245,274252,274259,7,7,1,900,1.4
274255,274261,274579,6,318,14,660,1.01886792453
274577,274584,274591,7,7,1,900,1.4
274589,274595,274892,6,297,14,660,1.0202020202
274846,330371,333953,55525,3582,2,7200,16.5011166946
274870,330701,334062,55831,3361,2,7200,17.6114251711
274890,274896,274904,6,8,1,900,1.4
274899,274906,275198,7,292,14,660,1.02397260274
275196,275203,275210,7,7,1,900,1.4
275206,275212,275563,6,351,14,660,1.01709401709
275561,275569,275575,8,6,1,900,1.4
275572,275578,275932,6,354,14,660,1.01694915254
275930,275937,275944,7,7,1,900,1.4
275940,275946,276267,6,321,14,660,1.01869158879
276086,330805,334298,54719,3493,2,7200,16.6653306613
276266,276272,276280,6,8,1,900,1.4
276275,276282,276563,7,281,14,660,1.02491103203
276561,276568,276573,7,5,1,900,1.2
276570,276577,276924,7,347,14,660,1.02017291066
276922,276928,276936,6,8,1,900,1.4
276935,276941,277229,6,288,14,660,1.02083333333
277121,277128,295123,7,17995,8,180000,1.00038899694
277203,333859,337309,56656,3450,2,7200,17.4220289855
277227,277233,277239,6,6,1,900,1.2
277237,277243,277554,6,311,14,660,1.0192926045
277243,277250,331894,7,54644,8,180000,1.0001281019
277354,277360,309053,6,31693,8,180000,1.00018931625
277552,277559,277565,7,6,1,900,1.3
277562,277569,277919,7,350,14,660,1.02
277917,277924,277930,7,6,1,900,1.3
277925,277931,278274,6,343,14,660,1.01749271137
278070,333965,337318,55895,3353,2,7200,17.6701461378
278147,278153,290625,6,12472,1,14400,1.00048107761
278157,334074,337279,55917,3205,2,7200,18.4468018721
278272,278279,278285,7,6,1,900,1.3
278281,278288,278604,7,316,14,660,1.02215189873
278602,278608,278615,6,7,1,900,1.3
278612,278619,278929,7,310,14,660,1.02258064516
278927,278934,278942,7,8,1,900,1.5
278937,278943,279290,6,347,14,660,1.01729106628
279288,279294,279301,6,7,1,900,1.3
279298,279304,279624,6,320,14,660,1.01875
279524,334311,337735,54787,3424,2,7200,17.0008761682
279622,279629,279635,7,6,1,900,1.3
279631,279637,279948,6,311,14,660,1.0192926045
279946,279953,279959,7,6,1,900,1.3
279957,279963,280291,6,328,14,660,1.01829268293
280289,280295,280303,6,8,1,900,1.4
280297,280304,280691,7,387,14,660,1.0180878553
280689,280696,280702,7,6,1,900,1.3
280697,280704,281025,7,321,14,660,1.02180685358
280876,337292,340362,56416,3070,2,7200,19.3765472313
281023,281029,281036,6,7,1,900,1.3
281034,281040,281385,6,345,14,660,1.01739130435
281383,281390,281396,7,6,1,900,1.3
281393,281399,281710,6,311,14,660,1.0192926045
281641,337321,340731,55680,3410,2,7200,17.3284457478
281659,337330,340694,55671,3364,2,7200,17.5490487515
281708,281714,281721,6,7,1,900,1.3
281717,281724,282038,7,314,14,660,1.02229299363
282036,282043,282049,7,6,1,900,1.3
282046,282052,282368,6,316,14,660,1.01898734177
282366,282373,282379,7,6,1,900,1.3
282376,282382,282689,6,307,14,660,1.01954397394
282688,282694,282700,6,6,1,900,1.2
282697,282703,283057,6,354,14,660,1.01694915254
282819,337747,341168,54928,3421,2,7200,17.0561239404
283055,283062,283068,7,6,1,900,1.3
283065,283071,283410,6,339,14,660,1.01769911504
283408,283416,283424,8,8,1,900,1.6
283418,283425,283734,7,309,14,660,1.02265372168
283732,283739,283745,7,6,1,900,1.3
283741,283748,284060,7,312,14,660,1.02243589744
284058,284065,284071,7,6,1,900,1.3
284067,284073,284353,6,280,14,660,1.02142857143
284193,340375,343642,56182,3267,2,7200,18.1968166514
284346,284353,284363,7,10,1,900,1.7
284359,284364,284647,5,283,14,660,1.01766784452
284645,284651,284657,6,6,1,900,1.2
284654,284660,284975,6,315,14,660,1.01904761905
284950,340707,344085,55757,3378,2,7200,17.5059206631
284974,284980,284985,6,5,1,900,1.1
284982,284989,285273,7,284,14,660,1.02464788732
284989,340743,344067,55754,3324,2,7200,17.7731648616
285271,285277,285283,6,6,1,900,1.2
285280,285286,285666,6,380,14,660,1.01578947368
285664,285670,285676,6,6,1,900,1.2
285673,285679,286034,6,355,14,660,1.01690140845
286033,286039,286045,6,6,1,900,1.2
286042,286048,286327,6,279,14,660,1.02150537634
286271,286278,286329,7,51,2,86400,1.13725490196
286321,286327,286333,6,6,1,900,1.2
286331,286337,286650,6,313,14,660,1.01916932907
286451,341181,344499,54730,3318,2,7200,17.4948764316
286647,286654,286659,7,5,1,900,1.2
286663,286670,286952,7,282,14,660,1.02482269504
286782,286788,309379,6,22591,4,32400,1.00026559249
286950,286957,286963,7,6,1,900,1.3
286959,286965,287349,6,384,14,660,1.015625
287172,287180,287182,8,2,8,86400,1.0
287347,287354,287360,7,6,1,900,1.3
287357,287363,287740,6,377,14,660,1.01591511936
287546,343654,347070,56108,3416,2,7200,17.425058548
287738,287745,287750,7,5,1,900,1.2
287739,287751,287753,12,2,8,86400,1.4
287748,287758,288137,10,379,14,660,1.02638522427
288135,288142,288148,7,6,1,900,1.3
288145,288153,288472,8,319,14,660,1.02507836991
288188,344080,347304,55892,3224,2,7200,18.3362282878
288451,344098,347384,55647,3286,2,7200,17.9345709069
288470,288477,288484,7,7,1,900,1.4
288480,288486,288842,6,356,14,660,1.01685393258
288841,288848,288854,7,6,1,900,1.3
288851,288858,289187,7,329,14,660,1.02127659574
289015,289021,289299,6,278,2,86400,1.02158273381
289185,289192,289198,7,6,1,900,1.3
289195,289201,289511,6,310,14,660,1.01935483871
289312,289319,289446,7,127,4,86400,1.05511811024
289509,289515,289523,6,8,1,900,1.4
289521,289528,289844,7,316,14,660,1.02215189873
289689,289695,290122,6,427,2,14400,1.01405152225
289727,344512,347951,54785,3439,2,7200,16.9305030532
289842,289848,289855,6,7,1,900,1.3
289852,289859,290138,7,279,14,660,1.02508960573
289921,289927,290265,6,338,2,14400,1.01775147929
290137,290143,290150,6,7,1,900,1.3
290149,290155,290462,6,307,14,660,1.01954397394
290335,290342,291254,7,912,16,3010,1.0076754386
290398,290405,293520,7,3115,2,21600,1.00224719101
290461,290467,290474,6,7,1,900,1.3
290470,290477,290818,7,341,14,660,1.02052785924
290729,347083,350285,56354,3202,2,7200,18.5996252342
290816,290822,290829,6,7,1,900,1.3
290829,290835,291114,6,279,14,660,1.02150537634
290932,290938,292963,6,2025,8,86400,1.00296296296
290977,290983,293841,6,2858,8,86400,1.00209937019
291020,291027,296195,7,5168,8,86400,1.00135448916
291112,291119,291126,7,7,1,900,1.4
291122,291128,291440,6,312,14,660,1.01923076923
291365,291372,291382,7,10,2,10800,1.7
291438,291444,291451,6,7,1,900,1.3
291449,291456,291887,7,431,14,660,1.0162412993
291664,347317,350613,55653,3296,2,7200,17.8850121359
291668,291675,291683,7,8,2,10800,1.5
291805,291811,291952,6,141,1,900,1.04255319149
291846,291853,292383,7,530,14,660,1.01320754717
291965,347396,350737,55431,3341,2,7200,17.5911403771
292271,292277,292478,6,201,2,10800,1.02985074627
292381,292387,292394,6,7,1,900,1.3
292392,292399,292784,7,385,14,660,1.01818181818
292523,292530,292721,7,191,2,10800,1.03664921466
292649,292656,293088,7,432,8,86400,1.0162037037
292782,292788,292797,6,9,1,900,1.5
292801,292808,293158,7,350,14,660,1.02
293060,293067,299998,7,6931,8,86400,1.00100995527
293109,293117,296877,8,3760,8,86400,1.00212765957
293158,293165,293173,7,8,1,900,1.5
293176,293183,293497,7,314,14,660,1.02229299363
293203,347964,351106,54761,3142,2,7200,18.4287078294
293377,293509,294396,132,887,16,3010,1.1488162345
293495,293502,293508,7,6,1,900,1.3
293508,293532,293826,24,294,14,660,1.08163265306
293615,293839,297013,224,3174,8,86400,1.07057340895
293825,293844,293850,19,6,1,900,2.5
293834,293861,294247,27,386,14,660,1.06994818653
293915,350297,353703,56382,3406,2,7200,17.553728714
294245,294252,294258,7,6,1,900,1.3
294256,294262,294573,6,311,14,660,1.0192926045
294572,294578,294585,6,7,1,900,1.3
294582,294588,294902,6,314,14,660,1.01910828025
294891,350626,353798,55735,3172,2,7200,18.5709331652
294900,294911,294917,11,6,1,900,1.7
294910,294917,295279,7,362,14,660,1.01933701657
294925,294931,295300,6,369,16,1800,1.0162601626
294945,296857,297129,1912,272,35,7200,8.02941176471
295162,295169,296022,7,853,2,7200,1.0082063306
295277,295283,295301,6,18,1,900,1.33333333333
295289,295295,295627,6,332,14,660,1.01807228916
295296,295312,308069,16,12757,8,86400,1.00125421337
295390,295397,296082,7,685,2,7200,1.0102189781
295402,295408,381855,6,86447,8,86400,1.00006940669
295427,295638,296532,211,894,16,3010,1.23601789709
295459,350749,354126,55290,3377,2,7200,17.3725199882
295467,297143,297517,1676,374,32,1800,5.48128342246
295625,295632,295641,7,9,1,900,1.6
295635,296197,296496,562,299,14,660,2.87959866221
295669,295676,296397,7,721,2,7200,1.00970873786
295756,298958,299327,3202,369,64,1800,9.67750677507
295810,328039,328680,32229,641,128,1800,51.27925117
295829,2657284,2658211,2361455,927,256,900,2548.41639698
295883,295890,296666,7,776,2,7200,1.00902061856
295971,296034,296154,63,120,1,600,1.525
296161,296167,296988,6,821,2,7200,1.00730816078
296358,296364,296367,6,3,2,14400,1.0
296371,296377,297181,6,804,2,7200,1.00746268657
296396,296402,296406,6,4,2,14400,1.0
296435,296441,296452,6,11,2,14400,1.54545454545
296449,351117,354556,54668,3439,2,7200,16.8964815353
296490,296497,296504,7,7,1,900,1.4
296500,296507,296845,7,338,14,660,1.02071005917
296534,296540,296545,6,5,2,14400,1.1
296575,296581,296586,6,5,2,14400,1.1
296624,296631,296635,7,4,2,14400,1.1
296707,296714,298310,7,1596,2,14400,1.00438596491
296843,296850,296858,7,8,1,900,1.5
296854,297025,297371,171,346,14,660,1.49421965318
296923,296930,296933,7,3,2,43200,1.0
296971,296978,321848,7,24870,2,43200,1.00028146361
297076,297082,325849,6,28767,2,43200,1.00020857232
297189,297196,321993,7,24797,2,43200,1.00028229221
297241,353716,356819,56475,3103,2,7200,19.2001289075
297311,297318,303822,7,6504,2,18000,1.00107626076
297371,297377,297457,6,80,1,900,1.075
297387,297393,297806,6,413,14,660,1.01452784504
297459,297465,297497,6,32,2,57600,1.1875
297536,299360,322075,1824,22715,2,57600,1.08029936166
297541,297548,297667,7,119,35,1800,1.05882352941
297677,298826,299659,1149,833,2,14400,2.3793517407
297803,299354,303899,1551,4545,2,18000,1.34125412541
297804,297810,297819,6,9,1,900,1.5
297815,297821,298204,6,383,14,660,1.01566579634
298049,298056,298250,7,194,1,2100,1.03608247423
298096,353810,357154,55714,3344,2,7200,17.6608851675
298202,298209,298215,7,6,1,900,1.3
298213,298219,298531,6,312,14,660,1.01923076923
298530,298537,298542,7,5,1,900,1.2
298551,298558,298946,7,388,14,660,1.01804123711
298577,298583,298614,6,31,1,2100,1.1935483871
298658,299365,299501,707,136,4,86400,6.19852941176
298815,354138,357180,55323,3042,2,7200,19.1863905325
298829,298837,298988,8,151,1,2100,1.05298013245
298944,299004,299263,60,259,1,900,1.23166023166
298956,299514,623536,558,324022,3,324000,1.00172210529
298961,299344,299662,383,318,14,660,2.20440251572
299145,299339,299363,194,24,16,300,9.08333333333
299173,299349,299358,176,9,2,43200,18.5
299469,299476,299495,7,19,16,3010,1.36842105263
299618,299625,299632,7,7,16,300,1.4
299660,299666,299673,6,7,1,900,1.3
299670,299677,300023,7,346,14,660,1.02023121387
299878,354568,358021,54690,3453,2,7200,16.8384013901
299964,299971,300164,7,193,1,600,1.03626943005
299985,328718,335397,28733,6679,8,86400,5.30199131607
300007,300014,300127,7,113,14,660,1.06194690265
300018,328723,330780,28705,2057,8,86400,14.954788527
300021,300027,300032,6,5,1,900,1.1
300031,300037,300423,6,386,14,660,1.01554404145
300081,300087,300266,6,179,2,600,1.03351955307
300111,300118,300277,7,159,4,600,1.04402515723
300126,300132,300143,6,11,1,900,1.54545454545
300133,300139,300271,6,132,14,660,1.04545454545
300138,300146,300310,8,164,8,600,1.0487804878
300161,300168,300332,7,164,16,600,1.04268292683
300188,300341,300530,153,189,32,600,1.80952380952
300269,300275,300283,6,8,1,900,1.4
300279,300285,300416,6,131,14,660,1.04580152672
300329,356832,359889,56503,3057,2,7200,19.4831534184
300374,300380,300531,6,151,1,600,1.03973509934
300379,300387,300552,8,165,2,600,1.04848484848
300386,300395,300565,9,170,4,600,1.05294117647
300391,300402,300573,11,171,8,600,1.06432748538
300396,300585,300763,189,178,16,600,2.06179775281
300402,300542,300742,140,200,32,600,1.7
300414,300421,300427,7,6,1,900,1.3
300422,300428,300434,6,6,1,900,1.2
300423,300435,300628,12,193,14,660,1.0621761658
300431,300447,300725,16,278,14,660,1.05755395683
300626,300640,300644,14,4,1,900,1.8
300643,300655,300846,12,191,14,660,1.06282722513
300723,300737,300742,14,5,1,900,1.9
300735,300753,301065,18,312,14,660,1.05769230769
300823,300829,326017,6,25188,16,36000,1.00023820867
300845,300852,300858,7,6,1,900,1.3
300857,300863,301053,6,190,14,660,1.03157894737
300981,300987,300996,6,9,16,36000,1.5
301052,301059,301066,7,7,1,900,1.4
301061,301067,301319,6,252,14,660,1.02380952381
301063,301073,301082,10,9,1,900,1.9
301073,301080,301467,7,387,14,660,1.0180878553
301317,301324,301332,7,8,1,900,1.5
301326,301333,301588,7,255,14,660,1.02745098039
301465,301473,301480,8,7,1,900,1.5
301476,301484,301837,8,353,14,660,1.02266288952
301489,301497,302264,8,767,2,14400,1.01043024772
301502,301509,301523,7,14,4,108000,1.5
301528,357166,360461,55638,3295,2,7200,17.8855842185
301586,301593,301600,7,7,1,900,1.4
301597,301604,301824,7,220,14,660,1.03181818182
301633,301639,368845,6,67206,2,180000,1.00008927774
301804,301810,302169,6,359,2,14400,1.01671309192
301822,301829,301835,7,6,1,900,1.3
301831,301837,302028,6,191,14,660,1.03141361257
301835,301844,301851,9,7,1,900,1.6
301846,301852,302168,6,316,14,660,1.01898734177
301863,301869,323611,6,21742,2,360000,1.00027596357
302027,302034,302040,7,6,1,900,1.3
302038,302044,302233,6,189,14,660,1.03174603175
302058,302064,302584,6,520,2,14400,1.01153846154
302167,302173,302180,6,7,1,900,1.3
302177,302185,302534,8,349,14,660,1.0229226361
302232,302239,302245,7,6,1,900,1.3
302240,302247,302435,7,188,14,660,1.03723404255
302374,302380,302646,6,266,2,14400,1.02255639098
302433,302440,302447,7,7,1,900,1.4
302442,302448,302638,6,190,14,660,1.03157894737
302460,357192,360637,54732,3445,2,7200,16.8873730044
302473,302479,302510,6,31,2,28800,1.1935483871
302534,302541,302548,7,7,1,900,1.4
302543,302549,302931,6,382,14,660,1.01570680628
302636,302644,302650,8,6,1,900,1.4
302645,302651,302840,6,189,14,660,1.03174603175
302648,302658,302861,10,203,2,28800,1.04926108374
302683,302690,303031,7,341,2,14400,1.02052785924
302839,302846,302852,7,6,1,900,1.3
302849,302855,303043,6,188,14,660,1.03191489362
302856,302862,303209,6,347,2,14400,1.01729106628
302894,302901,303778,7,877,2,28800,1.00798175599
302930,302936,302943,6,7,1,900,1.3
302940,302946,303258,6,312,14,660,1.01923076923
303041,303047,303054,6,7,1,900,1.3
303055,303063,303293,8,230,14,660,1.0347826087
303106,358033,361265,54927,3232,2,7200,17.994740099
303256,303263,303270,7,7,1,900,1.4
303266,303272,303561,6,289,14,660,1.02076124567
303291,303297,303304,6,7,1,900,1.3
303299,303307,303401,8,94,14,660,1.08510638298
303319,303325,402791,6,99466,1,345600,1.00006032212
303399,303406,303411,7,5,1,900,1.2
303408,303415,303603,7,188,14,660,1.03723404255
303438,359902,363308,56464,3406,2,7200,17.5778038755
303471,303477,357084,6,53607,1,345600,1.00011192568
303560,303567,303574,7,7,1,900,1.4
303572,303579,303895,7,316,14,660,1.02215189873
303601,303608,303614,7,6,1,900,1.3
303606,320885,506515,17279,185630,1,345600,1.0930830146
303611,303617,303808,6,191,14,660,1.03141361257
303744,322988,380215,19244,57227,1,345600,1.33627483531
303806,303812,303820,6,8,1,900,1.4
303816,303823,304005,7,182,14,660,1.03846153846
303890,303896,303904,6,8,1,900,1.4
303901,303908,304293,7,385,14,660,1.01818181818
303903,322993,639039,19090,316046,1,345600,1.06040259962
303990,323623,416344,19633,92721,1,345600,1.21174275515
304005,304013,304021,8,8,1,900,1.6
304014,304020,304207,6,187,14,660,1.0320855615
304206,304213,304221,7,8,1,900,1.5
304214,304222,304354,8,132,14,660,1.06060606061
304291,304297,304306,6,9,1,900,1.5
304301,304307,304657,6,350,14,660,1.01714285714
304352,304358,304365,6,7,1,900,1.3
304362,304368,304498,6,130,14,660,1.04615384615
304404,304410,325484,6,21074,2,28800,1.00028471102
304496,304503,304509,7,6,1,900,1.3
304505,304512,304651,7,139,14,660,1.05035971223
304644,304651,304657,7,6,1,900,1.3
304655,304662,304670,7,8,1,900,1.5
304659,304668,304831,9,163,14,660,1.05521472393
304664,304675,305018,11,343,14,660,1.03206997085
304780,360473,364029,55693,3556,2,7200,16.6616985377
304829,304835,304842,6,7,1,900,1.3
304837,304844,304974,7,130,14,660,1.05384615385
304972,304978,304986,6,8,1,900,1.4
304983,304989,305100,6,111,14,660,1.05405405405
305016,305023,305033,7,10,1,900,1.7
305027,305033,305388,6,355,14,660,1.01690140845
305098,305104,305115,6,11,1,900,1.54545454545
305107,305114,305239,7,125,14,660,1.056
305237,305244,305251,7,7,1,900,1.4
305249,305256,305386,7,130,14,660,1.05384615385
305385,305392,305400,7,8,1,900,1.5
305386,305399,305407,13,8,1,900,2.1
305393,305406,305590,13,184,14,660,1.07065217391
305397,305411,305727,14,316,14,660,1.04430379747
305590,305596,305613,6,17,1,900,1.35294117647
305600,305607,305763,7,156,14,660,1.04487179487
305725,305732,305738,7,6,1,900,1.3
305734,305740,306127,6,387,14,660,1.01550387597
305762,305768,305777,6,9,1,900,1.5
305772,305778,305908,6,130,14,660,1.04615384615
305801,305807,305866,6,59,2,3600,1.10169491525
305873,305881,309337,8,3456,2,14400,1.00231481481
305881,328692,331262,22811,2570,16,324000,9.87587548638
305891,305898,305967,7,69,8,3600,1.10144927536
305906,305913,305923,7,10,1,900,1.7
305916,305924,306110,8,186,14,660,1.04301075269
305994,360650,363928,54656,3278,2,7200,17.6735814521
306108,306115,306122,7,7,1,900,1.4
306119,306126,306252,7,126,14,660,1.05555555556
306125,306133,306141,8,8,1,900,1.6
306136,306143,306518,7,375,14,660,1.01866666667
306180,306186,308536,6,2350,2,14400,1.00255319149
306250,306257,306266,7,9,1,900,1.6
306260,306266,306426,6,160,14,660,1.0375
306409,306416,306419,7,3,8,3600,1.0
306424,306431,306438,7,7,1,900,1.4
306433,306439,306630,6,191,14,660,1.03141361257
306442,306449,309833,7,3384,2,14400,1.00206855792
306517,306524,306530,7,6,1,900,1.3
306528,306534,306848,6,314,14,660,1.01910828025
306626,306632,306641,6,9,1,900,1.5
306634,306641,306797,7,156,14,660,1.04487179487
306667,361277,364494,54610,3217,2,7200,17.9754429593
306795,306802,306810,7,8,1,900,1.5
306805,306811,307001,6,190,14,660,1.03157894737
306812,306819,309435,7,2616,2,14400,1.00267584098
306847,306853,306861,6,8,1,900,1.4
306851,363321,366450,56470,3129,2,7200,19.0472994567
306859,306865,307180,6,315,14,660,1.01904761905
306999,307006,307013,7,7,1,900,1.4
307009,307016,307202,7,186,14,660,1.0376344086
307112,307118,308916,6,1798,2,14400,1.00333704116
307179,307185,307191,6,6,1,900,1.2
307188,307194,307542,6,348,14,660,1.01724137931
307201,307208,307215,7,7,1,900,1.4
307211,307217,307375,6,158,14,660,1.03797468354
307236,388135,989828,80899,601693,3,604800,1.13445228713
307343,307349,309966,6,2617,2,14400,1.00229270157
307373,307380,307387,7,7,1,900,1.4
307381,307387,307575,6,188,14,660,1.03191489362
307541,307547,307555,6,8,1,900,1.4
307553,307559,307912,6,353,14,660,1.01699716714
307573,307579,307586,6,7,1,900,1.3
307583,307589,307781,6,192,14,660,1.03125
307779,307786,307794,7,8,1,900,1.5
307788,307794,308090,6,296,14,660,1.02027027027
307910,307917,307923,7,6,1,900,1.3
307919,307925,308268,6,343,14,660,1.01749271137
308088,308096,308104,8,8,1,900,1.6
308098,308105,308298,7,193,14,660,1.03626943005
308213,363939,367296,55726,3357,2,7200,17.599940423
308266,308273,308280,7,7,1,900,1.4
308278,308285,308415,7,130,14,660,1.05384615385
308297,308303,308312,6,9,1,900,1.5
308306,308312,308612,6,300,14,660,1.02
308414,308420,308421,6,1,1,900,1.0
308610,308617,308626,7,9,1,900,1.6
308620,308627,308820,7,193,14,660,1.03626943005
308818,308825,308831,7,6,1,900,1.3
308820,308831,308896,11,65,8,3600,1.16923076923
308899,308905,312540,6,3635,8,3600,1.00165061898
308918,308924,309113,6,189,14,660,1.03174603175
309112,309119,309129,7,10,1,900,1.7
309129,309135,309324,6,189,14,660,1.03174603175
309322,309329,309341,7,12,1,900,1.58333333333
309343,309349,309537,6,188,14,660,1.03191489362
309438,364041,367526,54603,3485,2,7200,16.6680057389
309535,309541,309548,6,7,1,900,1.3
309643,309650,309893,7,243,14,660,1.02880658436
309891,309898,309906,7,8,1,900,1.5
310003,310009,310293,6,284,14,660,1.02112676056
310147,364507,367804,54360,3297,2,7200,17.4877161056
310243,328707,933530,18464,604823,8,604800,1.03052793958
310292,310299,310305,7,6,1,900,1.3
310300,310308,310446,8,138,14,660,1.05797101449
310441,310447,310448,6,1,1,900,1.0
310510,366462,370000,55952,3538,2,7200,16.814584511
310597,310604,310892,7,288,14,2460,1.02430555556
310767,310773,313383,6,2610,4,10800,1.00229885057
310890,310896,310903,6,7,1,900,1.3
310957,310964,318466,7,7502,2,14400,1.00093308451
310989,310996,311781,7,785,14,2460,1.00891719745
311393,367308,370777,55915,3469,2,7200,17.1184779475
311404,311410,347435,6,36025,2,43200,1.00016655101
311774,311781,311788,7,7,1,900,1.4
311783,311790,312132,7,342,14,2460,1.02046783626
311942,311949,318708,7,6759,2,14400,1.00103565616
312132,312138,312139,6,1,1,900,1.0
312737,367539,370715,54802,3176,2,7200,18.2550377834
312841,312848,313169,7,321,14,1140,1.02180685358
313167,313175,313183,8,8,1,900,1.6
313199,313205,313409,6,204,2,10800,1.02941176471
313233,313240,313920,7,680,14,1140,1.01029411765
313615,367817,371173,54202,3356,2,7200,17.1507747318
313633,328702,328705,15069,3,11,86400,1507.2
313825,323628,366214,9803,42586,1,345600,1.23019302118
313857,324346,390997,10489,66651,1,345600,1.15737198242
313918,313925,313933,7,8,1,900,1.5
313992,370013,373117,56021,3104,2,7200,19.0480025773
314027,321724,328940,7697,7216,2,86400,2.06665742794
314087,314093,315014,6,921,14,1140,1.00651465798
314419,314425,314726,6,301,2,14400,1.01993355482
314821,370727,373944,55906,3217,2,7200,18.3783027666
314824,314832,317889,8,3057,1,3010,1.00261694472
315012,315019,315027,7,8,1,900,1.5
315028,315034,315225,6,191,2,14400,1.03141361257
315179,315185,316218,6,1033,14,1140,1.00580832527
315546,315553,316316,7,763,2,28800,1.00917431193
315755,315762,315986,7,224,2,14400,1.03125
316216,316222,316230,6,8,1,900,1.4
316227,316234,317192,7,958,14,1140,1.00730688935
316372,370789,373956,54417,3167,2,7200,18.1825071045
316471,316478,316734,7,256,2,14400,1.02734375
316701,371185,374516,54484,3331,2,7200,17.3566496548
317190,317196,317204,6,8,1,900,1.4
317199,317206,318116,7,910,14,1140,1.00769230769
317220,373129,376346,55909,3217,2,7200,18.3792353124
317288,322761,324334,5473,1573,2,28800,4.47933884298
317980,373957,377061,55977,3104,2,7200,19.0338273196
318003,318009,321060,6,3051,1,3010,1.00196656834
318114,318120,318132,6,12,1,900,1.5
318125,318131,318989,6,858,14,1140,1.00699300699
318986,318993,319003,7,10,1,900,1.7
318998,319004,320002,6,998,14,1140,1.00601202405
319234,319241,319638,7,397,1,1200,1.01763224181
319642,373968,377238,54326,3270,2,7200,17.6134556575
320000,320006,320015,6,9,1,900,1.5
320009,320015,321051,6,1036,14,1140,1.00579150579
320099,374529,377944,54430,3415,2,7200,16.9385065886
320192,320199,320213,7,14,1,1200,1.5
320259,376364,379916,56105,3552,2,7200,16.7953265766
320363,320371,322203,8,1832,1,1800,1.00436681223
320464,328728,329144,8264,416,4,108000,20.8653846154
321049,321056,321064,7,8,1,900,1.5
321058,321064,322116,6,1052,14,1140,1.00570342205
321289,377074,380577,55785,3503,2,7200,16.9249214959
321890,321896,322027,6,131,2,10800,1.04580152672
321893,328734,353651,6841,24917,4,43200,1.27455151102
322006,328739,357896,6733,29157,4,43200,1.23092224852
322087,328744,355591,6657,26847,4,57600,1.247960666
322090,322096,322180,6,84,2,10800,1.07142857143
322114,322120,322130,6,10,1,900,1.6
322122,322129,323244,7,1115,14,1140,1.00627802691
322303,322310,322448,7,138,2,10800,1.05072463768
322325,322906,333193,581,10287,2,28800,1.05647905123
322484,326422,328027,3938,1605,4,57600,3.45358255452
322560,322566,322642,6,76,2,10800,1.07894736842
323033,323041,323240,8,199,2,10800,1.04020100503
323097,377250,380527,54153,3277,2,7200,17.5251754654
323628,377956,381448,54328,3492,2,7200,16.5578465063
323872,379927,382992,56055,3065,2,7200,19.2887438825
324723,380539,383770,55816,3231,2,7200,18.2751470133
324867,324874,325223,7,349,14,1380,1.02005730659
325215,325221,325228,6,7,1,900,1.3
325223,325229,326239,6,1010,14,1380,1.00594059406
326237,326244,326251,7,7,1,900,1.4
326246,326253,326924,7,671,14,1380,1.01043219076
326255,328713,337288,2458,8575,8,36000,1.28664723032
326723,380590,383814,53867,3224,2,7200,17.7081265509
326867,381460,384688,54593,3228,2,7200,17.9123296159
326922,326929,326935,7,6,1,900,1.3
326930,326936,327285,6,349,14,1380,1.01719197708
327108,383004,386065,55896,3061,2,7200,19.2606991179
327284,327290,327291,6,1,1,900,1.0
327727,383783,387174,56056,3391,2,7200,17.5308168682
328403,328410,328493,7,83,1,342000,1.0843373494
328608,328697,329038,89,341,14,1380,1.26099706745
328942,328949,489628,7,160679,1,342000,1.00004356512
329036,329042,329050,6,8,1,900,1.4
329045,329052,329981,7,929,14,1380,1.00753498385
329242,329249,356148,7,26899,11,86400,1.00026023272
329979,329985,329992,6,7,1,900,1.3
329988,329995,330934,7,939,14,1380,1.00745473908
330155,330161,351854,6,21693,1,36000,1.00027658692
330236,383826,387293,53590,3467,2,7200,16.45716758
330360,384700,388125,54340,3425,2,7200,16.8656934307
330688,386083,389290,55395,3207,2,7200,18.273152479
330793,387187,390658,56394,3471,2,7200,17.2471910112
330932,330939,330946,7,7,1,900,1.4
330941,330948,331270,7,322,14,1380,1.02173913043
331210,331216,334268,6,3052,1,3010,1.00196592398
331269,331276,331277,7,1,1,900,1.0
331711,331718,331780,7,62,16,324000,1.11290322581
331882,331888,331946,6,58,16,324000,1.10344827586
332370,332376,332378,6,2,2,3540,1.0
332506,332512,332613,6,101,16,324000,1.05940594059
332983,332990,333040,7,50,16,324000,1.14
333465,333472,333524,7,52,16,324000,1.13461538462
333694,333701,333812,7,111,16,324000,1.06306306306
333848,387304,390585,53456,3281,2,7200,17.2925937214
333954,388142,391552,54188,3410,2,7200,16.8909090909
334032,334038,334092,6,54,16,324000,1.11111111111
334062,389302,392567,55240,3265,2,7200,17.9188361409
334297,390597,393978,56300,3381,2,7200,17.6518781426
334460,334466,334525,6,59,16,324000,1.10169491525
336172,336179,341266,7,5087,1,6010,1.00137605661
336197,336203,336261,6,58,16,324000,1.10344827586
336503,336509,336566,6,57,16,324000,1.10526315789
337037,337043,337098,6,55,16,324000,1.10909090909
337277,390671,393907,53394,3236,2,7200,17.5
337302,337310,373355,8,36045,8,36000,1.00022194479
337311,391565,394863,54254,3298,2,7200,17.4505761067
337326,392579,395833,55253,3254,2,7200,17.9800245851
337737,393918,397152,56181,3234,2,7200,18.3719851577
337996,338003,364697,7,26694,1,36000,1.00026223121
338048,338054,424462,6,86408,8,86400,1.00006943801
338553,338560,415830,7,77270,6,108000,1.00009059143
338716,338724,338777,8,53,16,324000,1.15094339623
339153,339160,366739,7,27579,6,108000,1.00025381631
339460,339466,388713,6,49247,16,324000,1.00012183483
340366,393991,397245,53625,3254,2,7200,17.4797172711
340378,340385,340720,7,335,14,1380,1.02089552239
340695,394876,398022,54181,3146,2,7200,18.222186904
340719,340726,340732,7,6,1,900,1.3
340726,340732,341481,6,749,14,1380,1.00801068091
340731,395845,398993,55114,3148,2,7200,18.5076238882
341168,397165,400128,55997,2963,2,7200,19.8987512656
341479,341486,341492,7,6,1,900,1.3
341489,341495,342438,6,943,14,1380,1.00636267232
342435,342441,342447,6,6,1,900,1.2
342443,342449,343453,6,1004,14,1380,1.00597609562
343451,343457,343464,6,7,1,900,1.3
343461,343468,344419,7,951,14,1380,1.00736067298
343641,397258,400652,53617,3394,2,7200,16.7975839717
344069,398039,401326,53970,3287,2,7200,17.4192272589
344417,344423,344430,6,7,1,900,1.3
344425,344433,345447,8,1014,14,1380,1.00788954635
345445,345451,345458,6,7,1,900,1.3
345455,345462,346466,7,1004,14,1380,1.00697211155
346464,346471,346477,7,6,1,900,1.3
346472,346478,347522,6,1044,14,1380,1.00574712644
347520,347526,347533,6,7,1,900,1.3
347529,347535,348599,6,1064,14,1380,1.00563909774
348597,348604,348610,7,6,1,900,1.3
348606,348612,349699,6,1087,14,1380,1.00551977921
349697,349704,349710,7,6,1,900,1.3
349705,349712,350805,7,1093,14,1380,1.00640439158
350802,350809,350814,7,5,1,900,1.2
350811,350818,351858,7,1040,14,1380,1.00673076923
351375,351392,567428,17,216036,1,216000,1.00007869059
351375,351381,567410,6,216029,1,216000,1.00002777405
351375,351386,567425,11,216039,1,216000,1.00005091673
351409,351416,459447,7,108031,1,108000,1.00006479622
351410,351421,459435,11,108014,1,108000,1.00010183865
351410,351426,459476,16,108050,1,108000,1.00014807959
351795,351802,351821,7,19,1,259200,1.36842105263
351854,351861,351868,7,7,1,900,1.4
351855,351868,356827,13,4959,3,259200,1.00262149627
351863,351874,352882,11,1008,14,1380,1.01091269841
352881,352888,352895,7,7,1,900,1.4
352889,352895,354188,6,1293,14,1380,1.00464037123
352908,352914,385975,6,33061,3,72000,1.00018148271
353044,353050,377743,6,24693,3,72000,1.00024298384
353396,353402,612652,6,259250,1,259200,1.00002314368
353590,353597,353714,7,117,3,36000,1.05982905983
353645,353651,440085,6,86434,16,86400,1.00006941713
353718,353724,483340,6,129616,1,259200,1.00004629058
353949,353955,353957,6,2,2,3540,1.0
354328,354334,355877,6,1543,1,36000,1.00388852884
354355,354361,390399,6,36038,1,36000,1.00016649093
368247,368254,368544,7,290,14,1440,1.02413793103
368543,368550,368556,7,6,1,900,1.3
368550,368556,368680,6,124,14,1440,1.04838709677
368687,368694,368820,7,126,14,1440,1.05555555556
368828,368834,368961,6,127,14,1440,1.04724409449
368969,368976,369102,7,126,14,1440,1.05555555556
369110,369116,369243,6,127,14,1440,1.04724409449
369251,369257,369381,6,124,14,1440,1.04838709677
369392,369398,369522,6,124,14,1440,1.04838709677
369533,369539,369663,6,124,14,1440,1.04838709677
369674,369681,369804,7,123,14,1440,1.05691056911
369815,369822,369945,7,123,14,1440,1.05691056911
369956,369963,370090,7,127,14,1440,1.05511811024
370100,370106,370233,6,127,14,1440,1.04724409449
370241,370247,370374,6,127,14,1440,1.04724409449
370279,370286,405231,7,34945,12,172800,1.00020031478
370382,370389,370512,7,123,14,1440,1.05691056911
370523,370529,370653,6,124,14,1440,1.04838709677
370664,370670,370794,6,124,14,1440,1.04838709677
370805,370811,370935,6,124,14,1440,1.04838709677
370946,370953,371079,7,126,14,1440,1.05555555556
371087,371094,371217,7,123,14,1440,1.05691056911
371228,371234,371358,6,124,14,1440,1.04838709677
371369,371375,371499,6,124,14,1440,1.04838709677
371510,371516,371640,6,124,14,1440,1.04838709677
371651,371658,371781,7,123,14,1440,1.05691056911
371792,371798,371923,6,125,14,1440,1.048
371933,371939,372063,6,124,14,1440,1.04838709677
372071,372078,372205,7,127,14,1440,1.05511811024
372212,372218,372346,6,128,14,1440,1.046875
372353,372360,372487,7,127,14,1440,1.05511811024
372494,372501,372628,7,127,14,1440,1.05511811024
372635,372641,372829,6,188,14,1440,1.03191489362
372836,372843,373030,7,187,14,1440,1.03743315508
373037,373043,373231,6,188,14,1440,1.03191489362
373238,373245,373432,7,187,14,1440,1.03743315508
373439,373445,373633,6,188,14,1440,1.03191489362
373640,373647,373779,7,132,14,1440,1.05303030303
373658,373665,395700,7,22035,2,180000,1.00031767642
373787,373794,373981,7,187,14,1440,1.03743315508
373988,373996,374182,8,186,14,1440,1.04301075269
374190,374196,374323,6,127,14,1440,1.04724409449
374331,374337,374461,6,124,14,1440,1.04838709677
374472,374478,374602,6,124,14,1440,1.04838709677
374612,374619,374806,7,187,14,1440,1.03743315508
374814,374821,375007,7,186,14,1440,1.0376344086
375015,375022,375148,7,126,14,1440,1.05555555556
375156,375163,375289,7,126,14,1440,1.05555555556
375297,375303,375490,6,187,14,1440,1.0320855615
375498,375505,375628,7,123,14,1440,1.05691056911
375639,375646,375832,7,186,14,1440,1.0376344086
375840,375847,376033,7,186,14,1440,1.0376344086
376003,376010,376356,7,346,14,1440,1.02023121387
376013,376019,376352,6,333,14,1440,1.01801801802
376041,376047,376234,6,187,14,1440,1.0320855615
376242,376248,376344,6,96,14,1440,1.0625
376329,376337,378401,8,2064,8,86400,1.00387596899
376350,376357,376363,7,6,1,900,1.3
376354,376369,376375,15,6,1,900,2.1
376359,376376,376499,17,123,14,1440,1.13821138211
376362,376381,376503,19,122,14,1440,1.15573770492
376377,376387,376573,10,186,14,1440,1.05376344086
376506,376513,376640,7,127,14,1440,1.05511811024
376514,376521,376648,7,127,14,1440,1.05511811024
376584,376590,376720,6,130,14,1440,1.04615384615
376648,376654,376781,6,127,14,1440,1.04724409449
376655,376663,376789,8,126,14,1440,1.06349206349
376657,376669,376672,12,3,8,86400,1.5
376731,376738,376924,7,186,14,1440,1.0376344086
376789,376795,376919,6,124,14,1440,1.04838709677
376796,376803,376927,7,124,14,1440,1.0564516129
376930,376936,377060,6,124,14,1440,1.04838709677
376932,376942,377068,10,126,14,1440,1.07936507937
376937,376949,377074,12,125,14,1440,1.096
377071,377081,377204,10,123,14,1440,1.08130081301
377079,377088,377275,9,187,14,1440,1.04812834225
377084,377094,377218,10,124,14,1440,1.08064516129
377212,377218,377342,6,124,14,1440,1.04838709677
377229,377236,377362,7,126,14,1440,1.05555555556
377263,377270,377277,7,7,4,2410,1.4
377283,377290,377416,7,126,14,1440,1.05555555556
377353,377360,377471,7,111,14,1440,1.06306306306
377370,377376,377506,6,130,14,1440,1.04615384615
377424,377431,377557,7,126,14,1440,1.05555555556
377455,377461,379232,6,1771,4,2410,1.00338791643
377485,377491,377522,6,31,14,1440,1.1935483871
377517,377523,377532,6,9,14,1440,1.5
377565,377572,377695,7,123,14,1440,1.05691056911
377641,377647,385441,6,7794,3,72000,1.00076982294
377700,377706,383239,6,5533,3,72000,1.00108440267
377706,377714,377839,8,125,14,1440,1.064
377847,377854,377998,7,144,14,1440,1.04861111111
378039,378046,378074,7,28,14,1440,1.25
378093,378099,378122,6,23,14,1440,1.26086956522
378144,378150,378275,6,125,14,1440,1.048
378238,378245,378248,7,3,8,7200,1.0
378249,378255,378400,6,145,1,600,1.04137931034
378285,378291,378416,6,125,14,1440,1.048
378426,378432,378557,6,125,14,1440,1.048
378442,378449,378450,7,1,8,7200,1.0
378567,378573,378701,6,128,14,1440,1.046875
378687,378693,378722,6,29,16,324000,1.20689655172
378697,378703,382226,6,3523,8,86400,1.00170309395
378711,378718,378845,7,127,14,1440,1.05511811024
378743,378749,378769,6,20,16,324000,1.3
378809,378816,389669,7,10853,1,72000,1.00064498295
378820,378827,378956,7,129,1,600,1.05426356589
378852,378858,378986,6,128,14,1440,1.046875
378950,378956,379009,6,53,16,324000,1.11320754717
379005,379011,379136,6,125,14,1440,1.048
379146,379154,379277,8,123,14,1440,1.06504065041
379215,379221,379245,6,24,1,600,1.25
379296,379303,379426,7,123,14,1440,1.05691056911
379447,379454,379552,7,98,14,1440,1.07142857143
379578,379586,379676,8,90,14,1440,1.08888888889
379692,379700,379818,8,118,14,1440,1.06779661017
379820,379827,380422,7,595,16,610,1.01176470588
379828,379834,380818,6,984,8,7200,1.00609756098
379833,379840,379864,7,24,14,1440,1.29166666667
379869,379875,379922,6,47,1,600,1.12765957447
379884,379892,380079,8,187,14,1440,1.04278074866
380088,380095,380219,7,124,14,1440,1.0564516129
380226,380233,380360,7,127,14,1440,1.05511811024
380301,380307,380325,6,18,16,324000,1.33333333333
380367,380375,380502,8,127,14,1440,1.06299212598
380372,380381,380393,9,12,16,324000,1.75
380420,380427,381297,7,870,2,10800,1.00804597701
380432,380438,400352,6,19914,1,43200,1.00030129557
380565,380572,380910,7,338,14,1440,1.02071005917
380608,380615,384056,7,3441,16,324000,1.00203429236
380705,380713,380743,8,30,1,600,1.26666666667
380757,382295,382489,1538,194,64,310,8.92783505155
380908,380915,380921,7,6,1,900,1.3
380916,380923,381047,7,124,14,1440,1.0564516129
380999,381006,382499,7,1493,2,10800,1.00468854655
381007,381015,382116,8,1101,8,7200,1.00726612171
381029,381036,383870,7,2834,1,2700,1.00247000706
381058,381064,381192,6,128,14,1440,1.046875
381199,381206,381333,7,127,14,1440,1.05511811024
381340,381347,381474,7,127,14,1440,1.05511811024
381481,381487,381612,6,125,14,1440,1.048
381622,381628,381753,6,125,14,1440,1.048
381763,381769,381894,6,125,14,1440,1.048
381904,381911,381922,7,11,14,1440,1.63636363636
381938,381944,382283,6,339,14,1560,1.01769911504
381999,382005,413775,6,31770,1,50400,1.00018885741
382281,382287,382294,6,7,1,900,1.3
382289,382501,383184,212,683,14,1560,1.31039531479
382359,382365,382366,6,1,1,900,1.0
382471,382477,383524,6,1047,8,7200,1.00573065903
382547,382553,383581,6,1028,9,180000,1.00583657588
382744,382751,383400,7,649,4,14400,1.01078582435
382811,382818,401187,7,18369,6,108000,1.00038107681
382817,382825,400033,8,17208,6,108000,1.00046490005
382824,382831,398976,7,16145,6,108000,1.00043357076
382829,382838,402631,9,19793,6,108000,1.00045470621
382835,382845,396389,10,13544,6,108000,1.00073833432
382843,382852,439818,9,56966,6,108000,1.00015798898
382847,382859,412679,12,29820,6,108000,1.00040241449
383014,383201,539306,187,156105,2,180000,1.00119791166
383087,383211,383737,124,526,1,345600,1.23574144487
383149,383195,384719,46,1524,8,7200,1.03018372703
383183,383206,383213,23,7,1,900,3.0
383267,383536,384558,269,1022,14,1560,1.26320939335
383323,383331,383983,8,652,1,345600,1.01226993865
383585,383591,384225,6,634,1,345600,1.0094637224
383799,383806,451966,7,68160,2,180000,1.00010269953
383976,383983,744007,7,360024,2,360000,1.00001944315
384010,384017,744021,7,360004,2,360000,1.00001944423
384036,384042,386858,6,2816,1,2700,1.00213068182
384152,384159,386255,7,2096,1,345600,1.00333969466
384175,384181,411600,6,27419,1,36000,1.00021882636
384213,384219,386506,6,2287,1,345600,1.00262352427
384274,384281,386400,7,2119,1,345600,1.00330344502
384556,384562,384569,6,7,1,900,1.3
384566,384574,385569,8,995,14,1560,1.00804020101
384723,384730,394610,7,9880,12,86400,1.00070850202
384753,384759,384761,6,2,8,86400,1.0
384800,385581,386092,781,511,28,1560,2.52837573386
385025,385032,385539,7,507,8,86400,1.01380670611
385567,385574,385579,7,5,1,900,1.2
385576,386078,386952,502,874,14,1560,1.57437070938
385784,385790,423782,6,37992,2,43200,1.00015792798
386092,386099,386112,7,13,1,900,1.53846153846
386107,386113,387090,6,977,28,1560,1.00614124872
386486,386518,400205,32,13687,4,14400,1.00233798495
386552,386964,387262,412,298,8,86400,2.38255033557
386951,386957,386965,6,8,1,900,1.4
386962,387102,388116,140,1014,14,1560,1.13806706114
387101,387274,387959,173,685,28,1560,1.25255474453
387278,387976,405681,698,17705,8,86400,1.03942389156
387445,387844,387932,399,88,2,10800,5.53409090909
387532,387881,729347,349,341466,2,345600,1.00102206369
387792,387971,388023,179,52,14,1560,4.44230769231
387958,387964,387976,6,12,1,900,1.5
387986,388129,388938,143,809,28,1560,1.17676143387
388113,388120,388143,7,23,1,900,1.30434782609
388123,388726,389846,603,1120,14,1560,1.53839285714
388253,388950,389009,697,59,14,1560,12.813559322
388355,388362,388365,7,3,3,604800,1.0
388375,388381,388480,6,99,2,10800,1.06060606061
388546,388553,837739,7,449186,3,604800,1.00001558374
388655,388662,388762,7,100,2,10800,1.07
388966,388973,389004,7,31,8,432000,1.22580645161
389168,389174,389244,6,70,8,432000,1.08571428571
389844,389851,389857,7,6,1,900,1.3
389855,389861,390861,6,1000,14,1560,1.006
390385,390392,390451,7,59,16,324000,1.1186440678
390515,390522,390587,7,65,16,324000,1.10769230769
390702,390874,463497,172,72623,16,324000,1.00236839569
390819,391501,392436,682,935,8,86400,1.72941176471
390859,390865,390880,6,15,1,900,1.4
390893,391364,392363,471,999,14,1560,1.47147147147
392361,392368,392374,7,6,1,900,1.3
392372,392378,393384,6,1006,14,1560,1.00596421471
392441,392448,411009,7,18561,8,86400,1.00037713485
393009,393396,393409,387,13,16,310,30.7692307692
393381,393388,393395,7,7,1,900,1.4
393390,393420,394421,30,1001,14,1560,1.02997002997
393539,393546,394586,7,1040,2,10800,1.00673076923
393549,394622,394801,1073,179,16,310,6.99441340782
393578,393584,393749,6,165,4,21600,1.03636363636
394023,394029,739642,6,345613,2,345600,1.00001736046
394064,394071,395494,7,1423,2,10800,1.00491918482
394086,394093,739726,7,345633,2,345600,1.0000202527
394088,394099,415731,11,21632,4,21600,1.00050850592
394266,394433,740072,167,345639,2,345600,1.00048316307
394419,394425,394432,6,7,1,900,1.3
394427,394813,395156,386,343,14,1560,2.12536443149
394500,394507,396140,7,1633,2,10800,1.0042865891
394822,394830,395756,8,926,6,900,1.00863930886
395150,395168,395211,18,43,16,610,1.41860465116
395155,395161,395162,6,1,1,900,1.0
395357,395363,395983,6,620,16,610,1.00967741935
395467,395506,397529,39,2023,4,2410,1.01927829956
395574,395768,395949,194,181,4,6010,2.07182320442
395969,395976,401205,7,5229,1,6010,1.00133868809
395973,395995,396735,22,740,6,88200,1.02972972973
395983,396000,396796,17,796,6,88200,1.02135678392
395994,396007,397282,13,1275,6,88200,1.01019607843
396002,396400,398215,398,1815,6,88200,1.21928374656
396011,396747,404544,736,7797,6,87300,1.09439528024
396021,396808,408670,787,11862,6,88200,1.06634631597
396028,396862,409995,834,13133,6,88200,1.06350414985
396036,397294,410261,1258,12967,6,88200,1.09701550089
396043,398227,412090,2184,13863,6,88200,1.15754165765
396049,398989,412955,2940,13966,6,88200,1.21051124159
396897,396904,397549,7,645,2,3600,1.01085271318
397053,397541,401249,488,3708,4,3600,1.13160733549
397657,398034,400597,377,2563,4,21600,1.1470932501
398136,412174,469787,14038,57613,2,57600,1.24366028501
398219,402357,440868,4138,38511,4,43200,1.10744981953
398274,398281,401552,7,3271,2,7200,1.00214001834
398275,398297,401685,22,3388,2,7200,1.00649350649
398275,398292,401687,17,3395,2,7200,1.00500736377
398275,398286,401645,11,3359,2,7200,1.00327478416
398276,398313,401919,37,3606,2,7200,1.01026067665
398276,398318,401617,42,3299,2,7200,1.01273113065
398276,398302,401758,26,3456,2,7200,1.00752314815
398276,398308,401852,32,3544,2,7200,1.00902934537
398277,398334,401495,57,3161,2,7200,1.01803226827
398277,398323,401631,46,3308,2,7200,1.01390568319
398277,398329,401880,52,3551,2,7200,1.01464376232
398278,398339,401920,61,3581,2,7200,1.01703434795
398278,398355,401862,77,3507,2,7200,1.02195608782
398278,398344,401622,66,3278,2,7200,1.02013422819
398278,398350,401773,72,3423,2,7200,1.02103418054
398279,398365,401654,86,3289,2,7200,1.02614776528
398279,398376,401831,97,3455,2,7200,1.02807525326
398279,398371,401765,92,3394,2,7200,1.02710665881
398279,398360,402016,81,3656,2,7200,1.02215536105
398280,398392,401704,112,3312,2,7200,1.03381642512
398280,398386,402064,106,3678,2,7200,1.02882001088
398280,398402,401882,122,3480,2,7200,1.03505747126
398280,398381,401662,101,3281,2,7200,1.03078329778
398280,398397,401763,117,3366,2,7200,1.03475935829
398281,398407,401950,126,3543,2,7200,1.03556308213
398281,398418,401694,137,3276,2,7200,1.04181929182
398281,398412,401814,131,3402,2,7200,1.03850676073
398282,398433,401636,151,3203,2,7200,1.04714330315
398282,398428,401589,146,3161,2,7200,1.04618791522
398282,398423,401951,141,3528,2,7200,1.03996598639
398282,398439,401780,157,3341,2,7200,1.04699191859
398283,398444,401683,161,3239,2,7200,1.0497066996
398283,398460,401734,177,3274,2,7200,1.0540623091
398283,398454,401778,171,3324,2,7200,1.05144404332
398283,398449,401771,166,3322,2,7200,1.04996989765
398284,398481,402087,197,3606,2,7200,1.05463117027
398284,398465,401617,181,3152,2,7200,1.05742385787
398284,398470,401755,186,3285,2,7200,1.05662100457
398284,398475,401863,191,3388,2,7200,1.05637544274
398284,399006,402191,722,3185,2,7200,1.22668759812
398285,400664,404130,2379,3466,2,7200,1.68638199654
398285,400051,403407,1766,3356,2,7200,1.52622169249
398285,401204,404796,2919,3592,2,7200,1.81263919822
398285,400141,403576,1856,3435,2,7200,1.5403202329
398286,401218,404586,2932,3368,2,7200,1.87054631829
398286,401339,404674,3053,3335,2,7200,1.91544227886
398286,401508,404947,3222,3439,2,7200,1.9369002617
398286,401565,405130,3279,3565,2,7200,1.91977559607
398287,401634,405147,3347,3513,2,7200,1.95274693994
398287,401641,405079,3354,3438,2,7200,1.97556719023
398287,401602,404711,3315,3109,2,7200,2.06625924735
398287,401629,405203,3342,3574,2,7200,1.93508673755
398288,401653,405142,3365,3489,2,7200,1.96445973058
398288,401659,405082,3371,3423,2,7200,1.98480864739
398288,401648,404884,3360,3236,2,7200,2.03831891224
398288,401666,405042,3378,3376,2,7200,2.00059241706
398289,401696,405211,3407,3515,2,7200,1.9692745377
398289,401708,405193,3419,3485,2,7200,1.98106169297
398289,401675,405103,3386,3428,2,7200,1.98774795799
398289,401703,404907,3414,3204,2,7200,2.06554307116
398290,401722,405051,3432,3329,2,7200,2.03094022229
398290,401768,405079,3478,3311,2,7200,2.05043793416
398290,401746,405174,3456,3428,2,7200,2.008168028
398290,401715,405044,3425,3329,2,7200,2.02883748874
398291,401775,405094,3484,3319,2,7200,2.04971376921
398316,401780,404941,3464,3161,2,7200,2.09585574185
398852,400046,403543,1194,3497,4,3600,1.34143551616
398925,493191,525283,94266,32092,36,86400,3.93736756824
398994,401787,405313,2793,3526,2,7200,1.79211571185
399891,401259,408531,1368,7272,4,28800,1.18811881188
400062,400215,402345,153,2130,4,2410,1.07183098592
400091,412691,412693,12600,2,2,57600,1260.2
400128,401792,404980,1664,3188,2,7200,1.52195734003
400138,400611,402664,473,2053,4,2410,1.23039454457
400388,405244,518588,4856,113344,10,540000,1.04284302654
400399,412968,499556,12569,86588,10,540000,1.1451586825
400464,488461,488540,87997,79,32,900,1114.88607595
400525,421248,464488,20723,43240,10,43200,1.47925531915
400654,401797,405120,1143,3323,2,7200,1.34396629552
400664,486037,486260,85373,223,64,900,383.838565022
400724,2189389,2190307,1788665,918,128,900,1949.43681917
400820,401274,404700,454,3426,4,28800,1.13251605371
400835,408079,409026,7244,947,2,1560,8.64941921859
401132,401199,401262,67,63,4,2410,2.06349206349
401329,401805,405063,476,3258,2,7200,1.14610190301
401495,401810,405141,315,3331,2,7200,1.09456619634
401555,401826,405058,271,3232,2,7200,1.0838490099
401591,401844,405298,253,3454,2,7200,1.07324840764
401618,401865,404951,247,3086,2,7200,1.08003888529
401619,401874,405264,255,3390,2,7200,1.07522123894
401635,401881,405443,246,3562,2,7200,1.06906232454
401636,401894,405179,258,3285,2,7200,1.07853881279
401638,401899,405233,261,3334,2,7200,1.07828434313
401653,401932,405347,279,3415,2,7200,1.08169838946
401654,401938,405164,284,3226,2,7200,1.08803471792
401669,401962,405061,293,3099,2,7200,1.09454662794
401684,401969,405353,285,3384,2,7200,1.08421985816
401699,402027,405156,328,3129,2,7200,1.10482582295
401701,402076,405090,375,3014,2,7200,1.12441937624
401702,402099,405558,397,3459,2,7200,1.1147730558
401717,402204,405533,487,3329,2,7200,1.14629017723
401735,402645,405936,910,3291,2,7200,1.27651169857
401756,402650,406178,894,3528,2,7200,1.25340136054
401772,402655,405959,883,3304,2,7200,1.26725181598
401773,402676,406082,903,3406,2,7200,1.26512037581
401774,402681,406012,907,3331,2,7200,1.27229060342
401776,403419,406688,1643,3269,2,7200,1.50260018354
401791,403589,407216,1798,3627,2,7200,1.49572649573
401792,404143,407277,2351,3134,2,7200,1.75015954052
401794,404507,408137,2713,3630,2,7200,1.74738292011
401815,404512,407732,2697,3220,2,7200,1.83757763975
401832,404557,408225,2725,3668,2,7200,1.74291166848
401854,404562,407917,2708,3355,2,7200,1.80715350224
401869,404567,408129,2698,3562,2,7200,1.75743964065
401870,404598,408066,2728,3468,2,7200,1.78662053057
401885,404686,408046,2801,3360,2,7200,1.83363095238
401886,404712,408038,2826,3326,2,7200,1.8496692724
401919,404717,407917,2798,3200,2,7200,1.874375
401921,404724,407905,2803,3181,2,7200,1.88116944357
401951,404808,408170,2857,3362,2,7200,1.8497917906
401953,404895,408245,2942,3350,2,7200,1.87820895522
402016,404920,408208,2904,3288,2,7200,1.88321167883
402064,404953,408424,2889,3471,2,7200,1.83232497839
402088,404960,408505,2872,3545,2,7200,1.8101551481
402107,409640,755258,7533,345618,2,345600,1.02179573981
402193,404967,408169,2774,3202,2,7200,1.86633354154
403024,403556,404497,532,941,4,5400,1.56535600425
403408,404992,408663,1584,3671,2,7200,1.43149005721
403577,405054,408350,1477,3296,2,7200,1.44811893204
403901,412696,754014,8795,341318,2,345600,1.0257677591
404066,410593,422994,6527,12401,2,28800,1.52632852189
404133,405062,408349,929,3287,2,7200,1.28262853666
404586,405069,408578,483,3509,2,7200,1.13764605301
404676,405076,408363,400,3287,2,7200,1.12169151202
404712,405081,408602,369,3521,2,7200,1.10479977279
404797,405087,408499,290,3412,2,7200,1.08499413834
404884,405093,408457,209,3364,2,7200,1.06212841855
404908,405099,408362,191,3263,2,7200,1.05853509041
404941,405104,408464,163,3360,2,7200,1.04851190476
404956,405111,408367,155,3256,2,7200,1.0476044226
404957,405116,408280,159,3164,2,7200,1.0502528445
404981,405122,408662,141,3540,2,7200,1.03983050847
405044,405133,408756,89,3623,2,7200,1.02456527739
405046,405143,408494,97,3351,2,7200,1.02894658311
405061,405153,408624,92,3471,2,7200,1.02650532988
405062,405160,408530,98,3370,2,7200,1.02908011869
405064,405165,408436,101,3271,2,7200,1.03087740752
405079,405172,408576,93,3404,2,7200,1.02732079906
405080,405179,408720,99,3541,2,7200,1.0279582039
405082,405186,408535,104,3349,2,7200,1.03105404598
405097,405193,408574,96,3381,2,7200,1.02839396628
405098,405206,408753,108,3547,2,7200,1.03044826614
405100,405215,408806,115,3591,2,7200,1.03202450571
405115,405224,408569,109,3345,2,7200,1.03258594918
405130,405249,408351,119,3102,2,7200,1.03836234687
405145,405257,408639,112,3382,2,7200,1.03311649911
405146,405277,408677,131,3400,2,7200,1.03852941176
405148,405310,408536,162,3226,2,7200,1.05021698698
405163,405326,408584,163,3258,2,7200,1.05003069368
405164,405360,408727,196,3367,2,7200,1.05821205821
405179,405367,408794,188,3427,2,7200,1.0548584768
405181,405456,408769,275,3313,2,7200,1.08300633867
405182,405546,408839,364,3293,2,7200,1.1105375038
405197,405571,409013,374,3442,2,7200,1.10865775712
405212,405698,408903,486,3205,2,7200,1.15163806552
405214,405948,409278,734,3330,2,7200,1.22042042042
405234,405971,409479,737,3508,2,7200,1.21009122007
405265,406024,409628,759,3604,2,7200,1.21059933407
405279,405693,488711,414,83018,6,172800,1.00498687032
405298,406095,409399,797,3304,2,7200,1.24122276029
405312,406190,409427,878,3237,2,7200,1.27123880136
405348,406700,410008,1352,3308,2,7200,1.40870616687
405363,407228,410580,1865,3352,2,7200,1.55638424821
405422,411031,414187,5609,3156,2,14400,2.77724968314
405445,407289,410508,1844,3219,2,7200,1.57284871078
405535,407744,411153,2209,3409,2,7200,1.64799061308
405559,407918,411038,2359,3120,2,7200,1.75608974359
405937,407929,411064,1992,3135,2,7200,1.63540669856
405958,407936,411301,1978,3365,2,7200,1.58781575037
406012,408051,411052,2039,3001,2,7200,1.6794401866
406085,408058,411430,1973,3372,2,7200,1.58511269276
406178,408141,411646,1963,3505,2,7200,1.56005706134
406688,408150,411484,1462,3334,2,7200,1.43851229754
407217,408181,411551,964,3370,2,7200,1.28605341246
407277,408188,411557,911,3369,2,7200,1.27040664886
407314,408543,410469,1229,1926,4,2410,1.63811007269
407732,408221,411457,489,3236,2,7200,1.15111248455
407908,408237,411671,329,3434,2,7200,1.09580663949
407923,408258,411501,335,3243,2,7200,1.10329941412
407924,408292,411572,368,3280,2,7200,1.11219512195
408038,408361,411620,323,3259,2,7200,1.09911015649
408053,408368,411763,315,3395,2,7200,1.09278350515
408068,408373,411719,305,3346,2,7200,1.09115361626
408131,408380,411789,249,3409,2,7200,1.07304194779
408146,408385,411676,239,3291,2,7200,1.07262230325
408170,408390,411700,220,3310,2,7200,1.0664652568
408171,408436,411895,265,3459,2,7200,1.0766117375
408211,408448,411720,237,3272,2,7200,1.07243276284
408226,408469,411616,243,3147,2,7200,1.07721639657
408246,408477,412028,231,3551,2,7200,1.065052098
408279,408507,411529,228,3022,2,7200,1.07544672402
408352,408514,411864,162,3350,2,7200,1.04835820896
408354,408520,411940,166,3420,2,7200,1.0485380117
408355,408548,411937,193,3389,2,7200,1.05694895249
408370,408555,411953,185,3398,2,7200,1.05444379046
408372,408560,411946,188,3386,2,7200,1.0555227407
408373,408581,411855,208,3274,2,7200,1.06353084911
408424,408587,411982,163,3395,2,7200,1.04801178203
408439,408593,411848,154,3255,2,7200,1.04731182796
408457,408600,412094,143,3494,2,7200,1.04092730395
408472,408605,411852,133,3247,2,7200,1.04096088697
408496,408614,412182,118,3568,2,7200,1.03307174888
408511,408636,412244,125,3608,2,7200,1.03464523282
408512,408652,411886,140,3234,2,7200,1.04329004329
408530,408675,412156,145,3481,2,7200,1.04165469693
408545,408680,411970,135,3290,2,7200,1.04103343465
408546,408686,412007,140,3321,2,7200,1.04215597712
408570,408691,411994,121,3303,2,7200,1.03663336361
408585,408697,411952,112,3255,2,7200,1.03440860215
408587,408704,412296,117,3592,2,7200,1.03257238307
408588,408732,412097,144,3365,2,7200,1.04279346211
408589,408739,412072,150,3333,2,7200,1.04500450045
408604,408765,412223,161,3458,2,7200,1.04655870445
408625,408772,411957,147,3185,2,7200,1.04615384615
408640,408782,412117,142,3335,2,7200,1.04257871064
408664,408805,412182,141,3377,2,7200,1.04175303524
408665,408819,412113,154,3294,2,7200,1.0467516697
408680,408852,412161,172,3309,2,7200,1.05197944998
408722,408915,412596,193,3681,2,7200,1.05243140451
408737,409025,412284,288,3259,2,7200,1.08837066585
408755,409038,412262,283,3224,2,7200,1.08777915633
408770,409290,412311,520,3021,2,7200,1.17212843429
408771,409411,412994,640,3583,2,7200,1.17862126709
408795,409439,412923,644,3484,2,7200,1.18484500574
408810,409491,412932,681,3441,2,7200,1.197907585
408840,410012,413157,1172,3145,2,7200,1.37265500795
408903,410020,413383,1117,3363,2,7200,1.33214391912
409015,410278,413823,1263,3545,2,7200,1.3562764457
409278,410481,413821,1203,3340,2,7200,1.36017964072
409399,410486,413840,1087,3354,2,7200,1.32409063804
409429,410520,413726,1091,3206,2,7200,1.34029943855
409480,411026,414508,1546,3482,2,7200,1.44399770247
409628,411051,414511,1423,3460,2,7200,1.4112716763
409672,412112,413191,2440,1079,2,14400,3.26135310473
409981,410007,448770,26,38763,4,43200,1.00067074272
410008,411065,414446,1057,3381,2,7200,1.31262939959
410039,410273,420963,234,10690,4,28800,1.02188961646
410510,411076,414448,566,3372,2,7200,1.16785290629
410535,411021,583849,486,172828,4,172800,1.00281204434
410582,411165,414429,583,3264,2,7200,1.17861519608
411038,411313,414586,275,3273,2,7200,1.08402077605
411053,411443,414698,390,3255,2,7200,1.1198156682
411068,411469,414643,401,3174,2,7200,1.12633900441
411155,411496,415021,341,3525,2,7200,1.09673758865
411300,411514,414923,214,3409,2,7200,1.06277500733
411433,411542,414627,109,3085,2,7200,1.03533225284
411457,411564,414880,107,3316,2,7200,1.03226779252
411487,411571,414916,84,3345,2,7200,1.02511210762
411505,411584,414914,79,3330,2,7200,1.02372372372
411532,411613,415408,81,3795,2,7200,1.02134387352
411552,411629,414987,77,3358,2,7200,1.02293031566
411567,411636,415240,69,3604,2,7200,1.01914539401
411582,411659,414877,77,3218,2,7200,1.02392790553
411618,411683,414964,65,3281,2,7200,1.01981103322
411633,411690,414991,57,3301,2,7200,1.0172674947
411648,411712,414942,64,3230,2,7200,1.01981424149
411672,411732,414967,60,3235,2,7200,1.01854714065
411687,411737,415080,50,3343,2,7200,1.01495662579
411701,411775,414976,74,3201,2,7200,1.0231177757
411719,411801,415165,82,3364,2,7200,1.02437574316
411721,411861,415150,140,3289,2,7200,1.04256612952
411763,411868,415524,105,3656,2,7200,1.02871991247
411790,411873,415290,83,3417,2,7200,1.02429031314
411851,411880,415256,29,3376,2,7200,1.00859004739
411866,411899,415333,33,3434,2,7200,1.00960978451
411867,411908,415169,41,3261,2,7200,1.01257283042
411869,411917,415633,48,3716,2,7200,1.01291711518
411887,411922,415554,35,3632,2,7200,1.00963656388
411901,411949,415525,48,3576,2,7200,1.01342281879
411941,411956,415396,15,3440,2,7200,1.00436046512
411942,411963,415265,21,3302,2,7200,1.00635978195
411958,411970,415170,12,3200,2,7200,1.00375
411959,411975,415008,16,3033,2,7200,1.00527530498
411960,411980,415399,20,3419,2,7200,1.00584966364
411961,411988,415570,27,3582,2,7200,1.00753768844
411976,411995,415588,19,3593,2,7200,1.00528806012
411991,412006,415300,15,3294,2,7200,1.00455373406
412006,412019,415227,13,3208,2,7200,1.00405236908
412007,412040,415410,33,3370,2,7200,1.00979228487
412028,412085,415531,57,3446,2,7200,1.01654091701
412074,412102,415460,28,3358,2,7200,1.00833829661
412095,412107,415642,12,3535,2,7200,1.00339462518
412109,412119,415275,10,3156,2,7200,1.00316856781
412124,412131,415510,7,3379,2,7200,1.00207161882
412126,412137,415467,11,3330,2,7200,1.0033033033
412156,412163,415757,7,3594,2,7200,1.0019476906
412170,412181,415271,11,3090,2,7200,1.00355987055
412186,412195,415598,9,3403,2,7200,1.00264472524
412187,412200,415572,13,3372,2,7200,1.00385527877
412223,412235,415735,12,3500,2,7200,1.00342857143
412244,412256,415806,12,3550,2,7200,1.00338028169
412265,412274,415772,9,3498,2,7200,1.0025728988
412286,412297,415798,11,3501,2,7200,1.00314195944
412300,412307,415663,7,3356,2,7200,1.00208581645
412315,412324,415716,9,3392,2,7200,1.00265330189
412597,412609,415810,12,3201,2,7200,1.00374882849
412923,412931,416398,8,3467,2,7200,1.00230747044
412938,412946,416370,8,3424,2,7200,1.0023364486
412996,413007,416426,11,3419,2,7200,1.003217315
413158,413169,416502,11,3333,2,7200,1.00330033003
413385,413391,416820,6,3429,2,7200,1.00174978128
413726,413732,417009,6,3277,2,7200,1.00183094294
413822,413830,416952,8,3122,2,7200,1.00256245996
413837,413843,417164,6,3321,2,7200,1.00180668473
413853,413859,417068,6,3209,2,7200,1.00186974135
414430,414437,417922,7,3485,2,7200,1.00200860832
414448,414454,417868,6,3414,2,7200,1.00175746924
414449,414462,418043,13,3581,2,7200,1.00363027087
414509,414515,417716,6,3201,2,7200,1.00187441425
414524,414530,417999,6,3469,2,7200,1.00172960507
414587,414593,417953,6,3360,2,7200,1.00178571429
414629,414636,417935,7,3299,2,7200,1.00212185511
414644,414650,418120,6,3470,2,7200,1.00172910663
414701,414708,417968,7,3260,2,7200,1.00214723926
414880,414887,418030,7,3143,2,7200,1.00222717149
414894,414900,418178,6,3278,2,7200,1.00183038438
414936,414942,418102,6,3160,2,7200,1.00189873418
414937,414949,418295,12,3346,2,7200,1.00358637179
414952,414958,418350,6,3392,2,7200,1.00176886792
414953,414964,418348,11,3384,2,7200,1.00325059102
414968,414976,418572,8,3596,2,7200,1.0022246941
414970,414981,418338,11,3357,2,7200,1.00327673518
414985,414991,418220,6,3229,2,7200,1.00185816042
414986,414999,418223,13,3224,2,7200,1.00403225806
415005,415012,418541,7,3529,2,7200,1.00198356475
415020,415027,418090,7,3063,2,7200,1.00228534117
415034,415042,418606,8,3564,2,7200,1.00224466891
415083,415090,418493,7,3403,2,7200,1.00205700852
415152,415158,418779,6,3621,2,7200,1.00165700083
415167,415173,418601,6,3428,2,7200,1.00175029172
415182,415189,418471,7,3282,2,7200,1.00213284583
415183,415195,418585,12,3390,2,7200,1.00353982301
415228,415234,418440,6,3206,2,7200,1.00187149095
415243,415250,418510,7,3260,2,7200,1.00214723926
415258,415265,418411,7,3146,2,7200,1.00222504768
415273,415279,418738,6,3459,2,7200,1.00173460538
415274,415286,418289,12,3003,2,7200,1.003996004
415289,415296,418476,7,3180,2,7200,1.00220125786
415304,415311,418482,7,3171,2,7200,1.00220750552
415305,415318,418727,13,3409,2,7200,1.00381343502
415335,415341,418674,6,3333,2,7200,1.00180018002
415395,415402,418987,7,3585,2,7200,1.0019525802
415411,415417,418827,6,3410,2,7200,1.00175953079
415412,415424,418638,12,3214,2,7200,1.00373366521
415413,415429,418978,16,3549,2,7200,1.0045083122
415461,415467,418868,6,3401,2,7200,1.001764187
415476,415482,418730,6,3248,2,7200,1.00184729064
415512,415518,419066,6,3548,2,7200,1.00169109357
415527,415533,418802,6,3269,2,7200,1.00183542368
415528,415540,418936,12,3396,2,7200,1.0035335689
415543,415550,418908,7,3358,2,7200,1.00208457415
415558,415564,418865,6,3301,2,7200,1.00181763102
415573,415580,418657,7,3077,2,7200,1.00227494313
415574,415587,418842,13,3255,2,7200,1.00399385561
415589,415596,418977,7,3381,2,7200,1.00207039337
415604,415611,418634,7,3023,2,7200,1.00231558055
415634,415640,418949,6,3309,2,7200,1.00181323663
415649,415655,419179,6,3524,2,7200,1.00170261067
415664,415670,419238,6,3568,2,7200,1.00168161435
415718,415724,419286,6,3562,2,7200,1.00168444694
415736,415742,418990,6,3248,2,7200,1.00184729064
415760,415766,419417,6,3651,2,7200,1.00164338537
415775,415782,419244,7,3462,2,7200,1.00202195263
415799,415806,418998,7,3192,2,7200,1.00219298246
415814,415821,419204,7,3383,2,7200,1.00206916938
415815,415827,419063,12,3236,2,7200,1.00370828183
415900,415907,420949,7,5042,1,9600,1.00138833796
415906,416387,418138,481,1751,4,2410,1.27470017133
415971,418150,418159,2179,9,4,2410,218.8
416064,416743,445446,679,28703,6,108000,1.02365606383
416373,416379,419949,6,3570,2,7200,1.00168067227
416400,416407,419701,7,3294,2,7200,1.0021250759
416427,416434,419728,7,3294,2,7200,1.0021250759
416505,416512,419919,7,3407,2,7200,1.00205459348
416823,416829,420136,6,3307,2,7200,1.00181433323
416953,416960,420146,7,3186,2,7200,1.00219711237
417011,417018,420432,7,3414,2,7200,1.00205038079
417071,417077,420392,6,3315,2,7200,1.00180995475
417164,417171,420653,7,3482,2,7200,1.00201033889
417716,417722,420844,6,3122,2,7200,1.00192184497
417870,417877,421500,7,3623,2,7200,1.00193210047
417924,417930,421232,6,3302,2,7200,1.00181708056
417939,417945,421119,6,3174,2,7200,1.00189035917
417954,417960,421232,6,3272,2,7200,1.00183374083
417969,417975,421312,6,3337,2,7200,1.00179802218
418002,418009,421401,7,3392,2,7200,1.00206367925
418032,418039,421592,7,3553,2,7200,1.00197016606
418047,418054,421627,7,3573,2,7200,1.00195913798
418092,418098,421564,6,3466,2,7200,1.00173110214
418106,418114,421425,8,3311,2,7200,1.00241618846
418121,418128,421486,7,3358,2,7200,1.00208457415
418178,418186,421664,8,3478,2,7200,1.00230017251
418221,418228,421834,7,3606,2,7200,1.0019412091
418236,418243,421232,7,2989,2,7200,1.00234192037
418290,418297,421754,7,3457,2,7200,1.00202487706
418304,418312,421715,8,3403,2,7200,1.00235086688
418341,418347,421498,6,3151,2,7200,1.00190415741
418356,418362,421551,6,3189,2,7200,1.00188146754
418357,418368,421694,11,3326,2,7200,1.00330727601
418380,418484,420103,104,1619,4,2410,1.06423718345
418411,418418,421940,7,3522,2,7200,1.0019875071
418441,418448,421910,7,3462,2,7200,1.00202195263
418471,418477,421924,6,3447,2,7200,1.00174064404
418486,418492,421724,6,3232,2,7200,1.00185643564
418488,418500,422088,12,3588,2,7200,1.00334448161
418502,418510,421697,8,3187,2,7200,1.00251019768
418517,418523,422166,6,3643,2,7200,1.00164699424
418538,418619,418620,81,1,2,3540,8.2
418541,418548,421820,7,3272,2,7200,1.0021393643
418574,418581,421733,7,3152,2,7200,1.00222081218
418589,418595,421809,6,3214,2,7200,1.00186683261
418604,418610,421990,6,3380,2,7200,1.00177514793
418619,418625,421854,6,3229,2,7200,1.00185816042
418634,418640,421941,6,3301,2,7200,1.00181763102
418648,418656,422059,8,3403,2,7200,1.00235086688
418663,418670,421878,7,3208,2,7200,1.00218204489
418678,418685,422077,7,3392,2,7200,1.00206367925
418729,418736,421961,7,3225,2,7200,1.00217054264
418744,418751,422099,7,3348,2,7200,1.00209080048
418746,418758,422109,12,3351,2,7200,1.00358102059
418779,418785,422246,6,3461,2,7200,1.001733603
418803,418809,422199,6,3390,2,7200,1.0017699115
418830,418837,422127,7,3290,2,7200,1.00212765957
418844,418852,422225,8,3373,2,7200,1.00237177587
418865,418872,422196,7,3324,2,7200,1.00210589651
418880,418886,422583,6,3697,2,7200,1.00162293752
418910,418917,422254,7,3337,2,7200,1.00209769254
418937,418944,422162,7,3218,2,7200,1.00217526414
418952,418958,422167,6,3209,2,7200,1.00186974135
418979,418985,422331,6,3346,2,7200,1.00179318589
418981,418992,422412,11,3420,2,7200,1.00321637427
418996,419003,422165,7,3162,2,7200,1.00221378874
418997,419008,422385,11,3377,2,7200,1.00325732899
419012,419018,422504,6,3486,2,7200,1.0017211704
419063,419071,422323,8,3252,2,7200,1.0024600246
419078,419085,422316,7,3231,2,7200,1.00216651192
419181,419188,422549,7,3361,2,7200,1.00208271348
419205,419211,422517,6,3306,2,7200,1.00181488203
419238,419245,422524,7,3279,2,7200,1.00213479719
419253,419260,422702,7,3442,2,7200,1.00203370134
419289,419295,422509,6,3214,2,7200,1.00186683261
419419,419426,422716,7,3290,2,7200,1.00212765957
419703,419710,422963,7,3253,2,7200,1.00215185982
419730,419736,422933,6,3197,2,7200,1.00187675946
419920,419928,423282,8,3354,2,7200,1.00238521169
419950,419957,423425,7,3468,2,7200,1.00201845444
420137,420143,423470,6,3327,2,7200,1.00180342651
420152,420158,423370,6,3212,2,7200,1.00186799502
420393,420401,424092,8,3691,2,7200,1.0021674343
420432,420440,423689,8,3249,2,7200,1.00246229609
420653,420661,424039,8,3378,2,7200,1.00236826525
420844,420851,424153,7,3302,2,7200,1.00211992732
421122,421128,424260,6,3132,2,7200,1.00191570881
421233,421240,424584,7,3344,2,7200,1.00209330144
421235,421253,424944,18,3691,2,7200,1.00487672717
421236,421258,424609,22,3351,2,7200,1.00656520442
421315,421321,424467,6,3146,2,7200,1.00190718373
421402,421408,424645,6,3237,2,7200,1.00185356812
421426,421434,424811,8,3377,2,7200,1.00236896654
421486,421494,425176,8,3682,2,7200,1.00217273221
421501,421509,425035,8,3526,2,7200,1.0022688599
421503,421516,424892,13,3376,2,7200,1.0038507109
421554,421561,424578,7,3017,2,7200,1.00232018561
421569,421575,424684,6,3109,2,7200,1.00192988099
421593,421600,424820,7,3220,2,7200,1.00217391304
421629,421635,424969,6,3334,2,7200,1.00179964007
421665,421672,425023,7,3351,2,7200,1.00208892868
421695,421702,425044,7,3342,2,7200,1.00209455416
421710,421717,425270,7,3553,2,7200,1.00197016606
421725,421732,425063,7,3331,2,7200,1.00210147103
421726,421739,424974,13,3235,2,7200,1.00401854714
421741,421748,424951,7,3203,2,7200,1.00218545114
421756,421763,425110,7,3347,2,7200,1.00209142516
421810,421816,425397,6,3581,2,7200,1.00167550963
421825,421831,425161,6,3330,2,7200,1.0018018018
421839,421846,425008,7,3162,2,7200,1.00221378874
421854,421860,425275,6,3415,2,7200,1.00175695461
421878,421885,425230,7,3345,2,7200,1.00209267564
421911,421917,425063,6,3146,2,7200,1.00190718373
421926,421932,425239,6,3307,2,7200,1.00181433323
421941,421947,425138,6,3191,2,7200,1.00188028831
421942,421954,425451,12,3497,2,7200,1.00343151273
421963,421971,425226,8,3255,2,7200,1.0024577573
421990,421997,425035,7,3038,2,7200,1.00230414747
422060,422065,425418,5,3353,2,7200,1.00149120191
422077,422085,425171,8,3086,2,7200,1.00259235256
422092,422099,425570,7,3471,2,7200,1.00201670988
422108,422114,425726,6,3612,2,7200,1.00166112957
422122,422129,425307,7,3178,2,7200,1.00220264317
422137,422143,425599,6,3456,2,7200,1.00173611111
422161,422168,425383,7,3215,2,7200,1.00217729393
422176,422182,425584,6,3402,2,7200,1.00176366843
422178,422189,425502,11,3313,2,7200,1.00332025355
422179,422194,425510,15,3316,2,7200,1.00452352232
422197,422203,425782,6,3579,2,7200,1.00167644593
422212,422219,425595,7,3376,2,7200,1.00207345972
422226,422233,425728,7,3495,2,7200,1.00200286123
422247,422254,425670,7,3416,2,7200,1.00204918033
422262,422268,425452,6,3184,2,7200,1.00188442211
422316,422323,425777,7,3454,2,7200,1.00202663578
422331,422338,425795,7,3457,2,7200,1.00202487706
422332,422344,425708,12,3364,2,7200,1.00356718193
422387,422394,425614,7,3220,2,7200,1.00217391304
422414,422420,425613,6,3193,2,7200,1.00187911055
422504,422511,425852,7,3341,2,7200,1.00209518108
422519,422526,425701,7,3175,2,7200,1.00220472441
422521,422534,425834,13,3300,2,7200,1.00393939394
422536,422543,425667,7,3124,2,7200,1.00224071703
422550,422558,425829,8,3271,2,7200,1.00244573525
422583,422591,425897,8,3306,2,7200,1.00241984271
422704,422711,426144,7,3433,2,7200,1.00203903292
422719,422726,426137,7,3411,2,7200,1.00205218411
422931,422938,426194,7,3256,2,7200,1.00214987715
422963,424475,515002,1512,90527,12,172800,1.01670219934
422964,422970,426582,6,3612,2,7200,1.00166112957
423284,423290,426607,6,3317,2,7200,1.00180886343
423372,423378,426551,6,3173,2,7200,1.00189095493
423426,423432,426608,6,3176,2,7200,1.00188916877
423471,423478,426657,7,3179,2,7200,1.0022019503
423691,423698,427117,7,3419,2,7200,1.00204738228
424042,424048,427276,6,3228,2,7200,1.00185873606
424093,424099,427723,6,3624,2,7200,1.00165562914
424153,424159,427699,6,3540,2,7200,1.00169491525
424261,424267,427544,6,3277,2,7200,1.00183094294
424470,424482,427895,12,3413,2,7200,1.00351596836
424578,424584,428046,6,3462,2,7200,1.00173310225
424593,424599,427855,6,3256,2,7200,1.00184275184
424611,424617,428146,6,3529,2,7200,1.00170019836
424647,424654,427833,7,3179,2,7200,1.0022019503
424686,424693,428124,7,3431,2,7200,1.00204022151
424812,424819,428297,7,3478,2,7200,1.00201265095
424827,424834,428313,7,3479,2,7200,1.00201207243
424894,424900,428082,6,3182,2,7200,1.00188560654
424945,424951,428383,6,3432,2,7200,1.00174825175
424959,424967,428116,8,3149,2,7200,1.00254048904
424974,424981,428424,7,3443,2,7200,1.00203311066
424976,424988,428293,12,3305,2,7200,1.00363086233
425009,425015,428110,6,3095,2,7200,1.00193861066
425024,425030,428379,6,3349,2,7200,1.00179157958
425039,425046,428230,7,3184,2,7200,1.00219849246
425040,425053,428389,13,3336,2,7200,1.00389688249
425055,425061,428228,6,3167,2,7200,1.00189453742
425070,425077,428417,7,3340,2,7200,1.00209580838
425071,425084,428559,13,3475,2,7200,1.00374100719
425110,425116,428526,6,3410,2,7200,1.00175953079
425140,425147,428732,7,3585,2,7200,1.0019525802
425161,425168,428557,7,3389,2,7200,1.00206550605
425176,425182,428752,6,3570,2,7200,1.00168067227
425178,425190,428570,12,3380,2,7200,1.00355029586
425226,425232,428274,6,3042,2,7200,1.00197238659
425241,425247,428477,6,3230,2,7200,1.00185758514
425242,425254,428529,12,3275,2,7200,1.00366412214
425272,425279,428544,7,3265,2,7200,1.002143951
425287,425294,429054,7,3760,2,7200,1.00186170213
425308,425314,428780,6,3466,2,7200,1.00173110214
425383,425390,428758,7,3368,2,7200,1.0020783848
425398,425405,428905,7,3500,2,7200,1.002
425419,425425,428924,6,3499,2,7200,1.00171477565
425452,425458,428782,6,3324,2,7200,1.00180505415
425454,425465,429003,11,3538,2,7200,1.00310910119
425502,425508,428903,6,3395,2,7200,1.00176730486
425516,425523,428923,7,3400,2,7200,1.00205882353
425571,425577,429010,6,3433,2,7200,1.0017477425
425585,425593,428901,8,3308,2,7200,1.00241837969
425600,425607,429101,7,3494,2,7200,1.00200343446
425602,425614,428852,12,3238,2,7200,1.00370599135
425617,425623,428974,6,3351,2,7200,1.0017905103
425618,425630,428858,12,3228,2,7200,1.00371747212
425670,425677,429068,7,3391,2,7200,1.00206428782
425671,425684,429209,13,3525,2,7200,1.00368794326
425701,425708,428906,7,3198,2,7200,1.00218886804
425716,425723,429206,7,3483,2,7200,1.0020097617
425731,425738,428950,7,3212,2,7200,1.00217932752
425732,425745,429270,13,3525,2,7200,1.00368794326
425778,425785,429240,7,3455,2,7200,1.0020260492
425793,425799,429170,6,3371,2,7200,1.00177988727
425807,425814,429176,7,3362,2,7200,1.00208209399
425831,425837,429239,6,3402,2,7200,1.00176366843
425846,425852,429095,6,3243,2,7200,1.00185013876
425861,425867,429120,6,3253,2,7200,1.00184445128
425900,425907,429108,7,3201,2,7200,1.00218681662
426139,426145,429807,6,3662,2,7200,1.00163844894
426154,426160,429462,6,3302,2,7200,1.00181708056
426196,426203,429453,7,3250,2,7200,1.00215384615
426553,426560,429807,7,3247,2,7200,1.00215583616
426583,426589,429791,6,3202,2,7200,1.00187382886
426607,426613,429962,6,3349,2,7200,1.00179157958
426622,426629,429926,7,3297,2,7200,1.00212314225
426658,426665,429869,7,3204,2,7200,1.00218476904
427119,427126,430529,7,3403,2,7200,1.00205700852
427276,427283,430709,7,3426,2,7200,1.00204319907
427545,427552,430892,7,3340,2,7200,1.00209580838
427606,440362,440778,12756,416,14,1560,31.6634615385
427702,427708,430974,6,3266,2,7200,1.00183710961
427726,427732,431058,6,3326,2,7200,1.00180396873
427835,427842,431197,7,3355,2,7200,1.00208643815
427856,427863,431283,7,3420,2,7200,1.00204678363
427898,427905,430976,7,3071,2,7200,1.00227938782
428049,428055,431313,6,3258,2,7200,1.00184162063
428085,428092,431525,7,3433,2,7200,1.00203903292
428112,428118,431448,6,3330,2,7200,1.0018018018
428127,428133,431453,6,3320,2,7200,1.00180722892
428128,428141,431219,13,3078,2,7200,1.00422352177
428149,428156,431323,7,3167,2,7200,1.00221029365
428231,428237,431863,6,3626,2,7200,1.00165471594
428232,428244,431652,12,3408,2,7200,1.00352112676
428277,428283,431679,6,3396,2,7200,1.00176678445
428295,428301,431353,6,3052,2,7200,1.00196592398
428310,428316,431580,6,3264,2,7200,1.00183823529
428325,428332,431556,7,3224,2,7200,1.00217121588
428382,428388,431861,6,3473,2,7200,1.00172761301
428397,428403,431782,6,3379,2,7200,1.00177567328
428398,428409,431634,11,3225,2,7200,1.00341085271
428419,428426,431589,7,3163,2,7200,1.00221308884
428434,428440,431775,6,3335,2,7200,1.00179910045
428479,428485,431618,6,3133,2,7200,1.00191509735
428527,428534,431915,7,3381,2,7200,1.00207039337
428542,428548,431825,6,3277,2,7200,1.00183094294
428557,428564,431702,7,3138,2,7200,1.0022307202
428572,428578,432021,6,3443,2,7200,1.00174266628
428573,428585,431911,12,3326,2,7200,1.00360793746
428575,428590,432103,15,3513,2,7200,1.00426985482
428732,428738,432099,6,3361,2,7200,1.00178518298
428753,428759,432102,6,3343,2,7200,1.00179479509
428767,428775,432209,8,3434,2,7200,1.00232964473
428782,428790,432275,8,3485,2,7200,1.00229555237
428784,428795,432377,11,3582,2,7200,1.00307091011
428853,428860,432173,7,3313,2,7200,1.00211288862
428868,428875,432260,7,3385,2,7200,1.00206794682
428901,428907,432010,6,3103,2,7200,1.00193361263
428916,428923,432442,7,3519,2,7200,1.00198920148
428918,428930,432259,12,3329,2,7200,1.00360468609
428919,428935,432196,16,3261,2,7200,1.00490647041
428934,428942,432174,8,3232,2,7200,1.00247524752
428935,428947,432480,12,3533,2,7200,1.00339654684
428950,428957,432168,7,3211,2,7200,1.00218000623
428974,428980,432354,6,3374,2,7200,1.00177830468
429004,429011,432374,7,3363,2,7200,1.00208147487
429019,429027,432627,8,3600,2,7200,1.00222222222
429055,429061,432582,6,3521,2,7200,1.00170406135
429070,429077,432542,7,3465,2,7200,1.00202020202
429097,429104,432323,7,3219,2,7200,1.00217458838
429112,429119,432432,7,3313,2,7200,1.00211288862
429113,429126,432305,13,3179,2,7200,1.00408933627
429129,429135,432634,6,3499,2,7200,1.00171477565
429171,429178,432434,7,3256,2,7200,1.00214987715
429186,429193,432505,7,3312,2,7200,1.00211352657
429207,429213,432524,6,3311,2,7200,1.00181214135
429222,429228,432444,6,3216,2,7200,1.00186567164
429240,429247,432710,7,3463,2,7200,1.00202136876
429241,429254,432586,13,3332,2,7200,1.00390156062
429271,429279,432559,8,3280,2,7200,1.00243902439
429456,429462,432783,6,3321,2,7200,1.00180668473
429471,429478,432952,7,3474,2,7200,1.00201496834
429791,429799,433207,8,3408,2,7200,1.00234741784
429809,429817,433156,8,3339,2,7200,1.00239592692
429811,429824,433298,13,3474,2,7200,1.00374208405
429871,429878,433346,7,3468,2,7200,1.00201845444
429928,429936,433469,8,3533,2,7200,1.00226436456
429965,429972,433186,7,3214,2,7200,1.00217797138
430529,430536,433884,7,3348,2,7200,1.00209080048
430711,430718,434052,7,3334,2,7200,1.00209958008
430892,430899,434366,7,3467,2,7200,1.00201903663
430976,430984,434263,8,3279,2,7200,1.00243976822
430978,430989,434608,11,3619,2,7200,1.00303951368
431003,440096,440349,9093,253,16,1800,36.9407114625
431059,431065,434156,6,3091,2,7200,1.00194111938
431074,488466,488714,57392,248,32,1800,232.419354839
431120,486273,486677,55153,404,64,1800,137.517326733
431172,2190319,2190781,1759147,462,128,1800,3808.67748918
431198,431206,434415,8,3209,2,7200,1.00249298847
431219,431226,434458,7,3232,2,7200,1.00216584158
431285,431292,434697,7,3405,2,7200,1.00205580029
431315,431322,434835,7,3513,2,7200,1.00199259892
431330,431338,434591,8,3253,2,7200,1.00245926837
431354,431361,434983,7,3622,2,7200,1.0019326339
431448,431455,434729,7,3274,2,7200,1.00213805742
431462,431469,435014,7,3545,2,7200,1.00197461213
431526,431532,434694,6,3162,2,7200,1.00189753321
431559,431565,434783,6,3218,2,7200,1.00186451212
431583,431590,435196,7,3606,2,7200,1.0019412091
431597,431605,434851,8,3246,2,7200,1.00246457178
431618,431624,435017,6,3393,2,7200,1.0017683466
431636,431642,434786,6,3144,2,7200,1.00190839695
431654,431661,435129,7,3468,2,7200,1.00201845444
431681,431688,435192,7,3504,2,7200,1.00199771689
431702,431709,435126,7,3417,2,7200,1.00204858063
431777,431785,435274,8,3489,2,7200,1.00229292061
431792,431798,435079,6,3281,2,7200,1.00182871076
431825,431831,435082,6,3251,2,7200,1.00184558597
431861,431869,435198,8,3329,2,7200,1.00240312406
431876,431882,435356,6,3474,2,7200,1.00172711572
431912,431920,435225,8,3305,2,7200,1.00242057489
431927,431933,435178,6,3245,2,7200,1.00184899846
432012,432019,435026,7,3007,2,7200,1.00232790156
432028,432034,435234,6,3200,2,7200,1.001875
432101,432107,435537,6,3430,2,7200,1.00174927114
432115,432123,435530,8,3407,2,7200,1.00234810684
432117,432130,435462,13,3332,2,7200,1.00390156062
432168,432174,435414,6,3240,2,7200,1.00185185185
432183,432189,435306,6,3117,2,7200,1.00192492782
432184,432197,435467,13,3270,2,7200,1.00397553517
432199,432206,435439,7,3233,2,7200,1.00216517167
432214,432221,435519,7,3298,2,7200,1.00212249848
432259,432265,435732,6,3467,2,7200,1.00173060283
432274,432280,435562,6,3282,2,7200,1.00182815356
432275,432287,435633,12,3346,2,7200,1.00358637179
432306,432313,435665,7,3352,2,7200,1.00208830549
432324,432331,435326,7,2995,2,7200,1.00233722871
432357,432364,435812,7,3448,2,7200,1.00203016241
432375,432382,435570,7,3188,2,7200,1.002195734
432389,432397,435809,8,3412,2,7200,1.00234466589
432435,432442,435807,7,3365,2,7200,1.00208023774
432436,432449,435824,13,3375,2,7200,1.00385185185
432451,432458,435876,7,3418,2,7200,1.00204798128
432453,432465,435886,12,3421,2,7200,1.00350774627
432483,432490,435931,7,3441,2,7200,1.00203429236
432507,432513,435928,6,3415,2,7200,1.00175695461
432525,432531,435917,6,3386,2,7200,1.00177200236
432543,432549,435721,6,3172,2,7200,1.00189155107
432561,432567,435778,6,3211,2,7200,1.00186857677
432585,432591,435850,6,3259,2,7200,1.00184105554
432600,432606,435849,6,3243,2,7200,1.00185013876
432627,432634,435776,7,3142,2,7200,1.00222788033
432642,432649,435834,7,3185,2,7200,1.0021978022
432711,432718,436224,7,3506,2,7200,1.0019965773
432783,432790,435944,7,3154,2,7200,1.00221940393
432953,432960,436226,7,3266,2,7200,1.00214329455
433158,433165,436565,7,3400,2,7200,1.00205882353
433188,433194,436515,6,3321,2,7200,1.00180668473
433209,433215,436590,6,3375,2,7200,1.00177777778
433300,433306,436970,6,3664,2,7200,1.00163755459
433348,433354,436506,6,3152,2,7200,1.0019035533
433472,433479,436798,7,3319,2,7200,1.002109069
433886,433892,437149,6,3257,2,7200,1.00184218606
434052,434058,437513,6,3455,2,7200,1.0017366136
434158,434165,437594,7,3429,2,7200,1.00204141149
434263,434270,437406,7,3136,2,7200,1.00223214286
434369,434375,437619,6,3244,2,7200,1.00184956843
434417,434423,437892,6,3469,2,7200,1.00172960507
434459,434465,437964,6,3499,2,7200,1.00171477565
434592,434599,438069,7,3470,2,7200,1.00201729107
434610,434616,437816,6,3200,2,7200,1.001875
434694,434700,438061,6,3361,2,7200,1.00178518298
434709,434716,438125,7,3409,2,7200,1.00205338809
434730,434737,438175,7,3438,2,7200,1.00203606748
434784,434791,438157,7,3366,2,7200,1.00207961973
434799,434806,437999,7,3193,2,7200,1.00219229565
434835,434842,437973,7,3131,2,7200,1.00223570744
434853,434859,437922,6,3063,2,7200,1.00195886386
434983,434990,438339,7,3349,2,7200,1.00209017617
435016,435023,438419,7,3396,2,7200,1.00206124853
435031,435037,438474,6,3437,2,7200,1.00174570847
435033,435044,438222,11,3178,2,7200,1.00346129641
435081,435087,438322,6,3235,2,7200,1.00185471406
435096,435103,438475,7,3372,2,7200,1.00207591934
435126,435132,438168,6,3036,2,7200,1.00197628458
435141,435148,438317,7,3169,2,7200,1.00220889871
435180,435186,438618,6,3432,2,7200,1.00174825175
435195,435202,438418,7,3216,2,7200,1.00217661692
435209,435216,438829,7,3613,2,7200,1.0019374481
435211,435222,438520,11,3298,2,7200,1.00333535476
435226,435232,438718,6,3486,2,7200,1.0017211704
435240,435246,438804,6,3558,2,7200,1.00168634064
435274,435281,438396,7,3115,2,7200,1.00224719101
435306,435314,438694,8,3380,2,7200,1.00236686391
435327,435335,438745,8,3410,2,7200,1.00234604106
435357,435365,438725,8,3360,2,7200,1.00238095238
435415,435422,438552,7,3130,2,7200,1.00223642173
435442,435448,438761,6,3313,2,7200,1.00181104739
435463,435469,438691,6,3222,2,7200,1.00186219739
435477,435484,438774,7,3290,2,7200,1.00212765957
435519,435527,438913,8,3386,2,7200,1.00236266982
435534,435542,438925,8,3383,2,7200,1.002364765
435549,435556,438733,7,3177,2,7200,1.00220333648
435564,435571,438650,7,3079,2,7200,1.00227346541
435579,435585,439004,6,3419,2,7200,1.00175489909
435635,435642,438734,7,3092,2,7200,1.00226390686
435668,435674,438866,6,3192,2,7200,1.00187969925
435722,435729,439032,7,3303,2,7200,1.0021192855
435737,435743,438922,6,3179,2,7200,1.00188738597
435776,435782,439281,6,3499,2,7200,1.00171477565
435791,435798,439238,7,3440,2,7200,1.00203488372
435809,435815,439321,6,3506,2,7200,1.00171135197
435824,435831,439297,7,3466,2,7200,1.00201961916
435825,435838,439438,13,3600,2,7200,1.00361111111
435827,435843,438996,16,3153,2,7200,1.00507453219
435842,435850,439368,8,3518,2,7200,1.00227401933
435857,435863,439290,6,3427,2,7200,1.00175080245
435858,435869,439251,11,3382,2,7200,1.00325251331
435876,435883,439020,7,3137,2,7200,1.0022314313
435891,435898,439519,7,3621,2,7200,1.00193316763
435918,435925,438821,7,2896,2,7200,1.00241712707
435933,435940,439539,7,3599,2,7200,1.00194498472
435934,435947,439131,13,3184,2,7200,1.00408291457
435949,435956,439213,7,3257,2,7200,1.00214921707
436224,436231,439732,7,3501,2,7200,1.00199942873
436239,436245,439634,6,3389,2,7200,1.00177043376
436509,436516,439736,7,3220,2,7200,1.00217391304
436523,436530,439745,7,3215,2,7200,1.00217729393
436565,436573,439883,8,3310,2,7200,1.00241691843
436589,436597,439905,8,3308,2,7200,1.00241837969
436801,436807,440109,6,3302,2,7200,1.00181708056
436970,436977,440355,7,3378,2,7200,1.00207223209
437151,437158,440488,7,3330,2,7200,1.0021021021
437408,437415,440862,7,3447,2,7200,1.00203075138
437514,437521,440816,7,3295,2,7200,1.00212443096
437595,437603,440584,8,2981,2,7200,1.0026836632
437620,437627,440667,7,3040,2,7200,1.00230263158
437816,437823,441190,7,3367,2,7200,1.00207900208
437894,437901,441197,7,3296,2,7200,1.00212378641
437922,437929,441223,7,3294,2,7200,1.0021250759
437967,437973,441359,6,3386,2,7200,1.00177200236
437982,437988,441618,6,3630,2,7200,1.00165289256
437999,438007,441241,8,3234,2,7200,1.00247371676
438063,438070,441493,7,3423,2,7200,1.00204498978
438077,438083,441419,6,3336,2,7200,1.00179856115
438125,438133,441396,8,3263,2,7200,1.00245173154
438159,438165,441578,6,3413,2,7200,1.00175798418
438174,438180,441634,6,3454,2,7200,1.00173711639
438188,438196,441750,8,3554,2,7200,1.00225098481
438221,438229,441466,8,3237,2,7200,1.00247142416
438318,438326,441800,8,3474,2,7200,1.00230282096
438333,438339,441822,6,3483,2,7200,1.00172265289
438348,438354,441636,6,3282,2,7200,1.00182815356
438396,438402,441720,6,3318,2,7200,1.00180831826
438420,438428,441594,8,3166,2,7200,1.00252684776
438422,438435,441704,13,3269,2,7200,1.0039767513
438476,438483,441734,7,3251,2,7200,1.00215318364
438477,438490,441908,13,3418,2,7200,1.0038033938
438523,438529,441762,6,3233,2,7200,1.00185586143
438553,438559,442046,6,3487,2,7200,1.0017206768
438619,438625,442150,6,3525,2,7200,1.00170212766
438652,438658,441963,6,3305,2,7200,1.00181543116
438691,438697,442100,6,3403,2,7200,1.00176315016
438706,438713,441932,7,3219,2,7200,1.00217458838
438721,438727,441915,6,3188,2,7200,1.00188205772
438736,438742,441990,6,3248,2,7200,1.00184729064
438737,438750,442445,13,3695,2,7200,1.00351826793
438739,438755,442186,16,3431,2,7200,1.00466336345
438754,438762,442207,8,3445,2,7200,1.0023222061
438768,438775,441958,7,3183,2,7200,1.00219918316
438783,438789,442248,6,3459,2,7200,1.00173460538
438786,438841,443727,55,4886,4,14400,1.01125665166
438804,438810,442367,6,3557,2,7200,1.00168681473
438822,438829,442490,7,3661,2,7200,1.00191204589
438837,438848,441951,11,3103,2,7200,1.00354495649
438867,438878,442134,11,3256,2,7200,1.00337837838
438915,438926,442103,11,3177,2,7200,1.0034623859
438931,438937,442239,6,3302,2,7200,1.00181708056
438932,438944,442088,12,3144,2,7200,1.00381679389
438999,439008,442594,9,3586,2,7200,1.00250976018
439013,439020,442596,7,3576,2,7200,1.00195749441
439028,439035,442504,7,3469,2,7200,1.00201787259
439043,439049,442387,6,3338,2,7200,1.00179748352
439131,439143,442667,12,3524,2,7200,1.00340522134
439213,439225,442525,12,3300,2,7200,1.00363636364
439240,439250,442488,10,3238,2,7200,1.00308832613
439255,439264,442382,9,3118,2,7200,1.00288646568
439282,439293,442774,11,3481,2,7200,1.00316001149
439297,439303,442736,6,3433,2,7200,1.0017477425
439298,439310,442938,12,3628,2,7200,1.0033076075
439323,439334,442485,11,3151,2,7200,1.00349095525
439368,439380,443001,12,3621,2,7200,1.00331400166
439440,439451,442812,11,3361,2,7200,1.00327283547
439519,439532,442761,13,3229,2,7200,1.00402601425
439540,439553,442922,13,3369,2,7200,1.00385871178
439636,439646,443158,10,3512,2,7200,1.00284738041
439733,439745,442842,12,3097,2,7200,1.00387471747
439748,439754,443107,6,3353,2,7200,1.00178944229
439750,439762,443080,12,3318,2,7200,1.00361663653
439886,439892,443307,6,3415,2,7200,1.00175695461
439907,439914,443190,7,3276,2,7200,1.00213675214
440110,440116,443522,6,3406,2,7200,1.00176159718
440288,440294,440296,6,2,2,3540,1.0
440362,440369,443942,7,3573,2,7200,1.00195913798
440489,440496,443666,7,3170,2,7200,1.00220820189
440585,440591,444183,6,3592,2,7200,1.00167037862
440667,440674,444149,7,3475,2,7200,1.00201438849
440773,440781,440918,8,137,1,900,1.05839416058
440796,440824,441728,28,904,14,1560,1.03097345133
440818,440831,444055,13,3224,2,7200,1.00403225806
440863,440870,444268,7,3398,2,7200,1.00206003531
441193,441199,444182,6,2983,2,7200,1.00201139792
441208,441214,444732,6,3518,2,7200,1.0017055145
441225,441232,444598,7,3366,2,7200,1.00207961973
441243,441250,444271,7,3021,2,7200,1.00231711354
441291,441297,441498,6,201,1,3600,1.02985074627
441361,441368,444496,7,3128,2,7200,1.00223785166
441398,441404,444755,6,3351,2,7200,1.0017905103
441422,441428,444708,6,3280,2,7200,1.00182926829
441468,441475,445094,7,3619,2,7200,1.00193423598
441495,441502,444586,7,3084,2,7200,1.00226977951
441580,441587,444929,7,3342,2,7200,1.00209455416
441595,441601,444996,6,3395,2,7200,1.00176730486
441618,441626,444978,8,3352,2,7200,1.00238663484
441637,441644,445129,7,3485,2,7200,1.00200860832
441638,441651,445100,13,3449,2,7200,1.00376920847
441689,441695,442050,6,355,1,3600,1.01690140845
441707,441715,445111,8,3396,2,7200,1.0023557126
441722,441728,445131,6,3403,2,7200,1.00176315016
441723,441735,441755,12,20,1,900,1.6
441737,441745,444979,8,3234,2,7200,1.00247371676
441743,464409,465622,22666,1213,14,1560,19.6859027205
441752,441759,445130,7,3371,2,7200,1.00207653515
441767,441773,445318,6,3545,2,7200,1.00169252468
441803,441810,445313,7,3503,2,7200,1.00199828718
441824,441830,445164,6,3334,2,7200,1.00179964007
441909,441916,445031,7,3115,2,7200,1.00224719101
441924,441931,445137,7,3206,2,7200,1.00218340611
441938,441946,445058,8,3112,2,7200,1.00257069409
441953,441960,445209,7,3249,2,7200,1.00215450908
441968,441975,445094,7,3119,2,7200,1.00224430907
441970,441982,445264,12,3282,2,7200,1.00365630713
441991,441998,445116,7,3118,2,7200,1.00224502886
442048,442055,445215,7,3160,2,7200,1.00221518987
442090,442096,445573,6,3477,2,7200,1.00172562554
442105,442112,445469,7,3357,2,7200,1.00208519511
442107,442119,445548,12,3429,2,7200,1.00349956255
442137,442143,445351,6,3208,2,7200,1.00187032419
442152,442158,445636,6,3478,2,7200,1.00172512938
442188,442194,445619,6,3425,2,7200,1.00175182482
442209,442216,445455,7,3239,2,7200,1.00216116085
442242,442249,445404,7,3155,2,7200,1.00221870048
442256,442263,445804,7,3541,2,7200,1.0019768427
442368,442374,445761,6,3387,2,7200,1.00177147919
442383,442390,445688,7,3298,2,7200,1.00212249848
442388,442397,443244,9,847,1,3600,1.0106257379
442398,442406,445660,8,3254,2,7200,1.0024585126
442446,442452,445616,6,3164,2,7200,1.00189633375
442486,442493,445979,7,3486,2,7200,1.00200803213
442500,442508,445846,8,3338,2,7200,1.0023966447
442502,442513,445916,11,3403,2,7200,1.00323244196
442517,442523,446070,6,3547,2,7200,1.00169157034
442531,442538,445841,7,3303,2,7200,1.0021192855
442595,442601,446231,6,3630,2,7200,1.00165289256
442610,442616,446273,6,3657,2,7200,1.00164068909
442667,442674,445965,7,3291,2,7200,1.00212701307
442737,442742,445986,5,3244,2,7200,1.00154130703
442764,442771,446331,7,3560,2,7200,1.00196629213
442778,442786,446448,8,3662,2,7200,1.00218459858
442812,442819,446277,7,3458,2,7200,1.0020242915
442842,442850,446276,8,3426,2,7200,1.00233508465
442924,442931,446494,7,3563,2,7200,1.00196463654
442939,442945,446267,6,3322,2,7200,1.00180614088
443002,443009,446213,7,3204,2,7200,1.00218476904
443081,443087,446391,6,3304,2,7200,1.00181598063
443108,443114,446676,6,3562,2,7200,1.00168444694
443159,443165,446574,6,3409,2,7200,1.00176004693
443192,443199,446552,7,3353,2,7200,1.00208768267
443308,443314,446542,6,3228,2,7200,1.00185873606
443509,443515,449154,6,5639,3,7200,1.00106401844
443523,443530,446810,7,3280,2,7200,1.00213414634
443667,443675,447110,8,3435,2,7200,1.00232896652
443735,443742,443748,7,6,1,72000,1.3
443855,443862,464614,7,20752,1,72000,1.00033731689
443946,443952,447318,6,3366,2,7200,1.00178253119
444054,444061,447449,7,3388,2,7200,1.0020661157
444076,444082,444087,6,5,1,72000,1.1
444151,444158,447796,7,3638,2,7200,1.00192413414
444185,444192,447705,7,3513,2,7200,1.00199259892
444186,444197,447524,11,3327,2,7200,1.00330628194
444271,444277,447544,6,3267,2,7200,1.00183654729
444273,444285,447579,12,3294,2,7200,1.00364298725
444295,444302,503262,7,58960,1,72000,1.00011872456
444497,444504,448006,7,3502,2,7200,1.0019988578
444498,444511,444645,13,134,1,3600,1.09701492537
444587,444595,447980,8,3385,2,7200,1.0023633678
444602,444609,447816,7,3207,2,7200,1.00218272529
444713,444720,447987,7,3267,2,7200,1.00214263851
444734,444740,448316,6,3576,2,7200,1.00167785235
444758,444764,448029,6,3265,2,7200,1.00183767228
444832,444838,445203,6,365,1,3600,1.01643835616
444930,444937,448353,7,3416,2,7200,1.00204918033
444974,444981,445158,7,177,1,3600,1.0395480226
444978,444988,448382,10,3394,2,7200,1.00294637596
444980,444993,448381,13,3388,2,7200,1.00383707202
444998,445004,448418,6,3414,2,7200,1.00175746924
445031,445037,448489,6,3452,2,7200,1.00173812283
445058,445065,448688,7,3623,2,7200,1.00193210047
445063,445072,445183,9,111,2,3600,1.08108108108
445094,445100,448653,6,3553,2,7200,1.00168871376
445096,445107,448565,11,3458,2,7200,1.0031810295
445111,445118,448371,7,3253,2,7200,1.00215185982
445112,445125,448473,13,3348,2,7200,1.00388291517
445127,445134,448465,7,3331,2,7200,1.00210147103
445142,445149,448385,7,3236,2,7200,1.0021631644
445144,445156,448507,12,3351,2,7200,1.00358102059
445145,445161,448435,16,3274,2,7200,1.00488698839
445146,445166,448498,20,3332,2,7200,1.00600240096
445164,445173,448222,9,3049,2,7200,1.00295178747
445210,445217,448506,7,3289,2,7200,1.00212830648
445225,445231,448915,6,3684,2,7200,1.0016286645
445264,445271,448640,7,3369,2,7200,1.00207776788
445315,445321,448540,6,3219,2,7200,1.0018639329
445330,445337,448535,7,3198,2,7200,1.00218886804
445337,445343,445698,6,355,1,3600,1.01690140845
445351,445359,448797,8,3438,2,7200,1.00232693426
445405,445411,448759,6,3348,2,7200,1.0017921147
445456,445464,449000,8,3536,2,7200,1.00226244344
445471,445477,448805,6,3328,2,7200,1.00180288462
445550,445557,448713,7,3156,2,7200,1.00221799747
445554,445564,445654,10,90,2,3600,1.11111111111
445574,445581,449139,7,3558,2,7200,1.00196739741
445616,445623,448975,7,3352,2,7200,1.00208830549
445631,445638,448827,7,3189,2,7200,1.00219504547
445646,445652,449004,6,3352,2,7200,1.00178997613
445661,445667,448754,6,3087,2,7200,1.0019436346
445667,445674,446310,7,636,1,3600,1.01100628931
445691,445698,449411,7,3713,2,7200,1.00188526798
445764,445770,448980,6,3210,2,7200,1.00186915888
445803,445809,449269,6,3460,2,7200,1.00173410405
445842,445849,449324,7,3475,2,7200,1.00201438849
445857,445863,449181,6,3318,2,7200,1.00180831826
445917,445924,449150,7,3226,2,7200,1.00216986981
445966,445972,449113,6,3141,2,7200,1.00191021968
445981,445987,449358,6,3371,2,7200,1.00177988727
445995,446002,449548,7,3546,2,7200,1.00197405527
446066,446073,446945,7,872,1,3600,1.00802752294
446071,446079,449194,8,3115,2,7200,1.0025682183
446213,446220,449632,7,3412,2,7200,1.00205158265
446231,446237,449770,6,3533,2,7200,1.00169827342
446267,446275,449612,8,3337,2,7200,1.0023973629
446283,446290,449431,7,3141,2,7200,1.00222858962
446284,446297,449403,13,3106,2,7200,1.00418544752
446285,446302,449842,17,3540,2,7200,1.00480225989
446286,446320,446543,34,223,2,3600,1.15246636771
446337,446343,449634,6,3291,2,7200,1.00182315406
446392,446398,449782,6,3384,2,7200,1.00177304965
446449,446455,449817,6,3362,2,7200,1.00178465199
446495,446502,450062,7,3560,2,7200,1.00196629213
446543,446550,450215,7,3665,2,7200,1.00190995907
446558,446564,449944,6,3380,2,7200,1.00177514793
446576,446582,449900,6,3318,2,7200,1.00180831826
446675,446682,449770,7,3088,2,7200,1.00226683938
446811,446819,450296,8,3477,2,7200,1.00230083405
447116,447124,450358,8,3234,2,7200,1.00247371676
447249,447256,447394,7,138,1,14400,1.05072463768
447319,447326,450557,7,3231,2,7200,1.00216651192
447452,447459,450776,7,3317,2,7200,1.00211034067
447524,447532,450917,8,3385,2,7200,1.0023633678
447542,447549,450822,7,3273,2,7200,1.00213871066
447581,447588,450974,7,3386,2,7200,1.00206733609
447709,447715,451205,6,3490,2,7200,1.00171919771
447796,447803,451149,7,3346,2,7200,1.00209205021
447817,447824,451067,7,3243,2,7200,1.00215849522
447869,447876,447956,7,80,2,3600,1.0875
447982,447989,451332,7,3343,2,7200,1.00209392761
447997,448004,451088,7,3084,2,7200,1.00226977951
448012,448020,451530,8,3510,2,7200,1.00227920228
448030,448038,451265,8,3227,2,7200,1.00247908274
448038,448045,462292,7,14247,1,14400,1.00049133151
448100,448106,448184,6,78,2,3600,1.07692307692
448221,448228,451442,7,3214,2,7200,1.00217797138
448229,448242,448358,13,116,1,3600,1.11206896552
448230,448237,448307,7,70,2,3600,1.1
448319,448326,451619,7,3293,2,7200,1.00212572123
448355,448361,451758,6,3397,2,7200,1.00176626435
448373,448379,451580,6,3201,2,7200,1.00187441425
448388,448395,451801,7,3406,2,7200,1.00205519671
448389,448402,452025,13,3623,2,7200,1.00358818659
448391,448407,451601,16,3194,2,7200,1.00500939261
448421,448427,451754,6,3327,2,7200,1.00180342651
448436,448442,451677,6,3235,2,7200,1.00185471406
448466,448473,451641,7,3168,2,7200,1.00220959596
448481,448487,451757,6,3270,2,7200,1.00183486239
448496,448503,451797,7,3294,2,7200,1.0021250759
448512,448518,451678,6,3160,2,7200,1.00189873418
448513,448525,451934,12,3409,2,7200,1.00352009387
448514,448530,452050,16,3520,2,7200,1.00454545455
448535,448541,451550,6,3009,2,7200,1.00199401795
448546,448554,448882,8,328,1,3600,1.0243902439
448550,448561,452045,11,3484,2,7200,1.00315729047
448568,448575,452026,7,3451,2,7200,1.00202839757
448595,448602,448715,7,113,1,1800,1.06194690265
448640,448647,452190,7,3543,2,7200,1.00197572679
448655,448661,451898,6,3237,2,7200,1.00185356812
448688,448696,452255,8,3559,2,7200,1.00224782242
448715,448726,452191,11,3465,2,7200,1.00317460317
448755,448762,452030,7,3268,2,7200,1.00214198286
448770,448776,452135,6,3359,2,7200,1.00178624591
448800,448806,452012,6,3206,2,7200,1.00187149095
448815,448822,452163,7,3341,2,7200,1.00209518108
448830,448836,452130,6,3294,2,7200,1.00182149362
448915,448923,452599,8,3676,2,7200,1.00217627856
448976,448983,452187,7,3204,2,7200,1.00218476904
448991,448997,452496,6,3499,2,7200,1.00171477565
449006,449013,452370,7,3357,2,7200,1.00208519511
449007,449020,452479,13,3459,2,7200,1.00375831165
449026,449033,449212,7,179,1,1800,1.03910614525
449114,449121,452250,7,3129,2,7200,1.00223713647
449141,449148,452632,7,3484,2,7200,1.00200918485
449156,449162,452505,6,3343,2,7200,1.00179479509
449183,449189,452500,6,3311,2,7200,1.00181214135
449198,449205,452594,7,3389,2,7200,1.00206550605
449272,449279,452589,7,3310,2,7200,1.00211480363
449318,449324,452036,6,2712,4,14400,1.00221238938
449326,449333,452944,7,3611,2,7200,1.00193852119
449359,449366,452767,7,3401,2,7200,1.00205821817
449399,449419,450044,20,625,1,3600,1.032
449405,449412,452592,7,3180,2,7200,1.00220125786
449419,449426,452659,7,3233,2,7200,1.00216517167
449434,449441,452627,7,3186,2,7200,1.00219711237
449549,449555,452904,6,3349,2,7200,1.00179157958
449613,449619,452700,6,3081,2,7200,1.00194741967
449634,449640,453128,6,3488,2,7200,1.00172018349
449635,449648,452967,13,3319,2,7200,1.00391684242
449771,449779,453097,8,3318,2,7200,1.00241109102
449773,449784,453091,11,3307,2,7200,1.00332627759
449788,449794,453240,6,3446,2,7200,1.00174114916
449818,449825,453025,7,3200,2,7200,1.0021875
449845,449851,453084,6,3233,2,7200,1.00185586143
449902,449908,453144,6,3236,2,7200,1.00185414091
449928,449934,450532,6,598,1,1800,1.01003344482
449944,449950,453137,6,3187,2,7200,1.00188264826
450066,450073,453500,7,3427,2,7200,1.00204260286
450217,450224,453703,7,3479,2,7200,1.00201207243
450298,450306,453661,8,3355,2,7200,1.00238450075
450359,450365,453530,6,3165,2,7200,1.0018957346
450555,450562,453857,7,3295,2,7200,1.00212443096
450777,450785,454390,8,3605,2,7200,1.00221914008
450823,450829,453942,6,3113,2,7200,1.00192740122
450917,450923,454358,6,3435,2,7200,1.00174672489
450974,450981,454509,7,3528,2,7200,1.00198412698
451067,451073,454538,6,3465,2,7200,1.00173160173
451088,451095,454445,7,3350,2,7200,1.00208955224
451151,451158,454656,7,3498,2,7200,1.00200114351
451206,451212,454566,6,3354,2,7200,1.00178890877
451266,451273,454435,7,3162,2,7200,1.00221378874
451332,451340,454773,8,3433,2,7200,1.00233032333
451444,451451,455012,7,3561,2,7200,1.00196573996
451532,451538,455075,6,3537,2,7200,1.00169635284
451550,451556,454767,6,3211,2,7200,1.00186857677
451580,451586,454891,6,3305,2,7200,1.00181543116
451601,451607,455049,6,3442,2,7200,1.00174317257
451622,451629,455026,7,3397,2,7200,1.00206064174
451643,451649,454994,6,3345,2,7200,1.00179372197
451676,451683,455109,7,3426,2,7200,1.00204319907
451678,451690,455085,12,3395,2,7200,1.00353460972
451754,451760,455056,6,3296,2,7200,1.00182038835
451755,451767,455111,12,3344,2,7200,1.00358851675
451756,451772,454998,16,3226,2,7200,1.00495970242
451799,451806,455430,7,3624,2,7200,1.00193156733
451891,451897,455340,6,3443,2,7200,1.00174266628
451906,451912,455314,6,3402,2,7200,1.00176366843
451933,451939,455267,6,3328,2,7200,1.00180288462
452012,452018,455063,6,3045,2,7200,1.00197044335
452027,452033,455177,6,3144,2,7200,1.00190839695
452028,452041,455258,13,3217,2,7200,1.00404103202
452043,452049,455399,6,3350,2,7200,1.00179104478
452058,452064,455451,6,3387,2,7200,1.00177147919
452059,452070,455413,11,3343,2,7200,1.00329045767
452104,452111,460856,7,8745,4,86400,1.0008004574
452129,452135,455219,6,3084,2,7200,1.00194552529
452144,452150,455512,6,3362,2,7200,1.00178465199
452165,452172,455397,7,3225,2,7200,1.00217054264
452190,452196,455250,6,3054,2,7200,1.00196463654
452191,452204,455763,13,3559,2,7200,1.00365271144
452206,452212,455569,6,3357,2,7200,1.0017873101
452252,452259,455614,7,3355,2,7200,1.00208643815
452267,452273,455629,6,3356,2,7200,1.00178784267
452376,452383,455489,7,3106,2,7200,1.00225370251
452482,452488,455904,6,3416,2,7200,1.00175644028
452497,452503,456062,6,3559,2,7200,1.00168586682
452512,452519,456082,7,3563,2,7200,1.00196463654
452513,452524,455815,11,3291,2,7200,1.0033424491
452589,452596,455750,7,3154,2,7200,1.00221940393
452604,452611,455807,7,3196,2,7200,1.0021902378
452605,452618,455991,13,3373,2,7200,1.00385413578
452607,452623,455817,16,3194,2,7200,1.00500939261
452628,452635,455936,7,3301,2,7200,1.00212056952
452643,452649,455910,6,3261,2,7200,1.0018399264
452652,452660,452712,8,52,1,1800,1.15384615385
452661,452668,455978,7,3310,2,7200,1.00211480363
452700,452706,455876,6,3170,2,7200,1.00189274448
452731,452738,452865,7,127,1,1800,1.05511811024
452767,452773,456166,6,3393,2,7200,1.0017683466
452907,452915,456153,8,3238,2,7200,1.0024706609
452947,452953,456497,6,3544,2,7200,1.00169300226
452967,452975,456297,8,3322,2,7200,1.00240818784
453028,453035,456634,7,3599,2,7200,1.00194498472
453031,453042,453115,11,73,1,1800,1.15068493151
453085,453092,456483,7,3391,2,7200,1.00206428782
453100,453106,456404,6,3298,2,7200,1.00181928441
453101,453114,456632,13,3518,2,7200,1.00369528141
453129,453136,456448,7,3312,2,7200,1.00211352657
453144,453151,456377,7,3226,2,7200,1.00216986981
453146,453159,456505,13,3346,2,7200,1.0038852361
453189,453195,453309,6,114,1,1800,1.05263157895
453243,453249,456620,6,3371,2,7200,1.00177988727
453504,453511,456769,7,3258,2,7200,1.0021485574
453531,453537,456664,6,3127,2,7200,1.00191877199
453661,453667,457108,6,3441,2,7200,1.00174367916
453704,453710,457143,6,3433,2,7200,1.0017477425
453858,453865,457199,7,3334,2,7200,1.00209958008
453942,453948,457289,6,3341,2,7200,1.0017958695
454041,454048,454650,7,602,1,1800,1.01162790698
454075,454081,454419,6,338,1,1800,1.01775147929
454359,454367,457606,8,3239,2,7200,1.00246989812
454393,454399,457710,6,3311,2,7200,1.00181214135
454437,454443,457780,6,3337,2,7200,1.00179802218
454452,454458,457612,6,3154,2,7200,1.00190234623
454510,454517,457868,7,3351,2,7200,1.00208892868
454540,454546,458037,6,3491,2,7200,1.00171870524
454567,454574,457781,7,3207,2,7200,1.00218272529
454659,454665,458010,6,3345,2,7200,1.00179372197
454769,454776,458098,7,3322,2,7200,1.00210716436
454784,454791,458104,7,3313,2,7200,1.00211288862
454893,454899,458225,6,3326,2,7200,1.00180396873
454996,455003,458444,7,3441,2,7200,1.00203429236
454997,455010,458367,13,3357,2,7200,1.00387250521
455012,455019,458290,7,3271,2,7200,1.00214001834
455027,455033,458287,6,3254,2,7200,1.00184388445
455051,455058,458164,7,3106,2,7200,1.00225370251
455066,455073,458496,7,3423,2,7200,1.00204498978
455068,455081,458288,13,3207,2,7200,1.00405363268
455083,455090,458126,7,3036,2,7200,1.00230566535
455098,455105,458482,7,3377,2,7200,1.00207284572
455113,455120,458629,7,3509,2,7200,1.00199487033
455114,455127,458457,13,3330,2,7200,1.0039039039
455177,455185,458552,8,3367,2,7200,1.00237600238
455220,455226,458489,6,3263,2,7200,1.00183879865
455250,455256,458775,6,3519,2,7200,1.00170502984
455265,455273,458441,8,3168,2,7200,1.00252525253
455280,455286,458544,6,3258,2,7200,1.00184162063
455313,455320,458553,7,3233,2,7200,1.00216517167
455340,455346,458412,6,3066,2,7200,1.00195694716
455398,455405,458541,7,3136,2,7200,1.00223214286
455413,455419,458732,6,3313,2,7200,1.00181104739
455415,455427,458886,12,3459,2,7200,1.00346921075
455430,455436,459012,6,3576,2,7200,1.00167785235
455451,455458,458728,7,3270,2,7200,1.00214067278
455490,455496,458963,6,3467,2,7200,1.00173060283
455514,455520,458711,6,3191,2,7200,1.00188028831
455571,455578,458892,7,3314,2,7200,1.00211225106
455617,455623,458845,6,3222,2,7200,1.00186219739
455632,455638,459042,6,3404,2,7200,1.0017626322
455750,455756,459103,6,3347,2,7200,1.00179265013
455765,455771,459123,6,3352,2,7200,1.00178997613
455807,455814,459273,7,3459,2,7200,1.00202370627
455822,455829,459285,7,3456,2,7200,1.00202546296
455824,455837,459281,13,3444,2,7200,1.0037746806
455878,455884,459365,6,3481,2,7200,1.00172364263
455905,455913,459229,8,3316,2,7200,1.00241254524
455920,455926,459261,6,3335,2,7200,1.00179910045
455938,455944,459242,6,3298,2,7200,1.00181928441
455980,455987,459338,7,3351,2,7200,1.00208892868
455995,456003,459145,8,3142,2,7200,1.00254614895
456065,456072,459254,7,3182,2,7200,1.00219987429
456083,456090,459456,7,3366,2,7200,1.00207961973
456153,456159,459582,6,3423,2,7200,1.00175284838
456168,456174,459827,6,3653,2,7200,1.00164248563
456297,456303,459782,6,3479,2,7200,1.00172463352
456379,456387,459962,8,3575,2,7200,1.00223776224
456404,456411,459857,7,3446,2,7200,1.00203134068
456449,456456,459577,7,3121,2,7200,1.00224287087
456477,456483,456534,6,51,1,1800,1.11764705882
456486,456493,459726,7,3233,2,7200,1.00216517167
456501,456508,459960,7,3452,2,7200,1.00202780997
456515,456523,460041,8,3518,2,7200,1.00227401933
456622,456628,459763,6,3135,2,7200,1.0019138756
456637,456644,459899,7,3255,2,7200,1.00215053763
456638,456651,459840,13,3189,2,7200,1.00407651301
456665,456672,459908,7,3236,2,7200,1.0021631644
456768,456775,460043,7,3268,2,7200,1.00214198286
456874,456880,456959,6,79,1,1800,1.07594936709
457107,457113,460458,6,3345,2,7200,1.00179372197
457144,457151,460452,7,3301,2,7200,1.00212056952
457201,457207,460781,6,3574,2,7200,1.00167879127
457288,457296,460410,8,3114,2,7200,1.00256904303
457605,457612,461044,7,3432,2,7200,1.00203962704
457620,457627,460872,7,3245,2,7200,1.00215716487
457711,457717,460971,6,3254,2,7200,1.00184388445
457780,457786,461283,6,3497,2,7200,1.00171575636
457782,457793,460947,11,3154,2,7200,1.00348763475
457869,457876,461258,7,3382,2,7200,1.00206978119
457981,457988,458286,7,298,1,1800,1.02348993289
458011,458017,461465,6,3448,2,7200,1.00174013921
458038,458045,461347,7,3302,2,7200,1.00211992732
458099,458105,461590,6,3485,2,7200,1.00172166428
458113,458120,461719,7,3599,2,7200,1.00194498472
458128,458135,461551,7,3416,2,7200,1.00204918033
458165,458172,461290,7,3118,2,7200,1.00224502886
458225,458232,461386,7,3154,2,7200,1.00221940393
458289,458296,461759,7,3463,2,7200,1.00202136876
458290,458303,461505,13,3202,2,7200,1.00405996252
458305,458312,461625,7,3313,2,7200,1.00211288862
458369,458376,461776,7,3400,2,7200,1.00205882353
458414,458421,461552,7,3131,2,7200,1.00223570744
458444,458451,461725,7,3274,2,7200,1.00213805742
458445,458458,461698,13,3240,2,7200,1.00401234568
458460,458467,461883,7,3416,2,7200,1.00204918033
458481,458489,461863,8,3374,2,7200,1.00237107291
458497,458503,461554,6,3051,2,7200,1.00196656834
458498,458510,461988,12,3478,2,7200,1.00345025877
458540,458547,461807,7,3260,2,7200,1.00214723926
458556,458562,461771,6,3209,2,7200,1.00186974135
458557,458569,461964,12,3395,2,7200,1.00353460972
458558,458574,462234,16,3660,2,7200,1.0043715847
458628,458635,461857,7,3222,2,7200,1.00217256363
458713,458720,462105,7,3385,2,7200,1.00206794682
458728,458734,462318,6,3584,2,7200,1.00167410714
458743,458749,462139,6,3390,2,7200,1.0017699115
458776,458783,462073,7,3290,2,7200,1.00212765957
458848,458855,462009,7,3154,2,7200,1.00221940393
458887,458894,462354,7,3460,2,7200,1.00202312139
458902,458908,462327,6,3419,2,7200,1.00175489909
458963,458970,462093,7,3123,2,7200,1.00224143452
459014,459021,462378,7,3357,2,7200,1.00208519511
459044,459051,462536,7,3485,2,7200,1.00200860832
459105,459112,462435,7,3323,2,7200,1.00210653024
459126,459132,462409,6,3277,2,7200,1.00183094294
459147,459153,462424,6,3271,2,7200,1.00183430144
459231,459238,462456,7,3218,2,7200,1.00217526414
459246,459252,462553,6,3301,2,7200,1.00181763102
459261,459268,462512,7,3244,2,7200,1.00215782984
459263,459275,462685,12,3410,2,7200,1.00351906158
459278,459285,462555,7,3270,2,7200,1.00214067278
459293,459300,462273,7,2973,2,7200,1.00235452405
459295,459307,463035,12,3728,2,7200,1.00321888412
459340,459347,462706,7,3359,2,7200,1.00208395356
459364,459371,462411,7,3040,2,7200,1.00230263158
459458,459465,462608,7,3143,2,7200,1.00222717149
459578,459586,463006,8,3420,2,7200,1.00233918129
459593,459599,463045,6,3446,2,7200,1.00174114916
459729,459736,463221,7,3485,2,7200,1.00200860832
459762,459768,463222,6,3454,2,7200,1.00173711639
459783,459790,463328,7,3538,2,7200,1.00197851894
459828,459835,463285,7,3450,2,7200,1.00202898551
459843,459849,463181,6,3332,2,7200,1.00180072029
459858,459865,463147,7,3282,2,7200,1.00213284583
459901,459908,463193,7,3285,2,7200,1.00213089802
459916,459922,463371,6,3449,2,7200,1.00173963468
459961,459969,463257,8,3288,2,7200,1.00243309002
459963,459976,463149,13,3173,2,7200,1.00409706902
460041,460047,463401,6,3354,2,7200,1.00178890877
460056,460063,463520,7,3457,2,7200,1.00202487706
460266,460273,526896,7,66623,2,180000,1.00010506882
460290,460298,820317,8,360019,2,360000,1.00002222105
460411,460418,463811,7,3393,2,7200,1.00206307103
460454,460460,463778,6,3318,2,7200,1.00180831826
460468,460474,463750,6,3276,2,7200,1.00183150183
460782,460788,464253,6,3465,2,7200,1.00173160173
460874,460880,463974,6,3094,2,7200,1.00193923723
460950,460956,464167,6,3211,2,7200,1.00186857677
460974,460980,464277,6,3297,2,7200,1.00181983621
461001,461018,569051,17,108033,1,108000,1.00015735933
461001,461007,569040,6,108033,1,108000,1.00005553859
461001,461013,569057,12,108044,1,108000,1.00011106586
461046,461053,464597,7,3544,2,7200,1.0019751693
461257,461263,464464,6,3201,2,7200,1.00187441425
461284,461292,464754,8,3462,2,7200,1.002310803
461299,461305,464578,6,3273,2,7200,1.00183318057
461348,461355,464852,7,3497,2,7200,1.00200171576
461387,461394,464485,7,3091,2,7200,1.00226463928
461466,461473,464555,7,3082,2,7200,1.00227125243
461505,461511,464791,6,3280,2,7200,1.00182926829
461554,461561,464632,7,3071,2,7200,1.00227938782
461555,461568,464856,13,3288,2,7200,1.00395377129
461570,461577,464872,7,3295,2,7200,1.00212443096
461591,461598,464972,7,3374,2,7200,1.0020746888
461625,461632,464721,7,3089,2,7200,1.00226610554
461700,461706,464725,6,3019,2,7200,1.00198741305
461721,461728,465079,7,3351,2,7200,1.00208892868
461736,461742,465031,6,3289,2,7200,1.00182426269
461760,461767,465046,7,3279,2,7200,1.00213479719
461775,461782,465243,7,3461,2,7200,1.00202253684
461776,461789,465222,13,3433,2,7200,1.00378677542
461783,461794,462681,11,887,1,7200,1.01240135287
461807,461813,465159,6,3346,2,7200,1.00179318589
461858,461864,464969,6,3105,2,7200,1.00193236715
461873,461880,465424,7,3544,2,7200,1.0019751693
461888,461894,465103,6,3209,2,7200,1.00186974135
461967,461974,465259,7,3285,2,7200,1.00213089802
461991,461998,465415,7,3417,2,7200,1.00204858063
462009,462016,465076,7,3060,2,7200,1.0022875817
462072,462080,465389,8,3309,2,7200,1.00241764884
462094,462101,465416,7,3315,2,7200,1.00211161388
462109,462116,465407,7,3291,2,7200,1.00212701307
462139,462145,465311,6,3166,2,7200,1.00189513582
462236,462243,465206,7,2963,2,7200,1.00236247047
462275,462281,465564,6,3283,2,7200,1.00182759671
462320,462327,465697,7,3370,2,7200,1.00207715134
462323,462334,462513,11,179,2,3600,1.06145251397
462335,462343,465739,8,3396,2,7200,1.0023557126
462356,462363,465612,7,3249,2,7200,1.00215450908
462380,462386,465816,6,3430,2,7200,1.00174927114
462404,462411,465335,7,2924,2,72000,1.00239398085
462411,462418,465846,7,3428,2,7200,1.002042007
462412,462425,466065,13,3640,2,7200,1.00357142857
462427,462434,465738,7,3304,2,7200,1.00211864407
462442,462450,465837,8,3387,2,7200,1.00236197225
462457,462463,465684,6,3221,2,7200,1.00186277554
462511,462517,465641,6,3124,2,7200,1.0019206146
462538,462544,465810,6,3266,2,7200,1.00183710961
462553,462560,466020,7,3460,2,7200,1.00202312139
462568,462574,466119,6,3545,2,7200,1.00169252468
462608,462614,465861,6,3247,2,7200,1.00184785956
462686,462693,465990,7,3297,2,7200,1.00212314225
462707,462713,466189,6,3476,2,7200,1.00172612198
462956,462963,463829,7,866,2,3600,1.00808314088
463002,463021,463769,19,748,1,14400,1.02540106952
463007,463013,466407,6,3394,2,7200,1.00176782557
463037,463044,466267,7,3223,2,7200,1.00217188954
463038,463051,464588,13,1537,2,18000,1.00845803513
463052,463059,466095,7,3036,2,7200,1.00230566535
463149,463156,466424,7,3268,2,7200,1.00214198286
463151,463162,466233,11,3071,2,7200,1.00358189515
463181,463188,466726,7,3538,2,7200,1.00197851894
463196,463202,466693,6,3491,2,7200,1.00171870524
463223,463230,466420,7,3190,2,7200,1.00219435737
463224,463237,466653,13,3416,2,7200,1.00380562061
463258,463265,466642,7,3377,2,7200,1.00207284572
463288,463295,466610,7,3315,2,7200,1.00211161388
463324,463331,466839,7,3508,2,7200,1.001995439
463373,463379,466751,6,3372,2,7200,1.00177935943
463403,463410,466691,7,3281,2,7200,1.00213349589
463521,463527,466610,6,3083,2,7200,1.00194615634
463627,463634,465208,7,1574,2,18000,1.00444726811
463751,463758,467076,7,3318,2,7200,1.00210970464
463781,463788,467122,7,3334,2,7200,1.00209958008
463811,463818,467220,7,3402,2,7200,1.00205761317
463872,463878,464538,6,660,1,14400,1.00909090909
463975,463982,467295,7,3313,2,7200,1.00211288862
464168,464176,467406,8,3230,2,7200,1.00247678019
464253,464260,467640,7,3380,2,7200,1.00207100592
464280,464286,467926,6,3640,2,7200,1.00164835165
464336,464343,464517,7,174,2,3600,1.04022988506
464463,464470,467795,7,3325,2,7200,1.00210526316
464487,464493,467764,6,3271,2,7200,1.00183430144
464556,464562,467883,6,3321,2,7200,1.00180668473
464580,464586,468058,6,3472,2,7200,1.0017281106
464598,464605,468051,7,3446,2,7200,1.00203134068
464605,464612,464833,7,221,1,3600,1.03167420814
464634,464640,468094,6,3454,2,7200,1.00173711639
464705,464711,464945,6,234,16,324000,1.02564102564
464722,464728,468391,6,3663,2,7200,1.00163800164
464736,464744,468173,8,3429,2,7200,1.0023330417
464754,464761,468069,7,3308,2,7200,1.00211608222
464791,464798,467992,7,3194,2,7200,1.00219160927
464854,464861,468103,7,3242,2,7200,1.00215916101
464869,464877,468248,8,3371,2,7200,1.00237318303
464885,464892,468245,7,3353,2,7200,1.00208768267
464969,464976,468458,7,3482,2,7200,1.00201033889
464984,464991,468210,7,3219,2,7200,1.00217458838
464995,465002,516117,7,51115,1,60010,1.0001369461
465033,465039,468438,6,3399,2,7200,1.00176522507
465048,465054,468372,6,3318,2,7200,1.00180831826
465078,465084,468350,6,3266,2,7200,1.00183710961
465081,465092,478277,11,13185,4,24010,1.00083428138
465093,465100,468455,7,3355,2,7200,1.00208643815
465108,465115,468544,7,3429,2,7200,1.00204141149
465163,465170,468686,7,3516,2,7200,1.00199089875
465208,465214,468812,6,3598,2,7200,1.00166759311
465223,465231,468501,8,3270,2,7200,1.00244648318
465225,465672,470420,447,4748,16,7210,1.09414490312
465245,465251,468340,6,3089,2,7200,1.00194237617
465259,465266,468537,7,3271,2,7200,1.00214001834
465295,486689,488449,21394,1760,64,5410,13.1556818182
465314,465321,468614,7,3293,2,7200,1.00212572123
465390,465396,468696,6,3300,2,7200,1.00181818182
465408,465415,468798,7,3383,2,7200,1.00206916938
465423,465429,468866,6,3437,2,7200,1.00174570847
465424,465437,468822,13,3385,2,7200,1.00384047267
465439,465445,469123,6,3678,2,7200,1.00163132137
465532,465539,467579,7,2040,4,86400,1.00343137255
465566,465573,468818,7,3245,2,7200,1.00215716487
465614,465621,468797,7,3176,2,7200,1.00220403023
465620,465628,465639,8,11,1,900,1.72727272727
465628,465635,465660,7,25,14,1560,1.28
465641,465647,469207,6,3560,2,7200,1.00168539326
465684,465691,469001,7,3310,2,7200,1.00211480363
465698,465706,468886,8,3180,2,7200,1.00251572327
465741,465747,468995,6,3248,2,7200,1.00184729064
465742,465755,469099,13,3344,2,7200,1.00388755981
465776,465862,476603,86,10741,16,324000,1.00800670329
465812,465819,468976,7,3157,2,7200,1.0022172949
465827,465833,468881,6,3048,2,7200,1.00196850394
465842,465848,469061,6,3213,2,7200,1.00186741363
465856,465869,469356,13,3487,2,7200,1.00372813307
465871,465878,469338,7,3460,2,7200,1.00202312139
465992,465999,469520,7,3521,2,7200,1.00198807157
466022,466029,469243,7,3214,2,7200,1.00217797138
466068,466074,469316,6,3242,2,7200,1.00185070944
466095,466101,469350,6,3249,2,7200,1.00184672207
466122,466128,469331,6,3203,2,7200,1.00187324383
466191,466198,469432,7,3234,2,7200,1.00216450216
466234,466241,469547,7,3306,2,7200,1.00211736237
466239,466248,466623,9,375,1,1560,1.024
466267,466273,469627,6,3354,2,7200,1.00178890877
466409,466416,469644,7,3228,2,7200,1.0021685254
466424,466432,469815,8,3383,2,7200,1.002364765
466426,466439,469799,13,3360,2,7200,1.00386904762
466608,466614,470031,6,3417,2,7200,1.00175592625
466623,466629,470010,6,3381,2,7200,1.00177462289
466644,466650,469831,6,3181,2,7200,1.00188619931
466659,466665,469699,6,3034,2,7200,1.00197758734
466692,466699,470122,7,3423,2,7200,1.00204498978
466707,466714,470106,7,3392,2,7200,1.00206367925
466728,466734,470183,6,3449,2,7200,1.00173963468
466752,466759,469927,7,3168,2,7200,1.00220959596
466842,466850,470010,8,3160,2,7200,1.00253164557
466915,470433,470853,3518,420,14,1560,9.37619047619
467080,467086,470441,6,3355,2,7200,1.00178837556
467098,467136,468669,38,1533,2,180000,1.02478799739
467123,467129,470476,6,3347,2,7200,1.00179265013
467223,467230,470497,7,3267,2,7200,1.00214263851
467297,467304,470715,7,3411,2,7200,1.00205218411
467409,467415,470887,6,3472,2,7200,1.0017281106
467643,467650,471420,7,3770,2,7200,1.00185676393
467748,467755,471468,7,3713,1,3600,1.00188526798
467771,467778,470904,7,3126,2,7200,1.00223928343
467799,467806,471058,7,3252,2,7200,1.00215252153
467886,467893,471118,7,3225,2,7200,1.00217054264
467926,467933,471296,7,3363,2,7200,1.00208147487
467993,468000,471345,7,3345,2,7200,1.00209267564
468053,468059,471293,6,3234,2,7200,1.00185528757
468068,468075,471476,7,3401,2,7200,1.00205821817
468070,468082,471149,12,3067,2,7200,1.00391261819
468094,468101,471600,7,3499,2,7200,1.00200057159
468097,468108,469330,11,1222,1,2700,1.00900163666
468109,468117,471292,8,3175,2,7200,1.00251968504
468136,468143,732818,7,264675,2,345600,1.00002644753
468158,468164,468383,6,219,1,14400,1.02739726027
468175,468182,471476,7,3294,2,7200,1.0021250759
468211,468218,471354,7,3136,2,7200,1.00223214286
468247,468254,471461,7,3207,2,7200,1.00218272529
468262,468268,471473,6,3205,2,7200,1.00187207488
468341,468348,471685,7,3337,2,7200,1.00209769254
468356,468362,471803,6,3441,2,7200,1.00174367916
468374,468381,471725,7,3344,2,7200,1.00209330144
468391,468398,468652,7,254,4,86400,1.02755905512
468392,468403,471654,11,3251,2,7200,1.00338357428
468440,468446,471790,6,3344,2,7200,1.00179425837
468455,468462,471811,7,3349,2,7200,1.00209017617
468470,468477,471642,7,3165,2,7200,1.00221169036
468503,468510,471674,7,3164,2,7200,1.00221238938
468539,468545,471975,6,3430,2,7200,1.00174927114
468554,468560,471975,6,3415,2,7200,1.00175695461
468614,468621,471916,7,3295,2,7200,1.00212443096
468687,468693,471766,6,3073,2,7200,1.00195248942
468702,468708,472169,6,3461,2,7200,1.001733603
468799,468806,472320,7,3514,2,7200,1.00199203187
468800,468813,472027,13,3214,2,7200,1.00404480398
468815,468821,472267,6,3446,2,7200,1.00174114916
468830,468836,472108,6,3272,2,7200,1.00183374083
468832,468842,472244,10,3402,2,7200,1.00293944738
468868,468874,472270,6,3396,2,7200,1.00176678445
468883,468889,472153,6,3264,2,7200,1.00183823529
468898,468905,472252,7,3347,2,7200,1.00209142516
468976,468983,472153,7,3170,2,7200,1.00220820189
468979,468990,541005,11,72015,2,72000,1.00015274596
468994,469001,472331,7,3330,2,7200,1.0021021021
469009,469017,472460,8,3443,2,7200,1.00232355504
469048,469350,470796,302,1446,4,86400,1.20885200553
469061,469068,472476,7,3408,2,7200,1.00205399061
469100,469106,472478,6,3372,2,7200,1.00177935943
469124,469131,472290,7,3159,2,7200,1.0022158911
469206,469213,472650,7,3437,2,7200,1.00203665988
469245,469252,472558,7,3306,2,7200,1.00211736237
469317,469323,472670,6,3347,2,7200,1.00179265013
469332,469340,472826,8,3486,2,7200,1.00229489386
469347,469356,472635,9,3279,2,7200,1.00274473925
469362,469369,472812,7,3443,2,7200,1.00203311066
469364,469375,472758,11,3383,2,7200,1.00325155188
469433,469441,473053,8,3612,2,7200,1.00221483942
469518,469525,472953,7,3428,2,7200,1.002042007
469548,469555,472659,7,3104,2,7200,1.00225515464
469630,469637,473035,7,3398,2,7200,1.00206003531
469645,469651,472970,6,3319,2,7200,1.00180777343
469702,469708,472994,6,3286,2,7200,1.00182592818
469783,469790,470532,7,742,2,18000,1.00943396226
469798,469805,472891,7,3086,2,7200,1.00226830849
469816,469823,473292,7,3469,2,7200,1.00201787259
469831,469839,473382,8,3543,2,7200,1.00225797347
469928,469935,473277,7,3342,2,7200,1.00209455416
470010,470017,473197,7,3180,2,7200,1.00220125786
470011,470024,473352,13,3328,2,7200,1.00390625
470032,470040,473285,8,3245,2,7200,1.00246533128
470034,470809,480151,775,9342,6,108000,1.08295868122
470108,470114,473301,6,3187,2,7200,1.00188264826
470123,470129,473491,6,3362,2,7200,1.00178465199
470183,470189,473420,6,3231,2,7200,1.00185701021
470444,470450,473632,6,3182,2,7200,1.00188560654
470477,470483,473967,6,3484,2,7200,1.00172215844
470498,470504,473918,6,3414,2,7200,1.00175746924
470716,470723,473850,7,3127,2,7200,1.00223856732
470850,470865,470891,15,26,1,900,1.57692307692
470870,486042,486888,15172,846,14,1560,18.9338061466
470888,470895,474357,7,3462,2,7200,1.00202195263
470906,470913,474233,7,3320,2,7200,1.00210843373
471053,471059,475948,6,4889,4,14400,1.00122724484
471057,471066,474186,9,3120,2,7200,1.00288461538
471118,471124,474408,6,3284,2,7200,1.00182704019
471148,471154,474270,6,3116,2,7200,1.00192554557
471293,471300,474676,7,3376,2,7200,1.00207345972
471294,471307,474609,13,3302,2,7200,1.00393700787
471309,471315,474511,6,3196,2,7200,1.00187734668
471346,471353,474651,7,3298,2,7200,1.00212249848
471361,471369,474818,8,3449,2,7200,1.0023195129
471421,471428,474684,7,3256,2,7200,1.00214987715
471464,471470,474954,6,3484,2,7200,1.00172215844
471479,471485,474908,6,3423,2,7200,1.00175284838
471480,471493,474786,13,3293,2,7200,1.00394776799
471482,471498,474901,16,3403,2,7200,1.00470173376
471604,471610,474969,6,3359,2,7200,1.00178624591
471643,471649,475006,6,3357,2,7200,1.0017873101
471658,471665,474861,7,3196,2,7200,1.0021902378
471673,471680,474892,7,3212,2,7200,1.00217932752
471688,471694,475111,6,3417,2,7200,1.00175592625
471724,471730,474963,6,3233,2,7200,1.00185586143
471766,471773,474998,7,3225,2,7200,1.00217054264
471790,471797,475199,7,3402,2,7200,1.00205761317
471805,471812,475063,7,3251,2,7200,1.00215318364
471820,471827,475032,7,3205,2,7200,1.00218408736
471917,471925,475491,8,3566,2,7200,1.00224340998
471975,471982,475498,7,3516,2,7200,1.00199089875
471976,471989,475464,13,3475,2,7200,1.00374100719
472028,472034,475282,6,3248,2,7200,1.00184729064
472109,472116,475561,7,3445,2,7200,1.00203193033
472155,472162,475459,7,3297,2,7200,1.00212314225
472156,472169,475747,13,3578,2,7200,1.0036333147
472171,472177,475470,6,3293,2,7200,1.00182204677
472247,472254,475724,7,3470,2,7200,1.00201729107
472262,472269,475584,7,3315,2,7200,1.00211161388
472277,472283,475726,6,3443,2,7200,1.00174266628
472278,472290,475509,12,3219,2,7200,1.0037278658
472293,472299,475761,6,3462,2,7200,1.00173310225
472320,472327,475951,7,3624,2,7200,1.00193156733
472335,472341,475670,6,3329,2,7200,1.00180234305
472462,472469,475713,7,3244,2,7200,1.00215782984
472477,472483,475881,6,3398,2,7200,1.00176574456
472492,472499,475677,7,3178,2,7200,1.00220264317
472512,474697,476482,2185,1785,4,14400,2.22408963585
472559,472566,476013,7,3447,2,7200,1.00203075138
472637,472644,475714,7,3070,2,7200,1.00228013029
472652,472658,475974,6,3316,2,7200,1.00180940893
472667,472674,476001,7,3327,2,7200,1.0021039976
472682,472688,475955,6,3267,2,7200,1.00183654729
472761,472767,476010,6,3243,2,7200,1.00185013876
472795,474975,476482,2180,1507,4,14400,2.44658261447
472815,472822,476088,7,3266,2,7200,1.00214329455
472823,475018,476478,2195,1460,4,14400,2.50342465753
472830,472836,475948,6,3112,2,7200,1.00192802057
472890,472896,476176,6,3280,2,7200,1.00182926829
472954,472961,476469,7,3508,2,7200,1.001995439
472971,472978,476367,7,3389,2,7200,1.00206550605
472996,473002,476494,6,3492,2,7200,1.00171821306
473038,473044,476407,6,3363,2,7200,1.00178412132
473053,473059,476399,6,3340,2,7200,1.00179640719
473198,473204,476695,6,3491,2,7200,1.00171870524
473279,473287,476696,8,3409,2,7200,1.00234672925
473294,473302,476713,8,3411,2,7200,1.00234535327
473296,473309,476722,13,3413,2,7200,1.00380896572
473311,473317,476517,6,3200,2,7200,1.001875
473353,473360,476730,7,3370,2,7200,1.00207715134
473383,473390,476870,7,3480,2,7200,1.00201149425
473421,473427,476733,6,3306,2,7200,1.00181488203
473493,473500,476711,7,3211,2,7200,1.00218000623
473635,473642,476889,7,3247,2,7200,1.00215583616
473850,473857,477362,7,3505,2,7200,1.00199714693
473920,473926,477642,6,3716,2,7200,1.0016146394
473968,473974,477401,6,3427,2,7200,1.00175080245
474186,474193,477408,7,3215,2,7200,1.00217729393
474234,474241,477914,7,3673,2,7200,1.00190579907
474270,474277,477396,7,3119,2,7200,1.00224430907
474358,474365,477765,7,3400,2,7200,1.00205882353
474409,474417,477694,8,3277,2,7200,1.00244125725
474512,474520,477568,8,3048,2,7200,1.00262467192
474573,474579,476214,6,1635,2,18000,1.00366972477
474609,474615,478105,6,3490,2,7200,1.00171919771
474651,474658,478069,7,3411,2,7200,1.00205218411
474679,474685,477676,6,2991,2,7200,1.00200601805
474693,474703,478164,10,3461,2,7200,1.00288933834
474787,474793,478146,6,3353,2,7200,1.00178944229
474820,474826,478314,6,3488,2,7200,1.00172018349
474862,474869,478006,7,3137,2,7200,1.0022314313
474892,474899,478298,7,3399,2,7200,1.00205942924
474907,474914,478048,7,3134,2,7200,1.00223356733
474922,474928,478338,6,3410,2,7200,1.00175953079
474956,474963,478352,7,3389,2,7200,1.00206550605
474971,474983,478334,12,3351,2,7200,1.00358102059
474972,474988,478391,16,3403,2,7200,1.00470173376
474999,475006,478292,7,3286,2,7200,1.00213024954
475014,475025,478148,11,3123,2,7200,1.00352225424
475032,475038,478514,6,3476,2,7200,1.00172612198
475065,475071,478403,6,3332,2,7200,1.00180072029
475110,475117,478639,7,3522,2,7200,1.0019875071
475182,475217,475612,35,395,2,10800,1.08860759494
475203,475210,478572,7,3362,2,7200,1.00208209399
475285,475291,478354,6,3063,2,7200,1.00195886386
475460,475466,478863,6,3397,2,7200,1.00176626435
475475,475482,478789,7,3307,2,7200,1.0021167221
475476,475489,478976,13,3487,2,7200,1.00372813307
475491,475499,478793,8,3294,2,7200,1.00242865817
475507,475513,478521,6,3008,2,7200,1.00199468085
475521,475527,478726,6,3199,2,7200,1.00187558612
475564,475571,478930,7,3359,2,7200,1.00208395356
475585,475591,479044,6,3453,2,7200,1.00173761946
475673,475679,479277,6,3598,2,7200,1.00166759311
475687,475694,479093,7,3399,2,7200,1.00205942924
475715,475722,479085,7,3363,2,7200,1.00208147487
475716,475729,479027,13,3298,2,7200,1.0039417829
475731,475739,479360,8,3621,2,7200,1.00220933444
475733,475746,478897,13,3151,2,7200,1.00412567439
475748,475755,479211,7,3456,2,7200,1.00202546296
475763,475769,478944,6,3175,2,7200,1.00188976378
475884,475890,479444,6,3554,2,7200,1.0016882386
475950,475958,479483,8,3525,2,7200,1.00226950355
475958,475970,477031,12,1061,4,14400,1.01131008483
475965,475977,479336,12,3359,2,7200,1.00357249181
475967,475982,479227,15,3245,2,7200,1.00462249615
475982,475989,479366,7,3377,2,7200,1.00207284572
476003,476010,479243,7,3233,2,7200,1.00216517167
476018,476025,479436,7,3411,2,7200,1.00205218411
476019,476032,479599,13,3567,2,7200,1.0036445192
476089,476096,479393,7,3297,2,7200,1.00212314225
476177,476184,479444,7,3260,2,7200,1.00214723926
476367,476374,479767,7,3393,2,7200,1.00206307103
476401,476407,479585,6,3178,2,7200,1.00188797986
476415,476423,479712,8,3289,2,7200,1.00243235026
476470,476477,479878,7,3401,2,7200,1.00205821817
476494,476500,479816,6,3316,2,7200,1.00180940893
476518,476525,479766,7,3241,2,7200,1.00215982721
476591,477041,520273,450,43232,4,43200,1.01040895633
476601,477395,496599,794,19204,4,43200,1.04134555301
476604,477400,511401,796,34001,4,43200,1.02341107614
476685,477520,478013,835,493,16,324000,2.69371196755
476694,476701,479958,7,3257,2,7200,1.00214921707
476708,476715,480059,7,3344,2,7200,1.00209330144
476724,476731,480067,7,3336,2,7200,1.00209832134
476725,476739,479854,14,3115,2,7200,1.00449438202
476727,476744,480006,17,3262,2,7200,1.00521152667
476742,476751,480116,9,3365,2,7200,1.00267459138
476743,476756,479903,13,3147,2,7200,1.00413091833
476871,476877,480130,6,3253,2,7200,1.00184445128
476891,476899,480342,8,3443,2,7200,1.00232355504
477109,478289,478403,1180,114,4,86400,11.350877193
477363,477371,481068,8,3697,2,7200,1.00216391669
477397,477407,480691,10,3284,2,7200,1.00304506699
477412,477418,480963,6,3545,2,7200,1.00169252468
477413,477425,480481,12,3056,2,7200,1.00392670157
477570,477577,480794,7,3217,2,7200,1.00217594032
477643,477649,481020,6,3371,2,7200,1.00177988727
477679,477686,481242,7,3556,2,7200,1.00196850394
477694,477700,480965,6,3265,2,7200,1.00183767228
477767,477774,481155,7,3381,2,7200,1.00207039337
477915,477921,481514,6,3593,2,7200,1.00166991372
478008,478016,481241,8,3225,2,7200,1.00248062016
478048,478054,481600,6,3546,2,7200,1.00169204738
478072,478078,481244,6,3166,2,7200,1.00189513582
478105,478111,481353,6,3242,2,7200,1.00185070944
478147,478154,481459,7,3305,2,7200,1.00211800303
478154,478926,481096,772,2170,16,324000,1.35576036866
478162,478169,481528,7,3359,2,7200,1.00208395356
478177,478183,481526,6,3343,2,7200,1.00179479509
478292,478299,481711,7,3412,2,7200,1.00205158265
478307,478313,481748,6,3435,2,7200,1.00174672489
478322,478328,481883,6,3555,2,7200,1.00168776371
478337,478344,481587,7,3243,2,7200,1.00215849522
478339,478351,481621,12,3270,2,7200,1.00366972477
478354,478360,481677,6,3317,2,7200,1.00180886343
478356,478368,481838,12,3470,2,7200,1.00345821326
478392,478398,482099,6,3701,2,7200,1.00162118346
478407,478414,481710,7,3296,2,7200,1.00212378641
478516,478522,481972,6,3450,2,7200,1.00173913043
478531,478537,481892,6,3355,2,7200,1.00178837556
478573,478580,481818,7,3238,2,7200,1.00216182829
478640,478647,482012,7,3365,2,7200,1.00208023774
478727,478734,481939,7,3205,2,7200,1.00218408736
478791,478798,482375,7,3577,2,7200,1.00195694716
478804,479106,479208,302,102,4,86400,3.96078431373
478806,478812,482234,6,3422,2,7200,1.00175336061
478863,478869,482155,6,3286,2,7200,1.00182592818
478896,478903,482147,7,3244,2,7200,1.00215782984
478932,478939,482430,7,3491,2,7200,1.00200515612
478947,478954,482342,7,3388,2,7200,1.0020661157
478978,478985,482525,7,3540,2,7200,1.00197740113
479029,479036,482428,7,3392,2,7200,1.00206367925
479047,479054,482521,7,3467,2,7200,1.00201903663
479087,479094,482406,7,3312,2,7200,1.00211352657
479102,479113,482279,11,3166,2,7200,1.00347441567
479211,479218,482468,7,3250,2,7200,1.00215384615
479229,479235,482475,6,3240,2,7200,1.00185185185
479244,479250,482727,6,3477,2,7200,1.00172562554
479277,479283,482864,6,3581,2,7200,1.00167550963
479337,479344,482606,7,3262,2,7200,1.00214592275
479362,479369,482725,7,3356,2,7200,1.00208581645
479376,479383,482708,7,3325,2,7200,1.00210526316
479394,479401,482603,7,3202,2,7200,1.00218613367
479437,479443,482703,6,3260,2,7200,1.0018404908
479452,479458,482955,6,3497,2,7200,1.00171575636
479453,479465,482795,12,3330,2,7200,1.0036036036
479484,479491,482979,7,3488,2,7200,1.00200688073
479586,479593,482958,7,3365,2,7200,1.00208023774
479601,479608,482884,7,3276,2,7200,1.00213675214
479713,479721,482949,8,3228,2,7200,1.00247831475
479765,479771,483244,6,3473,2,7200,1.00172761301
479771,479779,481329,8,1550,2,18000,1.00516129032
479780,479786,483038,6,3252,2,7200,1.00184501845
479816,479822,483154,6,3332,2,7200,1.00180072029
479855,479861,483326,6,3465,2,7200,1.00173160173
479879,479885,483222,6,3337,2,7200,1.00179802218
479906,479913,483147,7,3234,2,7200,1.00216450216
479961,479968,483345,7,3377,2,7200,1.00207284572
480009,480016,483364,7,3348,2,7200,1.00209080048
480060,480066,483455,6,3389,2,7200,1.00177043376
480075,480082,483447,7,3365,2,7200,1.00208023774
480118,480124,483397,6,3273,2,7200,1.00183318057
480132,480139,483664,7,3525,2,7200,1.0019858156
480295,480301,481469,6,1168,2,18000,1.0051369863
480345,480351,483746,6,3395,2,7200,1.00176730486
480484,480490,483860,6,3370,2,7200,1.00178041543
480690,480696,484131,6,3435,2,7200,1.00174672489
480796,480802,484278,6,3476,2,7200,1.00172612198
480939,482010,654565,1071,172555,18,216000,1.0062067167
480965,480971,484286,6,3315,2,7200,1.00180995475
480966,480979,484184,13,3205,2,7200,1.00405616225
481021,481028,484200,7,3172,2,7200,1.00220680958
481069,481076,484401,7,3325,2,7200,1.00210526316
481157,481163,484504,6,3341,2,7200,1.0017958695
481241,481249,484536,8,3287,2,7200,1.00243383024
481243,481254,484362,11,3108,2,7200,1.00353925354
481258,481265,484654,7,3389,2,7200,1.00206550605
481355,481362,484673,7,3311,2,7200,1.0021141649
481385,481393,482062,8,669,2,10800,1.01195814649
481436,488553,488555,7117,2,16,324000,711.9
481460,481467,484748,7,3281,2,7200,1.00213349589
481515,481522,485175,7,3653,2,7200,1.00191623323
481530,481537,485072,7,3535,2,7200,1.00198019802
481531,481544,485041,13,3497,2,7200,1.00371747212
481589,481596,484782,7,3186,2,7200,1.00219711237
481604,481610,484876,6,3266,2,7200,1.00183710961
481622,481628,485099,6,3471,2,7200,1.00172860847
481679,481685,484984,6,3299,2,7200,1.00181873295
481696,482971,495254,1275,12283,6,108000,1.10380200277
481713,481719,484880,6,3161,2,7200,1.0018981335
481714,481727,485028,13,3301,2,7200,1.00393820055
481750,481756,485094,6,3338,2,7200,1.00179748352
481820,481826,485259,6,3433,2,7200,1.0017477425
481841,481847,485006,6,3159,2,7200,1.00189933523
481886,481893,485143,7,3250,2,7200,1.00215384615
481897,481904,482216,7,312,2,10800,1.02243589744
481901,481911,485209,10,3298,2,7200,1.00303214069
481940,481946,485186,6,3240,2,7200,1.00185185185
481973,481980,485511,7,3531,2,7200,1.00198244123
482012,482020,485190,8,3170,2,7200,1.00252365931
482100,482107,485398,7,3291,2,7200,1.00212701307
482148,482155,485309,7,3154,2,7200,1.00221940393
482163,482170,485421,7,3251,2,7200,1.00215318364
482236,482243,485451,7,3208,2,7200,1.00218204489
482281,482288,485434,7,3146,2,7200,1.00222504768
482342,482349,485588,7,3239,2,7200,1.00216116085
482375,482381,485760,6,3379,2,7200,1.00177567328
482409,482416,485699,7,3283,2,7200,1.00213219616
482430,482436,485720,6,3284,2,7200,1.00182704019
482431,482444,485785,13,3341,2,7200,1.00389105058
482468,482474,485606,6,3132,2,7200,1.00191570881
482483,482490,485818,7,3328,2,7200,1.00210336538
482522,482528,485735,6,3207,2,7200,1.00187090739
482537,482544,485881,7,3337,2,7200,1.00209769254
482603,482610,485893,7,3283,2,7200,1.00213219616
482618,482625,486013,7,3388,2,7200,1.0020661157
482706,482712,486013,6,3301,2,7200,1.00181763102
482720,482727,485992,7,3265,2,7200,1.002143951
482735,482742,486014,7,3272,2,7200,1.0021393643
482737,482750,486014,13,3264,2,7200,1.00398284314
482797,482805,486014,8,3209,2,7200,1.00249298847
482864,482870,486014,6,3144,2,7200,1.00190839695
482885,482891,486014,6,3123,2,7200,1.00192122959
482952,482958,486015,6,3057,2,7200,1.00196270854
482967,482978,486015,11,3037,2,7200,1.00362199539
482968,482983,486015,15,3032,2,7200,1.00494722955
482983,482989,486015,6,3026,2,7200,1.0019828156
483040,483048,486015,8,2967,2,7200,1.00269632626
483147,483153,486015,6,2862,2,7200,1.00209643606
483162,483169,486015,7,2846,2,7200,1.00245959241
483222,483229,486015,7,2786,2,7200,1.00251256281
483246,483254,486015,8,2761,2,7200,1.00289750091
483325,483331,486015,6,2684,2,7200,1.00223546945
483327,483338,495607,11,12269,2,50400,1.00089656859
483346,483353,486015,7,2662,2,7200,1.0026296018
483364,483371,486015,7,2644,2,7200,1.00264750378
483397,483404,486015,7,2611,2,7200,1.00268096515
483448,483455,486015,7,2560,2,7200,1.002734375
483463,483470,486015,7,2545,2,7200,1.00275049116
483666,483673,486015,7,2342,2,7200,1.00298889838
483748,483754,486015,6,2261,2,7200,1.00265369306
483860,483866,486015,6,2149,2,7200,1.00279199628
484052,484058,484290,6,232,2,14400,1.02586206897
484132,484139,486015,7,1876,2,7200,1.00373134328
484184,484191,486015,7,1824,2,7200,1.0038377193
484202,484208,486015,6,1807,2,7200,1.00332042059
484277,484284,486015,7,1731,2,7200,1.00404390526
484292,484299,486015,7,1716,2,7200,1.00407925408
484362,484368,486015,6,1647,2,7200,1.00364298725
484404,484410,486015,6,1605,2,7200,1.00373831776
484507,484514,486015,7,1501,2,7200,1.00466355763
484537,484543,486015,6,1472,2,7200,1.00407608696
484655,484661,486015,6,1354,2,7200,1.00443131462
484673,484680,486015,7,1335,2,7200,1.00524344569
484748,484756,486015,8,1259,2,7200,1.0063542494
484782,484788,486015,6,1227,2,7200,1.00488997555
484872,484879,486015,7,1136,2,7200,1.00616197183
484887,484895,486015,8,1120,2,7200,1.00714285714
484956,486025,486401,1069,376,4,36000,3.84308510638
484987,484994,486015,7,1021,2,7200,1.00685602351
485008,485014,486015,6,1001,2,7200,1.00599400599
485029,485035,486015,6,980,2,7200,1.00612244898
485044,485051,486015,7,964,2,7200,1.00726141079
485045,485058,485379,13,321,2,10800,1.04049844237
485071,485077,486015,6,938,2,7200,1.00639658849
485095,485102,486015,7,913,2,7200,1.00766703176
485110,485117,486015,7,898,2,7200,1.00779510022
485143,485149,486015,6,866,2,7200,1.00692840647
485176,485182,486015,6,833,2,7200,1.00720288115
485191,485198,486015,7,817,2,7200,1.00856793146
485193,485205,486015,12,810,2,7200,1.01481481481
485208,485215,486015,7,800,2,7200,1.00875
485259,485266,486015,7,749,2,7200,1.00934579439
485310,485316,486015,6,699,2,7200,1.00858369099
485398,485405,486015,7,610,2,7200,1.01147540984
485422,485429,486015,7,586,2,7200,1.01194539249
485437,485444,486015,7,571,2,7200,1.0122591944
485452,485458,486015,6,557,2,7200,1.01077199282
485513,485519,486015,6,496,2,7200,1.01209677419
485588,485594,486015,6,421,2,7200,1.01425178147
485606,485613,486015,7,402,2,7200,1.01741293532
485700,485708,486015,8,307,2,7200,1.02605863192
485722,485729,486015,7,286,2,7200,1.02447552448
485737,485744,486015,7,271,2,7200,1.0258302583
485761,485767,486015,6,248,2,7200,1.02419354839
485788,485794,486015,6,221,2,7200,1.02714932127
485821,485828,486015,7,187,2,7200,1.03743315508
485881,485888,486015,7,127,2,7200,1.05511811024
485896,485903,486015,7,112,2,7200,1.0625
485994,486000,486015,6,15,2,7200,1.4
486048,486413,486753,365,340,2,10800,2.07352941176
486473,486764,486770,291,6,4,36000,29.7
486657,486782,490677,125,3895,4,36000,1.03209242619
486834,488558,493080,1724,4522,16,7210,1.38124723574
486885,486891,486897,6,6,1,900,1.2
486901,486908,488157,7,1249,14,1560,1.00560448359
487246,488170,494655,924,6485,4,36000,1.14248265227
487359,487367,487403,8,36,2,7200,1.22222222222
487361,487374,487410,13,36,2,7200,1.36111111111
487362,487379,487416,17,37,2,7200,1.45945945946
487363,487384,487420,21,36,2,7200,1.58333333333
487365,487389,487426,24,37,2,7200,1.64864864865
487366,487395,487430,29,35,2,7200,1.82857142857
487367,487400,487436,33,36,2,7200,1.91666666667
487369,487406,487441,37,35,2,7200,2.05714285714
487370,487411,487446,41,35,2,7200,2.17142857143
487372,487417,487452,45,35,2,7200,2.28571428571
487373,487422,487457,49,35,2,7200,2.4
487374,487427,487463,53,36,2,7200,2.47222222222
487376,487432,487468,56,36,2,7200,2.55555555556
487377,487438,487473,61,35,2,7200,2.74285714286
487378,487443,487477,65,34,2,7200,2.91176470588
487380,487448,487477,68,29,2,7200,3.34482758621
487381,487453,487477,72,24,2,7200,4.0
487382,487458,487477,76,19,2,7200,5.0
487384,487464,487477,80,13,2,7200,7.15384615385
487385,487469,487477,84,8,2,7200,9.2
487386,487474,487477,88,3,2,7200,9.1
487388,487479,487480,91,1,2,7200,9.2
487492,487498,491133,6,3635,2,7200,1.00165061898
487493,487505,491385,12,3880,2,7200,1.00309278351
487495,487510,491286,15,3776,2,7200,1.00397245763
487496,487515,491408,19,3893,2,7200,1.00488055484
487497,487520,491207,23,3687,2,7200,1.00623813398
487499,487526,491455,27,3929,2,7200,1.0068719776
487500,487533,491140,33,3607,2,7200,1.00914887718
487501,487538,490965,37,3427,2,7200,1.01079661512
487503,487543,491031,40,3488,2,7200,1.01146788991
487504,487548,491675,44,4127,2,7200,1.01066149746
487505,487554,490729,49,3175,2,7200,1.01543307087
487507,487559,491515,52,3956,2,7200,1.0131445905
487508,487564,491411,56,3847,2,7200,1.0145567975
487509,487569,491379,60,3810,2,7200,1.0157480315
487511,487575,490753,64,3178,2,7200,1.02013845186
487512,487580,491484,68,3904,2,7200,1.01741803279
487514,487585,491089,71,3504,2,7200,1.02026255708
487515,487590,491167,75,3577,2,7200,1.02096729103
487516,487596,491459,80,3863,2,7200,1.0207092933
487518,487601,491393,83,3792,2,7200,1.02188818565
487519,487606,491376,87,3770,2,7200,1.02307692308
487520,487611,491449,91,3838,2,7200,1.02371026576
487522,487616,491383,94,3767,2,7200,1.02495354393
487523,487622,491343,99,3721,2,7200,1.02660575114
487524,487627,491148,103,3521,2,7200,1.02925305311
487526,487632,491150,106,3518,2,7200,1.03013075611
487527,487638,490729,111,3091,2,7200,1.03591070851
487528,487644,491533,116,3889,2,7200,1.02982771921
487530,487649,491485,119,3836,2,7200,1.03102189781
487531,487654,491631,123,3977,2,7200,1.03092783505
487532,487659,491363,127,3704,2,7200,1.03428725702
487534,487665,490956,131,3291,2,7200,1.03980553023
487535,487670,491545,135,3875,2,7200,1.03483870968
487536,487675,491615,139,3940,2,7200,1.03527918782
487538,487680,491538,142,3858,2,7200,1.03680663556
487539,487685,491274,146,3589,2,7200,1.04067985511
487540,487691,491577,151,3886,2,7200,1.03885743695
487542,487696,491661,154,3965,2,7200,1.03883984868
487543,487701,491579,158,3878,2,7200,1.04074265085
487544,487707,491223,163,3516,2,7200,1.04635949943
487814,488186,489897,372,1711,1,18000,1.21741671537
487974,488175,500726,201,12551,4,36000,1.01601466019
487997,488180,493971,183,5791,4,36000,1.0316007598
488153,488805,488811,652,6,1,900,65.8
488153,488191,489845,38,1654,1,18000,1.02297460701
488155,488573,490568,418,1995,1,18000,1.20952380952
488157,488578,490486,421,1908,1,18000,1.22064989518
488159,488729,490399,570,1670,1,18000,1.34131736527
488161,488735,490576,574,1841,1,18000,1.31178707224
488162,488742,490754,580,2012,1,18000,1.28827037773
488164,488747,490608,583,1861,1,18000,1.31327243418
488166,488752,490556,586,1804,1,18000,1.32483370288
488168,488758,490170,590,1412,1,18000,1.4178470255
488169,488763,490733,594,1970,1,18000,1.30152284264
488170,488768,490550,598,1782,1,18000,1.33557800224
488173,488774,490581,601,1807,1,18000,1.33259546209
488175,488779,490584,604,1805,1,18000,1.33462603878
488177,488568,489571,391,1003,14,1560,1.38983050847
488177,488784,489859,607,1075,1,18000,1.56465116279
488180,488789,490632,609,1843,1,18000,1.33043950081
488182,488795,490859,613,2064,1,18000,1.29699612403
488183,488800,490936,617,2136,1,18000,1.2888576779
488670,488724,488872,54,148,4,540000,1.36486486486
488761,488812,489195,51,383,6,172800,1.13315926893
488859,488866,730268,7,241402,4,540000,1.00002899727
488894,488900,740587,6,251687,4,540000,1.00002383913
489198,490568,490577,1370,9,16,324000,137.9
489251,489257,489784,6,527,6,259200,1.01138519924
489392,489399,493470,7,4071,2,57600,1.00171947924
489567,489575,489623,8,48,1,900,1.16666666667
489581,489587,490557,6,970,14,1560,1.00618556701
489856,489863,490893,7,1030,6,259200,1.0067961165
490400,490406,498860,6,8454,4,36000,1.00070972321
490422,490429,490628,7,199,4,36000,1.0351758794
490437,490443,493172,6,2729,4,36000,1.00219860755
490555,490561,490753,6,192,1,900,1.03125
490568,490603,491842,35,1239,14,1560,1.02824858757
490734,490741,494471,7,3730,2,7200,1.0018766756
490736,490748,494136,12,3388,2,7200,1.00354191263
490756,490762,494796,6,4034,2,7200,1.00148735746
490876,490882,492885,6,2003,1,18000,1.00299550674
490878,490889,493083,11,2194,1,18000,1.00501367366
490879,490894,492576,15,1682,1,18000,1.00891795482
490880,490899,492975,19,2076,1,18000,1.0091522158
490881,490905,493043,24,2138,1,18000,1.01122544434
490882,490910,492843,28,1933,1,18000,1.01448525608
490882,490916,492913,34,1997,1,18000,1.01702553831
490884,490922,493157,38,2235,1,18000,1.01700223714
490887,490928,493790,41,2862,1,18000,1.0143256464
490888,490933,492782,45,1849,1,18000,1.02433747972
490888,490938,492534,50,1596,1,18000,1.0313283208
490889,490944,492840,55,1896,1,18000,1.02900843882
490891,490951,492805,60,1854,1,18000,1.03236245955
490892,491541,493179,649,1638,1,18000,1.39621489621
490892,491148,493258,256,2110,1,18000,1.12132701422
490899,491546,493155,647,1609,1,18000,1.40211311374
490900,491552,493848,652,2296,1,18000,1.28397212544
490951,491806,494470,855,2664,6,259200,1.32094594595
490958,490965,493989,7,3024,2,7200,1.00231481481
490972,490980,494608,8,3628,2,7200,1.00220507166
491032,491040,495106,8,4066,2,7200,1.00196753566
491089,491096,494656,7,3560,2,7200,1.00196629213
491134,491141,494674,7,3533,2,7200,1.00198131899
491149,491157,495181,8,4024,2,7200,1.00198807157
491151,491162,494916,11,3754,2,7200,1.00293020778
491166,491172,495238,6,4066,2,7200,1.00147565175
491180,491186,494820,6,3634,2,7200,1.0016510732
491210,491217,494932,7,3715,2,7200,1.00188425303
491225,491231,494565,6,3334,2,7200,1.00179964007
491273,491280,495150,7,3870,2,7200,1.00180878553
491287,491294,495398,7,4104,2,7200,1.00170565302
491350,491357,495648,7,4291,2,7200,1.00163132137
491364,491372,495156,8,3784,2,7200,1.0021141649
491381,491388,495556,7,4168,2,7200,1.00167946257
491382,491395,495262,13,3867,2,7200,1.00336177916
491398,491404,495516,6,4112,2,7200,1.00145914397
491399,491411,494915,12,3504,2,7200,1.00342465753
491400,491416,495390,16,3974,2,7200,1.00402617011
491415,491423,495226,8,3803,2,7200,1.00210360242
491417,491428,494798,11,3370,2,7200,1.00326409496
491449,491456,495257,7,3801,2,7200,1.00184162063
491464,491471,495914,7,4443,2,7200,1.00157551204
491466,491478,494989,12,3511,2,7200,1.00341782968
491487,491493,495513,6,4020,2,7200,1.00149253731
491488,491500,495030,12,3530,2,7200,1.00339943343
491515,491521,495184,6,3663,2,7200,1.00163800164
491536,491560,494895,24,3335,2,7200,1.0071964018
491550,491565,495336,15,3771,2,7200,1.00397772474
491552,491570,495348,18,3778,2,7200,1.00476442562
491579,491587,496178,8,4591,2,7200,1.00174253975
491581,491594,495025,13,3431,2,7200,1.0037889828
491617,491624,495447,7,3823,2,7200,1.00183102276
491631,491638,495285,7,3647,2,7200,1.0019193858
491664,491671,495792,7,4121,2,7200,1.00169861684
491679,491686,495350,7,3664,2,7200,1.00191048035
491840,491853,491863,13,10,1,900,2.3
491864,491875,492801,11,926,14,1560,1.01187904968
492799,492806,492828,7,22,1,900,1.31818181818
492833,492840,493850,7,1010,14,1560,1.00693069307
493030,493037,499124,7,6087,4,36000,1.00114999179
493045,493052,493058,7,6,1,300,1.3
493226,493270,493318,44,48,1,600,1.91666666667
493697,493704,493896,7,192,1,1800,1.03645833333
493793,493799,493803,6,4,2,57600,1.0
493831,493838,494575,7,737,2,57600,1.00949796472
493834,493863,559025,29,65162,6,604800,1.00044504466
493846,493852,493894,6,42,1,900,1.14285714286
493887,493893,907796,6,413903,6,604800,1.00001449615
493922,493928,495934,6,2006,1,18000,1.00299102692
493923,493935,495938,12,2003,1,18000,1.00599101348
493925,493940,496044,15,2104,1,18000,1.00712927757
493926,493945,496184,19,2239,1,18000,1.00848593122
493927,493951,495802,24,1851,1,18000,1.01296596434
493928,493983,496373,55,2390,1,18000,1.0230125523
493929,493989,495547,60,1558,1,18000,1.03851091142
493930,493994,496068,64,2074,1,18000,1.03085824494
493931,493999,496841,68,2842,1,18000,1.0239268121
493934,494151,495959,217,1808,1,18000,1.12002212389
493935,494156,496105,221,1949,1,18000,1.11339148281
493936,494671,496766,735,2095,1,18000,1.3508353222
493937,494676,496713,739,2037,1,18000,1.36278841433
493939,494682,496398,743,1716,1,18000,1.43298368298
493940,494687,496659,747,1972,1,18000,1.37880324544
493942,494809,496964,867,2155,1,18000,1.40232018561
493944,494814,496635,870,1821,1,18000,1.47775947282
493993,494006,498288,13,4282,2,7200,1.0030359645
493998,494485,494799,487,314,8,604800,2.55095541401
494023,494821,495070,798,249,8,604800,4.20481927711
494138,494144,498225,6,4081,2,7200,1.00147022789
494206,494586,545015,380,50429,2,86400,1.00753534673
494472,494478,498070,6,3592,2,7200,1.00167037862
494525,495082,728637,557,233555,6,259200,1.00238487722
494568,494575,498145,7,3570,2,7200,1.00196078431
494610,494616,498226,6,3610,2,7200,1.00166204986
494658,494664,498256,6,3592,2,7200,1.00167037862
494676,494694,498580,18,3886,2,7200,1.00463201235
494796,494802,498099,6,3297,2,7200,1.00181983621
494810,494826,498677,16,3851,2,7200,1.004154765
494825,494833,498451,8,3618,2,7200,1.00221116639
494897,494907,498502,10,3595,2,7200,1.00278164117
494918,494927,499010,9,4083,2,7200,1.00220426157
494919,494934,498631,15,3697,2,7200,1.00405734379
494934,494945,498674,11,3729,2,7200,1.00294985251
494991,495002,498745,11,3743,2,7200,1.00293881913
495027,495037,498938,10,3901,2,7200,1.00256344527
495041,495047,499339,6,4292,2,7200,1.00139794967
495107,495115,498428,8,3313,2,7200,1.00241472985
495128,495619,496700,491,1081,2,18000,1.45420906568
495152,495158,498966,6,3808,2,7200,1.00157563025
495167,495174,499552,7,4378,2,7200,1.00159890361
495182,495188,498705,6,3517,2,7200,1.00170599943
495196,495203,498706,7,3503,2,7200,1.00199828718
495226,495232,499339,6,4107,2,7200,1.00146092038
495241,495247,499076,6,3829,2,7200,1.00156698877
495259,495266,499063,7,3797,2,7200,1.00184356071
495273,495281,498757,8,3476,2,7200,1.00230149597
495288,495295,498801,7,3506,2,7200,1.0019965773
495336,495342,499461,6,4119,2,7200,1.00145666424
495351,495357,498897,6,3540,2,7200,1.00169491525
495352,495364,499346,12,3982,2,7200,1.00301356102
495391,495397,498647,6,3250,2,7200,1.00184615385
495406,495412,498910,6,3498,2,7200,1.00171526587
495448,495455,499605,7,4150,2,7200,1.00168674699
495514,495520,499176,6,3656,2,7200,1.00164113786
495528,495534,499270,6,3736,2,7200,1.00160599572
495558,495565,499641,7,4076,2,7200,1.00171736997
495648,495654,499190,6,3536,2,7200,1.00169683258
495793,495800,499173,7,3373,2,7200,1.00207530388
495884,495963,496219,79,256,2,10800,1.30859375
495917,495924,499773,7,3849,2,7200,1.0018186542
495937,495946,495951,9,5,1,342000,1.4
495961,496171,616372,210,120201,8,604800,1.00174707365
496179,496186,499576,7,3390,2,7200,1.00206489676
496487,496493,496543,6,50,2,18000,1.12
496582,496589,514604,7,18015,2,18000,1.00038856508
496698,496705,503946,7,7241,2,7200,1.0009667173
496889,496896,503079,7,6183,1,342000,1.0011321365
497004,497011,498797,7,1786,1,18000,1.0039193729
497006,497018,499297,12,2279,1,18000,1.00526546731
497009,497023,499180,14,2157,1,18000,1.00649049606
497010,497029,499019,19,1990,1,18000,1.00954773869
497012,497036,499325,24,2289,1,18000,1.01048492792
497013,497041,499144,28,2103,1,18000,1.01331431289
497014,497046,498893,32,1847,1,18000,1.01732539253
497016,497052,498981,36,1929,1,18000,1.01866251944
497018,497057,499178,39,2121,1,18000,1.01838755304
497020,497062,499413,42,2351,1,18000,1.01786473841
497022,497068,499214,46,2146,1,18000,1.02143522833
497022,497613,499382,591,1769,1,18000,1.33408705483
497023,497618,499639,595,2021,1,18000,1.29440870856
497024,498442,500460,1418,2018,1,18000,1.70267591675
497025,498519,500762,1494,2243,1,18000,1.6660722247
497025,498447,500378,1422,1931,1,18000,1.73640600725
497026,498873,500897,1847,2024,1,18000,1.91254940711
497919,498878,499093,959,215,1,342000,5.46046511628
498070,498076,501534,6,3458,2,7200,1.001735107
498100,498106,501494,6,3388,2,7200,1.00177095632
498145,498151,501544,6,3393,2,7200,1.0017683466
498226,498232,502273,6,4041,2,7200,1.00148478099
498227,498239,502071,12,3832,2,7200,1.00313152401
498257,498264,502151,7,3887,2,7200,1.00180087471
498290,498296,502197,6,3901,2,7200,1.00153806716
498429,498435,501765,6,3330,2,7200,1.0018018018
498453,498459,502292,6,3833,2,7200,1.00156535351
498504,498512,503253,8,4741,2,7200,1.00168740772
498582,498590,502425,8,3835,2,7200,1.00208604954
498634,498640,502658,6,4018,2,7200,1.00149328024
498648,498655,501915,7,3260,2,7200,1.00214723926
498675,498682,502873,7,4191,2,7200,1.00167024576
498690,498697,502374,7,3677,2,7200,1.00190372586
498705,498711,502774,6,4063,2,7200,1.00147674132
498706,498719,502566,13,3847,2,7200,1.00337925656
498745,498752,502475,7,3723,2,7200,1.00188020414
498760,498766,502816,6,4050,2,7200,1.00148148148
498802,498809,502540,7,3731,2,7200,1.00187617261
498898,498904,502796,6,3892,2,7200,1.00154162384
498913,498920,502664,7,3744,2,7200,1.00186965812
498939,498947,503110,8,4163,2,7200,1.00192169109
498966,498973,502468,7,3495,2,7200,1.00200286123
499011,499018,502603,7,3585,2,7200,1.0019525802
499065,499073,504028,8,4955,2,7200,1.00161453078
499080,499086,502993,6,3907,2,7200,1.00153570514
499173,499179,502841,6,3662,2,7200,1.00163844894
499188,499195,502851,7,3656,2,7200,1.00191466083
499203,499210,503036,7,3826,2,7200,1.00182958704
499272,499278,503189,6,3911,2,7200,1.00153413449
499342,499348,503292,6,3944,2,7200,1.00152129817
499343,499355,503220,12,3865,2,7200,1.00310478655
499358,499365,502796,7,3431,2,7200,1.00204022151
499463,499471,503304,8,3833,2,7200,1.00208713801
499554,499561,503096,7,3535,2,7200,1.00198019802
499577,499585,503061,8,3476,2,7200,1.00230149597
499607,499615,503594,8,3979,2,7200,1.00201055542
499643,499650,503426,7,3776,2,7200,1.00185381356
499776,499783,503656,7,3873,2,7200,1.00180738446
499870,500469,860478,599,360009,12,360000,1.00166384729
500928,500935,502780,7,1845,1,18000,1.00379403794
500929,500940,502726,11,1786,1,18000,1.00615901456
500930,500947,503138,17,2191,1,18000,1.00775901415
500931,500953,503331,22,2378,1,18000,1.00925147183
500932,500958,503010,26,2052,1,18000,1.0126705653
500934,500963,503002,29,2039,1,18000,1.01422265817
500936,500974,502745,38,1771,1,18000,1.02145680407
500936,500969,502428,33,1459,1,18000,1.02261823167
500939,502441,504680,1502,2239,1,18000,1.67083519428
500942,502555,504262,1613,1707,1,18000,1.94493263035
500942,502616,504034,1674,1418,1,18000,2.18053596615
500943,502676,504869,1733,2193,1,18000,1.79024167807
500944,502738,504862,1794,2124,1,18000,1.84463276836
500945,502758,504720,1813,1962,1,18000,1.92405708461
500947,502792,504590,1845,1798,1,18000,2.02614015573
500951,502855,504686,1904,1831,1,18000,2.03986892409
500952,502860,504879,1908,2019,1,18000,1.94502228826
501496,501503,505016,7,3513,2,7200,1.00199259892
501535,501542,505595,7,4053,2,7200,1.00172711572
501550,501558,504757,8,3199,2,7200,1.00250078149
501767,501774,505736,7,3962,2,7200,1.00176678445
501917,501923,505020,6,3097,2,7200,1.00193735873
502073,502081,505772,8,3691,2,7200,1.0021674343
502152,502158,505980,6,3822,2,7200,1.00156985871
502199,502206,505931,7,3725,2,7200,1.00187919463
502275,502282,505563,7,3281,2,7200,1.00213349589
502292,502299,506008,7,3709,2,7200,1.00188730116
502373,502381,505913,8,3532,2,7200,1.00226500566
502427,502434,506274,7,3840,2,7200,1.00182291667
502469,502476,506155,7,3679,2,7200,1.00190269095
502484,502491,506288,7,3797,2,7200,1.00184356071
502541,502548,505933,7,3385,2,7200,1.00206794682
502568,502574,506425,6,3851,2,7200,1.00155803687
502598,502605,506220,7,3615,2,7200,1.00193637621
502658,502664,506885,6,4221,2,7200,1.00142146411
502672,502682,506338,10,3656,2,7200,1.00273522976
502775,502782,506544,7,3762,2,7200,1.00186071239
502799,502806,506648,7,3842,2,7200,1.00182196773
502800,502813,506434,13,3621,2,7200,1.00359016846
502818,502824,506577,6,3753,2,7200,1.00159872102
502842,502848,507335,6,4487,2,7200,1.00133719634
502857,502866,506594,9,3728,2,7200,1.00241416309
502875,502882,506709,7,3827,2,7200,1.00182910896
502941,503014,503880,73,866,1,342000,1.08429561201
502995,503002,506802,7,3800,2,7200,1.00184210526
503037,503043,506628,6,3585,2,7200,1.00167364017
503046,503052,503880,6,828,1,342000,1.00724637681
503064,503071,506764,7,3693,2,7200,1.00189547793
503096,503104,508246,8,5142,2,7200,1.00155581486
503111,503118,507467,7,4349,2,7200,1.00160956542
503189,503197,507179,8,3982,2,7200,1.00200904068
503222,503228,506468,6,3240,2,7200,1.00185185185
503255,503262,507071,7,3809,2,7200,1.00183775269
503294,503301,507345,7,4044,2,7200,1.00173095945
503309,503316,507154,7,3838,2,7200,1.0018238666
503426,503432,507617,6,4185,2,7200,1.00143369176
503595,503601,506782,6,3181,2,7200,1.00188619931
503658,503664,507642,6,3978,2,7200,1.00150829563
503947,503953,555023,6,51070,1,60010,1.0001174858
503951,503960,519351,9,15391,4,24010,1.00058475733
503955,548602,550312,44647,1710,64,5410,27.1093567251
503993,503999,562055,6,58056,1,342000,1.00010334849
504004,504043,508138,39,4095,1,342000,1.00952380952
504030,504036,507939,6,3903,2,7200,1.00153727902
504759,504765,509091,6,4326,2,7200,1.00138696255
504903,504911,504913,8,2,2,3540,1.0
504908,504923,506860,15,1937,1,18000,1.00774393392
504908,504917,506849,9,1932,1,18000,1.00465838509
504910,504930,506663,20,1733,1,18000,1.0115406809
504911,504935,506889,24,1954,1,18000,1.01228249744
504912,504942,506770,30,1828,1,18000,1.01641137856
504913,504947,506821,34,1874,1,18000,1.01814300961
504915,504952,506668,37,1716,1,18000,1.02156177156
504916,506447,508472,1531,2025,1,18000,1.75604938272
504921,506452,508444,1531,1992,1,18000,1.76857429719
504923,506481,508536,1558,2055,1,18000,1.75815085158
504927,506486,508516,1559,2030,1,18000,1.76798029557
504928,506611,508497,1683,1886,1,18000,1.89236479321
504928,506528,508369,1600,1841,1,18000,1.8690928843
504929,506616,508171,1687,1555,1,18000,2.08488745981
504931,506644,508693,1713,2049,1,18000,1.83601756955
504932,506675,508582,1743,1907,1,18000,1.91400104877
504935,506682,508814,1747,2132,1,18000,1.81941838649
505018,505025,508972,7,3947,2,7200,1.00177349886
505033,505039,508570,6,3531,2,7200,1.00169923534
505127,506778,510244,1651,3466,1,6010,1.47634160415
505130,508510,512275,3380,3765,4,24010,1.89774236388
505135,517089,521861,11954,4772,16,7210,3.5050293378
505142,550324,556001,45182,5677,64,23410,8.95878104633
505563,505570,509258,7,3688,2,7200,1.00189804772
505596,505602,508946,6,3344,2,7200,1.00179425837
505738,505745,509130,7,3385,2,7200,1.00206794682
505774,505781,509352,7,3571,2,7200,1.00196023523
505915,505922,509639,7,3717,2,7200,1.00188323917
505933,505939,510162,6,4223,2,7200,1.00142079091
505934,505946,508820,12,2874,2,7200,1.00417536534
505983,505989,509612,6,3623,2,7200,1.00165608612
506009,506016,509636,7,3620,2,7200,1.00193370166
506157,506164,510149,7,3985,2,7200,1.0017565872
506220,506226,510025,6,3799,2,7200,1.00157936299
506274,506280,509526,6,3246,2,7200,1.00184842884
506289,506295,509619,6,3324,2,7200,1.00180505415
506340,506347,510459,7,4112,2,7200,1.00170233463
506427,506433,510044,6,3611,2,7200,1.00166158959
506441,506458,510042,17,3584,2,7200,1.00474330357
506468,506474,510056,6,3582,2,7200,1.00167504188
506546,506553,509953,7,3400,2,7200,1.00205882353
506579,506585,510710,6,4125,2,7200,1.00145454545
506597,506604,510310,7,3706,2,7200,1.00188882893
506630,506637,510604,7,3967,2,7200,1.0017645576
506651,506658,510474,7,3816,2,7200,1.00183438155
506711,506717,510557,6,3840,2,7200,1.0015625
506765,506771,508310,6,1539,2,7200,1.00389863548
506783,506790,510678,7,3888,2,7200,1.00180041152
506804,506810,510662,6,3852,2,7200,1.0015576324
506885,506892,510228,7,3336,2,7200,1.00209832134
507072,507079,510642,7,3563,2,7200,1.00196463654
507153,507160,511466,7,4306,2,7200,1.00162563864
507180,507186,510983,6,3797,2,7200,1.00158019489
507337,507343,511221,6,3878,2,7200,1.00154718927
507352,507359,511060,7,3701,2,7200,1.00189138071
507469,507476,511177,7,3701,2,7200,1.00189138071
507620,507626,511281,6,3655,2,7200,1.00164158687
507643,507650,511419,7,3769,2,7200,1.00185725657
507939,507945,511450,6,3505,2,7200,1.00171184023
508247,508254,511415,7,3161,2,7200,1.00221448909
508313,508319,512054,6,3735,2,7200,1.0016064257
508572,508578,512230,6,3652,2,7200,1.00164293538
508822,508830,512645,8,3815,2,7200,1.00209698558
508854,508860,510859,6,1999,1,18000,1.00300150075
508856,509106,510806,250,1700,1,18000,1.14705882353
508857,509111,511006,254,1895,1,18000,1.13403693931
508858,510243,512239,1385,1996,1,18000,1.69388777555
508859,510248,511993,1389,1745,1,18000,1.79598853868
508860,510257,511900,1397,1643,1,18000,1.85027388923
508861,510657,512021,1796,1364,1,18000,2.31671554252
508862,510663,512603,1801,1940,1,18000,1.92835051546
508864,510677,512788,1813,2111,1,18000,1.85883467551
508866,510693,512504,1827,1811,1,18000,2.00883489785
508867,510818,512765,1951,1947,1,18000,2.00205444273
508868,510870,512794,2002,1924,1,18000,2.04054054054
508869,510999,512700,2130,1701,1,18000,2.25220458554
508870,511004,512915,2134,1911,1,18000,2.11669283098
508873,511018,512755,2145,1737,1,18000,2.23488773748
508874,511074,513141,2200,2067,1,18000,2.06434446057
508876,511236,513072,2360,1836,1,18000,2.28540305011
508946,508953,513268,7,4315,2,7200,1.00162224797
508973,508979,512735,6,3756,2,7200,1.00159744409
509093,509099,512635,6,3536,2,7200,1.00169683258
509132,509139,512874,7,3735,2,7200,1.00187416332
509258,509265,513062,7,3797,2,7200,1.00184356071
509355,509362,513384,7,4022,2,7200,1.00174042765
509529,509535,513312,6,3777,2,7200,1.00158856235
509613,509621,513099,8,3478,2,7200,1.00230017251
509628,509634,512709,6,3075,2,7200,1.00195121951
509643,509651,513126,8,3475,2,7200,1.00230215827
509644,509656,513324,12,3668,2,7200,1.00327153762
509957,509965,513382,8,3417,2,7200,1.002341235
510027,510034,513816,7,3782,2,7200,1.00185087255
510045,510051,514021,6,3970,2,7200,1.00151133501
510046,510058,513751,12,3693,2,7200,1.00324939074
510061,510068,513859,7,3791,2,7200,1.0018464785
510151,510157,513809,6,3652,2,7200,1.00164293538
510166,510173,513507,7,3334,2,7200,1.00209958008
510229,510236,513912,7,3676,2,7200,1.00190424374
510310,510318,513874,8,3556,2,7200,1.00224971879
510461,510468,514294,7,3826,2,7200,1.00182958704
510476,510482,514024,6,3542,2,7200,1.00169395822
510557,510563,514393,6,3830,2,7200,1.00156657963
510605,510612,514395,7,3783,2,7200,1.00185038329
510644,510651,514348,7,3697,2,7200,1.0018934271
510662,510670,514106,8,3436,2,7200,1.00232828871
510680,510686,514356,6,3670,2,7200,1.00163487738
510710,510716,514152,6,3436,2,7200,1.00174621653
510984,510992,514711,8,3719,2,7200,1.00215111589
511060,511066,514813,6,3747,2,7200,1.00160128102
511177,511183,514993,6,3810,2,7200,1.00157480315
511222,511229,515134,7,3905,2,7200,1.00179257362
511282,511289,514770,7,3481,2,7200,1.0020109164
511415,511422,515983,7,4561,2,7200,1.00153475115
511416,511429,515154,13,3725,2,7200,1.00348993289
511449,511455,515742,6,4287,2,7200,1.00139958013
511467,511473,515250,6,3777,2,7200,1.00158856235
512055,512062,516251,7,4189,2,7200,1.00167104321
512233,512240,515969,7,3729,2,7200,1.00187717887
512637,512644,516229,7,3585,2,7200,1.0019525802
512652,512658,516280,6,3622,2,7200,1.00165654335
512712,512718,516764,6,4046,2,7200,1.00148294612
512735,512742,516544,7,3802,2,7200,1.00184113624
512874,512881,516518,7,3637,2,7200,1.00192466318
513064,513071,516858,7,3787,2,7200,1.00184842884
513100,513107,516766,7,3659,2,7200,1.00191309101
513127,513134,517136,7,4002,2,7200,1.00174912544
513221,513234,514789,13,1555,1,18000,1.00836012862
513221,513228,515370,7,2142,1,18000,1.00326797386
513224,513241,515307,17,2066,1,18000,1.00822846079
513226,513246,515105,20,1859,1,18000,1.0107584723
513227,514616,516442,1389,1826,1,18000,1.76067907996
513229,514801,516616,1572,1815,1,18000,1.86611570248
513229,514621,516472,1392,1851,1,18000,1.75202593193
513231,515014,517056,1783,2042,1,18000,1.87316356513
513233,515024,517077,1791,2053,1,18000,1.87238188018
513233,515019,516891,1786,1872,1,18000,1.95405982906
513235,515035,516669,1800,1634,1,18000,2.10159118727
513235,515030,516601,1795,1571,1,18000,2.14258434118
513236,515040,516996,1804,1956,1,18000,1.92229038855
513237,515046,517042,1809,1996,1,18000,1.90631262525
513238,515051,517154,1813,2103,1,18000,1.86210175939
513239,515058,517412,1819,2354,1,18000,1.77272727273
513240,515063,517304,1823,2241,1,18000,1.81347612673
513269,513275,517136,6,3861,2,7200,1.00155400155
513314,513321,517342,7,4021,2,7200,1.00174086048
513328,513336,517309,8,3973,2,7200,1.00201359174
513383,513389,518205,6,4816,2,7200,1.00124584718
513397,513404,517261,7,3857,2,7200,1.00181488203
513509,513516,517138,7,3622,2,7200,1.0019326339
513753,513760,517688,7,3928,2,7200,1.00178207739
513810,513816,517511,6,3695,2,7200,1.00162381597
513825,513831,517338,6,3507,2,7200,1.00171086399
513861,513868,517330,7,3462,2,7200,1.00202195263
513875,513882,517428,7,3546,2,7200,1.00197405527
513914,513920,517355,6,3435,2,7200,1.00174672489
514023,514029,518005,6,3976,2,7200,1.00150905433
514037,514043,518213,6,4170,2,7200,1.00143884892
514107,514114,517896,7,3782,2,7200,1.00185087255
514154,514162,517800,8,3638,2,7200,1.00219901045
514296,514303,517987,7,3684,2,7200,1.00190010858
514351,514357,518285,6,3928,2,7200,1.00152749491
514365,514372,517703,7,3331,2,7200,1.00210147103
514395,514402,518342,7,3940,2,7200,1.00177664975
514397,514409,518260,12,3851,2,7200,1.00311607375
514713,514720,518857,7,4137,2,7200,1.00169204738
514771,514778,518717,7,3939,2,7200,1.00177710079
514813,514820,518755,7,3935,2,7200,1.00177890724
514994,515001,518623,7,3622,2,7200,1.0019326339
515135,515141,518722,6,3581,2,7200,1.00167550963
515156,515162,519814,6,4652,2,7200,1.00128976784
515252,515258,518817,6,3559,2,7200,1.00168586682
515744,515750,519701,6,3951,2,7200,1.00151860289
515970,515977,519761,7,3784,2,7200,1.00184989429
515985,515991,519956,6,3965,2,7200,1.00151324086
516229,516236,520011,7,3775,2,7200,1.00185430464
516253,516260,520215,7,3955,2,7200,1.0017699115
516283,516290,519805,7,3515,2,7200,1.00199146515
516521,516527,520219,6,3692,2,7200,1.00162513543
516545,516552,520985,7,4433,2,7200,1.0015790661
516765,516771,520354,6,3583,2,7200,1.00167457438
516779,516786,520802,7,4016,2,7200,1.00174302789
516860,516867,520838,7,3971,2,7200,1.00176278016
517132,517138,521079,6,3941,2,7200,1.00152245623
517146,517153,521049,7,3896,2,7200,1.00179671458
517148,517160,521114,12,3954,2,7200,1.00303490137
517262,517269,521002,7,3733,2,7200,1.00187516743
517310,517318,521043,8,3725,2,7200,1.00214765101
517331,517338,521223,7,3885,2,7200,1.0018018018
517346,517352,520866,6,3514,2,7200,1.00170745589
517347,517359,520984,12,3625,2,7200,1.00331034483
517362,517370,520624,8,3254,2,7200,1.0024585126
517428,517435,521017,7,3582,2,7200,1.00195421552
517450,518600,520490,1150,1890,1,18000,1.60846560847
517451,518606,520752,1155,2146,1,18000,1.53821062442
517452,518611,520739,1159,2128,1,18000,1.54464285714
517454,518617,520880,1163,2263,1,18000,1.51391957578
517456,518622,520830,1166,2208,1,18000,1.52807971014
517457,518628,520297,1171,1669,1,18000,1.70161773517
517459,518633,520716,1174,2083,1,18000,1.56361017763
517460,518639,521032,1179,2393,1,18000,1.49268700376
517462,518644,520642,1182,1998,1,18000,1.59159159159
517463,518649,520454,1186,1805,1,18000,1.65706371191
517466,518734,520861,1268,2127,1,18000,1.59614480489
517468,518739,520781,1271,2042,1,18000,1.62242899119
517470,518832,521025,1362,2193,1,18000,1.62106703146
517472,518837,520762,1365,1925,1,18000,1.70909090909
517473,519363,521571,1890,2208,1,18000,1.85597826087
517476,519368,521255,1892,1887,1,18000,2.00264970853
517477,519373,520697,1896,1324,1,18000,2.43202416918
517507,517514,521197,7,3683,2,7200,1.00190062449
517688,517694,521542,6,3848,2,7200,1.00155925156
517702,517709,521259,7,3550,2,7200,1.00197183099
517802,517809,521125,7,3316,2,7200,1.00211097708
517895,517902,521774,7,3872,2,7200,1.00180785124
517988,517994,521401,6,3407,2,7200,1.00176108013
518006,518012,521829,6,3817,2,7200,1.00157191512
518205,518211,521700,6,3489,2,7200,1.00171969046
518219,518226,522507,7,4281,2,7200,1.00163513198
518262,518268,522770,6,4502,2,7200,1.001332741
518285,518291,522094,6,3803,2,7200,1.00157770181
518342,518349,521913,7,3564,2,7200,1.0019640853
518624,518656,522455,32,3799,2,7200,1.00842326928
518720,518727,522525,7,3798,2,7200,1.0018430753
518735,518745,522625,10,3880,2,7200,1.00257731959
518755,518763,522637,8,3874,2,7200,1.00206504904
518819,518825,522341,6,3516,2,7200,1.00170648464
518857,518865,522800,8,3935,2,7200,1.00203303685
519703,519710,523746,7,4036,2,7200,1.00173439049
519763,519769,523936,6,4167,2,7200,1.00143988481
519807,519815,523725,8,3910,2,7200,1.00204603581
519822,519828,523461,6,3633,2,7200,1.00165152766
519958,519965,523850,7,3885,2,7200,1.0018018018
520012,520018,524096,6,4078,2,7200,1.00147130947
520217,520223,524201,6,3978,2,7200,1.00150829563
520231,520239,524018,8,3779,2,7200,1.00211696216
520355,520361,524633,6,4272,2,7200,1.00140449438
520626,520634,524121,8,3487,2,7200,1.00229423573
520804,520810,524371,6,3561,2,7200,1.00168491997
520840,520846,524744,6,3898,2,7200,1.0015392509
520867,520875,524711,8,3836,2,7200,1.00208550574
520985,520991,524635,6,3644,2,7200,1.00164654226
520986,520998,525091,12,4093,2,7200,1.00293183484
521004,521011,524743,7,3732,2,7200,1.00187566988
521019,521025,525083,6,4058,2,7200,1.00147856087
521043,521050,525054,7,4004,2,7200,1.00174825175
521057,521063,525223,6,4160,2,7200,1.00144230769
521081,521087,524872,6,3785,2,7200,1.00158520476
521114,521120,525180,6,4060,2,7200,1.00147783251
521129,521135,525047,6,3912,2,7200,1.00153374233
521198,521204,524710,6,3506,2,7200,1.00171135197
521201,521211,521499,10,288,4,14400,1.03472222222
521224,521231,524984,7,3753,2,7200,1.00186517453
521260,521266,525129,6,3863,2,7200,1.001553197
521399,521405,525070,6,3665,2,7200,1.00163710778
521506,521513,521591,7,78,4,86400,1.08974358974
521544,521551,525243,7,3692,2,7200,1.00189599133
521629,521636,523985,7,2349,1,18000,1.00297999149
521631,521642,523970,11,2328,1,18000,1.00472508591
521633,521651,523168,18,1517,1,18000,1.01186552406
521637,521657,523295,20,1638,1,18000,1.01221001221
521638,521663,523679,25,2016,1,18000,1.01240079365
521642,521874,523818,232,1944,1,18000,1.11934156379
521643,521879,523533,236,1654,1,18000,1.14268440145
521644,521884,523664,240,1780,1,18000,1.13483146067
521649,521890,523772,241,1882,1,18000,1.12805526036
521651,521895,523808,244,1913,1,18000,1.12754835337
521653,521901,523533,248,1632,1,18000,1.15196078431
521654,521906,523818,252,1912,1,18000,1.13179916318
521658,521911,523849,253,1938,1,18000,1.13054695562
521659,521917,523587,258,1670,1,18000,1.15449101796
521660,521922,523924,262,2002,1,18000,1.13086913087
521661,521927,523717,266,1790,1,18000,1.14860335196
521663,521933,523677,270,1744,1,18000,1.15481651376
521700,521706,525778,6,4072,2,7200,1.00147347741
521776,521783,525619,7,3836,2,7200,1.00182481752
521830,521837,524993,7,3156,2,7200,1.00221799747
521914,521940,525660,26,3720,2,7200,1.00698924731
522096,522102,525697,6,3595,2,7200,1.0016689847
522343,522349,526232,6,3883,2,7200,1.00154519701
522458,522465,526329,7,3864,2,7200,1.0018115942
522509,522515,526242,6,3727,2,7200,1.00160987389
522526,522534,526026,8,3492,2,7200,1.00229095074
522626,522632,526761,6,4129,2,7200,1.00145313635
522640,522647,526405,7,3758,2,7200,1.00186269292
522773,522779,526816,6,4037,2,7200,1.00148625217
522803,522809,526569,6,3760,2,7200,1.00159574468
523461,523468,527270,7,3802,2,7200,1.00184113624
523724,523732,527709,8,3977,2,7200,1.00201156651
523748,523755,527349,7,3594,2,7200,1.0019476906
523850,523856,527379,6,3523,2,7200,1.00170309395
523938,523945,527993,7,4048,2,7200,1.00172924901
524019,524025,527394,6,3369,2,7200,1.0017809439
524038,524044,526215,6,2171,1,18000,1.00276370336
524040,524051,526134,11,2083,1,18000,1.00528084494
524043,524057,525978,14,1921,1,18000,1.0072878709
524045,524062,526105,17,2043,1,18000,1.00832109643
524051,524069,525896,18,1827,1,18000,1.00985221675
524056,524074,525552,18,1478,1,18000,1.01217861976
524064,524080,526359,16,2279,1,18000,1.00702062308
524071,524086,525988,15,1902,1,18000,1.00788643533
524075,524093,526069,18,1976,1,18000,1.00910931174
524079,524098,526201,19,2103,1,18000,1.00903471232
524081,524104,525702,23,1598,1,18000,1.01439299124
524084,524109,526243,25,2134,1,18000,1.01171508903
524085,524114,526194,29,2080,1,18000,1.01394230769
524087,524120,526404,33,2284,1,18000,1.01444833625
524088,524132,526161,44,2029,1,18000,1.02168555939
524089,524216,526377,127,2161,1,18000,1.05876908839
524097,524221,525623,124,1402,1,18000,1.08844507846
524097,524127,528096,30,3969,2,7200,1.00755857899
524124,524140,527656,16,3516,2,7200,1.00455062571
524202,524208,527481,6,3273,2,7200,1.00183318057
524371,524377,528261,6,3884,2,7200,1.00154479918
524633,524640,528495,7,3855,2,7200,1.00181582361
524648,524654,528471,6,3817,2,7200,1.00157191512
524711,524717,528119,6,3402,2,7200,1.00176366843
524712,524724,528813,12,4089,2,7200,1.00293470286
524743,524749,528530,6,3781,2,7200,1.00158688178
524744,524756,528191,12,3435,2,7200,1.00349344978
524873,524879,528552,6,3673,2,7200,1.00163354206
524984,524992,528734,8,3742,2,7200,1.00213789417
524999,525007,528475,8,3468,2,7200,1.00230680507
525047,525055,528768,8,3713,2,7200,1.00215459197
525062,525068,529275,6,4207,2,7200,1.00142619444
525077,525083,529351,6,4268,2,7200,1.00140581068
525093,525100,528496,7,3396,2,7200,1.00206124853
525094,525107,528591,13,3484,2,7200,1.00373134328
525130,525136,528643,6,3507,2,7200,1.00171086399
525181,525187,528693,6,3506,2,7200,1.00171135197
525223,525229,528902,6,3673,2,7200,1.00163354206
525244,525251,529014,7,3763,2,7200,1.00186021791
525619,525625,529397,6,3772,2,7200,1.00159066808
525661,525668,529802,7,4134,2,7200,1.00169327528
525700,525706,529863,6,4157,2,7200,1.00144334857
525778,525784,529845,6,4061,2,7200,1.0014774686
525907,525913,532276,6,6363,12,86400,1.00094295144
526025,526033,529863,8,3830,2,7200,1.00208877285
526234,526240,530643,6,4403,2,7200,1.00136270725
526248,526256,530315,8,4059,2,7200,1.0019709288
526329,526336,530039,7,3703,2,7200,1.00189035917
526405,526411,529949,6,3538,2,7200,1.00169587337
526458,526464,528457,6,1993,1,18000,1.00301053688
526459,526470,528197,11,1727,1,18000,1.00636942675
526459,526477,528356,18,1879,1,18000,1.0095795636
526461,526482,528539,21,2057,1,18000,1.01020904229
526461,526488,528359,27,1871,1,18000,1.01443078568
526462,526493,528482,31,1989,1,18000,1.01558572147
526463,526498,528306,35,1808,1,18000,1.01935840708
526464,526503,527809,39,1306,1,18000,1.02986217458
526465,526509,528047,44,1538,1,18000,1.02860858257
526467,526514,528434,47,1920,1,18000,1.02447916667
526468,526525,528442,57,1917,1,18000,1.02973395931
526468,526519,528550,51,2031,1,18000,1.02511078287
526469,526530,527785,61,1255,1,18000,1.04860557769
526470,526535,528395,65,1860,1,18000,1.03494623656
526471,526541,528576,70,2035,1,18000,1.0343980344
526472,526547,528408,75,1861,1,18000,1.04030091349
526473,526552,528629,79,2077,1,18000,1.03803562831
526569,526575,530429,6,3854,2,7200,1.00155682408
526717,526724,526726,7,2,2,3540,1.0
526763,526770,530636,7,3866,2,7200,1.00181065701
526817,526823,530446,6,3623,2,7200,1.00165608612
527272,527279,531510,7,4231,2,7200,1.00165445521
527348,527354,531455,6,4101,2,7200,1.00146305779
527381,527388,531337,7,3949,2,7200,1.00177260066
527396,527403,530941,7,3538,2,7200,1.00197851894
527483,527490,531238,7,3748,2,7200,1.00186766275
527658,527665,531361,7,3696,2,7200,1.00189393939
527709,527715,531539,6,3824,2,7200,1.00156903766
527722,527728,527916,6,188,1,3600,1.03191489362
527993,528000,531632,7,3632,2,7200,1.00192731278
528073,528080,528474,7,394,1,3600,1.01776649746
528096,528103,532013,7,3910,2,7200,1.00179028133
528120,528126,532203,6,4077,2,7200,1.00147167035
528192,528198,532065,6,3867,2,7200,1.00155159038
528261,528268,532008,7,3740,2,7200,1.00187165775
528472,528479,532416,7,3937,2,7200,1.00177800356
528487,528493,532078,6,3585,2,7200,1.00167364017
528502,528509,532321,7,3812,2,7200,1.0018363064
528503,528515,532322,12,3807,2,7200,1.00315208826
528530,528536,532576,6,4040,2,7200,1.00148514851
528555,528561,532164,6,3603,2,7200,1.00166527893
528593,528600,532163,7,3563,2,7200,1.00196463654
528641,528649,532525,8,3876,2,7200,1.00206398349
528692,528699,532860,7,4161,2,7200,1.00168228791
528735,528742,532551,7,3809,2,7200,1.00183775269
528748,528759,530611,11,1852,1,18000,1.00593952484
528748,528754,529900,6,1146,1,18000,1.00523560209
528749,528766,530141,17,1375,1,18000,1.01236363636
528749,528772,530543,23,1771,1,18000,1.01298701299
528750,528777,530112,27,1335,1,18000,1.0202247191
528751,528782,530598,31,1816,1,18000,1.01707048458
528752,528793,530238,41,1445,1,18000,1.02837370242
528752,528788,530756,36,1968,1,18000,1.01829268293
528753,528798,530658,45,1860,1,18000,1.02419354839
528753,528804,530781,51,1977,1,18000,1.02579666161
528754,528809,530306,55,1497,1,18000,1.03674014696
528755,528819,530891,64,2072,1,18000,1.03088803089
528755,528814,530774,59,1960,1,18000,1.03010204082
528755,528916,530435,161,1519,1,18000,1.10599078341
528756,528921,530905,165,1984,1,18000,1.08316532258
528757,529029,530950,272,1921,1,18000,1.14159292035
528759,529034,530687,275,1653,1,18000,1.16636418633
528771,528826,532675,55,3849,2,7200,1.01428942582
528813,528831,533051,18,4220,2,7200,1.00426540284
528849,529291,530228,442,937,1,3600,1.47171824973
528903,528909,532363,6,3454,2,7200,1.00173711639
529015,529022,532801,7,3779,2,7200,1.00185234189
529277,529283,533259,6,3976,2,7200,1.00150905433
529353,529359,533539,6,4180,2,7200,1.0014354067
529397,529405,532824,8,3419,2,7200,1.00233986546
529801,529809,533284,8,3475,2,7200,1.00230215827
529846,529852,533677,6,3825,2,7200,1.00156862745
529864,529870,533702,6,3832,2,7200,1.001565762
529866,529878,533560,12,3682,2,7200,1.00325909832
529950,529956,533599,6,3643,2,7200,1.00164699424
530040,530047,533671,7,3624,2,7200,1.00193156733
530316,530322,534173,6,3851,2,7200,1.00155803687
530430,530437,534284,7,3847,2,7200,1.00181959969
530448,530454,533782,6,3328,2,7200,1.00180288462
530638,530644,534624,6,3980,2,7200,1.00150753769
530653,530659,534336,6,3677,2,7200,1.00163176503
530945,530952,534500,7,3548,2,7200,1.0019729425
530987,530997,532669,10,1672,1,18000,1.00598086124
530987,531004,532935,17,1931,1,18000,1.00880372864
530988,531011,532977,23,1966,1,18000,1.01169888098
530989,531016,532787,27,1771,1,18000,1.01524562394
530990,531022,532766,32,1744,1,18000,1.01834862385
530991,531027,532666,36,1639,1,18000,1.02196461257
530995,531033,533256,38,2223,1,18000,1.01709401709
530997,531038,532641,41,1603,1,18000,1.02557704304
531000,531043,532653,43,1610,1,18000,1.02670807453
531001,531049,532717,48,1668,1,18000,1.02877697842
531002,531054,533065,52,2011,1,18000,1.0258577822
531002,531059,532886,57,1827,1,18000,1.03119868637
531003,531065,533022,62,1957,1,18000,1.03168114461
531004,531070,532622,66,1552,1,18000,1.0425257732
531005,531075,532991,70,1916,1,18000,1.03653444676
531006,531083,533019,77,1936,1,18000,1.03977272727
531007,531088,532845,81,1757,1,18000,1.04610130905
531243,531250,535522,7,4272,2,7200,1.00163857678
531339,531345,535273,6,3928,2,7200,1.00152749491
531339,531351,531545,12,194,1,3600,1.0618556701
531363,531370,535143,7,3773,2,7200,1.00185528757
531456,531463,535184,7,3721,2,7200,1.00188121473
531501,531508,531663,7,155,1,3600,1.04516129032
531510,531516,535259,6,3743,2,7200,1.00160299225
531537,531543,535269,6,3726,2,7200,1.00161030596
531633,531639,535873,6,4234,2,7200,1.00141709967
531767,531775,532171,8,396,1,3600,1.0202020202
531869,531875,532242,6,367,1,3600,1.01634877384
532011,532017,535598,6,3581,2,7200,1.00167550963
532013,532024,536046,11,4022,2,7200,1.00273495773
532064,532071,535966,7,3895,2,7200,1.00179717587
532079,532085,535551,6,3466,2,7200,1.00173110214
532166,532172,536075,6,3903,2,7200,1.00153727902
532167,532181,535916,14,3735,2,7200,1.00374832664
532203,532210,535808,7,3598,2,7200,1.00194552529
532322,532329,536091,7,3762,2,7200,1.00186071239
532323,532336,536349,13,4013,2,7200,1.00323947172
532362,532369,535991,7,3622,2,7200,1.0019326339
532416,532423,536622,7,4199,2,7200,1.00166706359
532525,532532,536448,7,3916,2,7200,1.0017875383
532546,532552,533456,6,904,1,3600,1.00663716814
532549,532560,536247,11,3687,2,7200,1.00298345538
532578,532586,536150,8,3564,2,7200,1.00224466891
532675,532681,537512,6,4831,2,7200,1.00124197889
532759,532766,533441,7,675,1,3600,1.01037037037
532803,532810,536713,7,3903,2,7200,1.00179349219
532824,532831,536488,7,3657,2,7200,1.00191413727
532860,532866,536538,6,3672,2,7200,1.00163398693
533053,533059,536530,6,3471,2,7200,1.00172860847
533258,533264,536933,6,3669,2,7200,1.00163532298
533285,533291,536598,6,3307,2,7200,1.00181433323
533335,533343,535171,8,1828,1,18000,1.00437636761
533338,533350,534933,12,1583,1,18000,1.00758054327
533340,533355,534930,15,1575,1,18000,1.00952380952
533341,533360,535192,19,1832,1,18000,1.01037117904
533343,533365,535435,22,2070,1,18000,1.01062801932
533344,533371,535701,27,2330,1,18000,1.01158798283
533346,533378,535205,32,1827,1,18000,1.017515052
533347,533383,535521,36,2138,1,18000,1.01683816651
533350,533389,535341,39,1952,1,18000,1.0199795082
533352,533394,535326,42,1932,1,18000,1.02173913043
533352,533399,535263,47,1864,1,18000,1.02521459227
533355,533405,535725,50,2320,1,18000,1.02155172414
533356,533410,535391,54,1981,1,18000,1.02725896012
533358,533415,535295,57,1880,1,18000,1.03031914894
533359,533420,535353,61,1933,1,18000,1.03155716503
533360,533426,534950,66,1524,1,18000,1.04330708661
533361,533431,535013,70,1582,1,18000,1.04424778761
533543,533550,536989,7,3439,2,7200,1.00203547543
533561,533567,537389,6,3822,2,7200,1.00156985871
533600,533607,536802,7,3195,2,7200,1.00219092332
533672,533678,537819,6,4141,2,7200,1.00144892538
533687,533693,537654,6,3961,2,7200,1.001514769
533701,533709,537392,8,3683,2,7200,1.00217214228
533783,533790,537311,7,3521,2,7200,1.00198807157
534183,534190,537953,7,3763,2,7200,1.00186021791
534282,534290,537743,8,3453,2,7200,1.00231682595
534337,534344,537892,7,3548,2,7200,1.0019729425
534498,534505,538253,7,3748,2,7200,1.00186766275
534626,534632,538182,6,3550,2,7200,1.00169014085
534748,534756,534884,8,128,1,3600,1.0625
534987,534993,535125,6,132,1,1800,1.04545454545
535038,535044,535391,6,347,1,3600,1.01729106628
535145,535151,539280,6,4129,2,7200,1.00145313635
535184,535190,538774,6,3584,2,7200,1.00167410714
535259,535267,538932,8,3665,2,7200,1.00218281037
535274,535281,539025,7,3744,2,7200,1.00186965812
535275,535288,539436,13,4148,2,7200,1.0031340405
535436,535443,535579,7,136,1,1800,1.05147058824
535521,535528,539196,7,3668,2,7200,1.00190839695
535550,535557,539321,7,3764,2,7200,1.0018597237
535601,535607,539325,6,3718,2,7200,1.00161377084
535809,535815,539286,6,3471,2,7200,1.00172860847
535818,535824,537720,6,1896,1,18000,1.00316455696
535822,535831,537776,9,1945,1,18000,1.00462724936
535824,535836,537932,12,2096,1,18000,1.00572519084
535825,535842,537613,17,1771,1,18000,1.00959909656
535826,535849,537768,23,1919,1,18000,1.01198540907
535827,535854,537948,27,2094,1,18000,1.01289398281
535828,535860,537782,32,1922,1,18000,1.01664932362
535829,535865,537524,36,1659,1,18000,1.02169981917
535830,535870,537652,40,1782,1,18000,1.02244668911
535830,535875,537774,45,1899,1,18000,1.02369668246
535832,535897,536595,65,698,1,3600,1.09312320917
535839,535881,537822,42,1941,1,18000,1.02163833076
535840,535886,537684,46,1798,1,18000,1.0255839822
535841,535891,537518,50,1627,1,18000,1.0307314075
535844,535909,537784,65,1875,1,18000,1.03466666667
535846,535915,538079,69,2164,1,18000,1.03188539741
535847,535920,538058,73,2138,1,18000,1.03414405987
535848,535925,537896,77,1971,1,18000,1.03906646372
535873,535904,539420,31,3516,2,7200,1.00881683732
535918,535932,539701,14,3769,2,7200,1.00371451313
535966,535972,540017,6,4045,2,7200,1.00148331273
535993,536000,539906,7,3906,2,7200,1.0017921147
536047,536053,539912,6,3859,2,7200,1.00155480694
536076,536082,539682,6,3600,2,7200,1.00166666667
536091,536097,540040,6,3943,2,7200,1.001521684
536151,536157,539827,6,3670,2,7200,1.00163487738
536215,536221,536868,6,647,1,1800,1.00927357032
536248,536255,539773,7,3518,2,7200,1.00198976691
536262,537733,538835,1471,1102,12,86400,2.33484573503
536350,536356,540429,6,4073,2,7200,1.00147311564
536446,536453,540305,7,3852,2,7200,1.0018172378
536489,536496,540116,7,3620,2,7200,1.00193370166
536531,536537,540517,6,3980,2,7200,1.00150753769
536546,536553,540382,7,3829,2,7200,1.00182815356
536599,536606,539963,7,3357,2,7200,1.00208519511
536621,536627,540485,6,3858,2,7200,1.00155520995
536714,536721,540275,7,3554,2,7200,1.00196961171
536802,536808,540435,6,3627,2,7200,1.00165425972
536942,536948,540643,6,3695,2,7200,1.00162381597
536990,536996,540769,6,3773,2,7200,1.00159024649
537311,537317,541083,6,3766,2,7200,1.00159320234
537386,537393,541205,7,3812,2,7200,1.0018363064
537401,537407,541144,6,3737,2,7200,1.00160556596
537513,537520,541005,7,3485,2,7200,1.00200860832
537655,537661,541735,6,4074,2,7200,1.00147275405
537745,537751,541668,6,3917,2,7200,1.00153178453
537820,537826,541408,6,3582,2,7200,1.00167504188
537892,537898,541556,6,3658,2,7200,1.00164024057
537955,537961,541484,6,3523,2,7200,1.00170309395
538182,538189,541779,7,3590,2,7200,1.00194986072
538218,538226,539932,8,1706,1,18000,1.00468933177
538220,538233,540377,13,2144,1,18000,1.00606343284
538221,538238,540352,17,2114,1,18000,1.00804162725
538222,538244,540149,22,1905,1,18000,1.01154855643
538223,538249,540424,26,2175,1,18000,1.01195402299
538225,538254,540326,29,2072,1,18000,1.013996139
538226,538260,540067,34,1807,1,18000,1.01881571666
538227,538272,540264,45,1992,1,18000,1.02259036145
538228,538278,540145,50,1867,1,18000,1.02678093198
538229,538283,540248,54,1965,1,18000,1.02748091603
538234,538288,540239,54,1951,1,18000,1.02767811379
538240,538294,540252,54,1958,1,18000,1.02757916241
538244,538299,540409,55,2110,1,18000,1.02606635071
538245,538790,540918,545,2128,1,18000,1.25610902256
538246,538795,541089,549,2294,1,18000,1.23931996513
538247,538848,540815,601,1967,1,18000,1.30554143366
538247,538853,540804,606,1951,1,18000,1.31060994362
538251,538267,542234,16,3967,2,7200,1.00403327451
538776,538783,542207,7,3424,2,7200,1.00204439252
538826,538858,538977,32,119,1,1800,1.26890756303
538864,538870,538954,6,84,1,1800,1.07142857143
538933,538939,542508,6,3569,2,7200,1.00168114318
539028,539035,542579,7,3544,2,7200,1.0019751693
539195,539201,543360,6,4159,2,7200,1.00144265448
539262,539269,539375,7,106,1,1800,1.06603773585
539264,539342,549756,78,10414,12,86400,1.00748991742
539279,539285,542947,6,3662,2,7200,1.00163844894
539294,539300,542984,6,3684,2,7200,1.0016286645
539321,539327,542872,6,3545,2,7200,1.00169252468
539329,539335,539479,6,144,1,1800,1.04166666667
539336,539347,543050,11,3703,2,7200,1.00297056441
539424,539431,543104,7,3673,2,7200,1.00190579907
539438,539445,542844,7,3399,2,7200,1.00205942924
539684,539692,543575,8,3883,2,7200,1.00206026268
539702,539708,543309,6,3601,2,7200,1.00166620383
539772,539779,543319,7,3540,2,7200,1.00197740113
539829,539835,543169,6,3334,2,7200,1.00179964007
539907,539913,543913,6,4000,2,7200,1.0015
539922,539928,543352,6,3424,2,7200,1.00175233645
539961,539968,543785,7,3817,2,7200,1.00183390097
540018,540025,543439,7,3414,2,7200,1.00205038079
540039,540047,543706,8,3659,2,7200,1.00218638972
540118,540124,543788,6,3664,2,7200,1.00163755459
540236,540243,540920,7,677,1,1800,1.01033973412
540278,540284,544363,6,4079,2,7200,1.00147094876
540305,540311,543761,6,3450,2,7200,1.00173913043
540383,540390,544048,7,3658,2,7200,1.001913614
540396,540402,540739,6,337,1,1800,1.0178041543
540428,540434,544037,6,3603,2,7200,1.00166527893
540443,540449,543953,6,3504,2,7200,1.00171232877
540484,540492,544298,8,3806,2,7200,1.0021019443
540517,540523,544150,6,3627,2,7200,1.00165425972
540644,540650,544098,6,3448,2,7200,1.00174013921
540772,540779,544331,7,3552,2,7200,1.00197072072
541010,541016,544697,6,3681,2,7200,1.00162999185
541085,541091,544882,6,3791,2,7200,1.00158269586
541145,541153,544949,8,3796,2,7200,1.00210748156
541206,541212,544840,6,3628,2,7200,1.00165380375
541254,541260,543138,6,1878,1,18000,1.00319488818
541256,541267,543532,11,2265,1,18000,1.00485651214
541257,541272,543450,15,2178,1,18000,1.00688705234
541259,541278,543122,19,1844,1,18000,1.01030368764
541261,541283,543505,22,2222,1,18000,1.0099009901
541262,541289,543200,27,1911,1,18000,1.01412872841
541263,541295,543429,32,2134,1,18000,1.01499531396
541265,541300,543469,35,2169,1,18000,1.01613646842
541267,541306,543300,39,1994,1,18000,1.01955867603
541268,541314,543382,46,2068,1,18000,1.02224371373
541269,541319,543048,50,1729,1,18000,1.02891844997
541270,541324,543237,54,1913,1,18000,1.02822791427
541271,541329,543389,58,2060,1,18000,1.02815533981
541273,541335,543220,62,1885,1,18000,1.03289124668
541274,541340,543318,66,1978,1,18000,1.03336703741
541276,541351,543678,75,2327,1,18000,1.03223033949
541276,541345,543350,69,2005,1,18000,1.03441396509
541405,541412,544924,7,3512,2,7200,1.00199316629
541486,541492,544940,6,3448,2,7200,1.00174013921
541558,541564,545421,6,3857,2,7200,1.00155561317
541670,541677,545320,7,3643,2,7200,1.00192149327
541736,541742,545715,6,3973,2,7200,1.00151019381
541775,541781,545373,6,3592,2,7200,1.00167037862
541982,543331,623311,1349,79980,10,432000,1.01686671668
542207,542213,545988,6,3775,2,7200,1.00158940397
542234,542240,546054,6,3814,2,7200,1.00157315155
542508,542515,546174,7,3659,2,7200,1.00191309101
542581,542588,546043,7,3455,2,7200,1.0020260492
542846,542852,546391,6,3539,2,7200,1.00169539418
542873,542879,546732,6,3853,2,7200,1.00155722813
542931,542937,542997,6,60,1,1800,1.1
542948,542954,546778,6,3824,2,7200,1.00156903766
542984,542990,546881,6,3891,2,7200,1.00154202005
543053,543060,546863,7,3803,2,7200,1.00184065212
543104,543110,546877,6,3767,2,7200,1.0015927794
543170,543178,546990,8,3812,2,7200,1.00209863589
543309,543316,546946,7,3630,2,7200,1.00192837466
543324,543336,547071,12,3735,2,7200,1.00321285141
543333,543343,543434,10,91,1,1800,1.10989010989
543354,543360,547102,6,3742,2,7200,1.00160342063
543369,543375,546976,6,3601,2,7200,1.00166620383
543441,543448,547108,7,3660,2,7200,1.00191256831
543578,543585,547259,7,3674,2,7200,1.00190528035
543707,543714,547270,7,3556,2,7200,1.00196850394
543729,543735,545793,6,2058,1,18000,1.0029154519
543730,543743,545601,13,1858,1,18000,1.00699677072
543735,543748,546016,13,2268,1,18000,1.0057319224
543739,543756,545944,17,2188,1,18000,1.00776965265
543740,543761,545861,21,2100,1,18000,1.01
543741,543767,545806,26,2039,1,18000,1.0127513487
543742,543772,545677,30,1905,1,18000,1.0157480315
543745,543777,545854,32,2077,1,18000,1.01540683678
543748,543782,545639,34,1857,1,18000,1.0183091007
543754,543795,545521,41,1726,1,18000,1.02375434531
543756,543801,545757,45,1956,1,18000,1.02300613497
543757,543806,545764,49,1958,1,18000,1.02502553626
543758,543929,545731,171,1802,1,18000,1.0948945616
543759,543934,545997,175,2063,1,18000,1.0848279205
543760,543968,546162,208,2194,1,18000,1.09480401094
543761,543973,545966,212,1993,1,18000,1.10637230306
543762,543790,547448,28,3658,2,7200,1.00765445599
543764,544051,545721,287,1670,1,18000,1.17185628743
543786,543813,547701,27,3888,2,7200,1.00694444444
543800,543818,547440,18,3622,2,7200,1.00496963004
543915,543922,547483,7,3561,2,7200,1.00196573996
543954,543961,547660,7,3699,2,7200,1.00189240335
544038,544044,547723,6,3679,2,7200,1.00163087796
544053,544060,547931,7,3871,2,7200,1.00180831826
544098,544104,547902,6,3798,2,7200,1.00157977883
544152,544160,548013,8,3853,2,7200,1.00207630418
544300,544306,547597,6,3291,2,7200,1.00182315406
544333,544339,548059,6,3720,2,7200,1.00161290323
544366,544374,547873,8,3499,2,7200,1.00228636753
544465,544471,544776,6,305,1,1800,1.01967213115
544698,544706,548042,8,3336,2,7200,1.00239808153
544842,544849,548424,7,3575,2,7200,1.00195804196
544884,544890,548659,6,3769,2,7200,1.0015919342
544926,544933,548751,7,3818,2,7200,1.00183342064
544940,544947,548590,7,3643,2,7200,1.00192149327
544955,544962,548450,7,3488,2,7200,1.00200688073
545321,545329,548737,8,3408,2,7200,1.00234741784
545372,545380,548738,8,3358,2,7200,1.00238237046
545420,545427,548992,7,3565,2,7200,1.00196353436
545716,545722,549531,6,3809,2,7200,1.00157521659
545987,545993,549623,6,3630,2,7200,1.00165289256
546044,546050,549612,6,3562,2,7200,1.00168444694
546059,546066,549514,7,3448,2,7200,1.00203016241
546174,546181,549803,7,3622,2,7200,1.0019326339
546366,546372,547960,6,1588,1,18000,1.00377833753
546369,546379,548483,10,2104,1,18000,1.00475285171
546372,546384,547609,12,1225,1,18000,1.00979591837
546374,546391,548336,17,1945,1,18000,1.0087403599
546375,546396,548321,21,1925,1,18000,1.01090909091
546376,546402,548645,26,2243,1,18000,1.01159161837
546378,546407,548751,29,2344,1,18000,1.01237201365
546380,546413,548360,33,1947,1,18000,1.01694915254
546386,546420,548233,34,1813,1,18000,1.01875344732
546387,546425,548495,38,2070,1,18000,1.01835748792
546388,546430,548524,42,2094,1,18000,1.02005730659
546395,546436,548408,41,1972,1,18000,1.02079107505
546399,546442,548311,43,1869,1,18000,1.02300695559
546401,546447,548330,46,1883,1,18000,1.0244291025
546405,546453,548223,48,1770,1,18000,1.02711864407
546406,546458,548366,52,1908,1,18000,1.02725366876
546410,546463,548309,53,1846,1,18000,1.02871072589
547750,547756,572425,6,24669,1,36000,1.00024322024
548778,548784,550567,6,1783,1,18000,1.00336511497
548779,548791,550603,12,1812,1,18000,1.00662251656
548780,548797,550648,17,1851,1,18000,1.00918422474
548781,548807,550460,26,1653,1,18000,1.01572897762
548781,548802,550778,21,1976,1,18000,1.01062753036
548784,548813,550688,29,1875,1,18000,1.01546666667
548789,548820,550770,31,1950,1,18000,1.0158974359
548792,548825,550886,33,2061,1,18000,1.01601164483
548793,548830,550806,37,1976,1,18000,1.01872469636
548795,548836,550893,41,2057,1,18000,1.01993193972
548798,549005,551191,207,2186,1,18000,1.09469350412
548799,549010,550965,211,1955,1,18000,1.10792838875
548800,549527,551353,727,1826,1,18000,1.39813800657
548802,549532,551290,730,1758,1,18000,1.41524459613
548807,549543,551800,736,2257,1,18000,1.32609658839
548808,549548,551447,740,1899,1,18000,1.3896787783
548808,549625,551263,817,1638,1,18000,1.49877899878
551826,551838,553968,12,2130,1,18000,1.00563380282
551826,551833,553840,7,2007,1,18000,1.00348779273
551827,551845,553783,18,1938,1,18000,1.0092879257
551830,551851,553588,21,1737,1,18000,1.01208981002
551836,551856,553872,20,2016,1,18000,1.00992063492
551838,551866,553788,28,1922,1,18000,1.01456815817
551839,551871,553763,32,1892,1,18000,1.01691331924
551841,551877,554091,36,2214,1,18000,1.0162601626
551842,551888,553810,46,1922,1,18000,1.02393340271
551842,551883,553712,41,1829,1,18000,1.0224166211
551845,551893,553509,48,1616,1,18000,1.0297029703
551845,551899,553899,54,2000,1,18000,1.027
551847,551904,553767,57,1863,1,18000,1.0305958132
551848,551915,553944,67,2029,1,18000,1.03302119271
551848,551909,553883,61,1974,1,18000,1.03090172239
551850,551920,553931,70,2011,1,18000,1.03480855296
551853,551925,554221,72,2296,1,18000,1.03135888502
552759,552764,568068,5,15304,12,86400,1.00032671197
554268,554274,556387,6,2113,1,18000,1.0028395646
554270,554280,556117,10,1837,1,18000,1.00544365814
554275,554286,556129,11,1843,1,18000,1.00596852957
554276,554292,556351,16,2059,1,18000,1.00777076251
554276,554297,556368,21,2071,1,18000,1.01014002897
554280,554302,556138,22,1836,1,18000,1.01198257081
554286,554308,556411,22,2103,1,18000,1.01046124584
554288,554313,556342,25,2029,1,18000,1.01232134056
554293,554324,556275,31,1951,1,18000,1.01588928754
554293,554319,555599,26,1280,1,18000,1.0203125
554296,554330,556293,34,1963,1,18000,1.01732042792
554302,554335,556281,33,1946,1,18000,1.01695786228
554304,554342,556381,38,2039,1,18000,1.01863658656
554308,554347,556453,39,2106,1,18000,1.01851851852
554309,554352,556543,43,2191,1,18000,1.01962574167
554311,554358,555981,47,1623,1,18000,1.02895871842
554315,554363,556270,48,1907,1,18000,1.02517042475
556572,556578,560693,6,4115,2,7200,1.00145808019
556573,556585,560347,12,3762,2,7200,1.00318979266
556575,556590,560330,15,3740,2,7200,1.00401069519
556576,556595,560444,19,3849,2,7200,1.0049363471
556577,556601,560525,24,3924,2,7200,1.00611620795
556579,556606,560735,27,4129,2,7200,1.00653911359
556580,556612,560059,32,3447,2,7200,1.00928343487
556582,556618,560393,36,3775,2,7200,1.00953642384
556583,556623,560647,40,4024,2,7200,1.00994035785
556584,556628,560542,44,3914,2,7200,1.01124169647
556586,556633,560384,47,3751,2,7200,1.012529992
556587,556639,560626,52,3987,2,7200,1.01304238776
556588,556644,560252,56,3608,2,7200,1.0155210643
556590,556649,560420,59,3771,2,7200,1.01564571732
556591,556655,560359,64,3704,2,7200,1.01727861771
556592,556660,560607,68,3947,2,7200,1.01722827464
556594,556665,560705,71,4040,2,7200,1.01757425743
556595,556671,560265,76,3594,2,7200,1.02114635504
556596,556676,560411,80,3735,2,7200,1.02141900937
556598,556681,560409,83,3728,2,7200,1.0222639485
556599,556686,560390,87,3704,2,7200,1.02348812095
556600,556692,560256,92,3564,2,7200,1.02581369248
556602,556697,560025,95,3328,2,7200,1.02854567308
556603,556702,560269,99,3567,2,7200,1.02775441548
556604,556707,560348,103,3641,2,7200,1.02828893161
556606,556713,560505,107,3792,2,7200,1.02821729958
556607,556720,560523,113,3803,2,7200,1.02971338417
556609,556725,560255,116,3530,2,7200,1.0328611898
556610,556730,560489,120,3759,2,7200,1.03192338388
556610,556798,558361,188,1563,1,18000,1.12028150992
556611,556736,560459,125,3723,2,7200,1.03357507387
556611,556803,558581,192,1778,1,18000,1.10798650169
556613,556808,558830,195,2022,1,18000,1.09643916914
556613,556741,560369,128,3628,2,7200,1.03528114664
556614,556746,560657,132,3911,2,7200,1.03375095883
556615,556814,558704,199,1890,1,18000,1.10529100529
556616,556751,560427,135,3676,2,7200,1.03672470076
556616,556819,558200,203,1381,1,18000,1.14699493121
556617,556757,560557,140,3800,2,7200,1.03684210526
556618,556824,558809,206,1985,1,18000,1.10377833753
556618,556762,560680,144,3918,2,7200,1.03675344564
556619,556830,558897,211,2067,1,18000,1.10208030963
556620,556767,560311,147,3544,2,7200,1.0414785553
556621,556772,560383,151,3611,2,7200,1.04181667128
556622,558212,559909,1590,1697,1,18000,1.93694755451
556622,556778,560506,156,3728,2,7200,1.04184549356
556624,556787,560450,163,3663,2,7200,1.0444990445
556624,558372,560281,1748,1909,1,18000,1.9156626506
556625,556792,560445,167,3653,2,7200,1.04571584999
556631,558593,560266,1962,1673,1,18000,2.17274357442
556634,558716,560449,2082,1733,1,18000,2.20138488171
556639,558821,560747,2182,1926,1,18000,2.13291796469
556645,558843,560509,2198,1666,1,18000,2.31932773109
556646,558909,561214,2263,2305,1,18000,1.98177874187
556648,559921,561575,3273,1654,1,18000,2.97883917775
556651,560041,561979,3390,1938,1,18000,2.74922600619
556652,560046,561933,3394,1887,1,18000,2.79862215156
559024,559040,777961,16,218921,6,604800,1.00007308572
559279,581063,617024,21784,35961,6,604800,1.60576735908
559757,560361,561243,604,882,6,88200,1.68480725624
559768,560407,648619,639,88212,6,88200,1.00724391239
559777,560537,562016,760,1479,6,88200,1.5138607167
559786,561254,563390,1468,2136,6,88200,1.6872659176
559796,561945,569200,2149,7255,6,87300,1.29620951068
559807,562028,572952,2221,10924,6,88200,1.20331380447
559815,563403,576113,3588,12710,6,88200,1.28229740362
559822,564269,576694,4447,12425,6,88200,1.35790744467
559828,568090,581051,8262,12961,6,88200,1.63745081398
559834,568095,581761,8261,13666,6,88200,1.60449290209
560027,560034,563436,7,3402,2,7200,1.00205761317
560060,560066,563763,6,3697,2,7200,1.00162293752
560254,560260,563594,6,3334,2,7200,1.00179964007
560255,560266,563711,11,3445,2,7200,1.00319303338
560256,560272,563818,16,3546,2,7200,1.00451212634
560271,560279,563946,8,3667,2,7200,1.00218161985
560273,560284,564143,11,3859,2,7200,1.0028504794
560311,560318,563884,7,3566,2,7200,1.00196298374
560329,560336,563660,7,3324,2,7200,1.00210589651
560347,560354,564078,7,3724,2,7200,1.00187969925
560349,560366,563932,17,3566,2,7200,1.00476724621
560364,560373,564064,9,3691,2,7200,1.00243836359
560379,560386,564229,7,3843,2,7200,1.00182149362
560394,560401,564101,7,3700,2,7200,1.00189189189
560395,560413,563903,18,3490,2,7200,1.00515759312
560397,560418,564094,21,3676,2,7200,1.00571273123
560398,560423,564263,25,3840,2,7200,1.00651041667
560413,560431,564668,18,4237,2,7200,1.00424828888
560414,560436,563840,22,3404,2,7200,1.00646298472
560429,560445,563994,16,3549,2,7200,1.0045083122
560430,560450,564032,20,3582,2,7200,1.00558347292
560445,560457,564420,12,3963,2,7200,1.00302800908
560447,560462,564282,15,3820,2,7200,1.00392670157
560462,560469,564256,7,3787,2,7200,1.00184842884
560463,560476,564252,13,3776,2,7200,1.00344279661
560490,560496,564161,6,3665,2,7200,1.00163710778
560505,560511,564094,6,3583,2,7200,1.00167457438
560520,560527,564061,7,3534,2,7200,1.00198075835
560535,560543,564104,8,3561,2,7200,1.00224655996
560536,560549,564012,13,3463,2,7200,1.00375397055
560551,560558,563912,7,3354,2,7200,1.00208706023
560566,560572,564390,6,3818,2,7200,1.0015715034
560608,560615,564385,7,3770,2,7200,1.00185676393
560626,560632,564508,6,3876,2,7200,1.00154798762
560647,560654,564447,7,3793,2,7200,1.00184550488
560662,560668,564163,6,3495,2,7200,1.0017167382
560676,560684,564292,8,3608,2,7200,1.0022172949
560694,560702,564255,8,3553,2,7200,1.00225161835
560709,560715,564470,6,3755,2,7200,1.00159786951
560736,560743,564211,7,3468,2,7200,1.00201845444
562066,562073,588814,7,26741,1,342000,1.00026177032
562164,569212,569578,7048,366,6,88200,20.2568306011
562173,569590,570188,7417,598,6,88200,13.4030100334
562181,570200,658408,8019,88208,6,88200,1.09091012153
562188,572964,574306,10776,1342,6,88200,9.02980625931
562200,574318,577324,12118,3006,6,87300,5.03127079175
562208,576125,580996,13917,4871,6,88200,3.85711352905
562215,576706,582094,14491,5388,6,88200,3.68949517446
562223,577336,582985,15113,5649,6,88200,3.67534076828
562231,578927,584800,16696,5873,6,88200,3.84284011578
562236,581008,586953,18772,5945,6,88200,4.15761143818
563434,563440,566928,6,3488,2,7200,1.00172018349
563594,563601,567228,7,3627,2,7200,1.00192996967
563660,563667,567153,7,3486,2,7200,1.00200803213
563711,563719,567174,8,3455,2,7200,1.0023154848
563764,563770,567266,6,3496,2,7200,1.00171624714
563818,563824,567837,6,4013,2,7200,1.00149514079
563842,563848,567535,6,3687,2,7200,1.0016273393
563884,563891,567688,7,3797,2,7200,1.00184356071
563905,563912,567643,7,3731,2,7200,1.00187617261
563920,563927,567843,7,3916,2,7200,1.0017875383
563935,563941,567480,6,3539,2,7200,1.00169539418
563949,563956,567500,7,3544,2,7200,1.0019751693
563994,564001,567387,7,3386,2,7200,1.00206733609
564012,564018,567800,6,3782,2,7200,1.00158646219
564030,564037,567691,7,3654,2,7200,1.00191570881
564063,564069,567892,6,3823,2,7200,1.00156944808
564064,564076,567583,12,3507,2,7200,1.00342172797
564079,564086,567625,7,3539,2,7200,1.00197795988
564095,564102,567746,7,3644,2,7200,1.00192096597
564096,564109,567729,13,3620,2,7200,1.00359116022
564111,564117,567796,6,3679,2,7200,1.00163087796
564112,564123,567812,11,3689,2,7200,1.0029818379
564147,564153,567730,6,3577,2,7200,1.00167738328
564161,564168,567764,7,3596,2,7200,1.00194660734
564176,564183,567202,7,3019,2,7200,1.00231864856
564212,564218,568116,6,3898,2,7200,1.0015392509
564230,564236,567609,6,3373,2,7200,1.0017788319
564255,564262,567909,7,3647,2,7200,1.0019193858
564256,564274,567690,18,3416,2,7200,1.00526932084
564271,564281,568023,10,3742,2,7200,1.00267236772
564273,564286,568143,13,3857,2,7200,1.0033704952
564287,564294,568096,7,3802,2,7200,1.00184113624
564302,564308,567856,6,3548,2,7200,1.00169109357
564386,564393,567627,7,3234,2,7200,1.00216450216
564401,564407,568252,6,3845,2,7200,1.00156046814
564419,564425,568448,6,4023,2,7200,1.00149142431
564446,564452,567843,6,3391,2,7200,1.00176938956
564470,564476,568372,6,3896,2,7200,1.00154004107
564509,564516,568177,7,3661,2,7200,1.00191204589
564670,564676,568298,6,3622,2,7200,1.00165654335
565362,585243,645229,19881,59986,16,324000,1.33142733304
566929,566935,570419,6,3484,2,7200,1.00172215844
567155,567162,570847,7,3685,2,7200,1.00189959294
567176,567182,570745,6,3563,2,7200,1.00168397418
567203,567209,570907,6,3698,2,7200,1.00162249865
567230,567236,570915,6,3679,2,7200,1.00163087796
567266,567272,570972,6,3700,2,7200,1.00162162162
567390,567397,570931,7,3534,2,7200,1.00198075835
567480,567487,571033,7,3546,2,7200,1.00197405527
567501,567507,571529,6,4022,2,7200,1.00149179513
567534,567541,571455,7,3914,2,7200,1.00178845171
567585,567591,571245,6,3654,2,7200,1.00164203612
567586,584812,585231,17226,419,14,1560,42.1121718377
567609,567616,571219,7,3603,2,7200,1.00194282542
567624,567630,571643,6,4013,2,7200,1.00149514079
567625,567637,571420,12,3783,2,7200,1.00317208565
567643,567651,571329,8,3678,2,7200,1.00217509516
567689,567695,571551,6,3856,2,7200,1.0015560166
567690,567702,571578,12,3876,2,7200,1.00309597523
567705,567712,571562,7,3850,2,7200,1.00181818182
567729,567735,571385,6,3650,2,7200,1.00164383562
567743,567750,571511,7,3761,2,7200,1.00186120713
567758,567765,571406,7,3641,2,7200,1.00192254875
567773,567779,571318,6,3539,2,7200,1.00169539418
567797,567804,571289,7,3485,2,7200,1.00200860832
567812,567819,571159,7,3340,2,7200,1.00209580838
567826,567834,571363,8,3529,2,7200,1.00226693114
567841,567848,571412,7,3564,2,7200,1.0019640853
567843,567855,571385,12,3530,2,7200,1.00339943343
567858,567865,571625,7,3760,2,7200,1.00186170213
567860,567872,571742,12,3870,2,7200,1.00310077519
567893,567899,571286,6,3387,2,7200,1.00177147919
567911,567917,571386,6,3469,2,7200,1.00172960507
568023,568029,571571,6,3542,2,7200,1.00169395822
568098,568104,571877,6,3773,2,7200,1.00159024649
568116,568123,571644,7,3521,2,7200,1.00198807157
568140,568146,571838,6,3692,2,7200,1.00162513543
568179,568185,572016,6,3831,2,7200,1.00156617071
568254,568262,572334,8,4072,2,7200,1.00196463654
568299,568306,571941,7,3635,2,7200,1.00192572215
568372,568379,572335,7,3956,2,7200,1.00176946411
568450,568457,572138,7,3681,2,7200,1.00190165716
570421,570427,574275,6,3848,2,7200,1.00155925156
570747,570754,574639,7,3885,2,7200,1.0018018018
570847,570853,574403,6,3550,2,7200,1.00169014085
570907,570914,574474,7,3560,2,7200,1.00196629213
570922,570927,574736,5,3809,2,7200,1.00131268049
570936,570943,574365,7,3422,2,7200,1.00204558738
570972,570979,574582,7,3603,2,7200,1.00194282542
571033,571040,574703,7,3663,2,7200,1.00191100191
571159,571165,574781,6,3616,2,7200,1.00165929204
571219,571227,575035,8,3808,2,7200,1.00210084034
571246,571253,575026,7,3773,2,7200,1.00185528757
571283,571289,574669,6,3380,2,7200,1.00177514793
571297,571303,574769,6,3466,2,7200,1.00173110214
571318,571324,574886,6,3562,2,7200,1.00168444694
571333,571339,574908,6,3569,2,7200,1.00168114318
571366,571372,575135,6,3763,2,7200,1.0015944725
571387,571393,574965,6,3572,2,7200,1.00167973124
571388,571400,574795,12,3395,2,7200,1.00353460972
571390,571405,574971,15,3566,2,7200,1.00420639372
571408,571416,575529,8,4113,2,7200,1.00194505227
571423,571429,574827,6,3398,2,7200,1.00176574456
571424,571436,575102,12,3666,2,7200,1.00327332242
571454,571462,575165,8,3703,2,7200,1.00216041048
571512,571519,575423,7,3904,2,7200,1.00179303279
571529,571536,574969,7,3433,2,7200,1.00203903292
571553,571560,575243,7,3683,2,7200,1.00190062449
571569,571575,575210,6,3635,2,7200,1.00165061898
571584,571591,575348,7,3757,2,7200,1.00186318871
571585,571598,575444,13,3846,2,7200,1.00338013521
571627,571634,575186,7,3552,2,7200,1.00197072072
571642,571649,575239,7,3590,2,7200,1.00194986072
571657,571663,575285,6,3622,2,7200,1.00165654335
571745,571752,575258,7,3506,2,7200,1.0019965773
571838,571845,576213,7,4368,2,7200,1.0016025641
571877,571884,575683,7,3799,2,7200,1.00184259016
571944,571951,575842,7,3891,2,7200,1.00179902339
572016,572022,575629,6,3607,2,7200,1.00166343222
572140,572146,575709,6,3563,2,7200,1.00168397418
572337,572343,576041,6,3698,2,7200,1.00162249865
572338,572351,575735,13,3384,2,7200,1.00384160757
574276,574282,577934,6,3652,2,7200,1.00164293538
574364,574371,578014,7,3643,2,7200,1.00192149327
574402,574409,578199,7,3790,2,7200,1.0018469657
574474,574482,577957,8,3475,2,7200,1.00230215827
574583,574590,578281,7,3691,2,7200,1.00189650501
574640,574646,578648,6,4002,2,7200,1.00149925037
574670,574677,578580,7,3903,2,7200,1.00179349219
574703,574709,578393,6,3684,2,7200,1.0016286645
574736,574742,578234,6,3492,2,7200,1.00171821306
574769,574775,578412,6,3637,2,7200,1.0016497113
574783,574790,578538,7,3748,2,7200,1.00186766275
574798,574804,578529,6,3725,2,7200,1.00161073826
574828,574834,578623,6,3789,2,7200,1.00158353127
574888,574896,578327,8,3431,2,7200,1.00233168173
574909,574915,578766,6,3851,2,7200,1.00155803687
574967,574974,578768,7,3794,2,7200,1.00184501845
574968,574981,578714,13,3733,2,7200,1.00348245379
574983,574989,578905,6,3916,2,7200,1.00153217569
575028,575034,578942,6,3908,2,7200,1.00153531218
575043,575051,578505,8,3454,2,7200,1.00231615518
575103,575109,578754,6,3645,2,7200,1.00164609053
575136,575143,578913,7,3770,2,7200,1.00185676393
575166,575173,578747,7,3574,2,7200,1.00195858982
575187,575193,578689,6,3496,2,7200,1.00171624714
575211,575218,578810,7,3592,2,7200,1.00194877506
575241,575248,578720,7,3472,2,7200,1.00201612903
575256,575263,578990,7,3727,2,7200,1.00187818621
575270,575277,578797,7,3520,2,7200,1.00198863636
575285,575292,578915,7,3623,2,7200,1.00193210047
575348,575354,579190,6,3836,2,7200,1.0015641293
575423,575431,578850,8,3419,2,7200,1.00233986546
575444,575450,579059,6,3609,2,7200,1.00166251039
575529,575535,579494,6,3959,2,7200,1.00151553423
575628,575634,579387,6,3753,2,7200,1.00159872102
575682,575689,579436,7,3747,2,7200,1.0018681612
575706,575713,579308,7,3595,2,7200,1.00194714882
575737,575744,579218,7,3474,2,7200,1.00201496834
575842,575848,579431,6,3583,2,7200,1.00167457438
576043,576050,579814,7,3764,2,7200,1.0018597237
576215,576222,579871,7,3649,2,7200,1.00191833379
577934,577941,581713,7,3772,2,7200,1.00185577943
577958,577964,581452,6,3488,2,7200,1.00172018349
578015,578021,581630,6,3609,2,7200,1.00166251039
578199,578206,581915,7,3709,2,7200,1.00188730116
578235,578242,581839,7,3597,2,7200,1.00194606617
578280,578286,581934,6,3648,2,7200,1.00164473684
578328,578334,581733,6,3399,2,7200,1.00176522507
578394,578401,581948,7,3547,2,7200,1.00197349873
578413,578420,581752,7,3332,2,7200,1.00210084034
578506,578512,581905,6,3393,2,7200,1.0017683466
578530,578537,582333,7,3796,2,7200,1.00184404636
578545,578552,582120,7,3568,2,7200,1.00196188341
578581,578587,582342,6,3755,2,7200,1.00159786951
578626,578632,582277,6,3645,2,7200,1.00164609053
578650,578657,582308,7,3651,2,7200,1.00191728294
578688,578695,582178,7,3483,2,7200,1.0020097617
578712,578719,582193,7,3474,2,7200,1.00201496834
578727,578733,582420,6,3687,2,7200,1.0016273393
578748,578755,582183,7,3428,2,7200,1.002042007
578763,578770,582146,7,3376,2,7200,1.00207345972
578778,578784,582182,6,3398,2,7200,1.00176574456
578779,578792,582753,13,3961,2,7200,1.0032819995
578797,578803,582369,6,3566,2,7200,1.00168255749
578812,578818,582767,6,3949,2,7200,1.00151937199
578851,578858,582615,7,3757,2,7200,1.00186318871
578905,578911,582834,6,3923,2,7200,1.00152944175
578920,578932,582211,12,3279,2,7200,1.00365965233
578921,578939,582602,18,3663,2,7200,1.00491400491
578942,578948,582563,6,3615,2,7200,1.00165975104
578990,578996,582572,6,3576,2,7200,1.00167785235
579060,579067,582459,7,3392,2,7200,1.00206367925
579190,579197,582906,7,3709,2,7200,1.00188730116
579220,579226,582612,6,3386,2,7200,1.00177200236
579310,579318,582786,8,3468,2,7200,1.00230680507
579389,579397,583188,8,3791,2,7200,1.00211026114
579432,579439,582822,7,3383,2,7200,1.00206916938
579446,579453,582992,7,3539,2,7200,1.00197795988
579494,579502,583288,8,3786,2,7200,1.00211304807
579815,579821,583404,6,3583,2,7200,1.00167457438
579873,579880,583931,7,4051,2,7200,1.0017279684
579945,581774,629339,1829,47565,4,54000,1.03845264375
580794,581779,683685,985,101906,4,108000,1.00966577042
581455,581462,584843,7,3381,2,7200,1.00207039337
581630,581637,585327,7,3690,2,7200,1.00189701897
581715,581722,585431,7,3709,2,7200,1.00188730116
581735,581742,585561,7,3819,2,7200,1.00183294056
581753,581759,585426,6,3667,2,7200,1.00163621489
581841,581847,585811,6,3964,2,7200,1.0015136226
581907,581913,585661,6,3748,2,7200,1.00160085379
581921,581929,585564,8,3635,2,7200,1.00220082531
581936,581943,585290,7,3347,2,7200,1.00209142516
581951,581957,585694,6,3737,2,7200,1.00160556596
582123,582129,586153,6,4024,2,7200,1.00149105368
582147,582153,585868,6,3715,2,7200,1.00161507402
582180,582186,585968,6,3782,2,7200,1.00158646219
582195,582201,585445,6,3244,2,7200,1.00184956843
582196,582208,585732,12,3524,2,7200,1.00340522134
582198,582213,585555,15,3342,2,7200,1.00448833034
582213,582220,586054,7,3834,2,7200,1.00182576943
582279,582286,585945,7,3659,2,7200,1.00191309101
582309,582316,585935,7,3619,2,7200,1.00193423598
582333,582340,585932,7,3592,2,7200,1.00194877506
582348,582354,585936,6,3582,2,7200,1.00167504188
582369,582375,585604,6,3229,2,7200,1.00185816042
582420,582427,586160,7,3733,2,7200,1.00187516743
582459,582466,585824,7,3358,2,7200,1.00208457415
582564,582571,586406,7,3835,2,7200,1.00182529335
582579,582585,586090,6,3505,2,7200,1.00171184023
582603,582610,586296,7,3686,2,7200,1.00189907759
582618,582625,586284,7,3659,2,7200,1.00191309101
582619,582630,586414,11,3784,2,7200,1.00290697674
582752,582758,586116,6,3358,2,7200,1.00178677784
582770,582776,586240,6,3464,2,7200,1.00173210162
582788,582794,586421,6,3627,2,7200,1.00165425972
582824,582831,586638,7,3807,2,7200,1.00183871815
582839,582846,586509,7,3663,2,7200,1.00191100191
582908,582916,586407,8,3491,2,7200,1.00229160699
582992,583000,586687,8,3687,2,7200,1.00216978573
583190,583196,586944,6,3748,2,7200,1.00160085379
583289,583295,586584,6,3289,2,7200,1.00182426269
583404,583411,586964,7,3553,2,7200,1.00197016606
583932,583940,587567,8,3627,2,7200,1.00220567963
584846,584853,588402,7,3549,2,7200,1.00197238659
585229,585236,585246,7,10,1,900,1.7
585248,617037,617877,31789,840,14,1560,38.844047619
585292,585298,588727,6,3429,2,7200,1.00174978128
585328,585335,589086,7,3751,2,7200,1.00186616902
585424,585430,589122,6,3692,2,7200,1.00162513543
585439,585446,589092,7,3646,2,7200,1.00191991223
585454,585460,589369,6,3909,2,7200,1.00153491942
585557,585564,589535,7,3971,2,7200,1.00176278016
585572,585579,589401,7,3822,2,7200,1.00183150183
585573,585585,589148,12,3563,2,7200,1.00336794836
585603,585609,589441,6,3832,2,7200,1.001565762
585660,585667,589420,7,3753,2,7200,1.00186517453
585696,585702,589380,6,3678,2,7200,1.00163132137
585735,585742,589734,7,3992,2,7200,1.00175350701
585814,585821,589387,7,3566,2,7200,1.00196298374
585828,585835,589368,7,3533,2,7200,1.00198131899
585871,585877,589652,6,3775,2,7200,1.00158940397
585931,585937,589827,6,3890,2,7200,1.00154241645
585947,585954,589612,7,3658,2,7200,1.001913614
585948,585960,589735,12,3775,2,7200,1.00317880795
585949,585966,589633,17,3667,2,7200,1.00463594219
585970,585977,589715,7,3738,2,7200,1.00187265918
586056,586063,589474,7,3411,2,7200,1.00205218411
586092,586099,589680,7,3581,2,7200,1.00195476124
586116,586122,590033,6,3911,2,7200,1.00153413449
586155,586162,589762,7,3600,2,7200,1.00194444444
586170,586177,589628,7,3451,2,7200,1.00202839757
586242,586249,590110,7,3861,2,7200,1.00181300181
586284,586290,589971,6,3681,2,7200,1.00162999185
586299,586306,589696,7,3390,2,7200,1.00206489676
586405,586412,589956,7,3544,2,7200,1.0019751693
586420,586427,590005,7,3578,2,7200,1.00195640022
586422,586434,590106,12,3672,2,7200,1.00326797386
586423,586439,590066,16,3627,2,7200,1.00441135925
586510,586517,590261,7,3744,2,7200,1.00186965812
586583,586590,590318,7,3728,2,7200,1.0018776824
586640,586646,590420,6,3774,2,7200,1.00158982512
586688,586694,590468,6,3774,2,7200,1.00158982512
586944,586951,590602,7,3651,2,7200,1.00191728294
586962,586969,590517,7,3548,2,7200,1.0019729425
587567,587573,591704,6,4131,2,7200,1.00145243282
588401,588409,591880,8,3471,2,7200,1.00230481129
588727,588734,592506,7,3772,2,7200,1.00185577943
588816,588824,597968,8,9144,1,342000,1.00087489064
589087,589094,592512,7,3418,2,7200,1.00204798128
589102,589108,592728,6,3620,2,7200,1.00165745856
589123,589130,592730,7,3600,2,7200,1.00194444444
589143,589150,592684,7,3534,2,7200,1.00198075835
589366,589373,593122,7,3749,2,7200,1.00186716458
589381,589388,593214,7,3826,2,7200,1.00182958704
589383,589395,592903,12,3508,2,7200,1.00342075257
589398,589405,593209,7,3804,2,7200,1.00184016824
589413,589419,593356,6,3937,2,7200,1.00152400305
589427,589434,593269,7,3835,2,7200,1.00182529335
589443,589449,592655,6,3206,2,7200,1.00187149095
589476,589483,592953,7,3470,2,7200,1.00201729107
589536,589542,593335,6,3793,2,7200,1.00158186132
589614,589621,593137,7,3516,2,7200,1.00199089875
589629,589635,593275,6,3640,2,7200,1.00164835165
589644,589651,593451,7,3800,2,7200,1.00184210526
589659,589666,593287,7,3621,2,7200,1.00193316763
589680,589687,593387,7,3700,2,7200,1.00189189189
589695,589702,593138,7,3436,2,7200,1.00203725262
589716,589722,593731,6,4009,2,7200,1.00149663258
589734,589741,593587,7,3846,2,7200,1.0018200728
589735,589748,593153,13,3405,2,7200,1.00381791483
589762,589769,593628,7,3859,2,7200,1.00181394144
589828,589835,593346,7,3511,2,7200,1.00199373398
589959,589965,593507,6,3542,2,7200,1.00169395822
589973,589980,593776,7,3796,2,7200,1.00184404636
590004,590010,593719,6,3709,2,7200,1.00161768671
590034,590041,593777,7,3736,2,7200,1.00187366167
590067,590073,593774,6,3701,2,7200,1.00162118346
590106,590113,593575,7,3462,2,7200,1.00202195263
590120,590128,593753,8,3625,2,7200,1.00220689655
590262,590269,593687,7,3418,2,7200,1.00204798128
590319,590327,594085,8,3758,2,7200,1.00212879191
590419,590426,594089,7,3663,2,7200,1.00191100191
590467,590475,594090,8,3615,2,7200,1.00221300138
590519,590526,594276,7,3750,2,7200,1.00186666667
590604,590610,594350,6,3740,2,7200,1.00160427807
591331,591337,591339,6,2,2,3540,1.0
591703,591709,595223,6,3514,2,7200,1.00170745589
591878,591885,595311,7,3426,2,7200,1.00204319907
592508,592515,596084,7,3569,2,7200,1.00196133371
592523,592530,596487,7,3957,2,7200,1.00176901693
592656,592663,596128,7,3465,2,7200,1.00202020202
592683,592689,596625,6,3936,2,7200,1.00152439024
592728,592734,596455,6,3721,2,7200,1.00161246977
592729,592740,596453,11,3713,2,7200,1.00296256396
592904,592912,596335,8,3423,2,7200,1.00233713117
592955,592963,596500,8,3537,2,7200,1.00226180379
593122,593129,597055,7,3926,2,7200,1.00178298523
593137,593144,596616,7,3472,2,7200,1.00201612903
593138,593151,596831,13,3680,2,7200,1.0035326087
593153,593160,596822,7,3662,2,7200,1.00191152376
593207,593213,596827,6,3614,2,7200,1.00166021029
593222,593228,597086,6,3858,2,7200,1.00155520995
593270,593276,597155,6,3879,2,7200,1.00154679041
593285,593292,597218,7,3926,2,7200,1.00178298523
593286,593299,597128,13,3829,2,7200,1.00339514233
593334,593342,596841,8,3499,2,7200,1.00228636753
593349,593355,596897,6,3542,2,7200,1.00169395822
593364,593370,597102,6,3732,2,7200,1.00160771704
593388,593395,596845,7,3450,2,7200,1.00202898551
593454,593461,596763,7,3302,2,7200,1.00211992732
593508,593515,597468,7,3953,2,7200,1.00177080698
593574,593581,597205,7,3624,2,7200,1.00193156733
593589,593595,597161,6,3566,2,7200,1.00168255749
593628,593634,597395,6,3761,2,7200,1.00159532039
593688,593695,597567,7,3872,2,7200,1.00180785124
593718,593726,597341,8,3615,2,7200,1.00221300138
593733,593739,597262,6,3523,2,7200,1.00170309395
593754,593761,597346,7,3585,2,7200,1.0019525802
593775,593781,597625,6,3844,2,7200,1.00156087409
593776,593788,597203,12,3415,2,7200,1.00351390922
593791,593798,597235,7,3437,2,7200,1.00203665988
594086,594094,597680,8,3586,2,7200,1.00223089794
594101,594108,597895,7,3787,2,7200,1.00184842884
594103,594114,597991,11,3877,2,7200,1.00283724529
594275,594282,597922,7,3640,2,7200,1.00192307692
594350,594357,597957,7,3600,2,7200,1.00194444444
595225,595231,598787,6,3556,2,7200,1.00168728909
595312,595318,598795,6,3477,2,7200,1.00172562554
596087,596093,599666,6,3573,2,7200,1.00167926113
596129,596136,600042,7,3906,2,7200,1.0017921147
596337,596343,600095,6,3752,2,7200,1.00159914712
596455,596461,600297,6,3836,2,7200,1.0015641293
596456,596468,600295,12,3827,2,7200,1.00313561536
596490,596496,600400,6,3904,2,7200,1.00153688525
596504,596512,600170,8,3658,2,7200,1.00218698742
596619,596625,600413,6,3788,2,7200,1.00158394931
596634,596640,600012,6,3372,2,7200,1.00177935943
596763,596771,600391,8,3620,2,7200,1.00220994475
596824,596830,600385,6,3555,2,7200,1.00168776371
596839,596846,600067,7,3221,2,7200,1.00217323812
596840,596853,600453,13,3600,2,7200,1.00361111111
596855,596862,600683,7,3821,2,7200,1.00183198116
596856,596869,600191,13,3322,2,7200,1.00391330524
596898,596905,600620,7,3715,2,7200,1.00188425303
597056,597062,600746,6,3684,2,7200,1.0016286645
597086,597093,600893,7,3800,2,7200,1.00184210526
597104,597111,600533,7,3422,2,7200,1.00204558738
597128,597134,600535,6,3401,2,7200,1.001764187
597155,597162,600871,7,3709,2,7200,1.00188730116
597157,597169,600862,12,3693,2,7200,1.00324939074
597205,597214,600648,9,3434,2,7200,1.00262085032
597207,597219,600989,12,3770,2,7200,1.00318302387
597222,597228,600819,6,3591,2,7200,1.00167084378
597236,597242,600940,6,3698,2,7200,1.00162249865
597263,597270,601081,7,3811,2,7200,1.00183678824
597342,597349,601334,7,3985,2,7200,1.0017565872
597357,597364,601044,7,3680,2,7200,1.00190217391
597396,597402,600977,6,3575,2,7200,1.00167832168
597469,597475,600900,6,3425,2,7200,1.00175182482
597568,597574,601410,6,3836,2,7200,1.0015641293
597625,597633,601222,8,3589,2,7200,1.00222903316
597680,597687,601617,7,3930,2,7200,1.00178117048
597895,597902,601399,7,3497,2,7200,1.00200171576
597922,597929,601398,7,3469,2,7200,1.00201787259
597955,597961,601662,6,3701,2,7200,1.00162118346
597991,597998,601878,7,3880,2,7200,1.00180412371
598254,598261,610318,7,12057,1,342000,1.0005805756
598789,598795,602617,6,3822,2,7200,1.00156985871
598804,598810,602359,6,3549,2,7200,1.00169061708
599668,599675,603047,7,3372,2,7200,1.00207591934
600013,600020,603773,7,3753,2,7200,1.00186517453
600043,600049,603673,6,3624,2,7200,1.00165562914
600067,600073,603590,6,3517,2,7200,1.00170599943
600094,600101,603666,7,3565,2,7200,1.00196353436
600172,600178,604044,6,3866,2,7200,1.00155199172
600193,600201,604006,8,3805,2,7200,1.00210249671
600296,600304,604108,8,3804,2,7200,1.00210304942
600298,600311,604039,13,3728,2,7200,1.00348712446
600385,600393,603807,8,3414,2,7200,1.00234329233
600400,600406,603869,6,3463,2,7200,1.00173260179
600402,600413,604397,11,3984,2,7200,1.00276104418
600416,600424,604055,8,3631,2,7200,1.00220324979
600453,600460,603927,7,3467,2,7200,1.00201903663
600534,600541,604341,7,3800,2,7200,1.00184210526
600549,600555,603986,6,3431,2,7200,1.00174876129
600621,600628,604532,7,3904,2,7200,1.00179303279
600651,600657,604110,6,3453,2,7200,1.00173761946
600684,600690,604396,6,3706,2,7200,1.00161899622
600747,600755,604354,8,3599,2,7200,1.00222283968
600820,600827,604623,7,3796,2,7200,1.00184404636
600862,600869,604668,7,3799,2,7200,1.00184259016
600877,600884,604484,7,3600,2,7200,1.00194444444
600894,600901,604859,7,3958,2,7200,1.00176856998
600909,600916,604536,7,3620,2,7200,1.00193370166
600939,600947,604595,8,3648,2,7200,1.00219298246
600978,600986,604446,8,3460,2,7200,1.00231213873
600993,600999,604568,6,3569,2,7200,1.00168114318
601044,601051,604794,7,3743,2,7200,1.00187015763
601083,601091,604893,8,3802,2,7200,1.00210415571
601223,601230,604938,7,3708,2,7200,1.00188781014
601335,601341,605054,6,3713,2,7200,1.00161594398
601398,601404,604880,6,3476,2,7200,1.00172612198
601400,601411,605113,11,3702,2,7200,1.00297136683
601415,601421,605435,6,4014,2,7200,1.00149476831
601617,601624,605587,7,3963,2,7200,1.00176633863
601662,601668,605455,6,3787,2,7200,1.00158436757
601877,601884,605508,7,3624,2,7200,1.00193156733
602359,602366,606204,7,3838,2,7200,1.0018238666
602616,602623,606403,7,3780,2,7200,1.00185185185
603048,603054,606714,6,3660,2,7200,1.00163934426
603591,603598,607352,7,3754,2,7200,1.00186467768
603667,603674,607299,7,3625,2,7200,1.00193103448
603681,603688,607385,7,3697,2,7200,1.0018934271
603775,603781,607446,6,3665,2,7200,1.00163710778
603808,603814,607433,6,3619,2,7200,1.00165791655
603871,603877,607661,6,3784,2,7200,1.00158562368
603930,603936,607635,6,3699,2,7200,1.00162206002
603987,603993,607428,6,3435,2,7200,1.00174672489
604008,604014,607914,6,3900,2,7200,1.00153846154
604041,604048,607774,7,3726,2,7200,1.00187869028
604056,604062,607729,6,3667,2,7200,1.00163621489
604057,604070,607802,13,3732,2,7200,1.00348338692
604109,604115,608129,6,4014,2,7200,1.00149476831
604123,604130,608035,7,3905,2,7200,1.00179257362
604341,604348,608034,7,3686,2,7200,1.00189907759
604356,604363,607817,7,3454,2,7200,1.00202663578
604398,604405,608016,7,3611,2,7200,1.00193852119
604400,604412,607675,12,3263,2,7200,1.0036775973
604448,604455,607999,7,3544,2,7200,1.0019751693
604484,604491,608104,7,3613,2,7200,1.0019374481
604532,604539,607970,7,3431,2,7200,1.00204022151
604547,604554,608164,7,3610,2,7200,1.00193905817
604571,604577,608122,6,3545,2,7200,1.00169252468
604595,604601,608308,6,3707,2,7200,1.00161855948
604625,604631,608191,6,3560,2,7200,1.00168539326
604667,604675,608082,8,3407,2,7200,1.00234810684
604795,604802,608390,7,3588,2,7200,1.0019509476
