SubmitTime,StartTime,EndTime,QueuedTime,RunTime,NodesRequested,walltime,bslowdown
6,12,1759,6,1747,2,36000,1.00343445907
66,72,1966,6,1894,2,36000,1.00316789863
84,90,1990,6,1900,2,36000,1.00315789474
151,157,1939,6,1782,2,36000,1.00336700337
197,203,1962,6,1759,2,36000,1.00341102899
217,223,1883,6,1660,2,36000,1.00361445783
236,242,2158,6,1916,2,36000,1.00313152401
237,248,1486,11,1238,2,36000,1.00888529887
263,269,1380,6,1111,2,36000,1.00540054005
305,311,1888,6,1577,2,36000,1.00380469245
320,326,2095,6,1769,2,36000,1.00339174675
371,377,2201,6,1824,2,36000,1.00328947368
437,443,2320,6,1877,2,36000,1.0031965903
453,459,2366,6,1907,2,36000,1.00314630309
471,477,2130,6,1653,2,36000,1.00362976407
506,512,2296,6,1784,2,36000,1.0033632287
523,529,2290,6,1761,2,36000,1.00340715503
542,548,2364,6,1816,2,36000,1.00330396476
558,564,2575,6,2011,2,36000,1.00298359025
581,587,2642,6,2055,2,36000,1.00291970803
603,609,2552,6,1943,2,36000,1.00308800823
659,665,2859,6,2194,2,36000,1.00273473108
675,681,2664,6,1983,2,36000,1.00302571861
691,698,2422,7,1724,2,36000,1.00406032483
710,716,2454,6,1738,2,36000,1.00345224396
742,748,2801,6,2053,2,36000,1.00292255236
760,766,2386,6,1620,2,36000,1.0037037037
790,796,2596,6,1800,2,36000,1.00333333333
812,818,2571,6,1753,2,36000,1.00342270394
814,824,2638,10,1814,2,36000,1.00551267916
847,853,2680,6,1827,2,36000,1.00328407225
862,869,2662,7,1793,2,36000,1.00390407139
898,905,2911,7,2006,2,36000,1.00348953141
919,925,2250,6,1325,2,36000,1.00452830189
934,940,2948,6,2008,2,36000,1.00298804781
949,956,2465,7,1509,2,36000,1.00463883366
951,962,2076,11,1114,2,36000,1.00987432675
966,972,2890,6,1918,2,36000,1.0031282586
967,978,2836,11,1858,2,36000,1.00592034446
969,983,2767,14,1784,2,36000,1.00784753363
984,990,2744,6,1754,2,36000,1.00342075257
985,996,2830,11,1834,2,36000,1.00599781897
987,1001,2195,14,1194,2,36000,1.01172529313
1008,1014,2829,6,1815,2,36000,1.00330578512
1072,1079,3070,7,1991,2,36000,1.0035158212
1111,1117,2525,6,1408,2,36000,1.00426136364
1121,1218,1328,97,110,14,7980,1.88181818182
1133,1140,3677,7,2537,2,36000,1.00275916437
1135,1146,3037,11,1891,2,36000,1.00581702803
1136,1151,2966,15,1815,2,36000,1.00826446281
1151,1157,2991,6,1834,2,36000,1.00327153762
1166,1172,3328,6,2156,2,36000,1.00278293135
1191,1197,2966,6,1769,2,36000,1.00339174675
1205,1212,3122,7,1910,2,36000,1.00366492147
1220,1226,3008,6,1782,2,36000,1.00336700337
1243,1249,3132,6,1883,2,36000,1.00318640467
1244,1255,2983,11,1728,2,36000,1.00636574074
1320,1327,3015,7,1688,2,36000,1.00414691943
1322,1334,1367,12,33,1,900,1.36363636364
1332,1340,1490,8,150,14,7980,1.05333333333
1347,1353,3007,6,1654,2,36000,1.00362756953
1348,1359,3497,11,2138,2,36000,1.00514499532
1364,1370,3271,6,1901,2,36000,1.00315623356
1382,1388,3129,6,1741,2,36000,1.00344629523
1383,1394,3159,11,1765,2,36000,1.00623229462
1434,1440,3354,6,1914,2,36000,1.00313479624
1450,1456,3151,6,1695,2,36000,1.00353982301
1451,1462,3294,11,1832,2,36000,1.00600436681
1453,1467,3069,14,1602,2,36000,1.00873907615
1487,1493,3557,6,2064,2,36000,1.00290697674
1488,1499,1510,11,11,1,900,2.0
1498,1505,1643,7,138,14,7980,1.05072463768
1525,1531,3334,6,1803,2,36000,1.00332778702
1526,1537,3245,11,1708,2,36000,1.00644028103
1542,1548,2685,6,1137,2,36000,1.00527704485
1543,1554,3612,11,2058,2,36000,1.00534499514
1544,1559,3361,15,1802,2,36000,1.00832408435
1563,1569,3306,6,1737,2,36000,1.00345423143
1586,1592,3492,6,1900,2,36000,1.00315789474
1611,1618,3298,7,1680,2,36000,1.00416666667
1613,1624,3599,11,1975,2,36000,1.00556962025
1634,1640,3460,6,1820,2,36000,1.0032967033
1643,1649,1665,6,16,1,900,1.375
1656,1662,3428,6,1766,2,36000,1.00339750849
1669,1675,1852,6,177,14,7980,1.03389830508
1723,1729,3442,6,1713,2,36000,1.00350262697
1760,1766,3665,6,1899,2,36000,1.00315955766
1761,1772,3541,11,1769,2,36000,1.00621820237
1826,1832,3467,6,1635,2,36000,1.00366972477
1846,1852,1982,6,130,1,900,1.04615384615
1850,1858,3729,8,1871,2,36000,1.00427578835
1895,1901,3719,6,1818,2,36000,1.00330033003
1896,1907,3465,11,1558,2,36000,1.00706033376
1943,1950,3702,7,1752,2,36000,1.00399543379
1965,1971,3741,6,1770,2,36000,1.00338983051
1981,1988,3950,7,1962,2,36000,1.00356778797
1990,1996,2191,6,195,14,7980,1.03076923077
2000,2006,4040,6,2034,2,36000,1.00294985251
2078,2084,3897,6,1813,2,36000,1.00330943188
2092,2099,3641,7,1542,2,36000,1.00453955901
2133,2139,4028,6,1889,2,36000,1.00317628375
2162,2168,4005,6,1837,2,36000,1.00326619488
2189,2195,2206,6,11,1,900,1.54545454545
2196,2202,3801,6,1599,2,36000,1.00375234522
2206,2211,2392,5,181,14,7980,1.02762430939
2210,2217,3931,7,1714,2,36000,1.004084014
2252,2258,4032,6,1774,2,36000,1.00338218715
2287,2293,4060,6,1767,2,36000,1.00339558574
2304,2310,4133,6,1823,2,36000,1.00329127811
2322,2329,4548,7,2219,2,36000,1.00315457413
2381,2387,4341,6,1954,2,36000,1.00307062436
2382,2393,4235,11,1842,2,36000,1.00597176982
2383,2398,2459,15,61,1,900,1.24590163934
2400,2406,4092,6,1686,2,36000,1.00355871886
2427,2433,3684,6,1251,2,36000,1.00479616307
2457,2463,4263,6,1800,2,36000,1.00333333333
2472,2478,4288,6,1810,2,36000,1.00331491713
2473,2484,2663,11,179,14,7980,1.06145251397
2528,2534,4407,6,1873,2,36000,1.00320341698
2554,2560,4382,6,1822,2,36000,1.00329308452
2573,2579,4568,6,1989,2,36000,1.00301659125
2588,2594,4470,6,1876,2,36000,1.00319829424
2604,2610,4471,6,1861,2,36000,1.00322407308
2662,2668,4375,6,1707,2,36000,1.00351493849
2662,2673,2714,11,41,1,900,1.26829268293
2663,2679,4337,16,1658,2,36000,1.00965018094
2665,2684,4368,19,1684,2,36000,1.01128266033
2687,2693,2930,6,237,14,7980,1.0253164557
2687,2698,3829,11,1131,2,36000,1.00972590628
2688,2704,4529,16,1825,2,36000,1.00876712329
2689,2709,4605,20,1896,2,36000,1.01054852321
2750,2756,4447,6,1691,2,36000,1.00354819633
2768,2774,4720,6,1946,2,36000,1.00308324769
2802,2808,4552,6,1744,2,36000,1.00344036697
2833,2839,4315,6,1476,2,36000,1.00406504065
2834,2845,4531,11,1686,2,36000,1.00652431791
2849,2855,4621,6,1766,2,36000,1.00339750849
2864,2869,4577,5,1708,2,36000,1.00292740047
2891,2897,4788,6,1891,2,36000,1.00317292438
2917,2922,4550,5,1628,2,36000,1.00307125307
2919,2928,2954,9,26,1,900,1.34615384615
2948,2954,3178,6,224,14,7980,1.02678571429
2951,2960,4536,9,1576,2,36000,1.0057106599
2966,2972,4942,6,1970,2,36000,1.00304568528
2967,2978,4849,11,1871,2,36000,1.00587920898
2985,2992,4845,7,1853,2,36000,1.00377765785
3001,3007,4829,6,1822,2,36000,1.00329308452
3017,3023,4597,6,1574,2,36000,1.00381194409
3018,3029,4672,11,1643,2,36000,1.00669506999
3020,3034,4827,14,1793,2,36000,1.00780814278
3038,3044,4807,6,1763,2,36000,1.00340328985
3072,3078,4609,6,1531,2,36000,1.00391900718
3073,3084,4988,11,1904,2,36000,1.00577731092
3126,3132,4990,6,1858,2,36000,1.00322927879
3141,3147,5000,6,1853,2,36000,1.00323799244
3142,3153,4910,11,1757,2,36000,1.0062606716
3157,3163,4797,6,1634,2,36000,1.00367197062
3172,3178,4798,6,1620,2,36000,1.0037037037
3176,3184,3196,8,12,1,900,1.66666666667
3188,3194,3438,6,244,14,7980,1.02459016393
3247,3253,5188,6,1935,2,36000,1.00310077519
3274,3280,5119,6,1839,2,36000,1.00326264274
3295,3301,5055,6,1754,2,36000,1.00342075257
3310,3316,5079,6,1763,2,36000,1.00340328985
3312,3322,5228,10,1906,2,36000,1.00524658972
3330,3336,5094,6,1758,2,36000,1.00341296928
3345,3351,5176,6,1825,2,36000,1.00328767123
3360,3365,5313,5,1948,2,36000,1.00256673511
3378,3385,5008,7,1623,2,36000,1.00431300062
3430,3437,5364,7,1927,2,36000,1.00363258952
3434,3443,3450,9,7,1,900,1.6
3445,3451,5251,6,1800,2,36000,1.00333333333
3448,3457,3676,9,219,14,7980,1.04109589041
3461,3467,5241,6,1774,2,36000,1.00338218715
3476,3482,5284,6,1802,2,36000,1.00332963374
3477,3488,5272,11,1784,2,36000,1.00616591928
3493,3499,5372,6,1873,2,36000,1.00320341698
3508,3514,5796,6,2282,2,36000,1.00262927257
3544,3550,5563,6,2013,2,36000,1.00298062593
3559,3565,4877,6,1312,2,36000,1.00457317073
3602,3608,5257,6,1649,2,36000,1.00363856883
3617,3622,5594,5,1972,2,36000,1.00253549696
3644,3650,5398,6,1748,2,36000,1.00343249428
3672,3678,3711,6,33,1,900,1.18181818182
3673,3684,5138,11,1454,2,36000,1.007565337
3683,3690,3844,7,154,14,7980,1.04545454545
3691,3697,5415,6,1718,2,36000,1.00349243306
3693,3703,4783,10,1080,2,36000,1.00925925926
3710,3716,5609,6,1893,2,36000,1.00316957211
3727,3733,5486,6,1753,2,36000,1.00342270394
3741,3748,5948,7,2200,2,36000,1.00318181818
3743,3754,4847,11,1093,2,36000,1.01006404392
3805,3811,5630,6,1819,2,36000,1.00329851567
3832,3838,5155,6,1317,2,36000,1.00455580866
3841,3847,3863,6,16,1,900,1.375
3853,3859,4005,6,146,14,7980,1.04109589041
3900,3906,5710,6,1804,2,36000,1.00332594235
3933,3939,5884,6,1945,2,36000,1.0030848329
3950,3957,5733,7,1776,2,36000,1.00394144144
4003,4010,4020,7,10,1,900,1.7
4005,4016,5842,11,1826,2,36000,1.00602409639
4012,4022,4174,10,152,14,7980,1.06578947368
4030,4036,5764,6,1728,2,36000,1.00347222222
4045,4051,5956,6,1905,2,36000,1.0031496063
4047,4057,5744,10,1687,2,36000,1.00592768228
4062,4068,5906,6,1838,2,36000,1.00326441785
4092,4098,6107,6,2009,2,36000,1.00298656048
4134,4140,6048,6,1908,2,36000,1.00314465409
4172,4178,4192,6,14,1,900,1.42857142857
4187,4194,4368,7,174,14,7980,1.04022988506
4235,4241,6107,6,1866,2,36000,1.00321543408
4265,4271,6072,6,1801,2,36000,1.00333148251
4289,4296,6086,7,1790,2,36000,1.00391061453
4316,4322,6011,6,1689,2,36000,1.00355239787
4338,4344,6092,6,1748,2,36000,1.00343249428
4352,4359,6237,7,1878,2,36000,1.00372736954
4366,4372,4378,6,6,1,900,1.2
4370,4378,6208,8,1830,2,36000,1.0043715847
4374,4384,4628,10,244,14,7980,1.04098360656
4386,4392,6094,6,1702,2,36000,1.00352526439
4387,4398,6105,11,1707,2,36000,1.0064440539
4408,4414,6194,6,1780,2,36000,1.00337078652
4449,4455,6277,6,1822,2,36000,1.00329308452
4474,4480,6332,6,1852,2,36000,1.00323974082
4475,4486,5982,11,1496,2,36000,1.00735294118
4530,4536,6441,6,1905,2,36000,1.0031496063
4546,4553,6144,7,1591,2,36000,1.00439974859
4548,4559,6379,11,1820,2,36000,1.00604395604
4564,4570,6452,6,1882,2,36000,1.00318809777
4565,4576,6461,11,1885,2,36000,1.00583554377
4567,4581,6287,14,1706,2,36000,1.0082063306
4582,4588,6304,6,1716,2,36000,1.0034965035
4583,4594,6499,11,1905,2,36000,1.00577427822
4600,4606,6312,6,1706,2,36000,1.00351699883
4614,4620,6342,6,1722,2,36000,1.00348432056
4616,4626,6418,10,1792,2,36000,1.00558035714
4626,4632,4640,6,8,1,900,1.4
4631,4638,6054,7,1416,2,36000,1.00494350282
4634,4644,4877,10,233,14,7980,1.04291845494
4673,4679,6364,6,1685,2,36000,1.00356083086
4721,4727,6305,6,1578,2,36000,1.00380228137
4785,4791,6507,6,1716,2,36000,1.0034965035
4800,4806,6708,6,1902,2,36000,1.00315457413
4801,4812,6553,11,1741,2,36000,1.00631820793
4803,4817,6610,14,1793,2,36000,1.00780814278
4818,4823,6603,5,1780,2,36000,1.00280898876
4833,4839,6565,6,1726,2,36000,1.00347624565
4834,4845,6640,11,1795,2,36000,1.0061281337
4849,4855,6604,6,1749,2,36000,1.00343053173
4851,4861,6467,10,1606,2,36000,1.00622665006
4852,4866,6970,14,2104,2,36000,1.0066539924
4875,4881,4887,6,6,1,900,1.2
4879,4887,6425,8,1538,2,36000,1.00520156047
4885,4893,5113,8,220,14,7980,1.03636363636
4912,4918,6806,6,1888,2,36000,1.0031779661
4942,4948,6719,6,1771,2,36000,1.00338791643
4991,4997,6895,6,1898,2,36000,1.00316122234
4992,5003,6905,11,1902,2,36000,1.00578338591
5007,5013,6945,6,1932,2,36000,1.00310559006
5023,5029,6725,6,1696,2,36000,1.00353773585
5056,5062,6759,6,1697,2,36000,1.00353565115
5086,5092,7059,6,1967,2,36000,1.00305033045
5101,5107,6911,6,1804,2,36000,1.00332594235
5111,5117,5125,6,8,1,900,1.4
5119,5125,5356,6,231,14,7980,1.02597402597
5119,5130,6831,11,1701,2,36000,1.00646678424
5140,5146,6902,6,1756,2,36000,1.00341685649
5156,5162,6841,6,1679,2,36000,1.00357355569
5179,5185,6748,6,1563,2,36000,1.00383877159
5193,5199,7134,6,1935,2,36000,1.00310077519
5230,5236,6978,6,1742,2,36000,1.00344431688
5245,5251,6542,6,1291,2,36000,1.00464756003
5260,5266,7396,6,2130,2,36000,1.00281690141
5262,5272,6958,10,1686,2,36000,1.0059311981
5276,5282,6416,6,1134,2,36000,1.00529100529
5291,5297,7017,6,1720,2,36000,1.00348837209
5315,5322,7205,7,1883,2,36000,1.00371747212
5352,5359,5378,7,19,1,900,1.36842105263
5365,5371,6955,6,1584,2,36000,1.00378787879
5377,5383,5609,6,226,14,7980,1.02654867257
5381,5389,7321,8,1932,2,36000,1.00414078675
5402,5408,7297,6,1889,2,36000,1.00317628375
5419,5425,6861,6,1436,2,36000,1.00417827298
5489,5496,7231,7,1735,2,36000,1.00403458213
5566,5572,7339,6,1767,2,36000,1.00339558574
5595,5601,7354,6,1753,2,36000,1.00342270394
5605,5612,5624,7,12,1,900,1.58333333333
5610,5618,7400,8,1782,2,36000,1.00448933782
5618,5624,5843,6,219,14,7980,1.02739726027
5632,5638,7650,6,2012,2,36000,1.00298210736
5689,6026,266063,337,260037,18,288000,1.00129596942
5713,5719,7502,6,1783,2,36000,1.00336511497
5734,5740,7615,6,1875,2,36000,1.0032
5749,5755,7601,6,1846,2,36000,1.00325027086
5764,5770,7519,6,1749,2,36000,1.00343053173
5798,5804,7064,6,1260,2,36000,1.00476190476
5839,5845,5868,6,23,1,900,1.26086956522
5845,5851,7560,6,1709,2,36000,1.00351082504
5851,5857,6081,6,224,14,7980,1.02678571429
5885,5891,7696,6,1805,2,36000,1.00332409972
5906,5912,7761,6,1849,2,36000,1.0032449973
5949,5955,7753,6,1798,2,36000,1.00333704116
5964,5971,7825,7,1854,2,36000,1.00377562028
5983,5989,7960,6,1971,2,36000,1.00304414003
6014,6020,6984,6,964,2,36000,1.00622406639
6050,6057,7926,7,1869,2,36000,1.00374531835
6065,6072,7834,7,1762,2,36000,1.00397275823
6078,6084,6098,6,14,1,900,1.42857142857
6080,6090,8053,10,1963,2,36000,1.0050942435
6089,6096,6326,7,230,14,7980,1.03043478261
6096,6102,7266,6,1164,2,36000,1.00515463918
6098,6108,7884,10,1776,2,36000,1.00563063063
6099,6113,7728,14,1615,2,36000,1.00866873065
6115,6121,7846,6,1725,2,36000,1.00347826087
6116,6127,7357,11,1230,2,36000,1.00894308943
6118,6132,7633,14,1501,2,36000,1.00932711526
6145,6151,7995,6,1844,2,36000,1.0032537961
6198,6204,7789,6,1585,2,36000,1.00378548896
6217,6224,7997,7,1773,2,36000,1.00394811055
6240,6247,8445,7,2198,2,36000,1.00318471338
6283,6289,8398,6,2109,2,36000,1.00284495021
6298,6304,8275,6,1971,2,36000,1.00304414003
6314,6320,8019,6,1699,2,36000,1.00353148911
6315,6326,8152,11,1826,2,36000,1.00602409639
6316,6331,7654,15,1323,2,36000,1.01133786848
6323,6337,6356,14,19,1,900,1.73684210526
6335,6343,8138,8,1795,2,36000,1.00445682451
6341,6349,6571,8,222,14,7980,1.03603603604
6350,6356,8152,6,1796,2,36000,1.00334075724
6375,6381,8097,6,1716,2,36000,1.0034965035
6391,6397,8255,6,1858,2,36000,1.00322927879
6419,6425,8294,6,1869,2,36000,1.00321027287
6420,6431,7580,11,1149,2,36000,1.00957354221
6436,6442,7556,6,1114,2,36000,1.00538599641
6451,6457,8203,6,1746,2,36000,1.00343642612
6462,6468,6470,6,2,1,72000,1.0
6462,6473,8551,11,2078,1,72000,1.00529355149
6463,6512,6514,49,2,1,72000,5.1
6463,6517,9104,54,2587,1,72000,1.02087359876
6463,6497,11904,34,5407,1,72000,1.006288145
6463,6529,14414,66,7885,1,72000,1.0083703234
6469,6480,8107,11,1627,2,36000,1.00676090965
6471,6485,8346,14,1861,2,36000,1.00752283718
6472,6490,7846,18,1356,2,36000,1.01327433628
6500,6506,8375,6,1869,2,36000,1.00321027287
6516,6523,8264,7,1741,2,36000,1.00402067777
6544,6550,8481,6,1931,2,36000,1.00310719834
6559,6565,8460,6,1895,2,36000,1.00316622691
6569,6575,6582,6,7,1,900,1.3
6574,6581,8274,7,1693,2,36000,1.00413467218
6578,6587,6817,9,230,14,7980,1.03913043478
6604,6610,8352,6,1742,2,36000,1.00344431688
6605,6616,8433,11,1817,2,36000,1.00605393506
6621,6627,8450,6,1823,2,36000,1.00329127811
6643,6649,8261,6,1612,2,36000,1.00372208437
6668,6674,10526,6,3852,1,72000,1.0015576324
6672,6680,10403,8,3723,1,72000,1.00214880473
6709,6716,8731,7,2015,2,36000,1.00347394541
6724,6730,8600,6,1870,2,36000,1.00320855615
6739,6745,8627,6,1882,2,36000,1.00318809777
6754,6759,8631,5,1872,2,36000,1.00267094017
6769,6775,8351,6,1576,2,36000,1.0038071066
6808,6814,8472,6,1658,2,36000,1.00361881785
6814,6820,6829,6,9,1,900,1.5
6824,6830,7051,6,221,14,7980,1.02714932127
6835,6840,8679,5,1839,2,36000,1.00271886895
6850,6856,8870,6,2014,2,36000,1.00297914598
6866,6872,8305,6,1433,2,36000,1.00418702024
6899,6905,8582,6,1677,2,36000,1.00357781753
6914,6920,8281,6,1361,2,36000,1.00440852314
6916,6926,8555,10,1629,2,36000,1.00613873542
6917,6931,8683,14,1752,2,36000,1.00799086758
6949,6955,8262,6,1307,2,36000,1.00459066565
6969,6975,8860,6,1885,2,36000,1.00318302387
6970,6981,8117,11,1136,2,36000,1.00968309859
6972,6986,8832,14,1846,2,36000,1.00758396533
6988,6995,8801,7,1806,2,36000,1.00387596899
6990,7001,8706,11,1705,2,36000,1.0064516129
7017,7023,8707,6,1684,2,36000,1.00356294537
7049,7055,7065,6,10,1,900,1.6
7060,7066,7315,6,249,14,7980,1.02409638554
7060,7071,8989,11,1918,2,36000,1.00573514077
7078,7084,9013,6,1929,2,36000,1.00311041991
7136,7142,8995,6,1853,2,36000,1.00323799244
7206,7212,9008,6,1796,2,36000,1.00334075724
7233,7239,9144,6,1905,2,36000,1.0031496063
7267,7274,8970,7,1696,2,36000,1.00412735849
7297,7303,8535,6,1232,2,36000,1.00487012987
7313,7319,7334,6,15,1,900,1.4
7322,7328,9422,6,2094,2,36000,1.00286532951
7323,7334,7554,11,220,14,7980,1.05
7340,7346,9213,6,1867,2,36000,1.00321371184
7355,7361,9055,6,1694,2,36000,1.00354191263
7370,7376,8997,6,1621,2,36000,1.00370141888
7398,7404,9372,6,1968,2,36000,1.00304878049
7399,7410,8761,11,1351,2,36000,1.00814211695
7502,7508,9249,6,1741,2,36000,1.00344629523
7520,7526,9315,6,1789,2,36000,1.00335382895
7552,7558,7563,6,5,1,900,1.1
7559,7565,9168,6,1603,2,36000,1.00374298191
7561,7571,7831,10,260,14,7980,1.03846153846
7574,7580,9855,6,2275,2,36000,1.00263736264
7589,7595,9401,6,1806,2,36000,1.00332225914
7604,7610,9475,6,1865,2,36000,1.00321715818
7619,7625,9417,6,1792,2,36000,1.00334821429
7634,7640,9619,6,1979,2,36000,1.00303183426
7652,7658,9608,6,1950,2,36000,1.00307692308
7668,7674,9503,6,1829,2,36000,1.00328048114
7697,7703,9748,6,2045,2,36000,1.00293398533
7729,7735,9510,6,1775,2,36000,1.00338028169
7753,7759,9749,6,1990,2,36000,1.00301507538
7768,7774,9212,6,1438,2,36000,1.00417246175
7790,7796,9054,6,1258,2,36000,1.00476947536
7827,7833,9549,6,1716,2,36000,1.0034965035
7828,7839,7846,11,7,1,900,1.8
7837,7845,8071,8,226,14,7980,1.03539823009
7842,7851,9708,9,1857,2,36000,1.00484652666
7857,7863,9818,6,1955,2,36000,1.00306905371
7858,7869,9486,11,1617,2,36000,1.00680272109
7885,7892,9692,7,1800,2,36000,1.00388888889
7928,7934,9709,6,1775,2,36000,1.00338028169
7961,7968,8924,7,956,2,36000,1.00732217573
7998,8004,9891,6,1887,2,36000,1.00317965024
7999,8010,9710,11,1700,2,36000,1.00647058824
8020,8026,9759,6,1733,2,36000,1.00346220427
8053,8059,9712,6,1653,2,36000,1.00362976407
8069,8075,8081,6,6,1,900,1.2
8078,8085,8315,7,230,14,7980,1.03043478261
8101,8107,10096,6,1989,2,36000,1.00301659125
8116,8122,9861,6,1739,2,36000,1.00345025877
8131,8137,9933,6,1796,2,36000,1.00334075724
8146,8152,10158,6,2006,2,36000,1.00299102692
8162,8168,9937,6,1769,2,36000,1.00339174675
8163,8174,9969,11,1795,2,36000,1.0061281337
8208,8214,9994,6,1780,2,36000,1.00337078652
8258,8264,8266,6,2,2,3540,1.0
8260,8270,10201,10,1931,2,36000,1.0051786639
8278,8284,10218,6,1934,2,36000,1.00310237849
8279,8290,10098,11,1808,2,36000,1.0060840708
8281,8295,10164,14,1869,2,36000,1.0074906367
8282,8300,10190,18,1890,2,36000,1.00952380952
8283,8306,9773,23,1467,2,36000,1.01567825494
8300,8312,10175,12,1863,2,36000,1.00644122383
8301,8317,9790,16,1473,2,36000,1.01086218601
8311,8328,8335,17,7,1,900,2.4
8317,8323,10071,6,1748,2,36000,1.00343249428
8331,8337,8590,6,253,14,7980,1.02371541502
8347,8354,10104,7,1750,2,36000,1.004
8363,8369,10410,6,2041,2,36000,1.00293973542
8364,8375,10104,11,1729,2,36000,1.00636205899
8379,8385,10087,6,1702,2,36000,1.00352526439
8400,8406,10329,6,1923,2,36000,1.0031201248
8436,8442,10433,6,1991,2,36000,1.00301356102
8452,8457,10013,5,1556,2,36000,1.00321336761
8453,8463,10271,10,1808,2,36000,1.00553097345
8468,8474,10223,6,1749,2,36000,1.00343053173
8484,8490,10327,6,1837,2,36000,1.00326619488
8485,8496,10226,11,1730,2,36000,1.0063583815
8536,8542,10745,6,2203,2,36000,1.00272355878
8558,8563,10413,5,1850,2,36000,1.0027027027
8585,8591,10589,6,1998,2,36000,1.003003003
8588,8597,8603,9,6,1,900,1.5
8598,8604,8821,6,217,14,7980,1.02764976959
8602,8610,10362,8,1752,2,36000,1.00456621005
8629,8636,9742,7,1106,2,36000,1.00632911392
8644,8650,10523,6,1873,2,36000,1.00320341698
8683,8689,10438,6,1749,2,36000,1.00343053173
8697,8704,10518,7,1814,2,36000,1.00385887541
8714,8720,10415,6,1695,2,36000,1.00353982301
8716,8726,10578,10,1852,2,36000,1.00539956803
8731,8737,10534,6,1797,2,36000,1.00333889816
8762,8768,10661,6,1893,2,36000,1.00316957211
8802,8808,10854,6,2046,2,36000,1.00293255132
8818,8824,8834,6,10,1,900,1.6
8829,8835,9056,6,221,14,7980,1.02714932127
8836,8842,10594,6,1752,2,36000,1.00342465753
8863,8869,10586,6,1717,2,36000,1.00349446709
8878,8884,10633,6,1749,2,36000,1.00343053173
8927,8934,10420,7,1486,2,36000,1.00471063257
8973,8979,10739,6,1760,2,36000,1.00340909091
8991,8997,10827,6,1830,2,36000,1.00327868852
9006,9012,10835,6,1823,2,36000,1.00329127811
9008,9018,10830,10,1812,2,36000,1.0055187638
9023,9029,10828,6,1799,2,36000,1.00333518621
9024,9035,11241,11,2206,2,36000,1.00498640073
9054,9060,9066,6,6,1,900,1.2
9057,9066,10756,9,1690,2,36000,1.00532544379
9059,9071,11101,12,2030,2,36000,1.00591133005
9069,9077,9312,8,235,14,7980,1.03404255319
9148,9155,10970,7,1815,2,36000,1.00385674931
9170,9176,10889,6,1713,2,36000,1.00350262697
9212,9219,11057,7,1838,2,36000,1.00380848749
9228,9234,10293,6,1059,2,36000,1.00566572238
9249,9255,11141,6,1886,2,36000,1.00318133616
9310,9316,9323,6,7,1,900,1.3
9316,9322,11103,6,1781,2,36000,1.00336889388
9319,9328,9559,9,231,14,7980,1.03896103896
9335,9341,9512,6,171,1,3600,1.0350877193
9373,9379,11255,6,1876,2,36000,1.00319829424
9403,9410,11424,7,2014,2,36000,1.00347567031
9419,9425,11296,6,1871,2,36000,1.00320684126
9433,9440,11112,7,1672,2,36000,1.00418660287
9477,9483,11434,6,1951,2,36000,1.00307534598
9492,9498,11191,6,1693,2,36000,1.00354400473
9507,9513,11132,6,1619,2,36000,1.00370599135
9522,9528,11272,6,1744,2,36000,1.00344036697
9550,9556,11332,6,1776,2,36000,1.00337837838
9556,9562,9571,6,9,1,900,1.5
9572,9578,9808,6,230,14,7980,1.02608695652
9610,9617,11508,7,1891,2,36000,1.00370174511
9626,9632,11511,6,1879,2,36000,1.00319318787
9682,9688,10032,6,344,1,3600,1.01744186047
9687,9694,11512,7,1818,2,36000,1.00385038504
9711,9717,11651,6,1934,2,36000,1.00310237849
9713,9723,11612,10,1889,2,36000,1.00529380625
9714,9728,11393,14,1665,2,36000,1.00840840841
9715,9734,11595,19,1861,2,36000,1.01020956475
9745,9752,11515,7,1763,2,36000,1.00397050482
9767,9773,11492,6,1719,2,36000,1.0034904014
9769,9779,11663,10,1884,2,36000,1.00530785563
9770,9784,11789,14,2005,2,36000,1.00698254364
9785,9790,11553,5,1763,2,36000,1.00283607487
9800,9806,11642,6,1836,2,36000,1.00326797386
9805,9812,9819,7,7,1,900,1.4
9815,9821,10037,6,216,14,7980,1.02777777778
9821,9827,11690,6,1863,2,36000,1.00322061192
9857,9863,11760,6,1897,2,36000,1.00316288877
9872,9878,11949,6,2071,2,36000,1.00289715113
9894,9900,11660,6,1760,2,36000,1.00340909091
9937,9943,11787,6,1844,2,36000,1.0032537961
9938,9949,11922,11,1973,2,36000,1.00557526609
9973,9979,11756,6,1777,2,36000,1.00337647721
9991,9997,11639,6,1642,2,36000,1.00365408039
10015,10021,11735,6,1714,2,36000,1.00350058343
10035,10042,10048,7,6,1,900,1.3
10047,10053,10285,6,232,14,7980,1.02586206897
10072,10078,11738,6,1660,2,36000,1.00361445783
10087,10093,11545,6,1452,2,36000,1.0041322314
10102,10108,11994,6,1886,2,36000,1.00318133616
10103,10114,12002,11,1888,2,36000,1.00582627119
10119,10125,11829,6,1704,2,36000,1.00352112676
10120,10131,12014,11,1883,2,36000,1.0058417419
10159,10165,12109,6,1944,2,36000,1.00308641975
10175,10181,11579,6,1398,2,36000,1.00429184549
10176,10187,11870,11,1683,2,36000,1.00653594771
10192,10198,12098,6,1900,2,36000,1.00315789474
10209,10215,12160,6,1945,2,36000,1.0030848329
10225,10231,12001,6,1770,2,36000,1.00338983051
10226,10237,11555,11,1318,2,36000,1.00834597876
10242,10248,11996,6,1748,2,36000,1.00343249428
10274,10280,12099,6,1819,2,36000,1.00329851567
10282,10288,10298,6,10,1,900,1.6
10295,10307,12109,12,1802,2,36000,1.00665926748
10296,10302,10531,6,229,14,7980,1.02620087336
10329,10335,12110,6,1775,2,36000,1.00338028169
10330,10341,12199,11,1858,2,36000,1.00592034446
10364,10370,11985,6,1615,2,36000,1.00371517028
10390,10396,11214,6,818,1,3600,1.00733496333
10413,10419,12082,6,1663,2,36000,1.00360793746
10414,10425,12349,11,1924,2,36000,1.00571725572
10429,10436,12422,7,1986,2,36000,1.00352467271
10431,10442,12194,11,1752,2,36000,1.00627853881
10446,10452,12300,6,1848,2,36000,1.00324675325
10447,10458,12351,11,1893,2,36000,1.0058108822
10521,10527,12309,6,1782,2,36000,1.00336700337
10529,10535,10544,6,9,1,900,1.5
10536,10542,12406,6,1864,2,36000,1.00321888412
10538,10548,10779,10,231,14,7980,1.04329004329
10538,10553,11758,15,1205,2,36000,1.01244813278
10580,10586,12370,6,1784,2,36000,1.0033632287
10597,10603,12230,6,1627,2,36000,1.0036877689
10598,10609,12561,11,1952,2,36000,1.0056352459
10599,10614,12461,15,1847,2,36000,1.00812127775
10637,10643,12665,6,2022,2,36000,1.00296735905
10661,10667,12426,6,1759,2,36000,1.00341102899
10743,10749,12329,6,1580,2,36000,1.00379746835
10759,10765,12543,6,1778,2,36000,1.00337457818
10760,10771,12576,11,1805,2,36000,1.00609418283
10776,10790,10796,14,6,1,900,2.0
10785,10807,11027,22,220,14,7980,1.1
10830,10836,12003,6,1167,2,36000,1.00514138817
10831,10842,12371,11,1529,2,36000,1.0071942446
10846,10852,12574,6,1722,2,36000,1.00348432056
10847,10858,12639,11,1781,2,36000,1.00617630545
10862,10868,12707,6,1839,2,36000,1.00326264274
10892,10899,12824,7,1925,2,36000,1.00363636364
10971,10978,12780,7,1802,2,36000,1.0038845727
11025,11031,11038,6,7,1,900,1.3
11033,11039,11270,6,231,14,7980,1.02597402597
11059,11065,12846,6,1781,2,36000,1.00336889388
11102,11108,12819,6,1711,2,36000,1.00350672122
11117,11123,12861,6,1738,2,36000,1.00345224396
11119,11129,13129,10,2000,2,36000,1.005
11134,11140,12943,6,1803,2,36000,1.00332778702
11149,11155,12935,6,1780,2,36000,1.00337078652
11194,11200,13157,6,1957,2,36000,1.00306591722
11242,11248,12925,6,1677,2,36000,1.00357781753
11257,11263,13269,6,2006,2,36000,1.00299102692
11268,11274,11284,6,10,1,900,1.6
11272,11280,13136,8,1856,2,36000,1.00431034483
11284,11290,11508,6,218,14,7980,1.02752293578
11296,11302,12377,6,1075,2,36000,1.00558139535
11336,11342,13057,6,1715,2,36000,1.00349854227
11394,11400,13348,6,1948,2,36000,1.00308008214
11426,11433,13152,7,1719,2,36000,1.00407213496
11442,11448,13389,6,1941,2,36000,1.00309119011
11493,11500,13512,7,2012,2,36000,1.00347912525
11506,11512,11517,6,5,1,900,1.1
11509,11518,13211,9,1693,2,36000,1.00531600709
11516,11524,11742,8,218,14,7980,1.03669724771
11524,11530,13008,6,1478,2,36000,1.00405953992
11526,11536,13332,10,1796,2,36000,1.00556792873
11527,11541,13375,14,1834,2,36000,1.00763358779
11545,11551,13565,6,2014,2,36000,1.00297914598
11562,11567,13170,5,1603,2,36000,1.00311915159
11563,11573,13691,10,2118,2,36000,1.00472143532
11581,11588,12878,7,1290,2,36000,1.00542635659
11596,11602,12981,6,1379,2,36000,1.00435097897
11616,11622,13492,6,1870,2,36000,1.00320855615
11644,11650,13383,6,1733,2,36000,1.00346220427
11646,11656,13432,10,1776,2,36000,1.00563063063
11662,11668,12966,6,1298,2,36000,1.00462249615
11663,11674,13555,11,1881,2,36000,1.00584795322
11679,11685,13557,6,1872,2,36000,1.00320512821
11694,11700,13545,6,1845,2,36000,1.00325203252
11740,11746,13484,6,1738,2,36000,1.00345224396
11741,11752,13312,11,1560,2,36000,1.00705128205
11741,11757,11763,16,6,1,900,2.2
11760,11766,13620,6,1854,2,36000,1.00323624595
11761,11777,13879,16,2102,2,36000,1.00761179829
11762,11772,12000,10,228,14,7980,1.04385964912
11763,11783,13656,20,1873,2,36000,1.01067805659
11788,11794,12762,6,968,2,36000,1.00619834711
11803,11809,13717,6,1908,2,36000,1.00314465409
11830,11837,13748,7,1911,2,36000,1.00366300366
11873,11879,13063,6,1184,2,36000,1.00506756757
11924,11930,13974,6,2044,2,36000,1.00293542074
11951,11957,13798,6,1841,2,36000,1.00325909832
11988,11994,13367,6,1373,2,36000,1.00436999272
11997,12003,12020,6,17,1,900,1.35294117647
12010,12016,13879,6,1863,2,36000,1.00322061192
12011,12028,13774,17,1746,2,36000,1.00973654066
12012,12033,13925,21,1892,2,36000,1.01109936575
12014,12038,13758,24,1720,2,36000,1.01395348837
12015,12043,13692,28,1649,2,36000,1.01697998787
12016,12022,12248,6,226,14,7980,1.02654867257
12031,12049,13811,18,1762,2,36000,1.01021566402
12086,12092,14062,6,1970,2,36000,1.00304568528
12101,12108,13311,7,1203,2,36000,1.00581878637
12103,12114,14058,11,1944,2,36000,1.00565843621
12119,12125,13966,6,1841,2,36000,1.00325909832
12120,12131,13936,11,1805,2,36000,1.00609418283
12121,12136,13645,15,1509,2,36000,1.00994035785
12163,12169,13921,6,1752,2,36000,1.00342465753
12194,12200,13952,6,1752,2,36000,1.00342465753
12210,12216,13978,6,1762,2,36000,1.00340522134
12231,12237,14085,6,1848,2,36000,1.00324675325
12246,12252,12257,6,5,1,900,1.1
12260,12266,12515,6,249,14,7980,1.02409638554
12302,12308,14110,6,1802,2,36000,1.00332963374
12317,12323,14211,6,1888,2,36000,1.0031779661
12332,12338,14127,6,1789,2,36000,1.00335382895
12350,12356,14213,6,1857,2,36000,1.00323101777
12366,12372,14465,6,2093,2,36000,1.00286669852
12383,12388,14246,5,1858,2,36000,1.00269106566
12384,12395,14306,11,1911,2,36000,1.00575614861
12385,12400,14270,15,1870,2,36000,1.00802139037
12407,12413,14119,6,1706,2,36000,1.00351699883
12425,12431,14178,6,1747,2,36000,1.00343445907
12426,12437,12557,11,120,1,3600,1.09166666667
12440,12446,14427,6,1981,2,36000,1.00302877335
12462,12468,14313,6,1845,2,36000,1.00325203252
12512,12519,12525,7,6,1,900,1.3
12526,12532,12745,6,213,14,7980,1.02816901408
12545,12552,13459,7,907,2,36000,1.00771775083
12564,12570,14285,6,1715,2,36000,1.00349854227
12581,12587,13894,6,1307,2,36000,1.00459066565
12582,12593,14405,11,1812,2,36000,1.00607064018
12641,12647,14453,6,1806,2,36000,1.00332225914
12668,12674,14418,6,1744,2,36000,1.00344036697
12708,12714,14479,6,1765,2,36000,1.00339943343
12735,12742,13054,7,312,1,3600,1.02243589744
12743,12749,12755,6,6,1,900,1.2
12755,12761,12984,6,223,14,7980,1.0269058296
12763,12769,14536,6,1767,2,36000,1.00339558574
12781,12787,14558,6,1771,2,36000,1.00338791643
12820,12826,14609,6,1783,2,36000,1.00336511497
12835,12841,14889,6,2048,2,36000,1.0029296875
12848,12855,13029,7,174,1,3600,1.04022988506
12850,12861,14911,11,2050,2,36000,1.00536585366
12866,12872,14713,6,1841,2,36000,1.00325909832
12881,12887,14486,6,1599,2,36000,1.00375234522
12928,12934,14662,6,1728,2,36000,1.00347222222
12945,12951,14808,6,1857,2,36000,1.00323101777
12946,12957,14357,11,1400,2,36000,1.00785714286
12968,12974,14852,6,1878,2,36000,1.00319488818
12982,12993,12999,11,6,1,900,1.7
12983,12988,14848,5,1860,2,36000,1.00268817204
12990,12999,13217,9,218,14,7980,1.04128440367
13010,13016,14301,6,1285,2,36000,1.0046692607
13059,13065,14761,6,1696,2,36000,1.00353773585
13074,13080,14142,6,1062,2,36000,1.00564971751
13129,13136,14470,7,1334,2,36000,1.00524737631
13145,13151,15135,6,1984,2,36000,1.00302419355
13160,13166,14918,6,1752,2,36000,1.00342465753
13161,13172,14870,11,1698,2,36000,1.00647820966
13177,13183,15126,6,1943,2,36000,1.00308800823
13197,13203,13550,6,347,1,3600,1.01729106628
13214,13220,15291,6,2071,2,36000,1.00289715113
13214,13226,13247,12,21,1,900,1.57142857143
13225,13232,13319,7,87,14,7980,1.08045977011
13270,13276,14701,6,1425,2,36000,1.00421052632
13314,13320,15187,6,1867,2,36000,1.00321371184
13315,13326,14880,11,1554,2,36000,1.00707850708
13316,13332,13333,16,1,1,900,1.7
13330,13338,15074,8,1736,2,36000,1.00460829493
13350,13356,15161,6,1805,2,36000,1.00332409972
13368,13374,15622,6,2248,2,36000,1.00266903915
13389,13394,15188,5,1794,2,36000,1.002787068
13390,13400,15361,10,1961,2,36000,1.00509943906
13406,13412,15273,6,1861,2,36000,1.00322407308
13436,13442,14521,6,1079,2,36000,1.00556070436
13464,13470,15276,6,1806,2,36000,1.00332225914
13486,13492,15246,6,1754,2,36000,1.00342075257
13501,13507,15244,6,1737,2,36000,1.00345423143
13516,13522,14565,6,1043,2,36000,1.00575263663
13538,13544,14150,6,606,1,3600,1.0099009901
13547,13553,15449,6,1896,2,36000,1.00316455696
13562,13568,15216,6,1648,2,36000,1.0036407767
13563,13574,15605,11,2031,2,36000,1.00541605121
13579,13585,15251,6,1666,2,36000,1.00360144058
13622,13628,15254,6,1626,2,36000,1.0036900369
13650,13656,15563,6,1907,2,36000,1.00314630309
13665,13671,15540,6,1869,2,36000,1.00321027287
13692,13698,15722,6,2024,2,36000,1.00296442688
13693,13704,15643,11,1939,2,36000,1.00567302733
13718,13724,15617,6,1893,2,36000,1.00316957211
13752,13758,15747,6,1989,2,36000,1.00301659125
13767,13773,15635,6,1862,2,36000,1.00322234157
13783,13789,15709,6,1920,2,36000,1.003125
13801,13807,15556,6,1749,2,36000,1.00343053173
13816,13822,15733,6,1911,2,36000,1.00313971743
13881,13887,15229,6,1342,2,36000,1.0044709389
13882,13893,16030,11,2137,2,36000,1.0051474029
13897,13903,15466,6,1563,2,36000,1.00383877159
13923,13929,15529,6,1600,2,36000,1.00375
13932,13939,14776,7,837,1,3600,1.00836320191
13938,13945,15696,7,1751,2,36000,1.00399771559
13939,13950,15030,11,1080,2,36000,1.01018518519
13954,13960,16103,6,2143,2,36000,1.00279981335
13969,13975,15838,6,1863,2,36000,1.00322061192
13984,13990,15550,6,1560,2,36000,1.00384615385
13986,13996,15629,10,1633,2,36000,1.00612369871
14059,14065,15827,6,1762,2,36000,1.00340522134
14074,14080,15900,6,1820,2,36000,1.0032967033
14089,14095,15761,6,1666,2,36000,1.00360144058
14110,14116,15982,6,1866,2,36000,1.00321543408
14125,14131,15838,6,1707,2,36000,1.00351493849
14140,14146,15908,6,1762,2,36000,1.00340522134
14155,14161,16036,6,1875,2,36000,1.0032
14179,14186,16171,7,1985,2,36000,1.00352644836
14213,14219,15820,6,1601,2,36000,1.00374765771
14214,14225,15795,11,1570,2,36000,1.00700636943
14248,14254,16361,6,2107,2,36000,1.00284765069
14272,14278,16128,6,1850,2,36000,1.00324324324
14287,14293,16013,6,1720,2,36000,1.00348837209
14302,14308,15980,6,1672,2,36000,1.00358851675
14317,14323,16118,6,1795,2,36000,1.00334261838
14319,14330,16226,11,1896,2,36000,1.00580168776
14358,14364,16106,6,1742,2,36000,1.00344431688
14407,14413,16142,6,1729,2,36000,1.003470214
14422,14428,16275,6,1847,2,36000,1.0032485111
14437,14443,16093,6,1650,2,36000,1.00363636364
14455,14462,16396,7,1934,2,36000,1.00361944157
14471,14477,16416,6,1939,2,36000,1.00309437855
14472,14483,16243,11,1760,2,36000,1.00625
14490,14496,15573,6,1077,2,36000,1.00557103064
14491,14502,16436,11,1934,2,36000,1.0056876939
14522,14528,16320,6,1792,2,36000,1.00334821429
14538,14545,16299,7,1754,2,36000,1.00399087799
14560,14566,16284,6,1718,2,36000,1.00349243306
14575,14581,16353,6,1772,2,36000,1.00338600451
14612,14618,15940,6,1322,2,36000,1.00453857791
14663,14669,16530,6,1861,2,36000,1.00322407308
14703,14709,16573,6,1864,2,36000,1.00321888412
14718,14724,16636,6,1912,2,36000,1.00313807531
14763,14770,16669,7,1899,2,36000,1.00368615061
14809,14815,16543,6,1728,2,36000,1.00347222222
14850,14856,16733,6,1877,2,36000,1.0031965903
14867,14873,16924,6,2051,2,36000,1.00292540224
14882,14888,16623,6,1735,2,36000,1.00345821326
14883,14894,16764,11,1870,2,36000,1.00588235294
14898,14905,16740,7,1835,2,36000,1.0038147139
14913,14920,16956,7,2036,2,36000,1.00343811395
14928,14935,16089,7,1154,2,36000,1.00606585789
15030,15036,16877,6,1841,2,36000,1.00325909832
15076,15082,16941,6,1859,2,36000,1.00322754169
15133,15139,16955,6,1816,2,36000,1.00330396476
15150,15156,17028,6,1872,2,36000,1.00320512821
15167,15172,17243,5,2071,2,36000,1.00241429261
15190,15197,17067,7,1870,2,36000,1.00374331551
15192,15202,17024,10,1822,2,36000,1.0054884742
15217,15223,17017,6,1794,2,36000,1.00334448161
15233,15239,17098,6,1859,2,36000,1.00322754169
15249,15255,17095,6,1840,2,36000,1.00326086957
15250,15261,16954,11,1693,2,36000,1.006497342
15265,15271,17260,6,1989,2,36000,1.00301659125
15267,15277,17044,10,1767,2,36000,1.00565930956
15282,15288,17274,6,1986,2,36000,1.00302114804
15284,15294,16974,10,1680,2,36000,1.00595238095
15299,15305,17165,6,1860,2,36000,1.00322580645
15361,15367,17130,6,1763,2,36000,1.00340328985
15449,15455,17218,6,1763,2,36000,1.00340328985
15467,15473,17331,6,1858,2,36000,1.00322927879
15530,15536,17239,6,1703,2,36000,1.00352319436
15546,15551,17367,5,1816,2,36000,1.00275330396
15561,15567,17253,6,1686,2,36000,1.00355871886
15562,15573,17506,11,1933,2,36000,1.00569063632
15580,15586,17020,6,1434,2,36000,1.00418410042
15582,15592,17495,10,1903,2,36000,1.00525486075
15606,15612,17581,6,1969,2,36000,1.0030472321
15621,15627,17855,6,2228,2,36000,1.0026929982
15637,15643,17459,6,1816,2,36000,1.00330396476
15638,15649,17461,11,1812,2,36000,1.00607064018
15639,15654,17722,15,2068,2,36000,1.00725338491
15654,15660,17662,6,2002,2,36000,1.002997003
15698,15704,17447,6,1743,2,36000,1.00344234079
15713,15719,17077,6,1358,2,36000,1.00441826215
15729,15735,17738,6,2003,2,36000,1.00299550674
15745,15751,17512,6,1761,2,36000,1.00340715503
15760,15767,17549,7,1782,2,36000,1.00392817059
15775,15781,17626,6,1845,2,36000,1.00325203252
15799,15805,17712,6,1907,2,36000,1.00314630309
15822,15828,17694,6,1866,2,36000,1.00321543408
15838,15844,17612,6,1768,2,36000,1.00339366516
15840,15850,17741,10,1891,2,36000,1.0052882073
15855,15862,17676,7,1814,2,36000,1.00385887541
15901,15907,17895,6,1988,2,36000,1.00301810865
15917,15923,17105,6,1182,2,36000,1.00507614213
15941,15947,17536,6,1589,2,36000,1.00377595972
15982,15988,17830,6,1842,2,36000,1.00325732899
15983,15994,18012,11,2018,2,36000,1.00545094153
15988,15999,16111,11,112,1,3600,1.09821428571
16014,16020,17739,6,1719,2,36000,1.0034904014
16032,16038,17761,6,1723,2,36000,1.00348229832
16047,16053,17977,6,1924,2,36000,1.00311850312
16089,16095,17927,6,1832,2,36000,1.00327510917
16104,16111,17757,7,1646,2,36000,1.0042527339
16106,16117,17780,11,1663,2,36000,1.00661455201
16121,16127,17949,6,1822,2,36000,1.00329308452
16122,16133,17748,11,1615,2,36000,1.00681114551
16137,16143,18259,6,2116,2,36000,1.00283553875
16152,16158,18149,6,1991,2,36000,1.00301356102
16173,16179,17890,6,1711,2,36000,1.00350672122
16230,16236,18141,6,1905,2,36000,1.0031496063
16245,16251,17993,6,1742,2,36000,1.00344431688
16275,16281,17975,6,1694,2,36000,1.00354191263
16279,16287,16609,8,322,1,3600,1.0248447205
16290,16296,18258,6,1962,2,36000,1.00305810398
16306,16311,17983,5,1672,2,36000,1.00299043062
16321,16327,18297,6,1970,2,36000,1.00304568528
16356,16362,18350,6,1988,2,36000,1.00301810865
16372,16378,18411,6,2033,2,36000,1.00295130349
16397,16403,18187,6,1784,2,36000,1.0033632287
16418,16424,18946,6,2522,2,36000,1.00237906423
16437,16443,18126,6,1683,2,36000,1.00356506239
16532,16538,18407,6,1869,2,36000,1.00321027287
16547,16553,18217,6,1664,2,36000,1.00360576923
16573,16580,16716,7,136,1,1800,1.05147058824
16576,16586,18009,10,1423,2,36000,1.00702740689
16626,16632,18442,6,1810,2,36000,1.00331491713
16641,16647,18287,6,1640,2,36000,1.00365853659
16671,16677,18316,6,1639,2,36000,1.00366076876
16736,16742,18405,6,1663,2,36000,1.00360793746
16751,16757,18711,6,1954,2,36000,1.00307062436
16767,16773,18436,6,1663,2,36000,1.00360793746
16877,16883,18560,6,1677,2,36000,1.00357781753
16925,16931,18827,6,1896,2,36000,1.00316455696
16943,16950,19033,7,2083,2,36000,1.00336053769
16959,16965,18607,6,1642,2,36000,1.00365408039
16961,16971,18280,10,1309,2,36000,1.0076394194
16962,16976,18862,14,1886,2,36000,1.00742311771
16977,16983,18734,6,1751,2,36000,1.00342661336
17010,17017,17128,7,111,1,1800,1.06306306306
17017,17023,18925,6,1902,2,36000,1.00315457413
17032,17038,18978,6,1940,2,36000,1.00309278351
17034,17044,18831,10,1787,2,36000,1.0055959709
17035,17049,18771,14,1722,2,36000,1.0081300813
17050,17061,17652,11,591,1,3600,1.01861252115
17050,17056,18935,6,1879,2,36000,1.00319318787
17068,17074,18997,6,1923,2,36000,1.0031201248
17083,17089,18905,6,1816,2,36000,1.00330396476
17099,17105,18995,6,1890,2,36000,1.00317460317
17100,17111,18864,11,1753,2,36000,1.00627495722
17115,17122,18844,7,1722,2,36000,1.00406504065
17131,17138,18486,7,1348,2,36000,1.00519287834
17167,17173,18997,6,1824,2,36000,1.00328947368
17219,17225,19083,6,1858,2,36000,1.00322927879
17240,17246,18777,6,1531,2,36000,1.00391900718
17256,17262,19096,6,1834,2,36000,1.00327153762
17257,17268,19164,11,1896,2,36000,1.00580168776
17273,17280,19097,7,1817,2,36000,1.00385250413
17275,17286,19235,11,1949,2,36000,1.00564391996
17333,17339,19044,6,1705,2,36000,1.00351906158
17369,17376,19241,7,1865,2,36000,1.00375335121
17449,17455,19235,6,1780,2,36000,1.00337078652
17464,17470,19241,6,1771,2,36000,1.00338791643
17465,17476,19130,11,1654,2,36000,1.00665054414
17496,17502,19242,6,1740,2,36000,1.00344827586
17511,17517,19184,6,1667,2,36000,1.00359928014
17527,17533,19356,6,1823,2,36000,1.00329127811
17547,17553,19378,6,1825,2,36000,1.00328767123
17563,17569,19463,6,1894,2,36000,1.00316789863
17581,17588,19266,7,1678,2,36000,1.0041716329
17615,17622,19463,7,1841,2,36000,1.00380228137
17631,17637,19372,6,1735,2,36000,1.00345821326
17665,17671,19132,6,1461,2,36000,1.00410677618
17682,17689,19508,7,1819,2,36000,1.00384826828
17699,17704,19655,5,1951,2,36000,1.00256278831
17715,17721,19568,6,1847,2,36000,1.0032485111
17729,17735,19508,6,1773,2,36000,1.00338409475
17745,17751,19718,6,1967,2,36000,1.00305033045
17747,17757,19723,10,1966,2,36000,1.00508646999
17748,17762,19529,14,1767,2,36000,1.00792303339
17768,17774,18915,6,1141,2,36000,1.00525854514
17769,17780,19425,11,1645,2,36000,1.00668693009
17770,17785,19490,15,1705,2,36000,1.00879765396
17787,17793,19458,6,1665,2,36000,1.0036036036
17794,17800,18309,6,509,1,1800,1.01178781925
17835,17841,19643,6,1802,2,36000,1.00332963374
17856,17862,19730,6,1868,2,36000,1.00321199143
17892,17898,19880,6,1982,2,36000,1.00302724521
17907,17914,19618,7,1704,2,36000,1.00410798122
17928,17935,19445,7,1510,2,36000,1.00463576159
17950,17956,19816,6,1860,2,36000,1.00322580645
17977,17983,19577,6,1594,2,36000,1.00376411543
17978,17989,19745,11,1756,2,36000,1.0062642369
17994,18000,19527,6,1527,2,36000,1.00392927308
17995,18006,19547,11,1541,2,36000,1.00713822193
18010,18016,19762,6,1746,2,36000,1.00343642612
18025,18032,20017,7,1985,2,36000,1.00352644836
18128,18135,19651,7,1516,2,36000,1.00461741425
18144,18150,19870,6,1720,2,36000,1.00348837209
18159,18165,19971,6,1806,2,36000,1.00332225914
18189,18195,19968,6,1773,2,36000,1.00338409475
18220,18226,20173,6,1947,2,36000,1.0030816641
18260,18266,20189,6,1923,2,36000,1.0031201248
18261,18272,19347,11,1075,2,36000,1.01023255814
18283,18289,19471,6,1182,2,36000,1.00507614213
18298,18304,20211,6,1907,2,36000,1.00314630309
18299,18310,19912,11,1602,2,36000,1.00686641698
18317,18324,20233,7,1909,2,36000,1.00366684128
18353,18359,19953,6,1594,2,36000,1.00376411543
18406,18413,20187,7,1774,2,36000,1.00394588501
18408,18419,20040,11,1621,2,36000,1.00678593461
18428,18434,20371,6,1937,2,36000,1.00309757357
18443,18450,20193,7,1743,2,36000,1.00401606426
18445,18455,20341,10,1886,2,36000,1.00530222694
18491,18497,19908,6,1411,2,36000,1.00425230333
18563,18569,20132,6,1563,2,36000,1.00383877159
18609,18615,20281,6,1666,2,36000,1.00360144058
18713,18719,20370,6,1651,2,36000,1.00363416111
18737,18743,20668,6,1925,2,36000,1.00311688312
18774,18780,20536,6,1756,2,36000,1.00341685649
18789,18795,20584,6,1789,2,36000,1.00335382895
18828,18834,20801,6,1967,2,36000,1.00305033045
18844,18850,20717,6,1867,2,36000,1.00321371184
18845,18856,20797,11,1941,2,36000,1.00566718187
18864,18870,20859,6,1989,2,36000,1.00301659125
18865,18876,20632,11,1756,2,36000,1.0062642369
18908,18914,20602,6,1688,2,36000,1.00355450237
18923,18929,20533,6,1604,2,36000,1.00374064838
18938,18944,20798,6,1854,2,36000,1.00323624595
18939,18950,20030,11,1080,2,36000,1.01018518519
18954,18960,20914,6,1954,2,36000,1.00307062436
18978,18985,20911,7,1926,2,36000,1.0036344756
18996,19003,21051,7,2048,2,36000,1.00341796875
19013,19019,20763,6,1744,2,36000,1.00344036697
19014,19025,20674,11,1649,2,36000,1.00667070952
19036,19042,20890,6,1848,2,36000,1.00324675325
19053,19059,20886,6,1827,2,36000,1.00328407225
19085,19091,20112,6,1021,2,36000,1.00587659158
19105,19111,20898,6,1787,2,36000,1.00335758254
19107,19117,20766,10,1649,2,36000,1.00606428138
19131,19137,20911,6,1774,2,36000,1.00338218715
19146,19152,20680,6,1528,2,36000,1.00392670157
19164,19170,20410,6,1240,2,36000,1.00483870968
19186,19192,21017,6,1825,2,36000,1.00328767123
19243,19249,21172,6,1923,2,36000,1.0031201248
19244,19255,21182,11,1927,2,36000,1.00570835496
19246,19260,21002,14,1742,2,36000,1.00803673938
19247,19266,20779,19,1513,2,36000,1.01255783212
19248,19271,20946,23,1675,2,36000,1.01373134328
19270,19277,20726,7,1449,2,36000,1.00483091787
19354,19360,21240,6,1880,2,36000,1.00319148936
19369,19375,21176,6,1801,2,36000,1.00333148251
19384,19390,20945,6,1555,2,36000,1.0038585209
19386,19396,21102,10,1706,2,36000,1.00586166471
19427,19433,21060,6,1627,2,36000,1.0036877689
19446,19452,21159,6,1707,2,36000,1.00351493849
19462,19468,21104,6,1636,2,36000,1.00366748166
19478,19484,21301,6,1817,2,36000,1.0033021464
19479,19490,21312,11,1822,2,36000,1.00603732162
19480,19495,21294,15,1799,2,36000,1.00833796554
19495,19501,21233,6,1732,2,36000,1.00346420323
19511,19517,21780,6,2263,2,36000,1.00265134777
19512,19523,21329,11,1806,2,36000,1.00609080842
19528,19534,20767,6,1233,2,36000,1.00486618005
19529,19540,21234,11,1694,2,36000,1.00649350649
19547,19553,21217,6,1664,2,36000,1.00360576923
19569,19575,21354,6,1779,2,36000,1.00337268128
19584,19590,21375,6,1785,2,36000,1.00336134454
19621,19627,20985,6,1358,2,36000,1.00441826215
19645,19651,21333,6,1682,2,36000,1.00356718193
19661,19667,21507,6,1840,2,36000,1.00326086957
19662,19673,21417,11,1744,2,36000,1.00630733945
19720,19726,21471,6,1745,2,36000,1.00343839542
19736,19742,21293,6,1551,2,36000,1.00386847195
19737,19748,21724,11,1976,2,36000,1.00556680162
19752,19758,21804,6,2046,2,36000,1.00293255132
19767,19773,21131,6,1358,2,36000,1.00441826215
19819,19825,21290,6,1465,2,36000,1.00409556314
19871,19877,21665,6,1788,2,36000,1.0033557047
19886,19892,21728,6,1836,2,36000,1.00326797386
19910,19917,21787,7,1870,2,36000,1.00374331551
19925,19931,21542,6,1611,2,36000,1.00372439479
19956,19962,21768,6,1806,2,36000,1.00332225914
19971,19977,21249,6,1272,2,36000,1.00471698113
19972,19983,21792,11,1809,2,36000,1.00608070757
19996,20002,20072,6,70,1,1800,1.08571428571
20020,20026,21904,6,1878,2,36000,1.00319488818
20036,20041,21787,5,1746,2,36000,1.00286368843
20052,20059,21682,7,1623,2,36000,1.00431300062
20115,20121,21709,6,1588,2,36000,1.00377833753
20134,20140,22206,6,2066,2,36000,1.00290416263
20176,20183,21805,7,1622,2,36000,1.00431565968
20192,20198,22085,6,1887,2,36000,1.00317965024
20193,20204,21480,11,1276,2,36000,1.00862068966
20199,20210,20331,11,121,1,1800,1.09090909091
20209,20216,21909,7,1693,2,36000,1.00413467218
20224,20230,22051,6,1821,2,36000,1.00329489292
20241,20247,21921,6,1674,2,36000,1.00358422939
20282,20288,21903,6,1615,2,36000,1.00371517028
20342,20349,22021,7,1672,2,36000,1.00418660287
20373,20379,22038,6,1659,2,36000,1.00361663653
20374,20385,22250,11,1865,2,36000,1.00589812332
20400,20406,20486,6,80,1,1800,1.075
20411,20417,22160,6,1743,2,36000,1.00344234079
20536,20542,22375,6,1833,2,36000,1.00327332242
20537,20548,22229,11,1681,2,36000,1.00654372397
20587,20593,22355,6,1762,2,36000,1.00340522134
20605,20611,22308,6,1697,2,36000,1.00353565115
20633,20639,22561,6,1922,2,36000,1.00312174818
20651,20657,20770,6,113,1,1800,1.05309734513
20669,20675,22968,6,2293,2,36000,1.0026166594
20684,20690,22535,6,1845,2,36000,1.00325203252
20686,20696,22667,10,1971,2,36000,1.00507356672
20720,20726,22529,6,1803,2,36000,1.00332778702
20736,20743,22628,7,1885,2,36000,1.00371352785
20761,20767,22481,6,1714,2,36000,1.00350058343
20776,20782,22500,6,1718,2,36000,1.00349243306
20777,20788,22697,11,1909,2,36000,1.00576217915
20793,20799,22640,6,1841,2,36000,1.00325909832
20811,20817,22451,6,1634,2,36000,1.00367197062
20812,20823,22838,11,2015,2,36000,1.00545905707
20813,20828,22704,15,1876,2,36000,1.00799573561
20860,20866,22707,6,1841,2,36000,1.00325909832
20889,20895,22637,6,1742,2,36000,1.00344431688
20890,20901,22699,11,1798,2,36000,1.00611790879
20907,20913,22774,6,1861,2,36000,1.00322407308
20922,20929,22257,7,1328,2,36000,1.00527108434
20924,20935,22130,11,1195,2,36000,1.00920502092
20925,20940,22598,15,1658,2,36000,1.00904704463
20947,20953,22703,6,1750,2,36000,1.00342857143
20948,20959,22209,11,1250,2,36000,1.0088
20987,20994,22471,7,1477,2,36000,1.00473933649
21003,21009,22820,6,1811,2,36000,1.00331308669
21019,21025,22878,6,1853,2,36000,1.00323799244
21054,21060,22936,6,1876,2,36000,1.00319829424
21069,21075,22926,6,1851,2,36000,1.00324149109
21103,21109,22510,6,1401,2,36000,1.00428265525
21118,21124,22974,6,1850,2,36000,1.00324324324
21133,21139,22864,6,1725,2,36000,1.00347826087
21163,21169,22952,6,1783,2,36000,1.00336511497
21178,21184,22963,6,1779,2,36000,1.00337268128
21179,21190,22902,11,1712,2,36000,1.00642523364
21194,21201,23075,7,1874,2,36000,1.00373532551
21219,21225,22780,6,1555,2,36000,1.0038585209
21234,21241,23149,7,1908,2,36000,1.0036687631
21236,21247,22255,11,1008,2,36000,1.01091269841
21251,21257,23138,6,1881,2,36000,1.00318979266
21252,21263,22901,11,1638,2,36000,1.00671550672
21293,21300,23130,7,1830,2,36000,1.00382513661
21295,21305,23233,10,1928,2,36000,1.00518672199
21296,21311,22990,15,1679,2,36000,1.00893388922
21312,21318,23101,6,1783,2,36000,1.00336511497
21313,21324,22983,11,1659,2,36000,1.0066305003
21331,21337,23192,6,1855,2,36000,1.00323450135
21337,21343,21620,6,277,1,1800,1.02166064982
21347,21354,23211,7,1857,2,36000,1.00376952073
21362,21369,22370,7,1001,2,36000,1.00699300699
21378,21384,23180,6,1796,2,36000,1.00334075724
21418,21424,23161,6,1737,2,36000,1.00345423143
21449,21455,21971,6,516,1,1800,1.01162790698
21473,21479,23328,6,1849,2,36000,1.0032449973
21490,21496,23270,6,1774,2,36000,1.00338218715
21510,21516,23319,6,1803,2,36000,1.00332778702
21544,21551,23442,7,1891,2,36000,1.00370174511
21667,21673,23436,6,1763,2,36000,1.00340328985
21682,21689,23649,7,1960,2,36000,1.00357142857
21711,21717,23494,6,1777,2,36000,1.00337647721
21726,21733,23491,7,1758,2,36000,1.0039817975
21742,21748,23029,6,1281,2,36000,1.00468384075
21768,21774,23673,6,1899,2,36000,1.00315955766
21784,21790,23459,6,1669,2,36000,1.00359496705
21803,21809,23739,6,1930,2,36000,1.00310880829
21805,21815,24028,10,2213,2,36000,1.00451875282
21806,21820,23815,14,1995,2,36000,1.00701754386
21821,21827,23430,6,1603,2,36000,1.00374298191
21823,21833,23901,10,2068,2,36000,1.00483558994
21914,21920,23783,6,1863,2,36000,1.00322061192
21915,21926,23194,11,1268,2,36000,1.00867507886
21917,21931,23663,14,1732,2,36000,1.00808314088
21932,21938,23852,6,1914,2,36000,1.00313479624
22026,22032,23858,6,1826,2,36000,1.00328587076
22041,22047,23780,6,1733,2,36000,1.00346220427
22060,22066,23877,6,1811,2,36000,1.00331308669
22087,22093,23335,6,1242,2,36000,1.00483091787
22133,22139,24263,6,2124,2,36000,1.00282485876
22163,22169,24094,6,1925,2,36000,1.00311688312
22209,22215,23590,6,1375,2,36000,1.00436363636
22210,22221,23985,11,1764,2,36000,1.00623582766
22231,22238,24068,7,1830,2,36000,1.00382513661
22250,22256,24116,6,1860,2,36000,1.00322580645
22265,22271,24190,6,1919,2,36000,1.00312662845
22266,22277,23878,11,1601,2,36000,1.00687070581
22309,22315,24173,6,1858,2,36000,1.00322927879
22355,22361,24222,6,1861,2,36000,1.00322407308
22370,22376,24394,6,2018,2,36000,1.00297324083
22385,22392,24444,7,2052,2,36000,1.00341130604
22452,22458,23841,6,1383,2,36000,1.00433839479
22473,22480,24247,7,1767,2,36000,1.00396151669
22489,22495,24270,6,1775,2,36000,1.00338028169
22504,22511,23839,7,1328,2,36000,1.00527108434
22519,22526,24426,7,1900,2,36000,1.00368421053
22535,22541,24352,6,1811,2,36000,1.00331308669
22550,22556,24217,6,1661,2,36000,1.00361228176
22565,22571,24354,6,1783,2,36000,1.00336511497
22598,22605,24318,7,1713,2,36000,1.00408639813
22628,22635,24367,7,1732,2,36000,1.00404157044
22644,22650,23745,6,1095,2,36000,1.00547945205
22645,22656,24374,11,1718,2,36000,1.00640279395
22669,22675,24384,6,1709,2,36000,1.00351082504
22697,22703,24366,6,1663,2,36000,1.00360793746
22713,22718,24387,5,1669,2,36000,1.00299580587
22714,22724,24611,10,1887,2,36000,1.00529941706
22715,22729,24526,14,1797,2,36000,1.00779076238
22716,22734,24512,18,1778,2,36000,1.01012373453
22774,22780,24805,6,2025,2,36000,1.00296296296
22789,22795,24668,6,1873,2,36000,1.00320341698
22822,22829,24663,7,1834,2,36000,1.00381679389
22840,22847,24651,7,1804,2,36000,1.00388026608
22865,22871,24527,6,1656,2,36000,1.00362318841
22880,22886,24639,6,1753,2,36000,1.00342270394
22904,22911,24712,7,1801,2,36000,1.00388672959
22906,22917,24778,11,1861,2,36000,1.00591080064
22928,22934,24688,6,1754,2,36000,1.00342075257
22943,22949,24680,6,1731,2,36000,1.00346620451
22958,22964,24802,6,1838,2,36000,1.00326441785
22973,22979,24648,6,1669,2,36000,1.00359496705
22974,22985,24755,11,1770,2,36000,1.00621468927
22991,22997,24892,6,1895,2,36000,1.00316622691
22992,23003,24704,11,1701,2,36000,1.00646678424
22993,23008,24810,15,1802,2,36000,1.00832408435
23031,23037,24693,6,1656,2,36000,1.00362318841
23077,23083,24854,6,1771,2,36000,1.00338791643
23104,23110,25115,6,2005,2,36000,1.0029925187
23133,23139,25020,6,1881,2,36000,1.00318979266
23148,23155,25019,7,1864,2,36000,1.00375536481
23150,23161,25037,11,1876,2,36000,1.00586353945
23166,23172,25394,6,2222,2,36000,1.00270027003
23185,23190,24822,5,1632,2,36000,1.00306372549
23200,23206,25030,6,1824,2,36000,1.00328947368
23202,23212,24822,10,1610,2,36000,1.00621118012
23217,23223,24922,6,1699,2,36000,1.00353148911
23235,23241,24533,6,1292,2,36000,1.00464396285
23269,23276,25079,7,1803,2,36000,1.00388241819
23323,23329,25060,6,1731,2,36000,1.00346620451
23346,23352,25031,6,1679,2,36000,1.00357355569
23348,23358,24888,10,1530,2,36000,1.00653594771
23434,23440,25174,6,1734,2,36000,1.00346020761
23449,23456,24784,7,1328,2,36000,1.00527108434
23451,23462,25221,11,1759,2,36000,1.00625355316
23466,23472,25198,6,1726,2,36000,1.00347624565
23493,23500,25270,7,1770,2,36000,1.00395480226
23495,23506,25224,11,1718,2,36000,1.00640279395
23591,23597,25662,6,2065,2,36000,1.00290556901
23652,23658,25406,6,1748,2,36000,1.00343249428
23668,23674,25464,6,1790,2,36000,1.00335195531
23683,23689,25387,6,1698,2,36000,1.0035335689
23739,23745,25659,6,1914,2,36000,1.00313479624
23755,23761,25445,6,1684,2,36000,1.00356294537
23782,23788,25525,6,1737,2,36000,1.00345423143
23797,23804,25648,7,1844,2,36000,1.00379609544
23816,23822,25406,6,1584,2,36000,1.00378787879
23829,23835,23885,6,50,1,1800,1.12
23840,23847,25657,7,1810,2,36000,1.00386740331
23856,23862,25825,6,1963,2,36000,1.0030565461
23857,23868,25471,11,1603,2,36000,1.0068621335
23872,23879,25548,7,1669,2,36000,1.00419412822
23888,23894,25085,6,1191,2,36000,1.00503778338
23889,23900,25549,11,1649,2,36000,1.00667070952
23904,23911,25781,7,1870,2,36000,1.00374331551
23983,23989,25768,6,1779,2,36000,1.00337268128
24029,24035,25897,6,1862,2,36000,1.00322234157
24074,24080,26000,6,1920,2,36000,1.003125
24096,24102,26070,6,1968,2,36000,1.00304878049
24117,24123,25795,6,1672,2,36000,1.00358851675
24174,24181,25872,7,1691,2,36000,1.00413956239
24193,24199,26142,6,1943,2,36000,1.00308800823
24220,24226,25978,6,1752,2,36000,1.00342465753
24225,24232,24311,7,79,1,1800,1.08860759494
24235,24241,26126,6,1885,2,36000,1.00318302387
24250,24256,26072,6,1816,2,36000,1.00330396476
24265,24272,26136,7,1864,2,36000,1.00375536481
24281,24287,26143,6,1856,2,36000,1.00323275862
24320,24326,26173,6,1847,2,36000,1.0032485111
24344,24350,26095,6,1745,2,36000,1.00343839542
24359,24365,25741,6,1376,2,36000,1.00436046512
24375,24381,25928,6,1547,2,36000,1.00387847447
24376,24387,25614,11,1227,2,36000,1.00896495518
24377,24392,26343,15,1951,2,36000,1.00768836494
24393,24399,25914,6,1515,2,36000,1.00396039604
24394,24405,26233,11,1828,2,36000,1.00601750547
24411,24417,26338,6,1921,2,36000,1.00312337324
24428,24434,26622,6,2188,2,36000,1.00274223035
24449,24455,26384,6,1929,2,36000,1.00311041991
24515,24521,26394,6,1873,2,36000,1.00320341698
24531,24537,25919,6,1382,2,36000,1.00434153401
24532,24543,26430,11,1887,2,36000,1.00582935877
24549,24555,26551,6,1996,2,36000,1.00300601202
24615,24620,26455,5,1835,2,36000,1.00272479564
24643,24649,26533,6,1884,2,36000,1.00318471338
24658,24664,26287,6,1623,2,36000,1.00369685767
24659,24670,26591,11,1921,2,36000,1.00572618428
24675,24681,26562,6,1881,2,36000,1.00318979266
24676,24687,25774,11,1087,2,36000,1.01011959522
24691,24697,26522,6,1825,2,36000,1.00328767123
24693,24703,26444,10,1741,2,36000,1.00574382539
24709,24715,26741,6,2026,2,36000,1.00296150049
24710,24721,26350,11,1629,2,36000,1.00675260896
24725,24732,26970,7,2238,2,36000,1.00312779267
24756,24762,26668,6,1906,2,36000,1.00314795383
24781,24787,26852,6,2065,2,36000,1.00290556901
24796,24802,26576,6,1774,2,36000,1.00338218715
24812,24817,26482,5,1665,2,36000,1.003003003
24813,24823,26633,10,1810,2,36000,1.00552486188
24814,24828,26699,14,1871,2,36000,1.00748262961
24829,24835,26570,6,1735,2,36000,1.00345821326
24831,24841,26587,10,1746,2,36000,1.00572737686
24855,24861,26579,6,1718,2,36000,1.00349243306
24889,24895,26604,6,1709,2,36000,1.00351082504
24904,24910,26597,6,1687,2,36000,1.00355660937
24926,24932,26810,6,1878,2,36000,1.00319488818
25021,25027,26709,6,1682,2,36000,1.00356718193
25022,25033,26883,11,1850,2,36000,1.00594594595
25038,25044,26751,6,1707,2,36000,1.00351493849
25039,25050,27026,11,1976,2,36000,1.00556680162
25041,25055,26624,14,1569,2,36000,1.00892288082
25063,25069,26805,6,1736,2,36000,1.0034562212
25084,25090,26706,6,1616,2,36000,1.00371287129
25100,25106,27059,6,1953,2,36000,1.00307219662
25118,25124,26775,6,1651,2,36000,1.00363416111
25176,25182,26700,6,1518,2,36000,1.00395256917
25200,25206,27087,6,1881,2,36000,1.00318979266
25222,25228,26955,6,1727,2,36000,1.00347423277
25237,25243,27064,6,1821,2,36000,1.00329489292
25270,25276,26635,6,1359,2,36000,1.00441501104
25319,25325,25634,6,309,1,1800,1.01941747573
25389,25395,27215,6,1820,2,36000,1.0032967033
25404,25411,27164,7,1753,2,36000,1.00399315459
25420,25426,27289,6,1863,2,36000,1.00322061192
25421,25432,27349,11,1917,2,36000,1.0057381325
25446,25452,27304,6,1852,2,36000,1.00323974082
25465,25471,27361,6,1890,2,36000,1.00317460317
25480,25486,27166,6,1680,2,36000,1.00357142857
25527,25533,27299,6,1766,2,36000,1.00339750849
25551,25558,27531,7,1973,2,36000,1.0035478966
25553,25564,27326,11,1762,2,36000,1.00624290579
25629,25635,27376,6,1741,2,36000,1.00344629523
25652,25658,27363,6,1705,2,36000,1.00351906158
25671,25678,27387,7,1709,2,36000,1.00409596255
25673,25684,27669,11,1985,2,36000,1.00554156171
25674,25689,26841,15,1152,2,36000,1.01302083333
25742,25748,27610,6,1862,2,36000,1.00322234157
25772,25778,27700,6,1922,2,36000,1.00312174818
25791,25797,27589,6,1792,2,36000,1.00334821429
25792,25803,27698,11,1895,2,36000,1.00580474934
25807,25813,26878,6,1065,2,36000,1.00563380282
25825,25832,27583,7,1751,2,36000,1.00399771559
25873,25879,27688,6,1809,2,36000,1.00331674959
25897,25904,27921,7,2017,2,36000,1.00347050074
25916,25922,27592,6,1670,2,36000,1.00359281437
25932,25938,27021,6,1083,2,36000,1.0055401662
25933,25944,28009,11,2065,2,36000,1.00532687651
25980,25986,27549,6,1563,2,36000,1.00383877159
26002,26008,27859,6,1851,2,36000,1.00324149109
26010,26300,29910,290,3610,17,3600,1.08033240997
26072,26079,27953,7,1874,2,36000,1.00373532551
26074,26085,27989,11,1904,2,36000,1.00577731092
26095,26101,28004,6,1903,2,36000,1.00315291645
26136,26141,27884,5,1743,2,36000,1.00286861733
26151,26158,28189,7,2031,2,36000,1.00344657804
26153,26164,28030,11,1866,2,36000,1.00589496249
26154,26173,28080,19,1907,2,36000,1.00996329313
26175,26181,28073,6,1892,2,36000,1.00317124736
26236,26242,28047,6,1805,2,36000,1.00332409972
26287,26294,28311,7,2017,2,36000,1.00347050074
26339,26345,27382,6,1037,2,36000,1.00578592093
26354,26360,28074,6,1714,2,36000,1.00350058343
26355,26366,28207,11,1841,2,36000,1.00597501358
26386,26392,28211,6,1819,2,36000,1.00329851567
26401,26407,28819,6,2412,2,36000,1.00248756219
26431,26437,28188,6,1751,2,36000,1.00342661336
26447,26453,28250,6,1797,2,36000,1.00333889816
26462,26468,27803,6,1335,2,36000,1.00449438202
26484,26490,28315,6,1825,2,36000,1.00328767123
26523,26529,28433,6,1904,2,36000,1.0031512605
26538,26544,28222,6,1678,2,36000,1.00357568534
26553,26560,28187,7,1627,2,36000,1.00430239705
26569,26575,28689,6,2114,2,36000,1.00283822138
26585,26590,28495,5,1905,2,36000,1.00262467192
26586,26596,28392,10,1796,2,36000,1.00556792873
26587,26601,28205,14,1604,2,36000,1.00872817955
26589,26606,28400,17,1794,2,36000,1.00947603122
26604,26612,28387,8,1775,2,36000,1.00450704225
26606,26617,28401,11,1784,2,36000,1.00616591928
26607,26623,28692,16,2069,2,36000,1.00773320445
26622,26629,28337,7,1708,2,36000,1.00409836066
26637,26643,28333,6,1690,2,36000,1.00355029586
26639,26649,27732,10,1083,2,36000,1.00923361034
26640,26654,28509,14,1855,2,36000,1.00754716981
26670,26676,28048,6,1372,2,36000,1.00437317784
26701,26707,28549,6,1842,2,36000,1.00325732899
26702,26713,28424,11,1711,2,36000,1.0064289889
26717,26724,28131,7,1407,2,36000,1.00497512438
26719,26730,28514,11,1784,2,36000,1.00616591928
26744,26750,28464,6,1714,2,36000,1.00350058343
26759,26765,28715,6,1950,2,36000,1.00307692308
26777,26783,28537,6,1754,2,36000,1.00342075257
26807,26814,28425,7,1611,2,36000,1.00434512725
26823,26829,28506,6,1677,2,36000,1.00357781753
26841,26847,28601,6,1754,2,36000,1.00342075257
26856,26862,28662,6,1800,2,36000,1.00333333333
26882,26888,28462,6,1574,2,36000,1.00381194409
26897,26903,28661,6,1758,2,36000,1.00341296928
26957,26963,28600,6,1637,2,36000,1.0036652413
26972,26978,28693,6,1715,2,36000,1.00349854227
27026,27032,28909,6,1877,2,36000,1.0031965903
27028,27038,29000,10,1962,2,36000,1.00509683996
27063,27069,28375,6,1306,2,36000,1.0045941807
27065,27076,28851,11,1775,2,36000,1.0061971831
27087,27094,29039,7,1945,2,36000,1.00359897172
27167,27174,28599,7,1425,2,36000,1.0049122807
27169,27180,28918,11,1738,2,36000,1.00632911392
27217,27223,29072,6,1849,2,36000,1.0032449973
27289,27296,28947,7,1651,2,36000,1.00423985463
27305,27311,29158,6,1847,2,36000,1.0032485111
27306,27317,29062,11,1745,2,36000,1.00630372493
27328,27334,29098,6,1764,2,36000,1.00340136054
27349,27355,29182,6,1827,2,36000,1.00328407225
27364,27370,29223,6,1853,2,36000,1.00323799244
27366,27376,29087,10,1711,2,36000,1.00584453536
27381,27387,28995,6,1608,2,36000,1.00373134328
27397,27404,29153,7,1749,2,36000,1.00400228702
27399,27410,29133,11,1723,2,36000,1.00638421358
27547,27553,29164,6,1611,2,36000,1.00372439479
27563,27569,29219,6,1650,2,36000,1.00363636364
27582,27588,29406,6,1818,2,36000,1.00330033003
27597,27603,29522,6,1919,2,36000,1.00312662845
27599,27609,29445,10,1836,2,36000,1.00544662309
27614,27620,29275,6,1655,2,36000,1.00362537764
27670,27677,29376,7,1699,2,36000,1.00412007063
27689,27695,29604,6,1909,2,36000,1.00314300681
27706,27712,29653,6,1941,2,36000,1.00309119011
27707,27718,29569,11,1851,2,36000,1.00594273366
27736,27742,29481,6,1739,2,36000,1.00345025877
27806,27812,29618,6,1806,2,36000,1.00332225914
27862,27868,29460,6,1592,2,36000,1.00376884422
27884,27890,29682,6,1792,2,36000,1.00334821429
27922,27928,29545,6,1617,2,36000,1.00371057514
27954,27960,29748,6,1788,2,36000,1.0033557047
27992,27998,29568,6,1570,2,36000,1.00382165605
28007,28013,29816,6,1803,2,36000,1.00332778702
28023,28029,30227,6,2198,2,36000,1.00272975432
28039,28045,30000,6,1955,2,36000,1.00306905371
28054,28060,29824,6,1764,2,36000,1.00340136054
28056,28066,30009,10,1943,2,36000,1.00514668039
28075,28081,29828,6,1747,2,36000,1.00343445907
28076,28087,29924,11,1837,2,36000,1.00598802395
28092,28098,29931,6,1833,2,36000,1.00327332242
28132,28138,29855,6,1717,2,36000,1.00349446709
28206,28212,30020,6,1808,2,36000,1.00331858407
28207,28218,30272,11,2054,2,36000,1.00535540409
28209,28223,29261,14,1038,2,36000,1.01348747592
28210,28228,30018,18,1790,2,36000,1.01005586592
28230,28237,29953,7,1716,2,36000,1.00407925408
28232,28243,30023,11,1780,2,36000,1.00617977528
28233,28248,30121,15,1873,2,36000,1.00800854245
28254,28260,30080,6,1820,2,36000,1.0032967033
28315,28321,30257,6,1936,2,36000,1.00309917355
28316,28327,30203,11,1876,2,36000,1.00586353945
28337,28343,29980,6,1637,2,36000,1.0036652413
28352,28358,30060,6,1702,2,36000,1.00352526439
28379,28385,29982,6,1597,2,36000,1.00375704446
28394,28400,30293,6,1893,2,36000,1.00316957211
28396,28406,30177,10,1771,2,36000,1.00564652739
28411,28417,30452,6,2035,2,36000,1.00294840295
28412,28423,30191,11,1768,2,36000,1.00622171946
28431,28436,30196,5,1760,2,36000,1.00284090909
28432,28442,30154,10,1712,2,36000,1.0058411215
28448,28454,30492,6,2038,2,36000,1.00294406281
28464,28470,30130,6,1660,2,36000,1.00361445783
28465,28476,30699,11,2223,2,36000,1.00494826811
28503,28509,30487,6,1978,2,36000,1.00303336704
28519,28525,30343,6,1818,2,36000,1.00330033003
28520,28531,30256,11,1725,2,36000,1.00637681159
28521,28536,30427,15,1891,2,36000,1.00793231095
28547,28553,30146,6,1593,2,36000,1.00376647834
28564,28570,30460,6,1890,2,36000,1.00317460317
28606,28612,30517,6,1905,2,36000,1.0031496063
28607,28618,30307,11,1689,2,36000,1.00651272943
28609,28623,30349,14,1726,2,36000,1.00811123986
28664,28670,30504,6,1834,2,36000,1.00327153762
28665,28676,30533,11,1857,2,36000,1.00592353258
28690,28696,30490,6,1794,2,36000,1.00334448161
28705,28711,30661,6,1950,2,36000,1.00307692308
28706,28717,30655,11,1938,2,36000,1.00567595459
28722,28728,30662,6,1934,2,36000,1.00310237849
28821,28827,30536,6,1709,2,36000,1.00351082504
28854,28860,30960,6,2100,2,36000,1.00285714286
28912,28918,30614,6,1696,2,36000,1.00353773585
28927,28933,30819,6,1886,2,36000,1.00318133616
28948,28954,30880,6,1926,2,36000,1.0031152648
28998,29004,30813,6,1809,2,36000,1.00331674959
28999,29010,30810,11,1800,2,36000,1.00611111111
29040,29046,30958,6,1912,2,36000,1.00313807531
29065,29071,30971,6,1900,2,36000,1.00315789474
29081,29087,30885,6,1798,2,36000,1.00333704116
29096,29103,30717,7,1614,2,36000,1.00433705081
29098,29109,30998,11,1889,2,36000,1.00582318687
29134,29140,31184,6,2044,2,36000,1.00293542074
29156,29162,30747,6,1585,2,36000,1.00378548896
29171,29177,30769,6,1592,2,36000,1.00376884422
29172,29183,30922,11,1739,2,36000,1.00632547441
29189,29195,31080,6,1885,2,36000,1.00318302387
29222,29228,31062,6,1834,2,36000,1.00327153762
29238,29244,30893,6,1649,2,36000,1.00363856883
29263,29269,31089,6,1820,2,36000,1.0032967033
29279,29285,31043,6,1758,2,36000,1.00341296928
29377,29383,31297,6,1914,2,36000,1.00313479624
29408,29414,31394,6,1980,2,36000,1.00303030303
29448,29455,31232,7,1777,2,36000,1.00393922341
29464,29470,31223,6,1753,2,36000,1.00342270394
29482,29488,31323,6,1835,2,36000,1.00326975477
29524,29530,31272,6,1742,2,36000,1.00344431688
29545,29551,31362,6,1811,2,36000,1.00331308669
29571,29577,31300,6,1723,2,36000,1.00348229832
29572,29583,31403,11,1820,2,36000,1.00604395604
29605,29612,31480,7,1868,2,36000,1.00374732334
29621,29627,31429,6,1802,2,36000,1.00332963374
29654,29660,31497,6,1837,2,36000,1.00326619488
29686,29692,31481,6,1789,2,36000,1.00335382895
29752,29758,31640,6,1882,2,36000,1.00318809777
29817,29823,31773,6,1950,2,36000,1.00307692308
29832,29839,31896,7,2057,2,36000,1.0034030141
29834,29845,31865,11,2020,2,36000,1.00544554455
29856,29862,31370,6,1508,2,36000,1.00397877984
29929,29935,31602,6,1667,2,36000,1.00359928014
29945,29951,32114,6,2163,2,36000,1.0027739251
29960,29967,31566,7,1599,2,36000,1.00437773609
29981,29987,32011,6,2024,2,36000,1.00296442688
29982,29993,31780,11,1787,2,36000,1.00615556799
30001,30007,31906,6,1899,2,36000,1.00315955766
30016,30022,31553,6,1531,2,36000,1.00391900718
30032,30038,31841,6,1803,2,36000,1.00332778702
30033,30044,30979,11,935,2,36000,1.01176470588
30034,30049,31579,15,1530,2,36000,1.00980392157
30064,30070,32009,6,1939,2,36000,1.00309437855
30082,30088,31758,6,1670,2,36000,1.00359281437
30121,30127,31939,6,1812,2,36000,1.00331125828
30137,30143,31930,6,1787,2,36000,1.00335758254
30155,30161,32080,6,1919,2,36000,1.00312662845
30156,30167,32501,11,2334,2,36000,1.00471293916
30178,30184,32090,6,1906,2,36000,1.00314795383
30194,30200,31908,6,1708,2,36000,1.00351288056
30195,30206,32059,11,1853,2,36000,1.00593631948
30213,30219,31736,6,1517,2,36000,1.00395517469
30228,30234,31929,6,1695,2,36000,1.00353982301
30259,30265,32177,6,1912,2,36000,1.00313807531
30260,30271,31578,11,1307,2,36000,1.00841622035
30275,30281,32003,6,1722,2,36000,1.00348432056
30295,30301,31757,6,1456,2,36000,1.00412087912
30310,30317,32164,7,1847,2,36000,1.00378992962
30345,30351,31987,6,1636,2,36000,1.00366748166
30361,30367,32108,6,1741,2,36000,1.00344629523
30429,30435,32324,6,1889,2,36000,1.00317628375
30453,30460,32203,7,1743,2,36000,1.00401606426
30469,30475,32471,6,1996,2,36000,1.00300601202
30487,30493,32186,6,1693,2,36000,1.00354400473
30502,30508,32297,6,1789,2,36000,1.00335382895
30504,30514,32371,10,1857,2,36000,1.00538502962
30519,30525,32409,6,1884,2,36000,1.00318471338
30521,30531,31735,10,1204,2,36000,1.00830564784
30536,30542,32306,6,1764,2,36000,1.00340136054
30537,30548,32347,11,1799,2,36000,1.00611450806
30616,30622,32463,6,1841,2,36000,1.00325909832
30656,30662,32238,6,1576,2,36000,1.0038071066
30671,30677,32697,6,2020,2,36000,1.00297029703
30672,30683,32194,11,1511,2,36000,1.00727994705
30700,30706,32509,6,1803,2,36000,1.00332778702
30718,30724,32662,6,1938,2,36000,1.00309597523
30749,30755,32332,6,1577,2,36000,1.00380469245
30771,30777,32574,6,1797,2,36000,1.00333889816
30811,30817,32772,6,1955,2,36000,1.00306905371
30826,30833,32863,7,2030,2,36000,1.00344827586
30828,30839,32724,11,1885,2,36000,1.00583554377
30881,30887,32570,6,1683,2,36000,1.00356506239
30896,30902,32972,6,2070,2,36000,1.00289855072
30897,30908,32529,11,1621,2,36000,1.00678593461
30922,30928,32750,6,1822,2,36000,1.00329308452
30958,30964,32891,6,1927,2,36000,1.00311364816
30974,30980,32776,6,1796,2,36000,1.00334075724
30975,30986,32700,11,1714,2,36000,1.00641773629
30990,30996,32740,6,1744,2,36000,1.00344036697
31005,31011,32915,6,1904,2,36000,1.0031512605
31045,31051,32980,6,1929,2,36000,1.00311041991
31063,31070,32652,7,1582,2,36000,1.00442477876
31084,31090,32833,6,1743,2,36000,1.00344234079
31099,31106,32851,7,1745,2,36000,1.00401146132
31186,31192,33060,6,1868,2,36000,1.00321199143
31231,31237,33287,6,2050,2,36000,1.00292682927
31248,31254,32910,6,1656,2,36000,1.00362318841
31273,31279,33068,6,1789,2,36000,1.00335382895
31300,31306,33065,6,1759,2,36000,1.00341102899
31301,31312,33143,11,1831,2,36000,1.0060076461
31327,31333,33035,6,1702,2,36000,1.00352526439
31363,31369,33263,6,1894,2,36000,1.00316789863
31378,31385,32782,7,1397,2,36000,1.00501073729
31394,31400,33272,6,1872,2,36000,1.00320512821
31411,31418,33210,7,1792,2,36000,1.00390625
31432,31438,33288,6,1850,2,36000,1.00324324324
31482,31488,32903,6,1415,2,36000,1.00424028269
31483,31494,33375,11,1881,2,36000,1.00584795322
31499,31505,33222,6,1717,2,36000,1.00349446709
31554,31561,33370,7,1809,2,36000,1.00386954118
31569,31576,33481,7,1905,2,36000,1.00367454068
31585,31590,33394,5,1804,2,36000,1.00277161863
31586,31596,33368,10,1772,2,36000,1.00564334086
31604,31610,33532,6,1922,2,36000,1.00312174818
31641,31647,33424,6,1777,2,36000,1.00337647721
31735,31742,33583,7,1841,2,36000,1.00380228137
31737,31747,33650,10,1903,2,36000,1.00525486075
31757,31764,33673,7,1909,2,36000,1.00366684128
31759,31770,33851,11,2081,2,36000,1.00528592023
31774,31780,33470,6,1690,2,36000,1.00355029586
31789,31795,33562,6,1767,2,36000,1.00339558574
31845,31851,33678,6,1827,2,36000,1.00328407225
31867,31874,33827,7,1953,2,36000,1.00358422939
31898,31904,33607,6,1703,2,36000,1.00352319436
31914,31919,33821,5,1902,2,36000,1.00262881178
31915,31925,33768,10,1843,2,36000,1.00542593597
31931,31937,33853,6,1916,2,36000,1.00313152401
31932,31943,33938,11,1995,2,36000,1.00551378446
31948,31955,33770,7,1815,2,36000,1.00385674931
31988,31994,33869,6,1875,2,36000,1.0032
31993,32208,41577,215,9369,32,356400,1.02294802007
32007,32013,33885,6,1872,2,36000,1.00320512821
32022,32029,33993,7,1964,2,36000,1.00356415479
32024,32035,33723,11,1688,2,36000,1.00651658768
32061,32067,33591,6,1524,2,36000,1.00393700787
32082,32088,34177,6,2089,2,36000,1.00287218765
32097,32104,33910,7,1806,2,36000,1.00387596899
32113,32118,33841,5,1723,2,36000,1.00290191526
32114,32124,33958,10,1834,2,36000,1.0054525627
32166,32172,33773,6,1601,2,36000,1.00374765771
32181,32187,34222,6,2035,2,36000,1.00294840295
32196,32202,33972,6,1770,2,36000,1.00338983051
32197,32213,33104,16,891,2,36000,1.01795735129
32212,32219,34053,7,1834,2,36000,1.00381679389
32241,32247,33957,6,1710,2,36000,1.00350877193
32298,32305,34117,7,1812,2,36000,1.00386313466
32314,32320,34153,6,1833,2,36000,1.00327332242
32329,32335,33869,6,1534,2,36000,1.00391134289
32344,32350,34148,6,1798,2,36000,1.00333704116
32359,32365,34074,6,1709,2,36000,1.00351082504
32374,32380,34320,6,1940,2,36000,1.00309278351
32411,32417,34112,6,1695,2,36000,1.00353982301
32466,32472,34199,6,1727,2,36000,1.00347423277
32481,32487,34064,6,1577,2,36000,1.00380469245
32502,32509,34308,7,1799,2,36000,1.00389105058
32518,32524,34410,6,1886,2,36000,1.00318133616
32533,32539,34275,6,1736,2,36000,1.0034562212
32573,32579,34448,6,1869,2,36000,1.00321027287
32589,32595,34352,6,1757,2,36000,1.00341491178
32654,32661,34405,7,1744,2,36000,1.00401376147
32671,32677,34566,6,1889,2,36000,1.00317628375
32703,32709,34547,6,1838,2,36000,1.00326441785
32704,32715,34468,11,1753,2,36000,1.00627495722
32728,32734,34402,6,1668,2,36000,1.0035971223
32743,32749,34863,6,2114,2,36000,1.00283822138
32758,32765,34556,7,1791,2,36000,1.00390843104
32774,32780,34721,6,1941,2,36000,1.00309119011
32791,32798,34496,7,1698,2,36000,1.00412249706
32793,32804,34822,11,2018,2,36000,1.00545094153
32838,32844,34619,6,1775,2,36000,1.00338028169
32854,32860,34644,6,1784,2,36000,1.0033632287
32869,32876,34938,7,2062,2,36000,1.00339476237
32891,32897,34574,6,1677,2,36000,1.00357781753
32906,32912,34866,6,1954,2,36000,1.00307062436
32921,32928,34248,7,1320,2,36000,1.0053030303
32923,32934,34788,11,1854,2,36000,1.00593311758
32972,32978,34828,6,1850,2,36000,1.00324324324
32987,32993,34811,6,1818,2,36000,1.00330033003
33036,33042,34864,6,1822,2,36000,1.00329308452
33060,33066,34983,6,1917,2,36000,1.00312989045
33060,33279,33846,219,567,17,3600,1.38624338624
33075,33082,34388,7,1306,2,36000,1.00535987749
33077,33088,34918,11,1830,2,36000,1.00601092896
33104,33110,34908,6,1798,2,36000,1.00333704116
33144,33150,34804,6,1654,2,36000,1.00362756953
33211,33217,35206,6,1989,2,36000,1.00301659125
33226,33232,35046,6,1814,2,36000,1.0033076075
33266,33273,35116,7,1843,2,36000,1.00379815518
33283,33289,35337,6,2048,2,36000,1.0029296875
33298,33304,35100,6,1796,2,36000,1.00334075724
33299,33310,34705,11,1395,2,36000,1.00788530466
33369,33376,35158,7,1782,2,36000,1.00392817059
33371,33382,34933,11,1551,2,36000,1.00709219858
33386,33392,35145,6,1753,2,36000,1.00342270394
33401,33407,35218,6,1811,2,36000,1.00331308669
33425,33432,35510,7,2078,2,36000,1.00336862368
33471,33477,35215,6,1738,2,36000,1.00345224396
33487,33493,35275,6,1782,2,36000,1.00336700337
33533,33540,35335,7,1795,2,36000,1.00389972145
33564,33570,35287,6,1717,2,36000,1.00349446709
33585,33591,35007,6,1416,2,36000,1.00423728814
33600,33607,35085,7,1478,2,36000,1.00473612991
33616,33622,35419,6,1797,2,36000,1.00333889816
33652,33658,35417,6,1759,2,36000,1.00341102899
33673,33679,35494,6,1815,2,36000,1.00330578512
33688,33694,35570,6,1876,2,36000,1.00319829424
33725,33731,35748,6,2017,2,36000,1.00297471492
33771,33777,35763,6,1986,2,36000,1.00302114804
33773,33783,35530,10,1747,2,36000,1.00572409845
33788,33794,35601,6,1807,2,36000,1.00332042059
33824,33830,35794,6,1964,2,36000,1.00305498982
33839,33846,35636,7,1790,2,36000,1.00391061453
33855,33861,35582,6,1721,2,36000,1.00348634515
33856,33867,35719,11,1852,2,36000,1.00593952484
33857,33872,35866,15,1994,2,36000,1.0075225677
33873,33879,35673,6,1794,2,36000,1.00334448161
33874,33885,35652,11,1767,2,36000,1.00622524052
33891,33897,35675,6,1778,2,36000,1.00337457818
33912,33919,35774,7,1855,2,36000,1.00377358491
33940,33946,35738,6,1792,2,36000,1.00334821429
33958,33965,35720,7,1755,2,36000,1.00398860399
33960,33970,35736,10,1766,2,36000,1.00566251416
33975,33981,35823,6,1842,2,36000,1.00325732899
33993,33999,35828,6,1829,2,36000,1.00328048114
34059,34065,35870,6,1805,2,36000,1.00332409972
34076,34082,35891,6,1809,2,36000,1.00331674959
34077,34088,36192,11,2104,2,36000,1.00522813688
34115,34121,35135,6,1014,2,36000,1.00591715976
34130,34136,36093,6,1957,2,36000,1.00306591722
34151,34157,35986,6,1829,2,36000,1.00328048114
34166,34173,35539,7,1366,2,36000,1.00512445095
34182,34188,35381,6,1193,2,36000,1.0050293378
34200,34206,36137,6,1931,2,36000,1.00310719834
34224,34231,36102,7,1871,2,36000,1.0037413148
34249,34255,36008,6,1753,2,36000,1.00342270394
34277,34283,35534,6,1251,2,36000,1.00479616307
34311,34317,36122,6,1805,2,36000,1.00332409972
34327,34333,36308,6,1975,2,36000,1.00303797468
34358,34364,36285,6,1921,2,36000,1.00312337324
34392,34398,36249,6,1851,2,36000,1.00324149109
34407,34413,36271,6,1858,2,36000,1.00322927879
34408,34419,36227,11,1808,2,36000,1.0060840708
34424,34430,36244,6,1814,2,36000,1.0033076075
34450,34457,36281,7,1824,2,36000,1.0038377193
34469,34475,36432,6,1957,2,36000,1.00306591722
34497,34503,36206,6,1703,2,36000,1.00352319436
34550,34556,36259,6,1703,2,36000,1.00352319436
34566,34572,36505,6,1933,2,36000,1.00310398345
34581,34587,36361,6,1774,2,36000,1.00338218715
34582,34593,36493,11,1900,2,36000,1.00578947368
34622,34628,36417,6,1789,2,36000,1.00335382895
34646,34653,36402,7,1749,2,36000,1.00400228702
34707,34714,36619,7,1905,2,36000,1.00367454068
34723,34729,36687,6,1958,2,36000,1.00306435138
34790,34795,36525,5,1730,2,36000,1.00289017341
34805,34811,36756,6,1945,2,36000,1.0030848329
34820,34826,36709,6,1883,2,36000,1.00318640467
34835,34841,36766,6,1925,2,36000,1.00311688312
34837,34847,36656,10,1809,2,36000,1.00552791598
34864,34871,36691,7,1820,2,36000,1.00384615385
34866,34877,36479,11,1602,2,36000,1.00686641698
34881,34887,36788,6,1901,2,36000,1.00315623356
34912,34918,36812,6,1894,2,36000,1.00316789863
34927,34933,36689,6,1756,2,36000,1.00341685649
34942,34948,36460,6,1512,2,36000,1.00396825397
34943,34954,36881,11,1927,2,36000,1.00570835496
34983,34989,37031,6,2042,2,36000,1.00293829579
35010,35016,37089,6,2073,2,36000,1.00289435601
35047,35053,36791,6,1738,2,36000,1.00345224396
35087,35093,36288,6,1195,2,36000,1.0050209205
35104,35110,36924,6,1814,2,36000,1.0033076075
35119,35126,36918,7,1792,2,36000,1.00390625
35138,35144,36816,6,1672,2,36000,1.00358851675
35154,35160,37111,6,1951,2,36000,1.00307534598
35170,35176,37057,6,1881,2,36000,1.00318979266
35207,35213,36946,6,1733,2,36000,1.00346220427
35222,35228,36937,6,1709,2,36000,1.00351082504
35223,35234,36878,11,1644,2,36000,1.00669099757
35276,35282,37321,6,2039,2,36000,1.00294261893
35292,35298,37150,6,1852,2,36000,1.00323974082
35336,35342,37460,6,2118,2,36000,1.00283286119
35351,35357,37274,6,1917,2,36000,1.00312989045
35381,35387,36963,6,1576,2,36000,1.0038071066
35418,35424,37162,6,1738,2,36000,1.00345224396
35433,35439,36911,6,1472,2,36000,1.00407608696
35496,35503,37402,7,1899,2,36000,1.00368615061
35512,35518,37442,6,1924,2,36000,1.00311850312
35530,35536,37407,6,1871,2,36000,1.00320684126
35545,35551,37573,6,2022,2,36000,1.00296735905
35547,35557,37290,10,1733,2,36000,1.00577034045
35571,35577,36804,6,1227,2,36000,1.00488997555
35586,35592,37667,6,2075,2,36000,1.00289156627
35602,35608,37282,6,1674,2,36000,1.00358422939
35638,35645,37533,7,1888,2,36000,1.00370762712
35654,35660,37677,6,2017,2,36000,1.00297471492
35675,35681,37237,6,1556,2,36000,1.00385604113
35676,35687,37620,11,1933,2,36000,1.00569063632
35719,35726,37578,7,1852,2,36000,1.00377969762
35721,35732,37586,11,1854,2,36000,1.00593311758
35736,35743,37605,7,1862,2,36000,1.0037593985
35738,35749,36955,11,1206,2,36000,1.00912106136
35753,35759,37790,6,2031,2,36000,1.00295420975
35772,35778,37914,6,2136,2,36000,1.00280898876
35787,35793,37545,6,1752,2,36000,1.00342465753
35803,35810,37625,7,1815,2,36000,1.00385674931
35828,35834,37224,6,1390,2,36000,1.00431654676
35829,35840,37867,11,2027,2,36000,1.00542673902
35870,35876,37819,6,1943,2,36000,1.00308800823
35871,35882,37171,11,1289,2,36000,1.00853374709
35896,35902,37701,6,1799,2,36000,1.00333518621
35989,35995,38017,6,2022,2,36000,1.00296735905
36010,36017,37743,7,1726,2,36000,1.00405561993
36093,36099,37830,6,1731,2,36000,1.00346620451
36108,36114,37911,6,1797,2,36000,1.00333889816
36126,36132,37906,6,1774,2,36000,1.00338218715
36141,36147,38023,6,1876,2,36000,1.00319829424
36193,36199,38048,6,1849,2,36000,1.0032449973
36208,36215,37461,7,1246,2,36000,1.00561797753
36230,36236,38273,6,2037,2,36000,1.0029455081
36245,36251,38096,6,1845,2,36000,1.00325203252
36260,36266,38029,6,1763,2,36000,1.00340328985
36261,36272,37946,11,1674,2,36000,1.00657108722
36277,36283,38043,6,1760,2,36000,1.00340909091
36292,36298,37680,6,1382,2,36000,1.00434153401
36294,36304,37973,10,1669,2,36000,1.00599161174
36295,36309,38436,14,2127,2,36000,1.00658204043
36310,36316,37956,6,1640,2,36000,1.00365853659
36364,36371,37755,7,1384,2,36000,1.00505780347
36404,36410,38160,6,1750,2,36000,1.00342857143
36419,36425,38412,6,1987,2,36000,1.00301962758
36435,36441,38254,6,1813,2,36000,1.00330943188
36462,36468,38230,6,1762,2,36000,1.00340522134
36480,36487,38176,7,1689,2,36000,1.00414446418
36498,36504,38266,6,1762,2,36000,1.00340522134
36514,36521,38667,7,2146,2,36000,1.00326188257
36531,36536,38221,5,1685,2,36000,1.00296735905
36622,36628,38631,6,2003,2,36000,1.00299550674
36658,36664,38425,6,1761,2,36000,1.00340715503
36689,36695,38370,6,1675,2,36000,1.00358208955
36690,36701,38834,11,2133,2,36000,1.00515705579
36705,36712,38664,7,1952,2,36000,1.00358606557
36721,36727,38516,6,1789,2,36000,1.00335382895
36761,36767,38670,6,1903,2,36000,1.00315291645
36778,36784,38531,6,1747,2,36000,1.00343445907
36793,36799,38563,6,1764,2,36000,1.00340136054
36794,36805,38567,11,1762,2,36000,1.00624290579
36810,36815,38451,5,1636,2,36000,1.00305623472
36825,36831,38834,6,2003,2,36000,1.00299550674
36826,36837,38706,11,1869,2,36000,1.00588550027
36881,36887,38717,6,1830,2,36000,1.00327868852
36882,36893,38542,11,1649,2,36000,1.00667070952
36913,36919,38757,6,1838,2,36000,1.00326441785
36928,36934,38688,6,1754,2,36000,1.00342075257
36930,36940,38804,10,1864,2,36000,1.00536480687
36945,36951,38585,6,1634,2,36000,1.00367197062
36960,36967,38824,7,1857,2,36000,1.00376952073
36962,36972,38932,10,1960,2,36000,1.00510204082
36977,36983,38607,6,1624,2,36000,1.00369458128
37032,37038,38865,6,1827,2,36000,1.00328407225
37059,37065,38893,6,1828,2,36000,1.00328227571
37090,37096,38960,6,1864,2,36000,1.00321888412
37114,37120,38862,6,1742,2,36000,1.00344431688
37151,37157,39048,6,1891,2,36000,1.00317292438
37167,37172,38925,5,1753,2,36000,1.00285225328
37184,37190,38968,6,1778,2,36000,1.00337457818
37226,37232,38972,6,1740,2,36000,1.00344827586
37244,37250,39275,6,2025,2,36000,1.00296296296
37277,37283,39202,6,1919,2,36000,1.00312662845
37295,37301,39115,6,1814,2,36000,1.0033076075
37296,37307,38960,11,1653,2,36000,1.00665456745
37323,37330,39199,7,1869,2,36000,1.00374531835
37403,37409,39000,6,1591,2,36000,1.00377121307
37418,37424,39345,6,1921,2,36000,1.00312337324
37442,37449,39230,7,1781,2,36000,1.00393037619
37461,37467,39403,6,1936,2,36000,1.00309917355
37462,37473,39208,11,1735,2,36000,1.00634005764
37536,37542,39202,6,1660,2,36000,1.00361445783
37551,37557,39402,6,1845,2,36000,1.00325203252
37573,37580,39307,7,1727,2,36000,1.00405327157
37589,37595,39011,6,1416,2,36000,1.00423728814
37590,37601,39524,11,1923,2,36000,1.00572022881
37605,37611,39377,6,1766,2,36000,1.00339750849
37621,37627,39529,6,1902,2,36000,1.00315457413
37636,37642,39516,6,1874,2,36000,1.00320170758
37669,37675,39448,6,1773,2,36000,1.00338409475
37684,37690,39610,6,1920,2,36000,1.003125
37685,37696,39598,11,1902,2,36000,1.00578338591
37700,37707,39720,7,2013,2,36000,1.00347739692
37745,37751,39494,6,1743,2,36000,1.00344234079
37760,37766,39545,6,1779,2,36000,1.00337268128
37791,37797,39462,6,1665,2,36000,1.0036036036
37822,37828,39723,6,1895,2,36000,1.00316622691
37837,37843,39759,6,1916,2,36000,1.00313152401
37867,37874,39322,7,1448,2,36000,1.00483425414
37907,37913,39983,6,2070,2,36000,1.00289855072
37922,37928,39528,6,1600,2,36000,1.00375
37924,37934,39800,10,1866,2,36000,1.00535905681
37948,37954,39984,6,2030,2,36000,1.00295566502
37967,37973,39563,6,1590,2,36000,1.00377358491
37983,37989,39789,6,1800,2,36000,1.00333333333
38019,38025,39740,6,1715,2,36000,1.00349854227
38035,38040,39761,5,1721,2,36000,1.00290528762
38036,38046,39785,10,1739,2,36000,1.00575043128
38051,38057,39741,6,1684,2,36000,1.00356294537
38053,38063,39466,10,1403,2,36000,1.00712758375
38098,38104,39746,6,1642,2,36000,1.00365408039
38162,38168,40139,6,1971,2,36000,1.00304414003
38177,38183,40037,6,1854,2,36000,1.00323624595
38222,38229,40199,7,1970,2,36000,1.00355329949
38238,38244,39914,6,1670,2,36000,1.00359281437
38257,38263,40110,6,1847,2,36000,1.0032485111
38272,38277,40314,5,2037,2,36000,1.00245459008
38287,38293,39991,6,1698,2,36000,1.0035335689
38373,38379,40186,6,1807,2,36000,1.00332042059
38413,38419,39991,6,1572,2,36000,1.00381679389
38429,38435,40411,6,1976,2,36000,1.00303643725
38446,38452,40088,6,1636,2,36000,1.00366748166
38462,38469,40215,7,1746,2,36000,1.0040091638
38518,38524,40375,6,1851,2,36000,1.00324149109
38534,38540,40491,6,1951,2,36000,1.00307534598
38549,38555,40276,6,1721,2,36000,1.00348634515
38564,38570,40579,6,2009,2,36000,1.00298656048
38579,38585,40321,6,1736,2,36000,1.0034562212
38595,38601,40288,6,1687,2,36000,1.00355660937
38610,38616,40405,6,1789,2,36000,1.00335382895
38631,38637,40215,6,1578,2,36000,1.00380228137
38662,38668,40369,6,1701,2,36000,1.00352733686
38677,38683,40485,6,1802,2,36000,1.00332963374
38678,38689,40283,11,1594,2,36000,1.00690087829
38694,38700,40390,6,1690,2,36000,1.00355029586
38710,38716,40402,6,1686,2,36000,1.00355871886
38725,38731,40729,6,1998,2,36000,1.003003003
38758,38764,40581,6,1817,2,36000,1.0033021464
38804,38810,40752,6,1942,2,36000,1.00308959835
38825,38832,40573,7,1741,2,36000,1.00402067777
38841,38847,40727,6,1880,2,36000,1.00319148936
38842,38853,40719,11,1866,2,36000,1.00589496249
38865,38871,40773,6,1902,2,36000,1.00315457413
38866,38877,40714,11,1837,2,36000,1.00598802395
38894,38900,40580,6,1680,2,36000,1.00357142857
38928,38934,40943,6,2009,2,36000,1.00298656048
38943,38949,40774,6,1825,2,36000,1.00328767123
38964,38970,40783,6,1813,2,36000,1.00330943188
38965,38976,40711,11,1735,2,36000,1.00634005764
38982,38988,40778,6,1790,2,36000,1.00335195531
38983,38994,40810,11,1816,2,36000,1.00605726872
39002,39008,40671,6,1663,2,36000,1.00360793746
39017,39023,40505,6,1482,2,36000,1.004048583
39050,39056,40681,6,1625,2,36000,1.00369230769
39117,39123,40840,6,1717,2,36000,1.00349446709
39200,39206,41069,6,1863,2,36000,1.00322061192
39215,39221,41093,6,1872,2,36000,1.00320512821
39216,39227,41367,11,2140,2,36000,1.00514018692
39218,39232,41341,14,2109,2,36000,1.00663821716
39233,39239,41182,6,1943,2,36000,1.00308800823
39279,39285,41194,6,1909,2,36000,1.00314300681
39309,39315,40517,6,1202,2,36000,1.00499168053
39325,39331,41161,6,1830,2,36000,1.00327868852
39346,39352,41164,6,1812,2,36000,1.00331125828
39379,39386,41297,7,1911,2,36000,1.00366300366
39404,39410,41137,6,1727,2,36000,1.00347423277
39405,39416,41306,11,1890,2,36000,1.00582010582
39448,39454,41193,6,1739,2,36000,1.00345025877
39463,39469,40886,6,1417,2,36000,1.00423429781
39478,39484,41186,6,1702,2,36000,1.00352526439
39496,39503,41312,7,1809,2,36000,1.00386954118
39518,39524,41290,6,1766,2,36000,1.00339750849
39533,39539,41633,6,2094,2,36000,1.00286532951
39534,39545,41355,11,1810,2,36000,1.00607734807
39536,39550,41170,14,1620,2,36000,1.00864197531
39551,39557,41539,6,1982,2,36000,1.00302724521
39566,39572,41276,6,1704,2,36000,1.00352112676
39600,39606,40960,6,1354,2,36000,1.00443131462
39615,39621,41559,6,1938,2,36000,1.00309597523
39722,39728,41558,6,1830,2,36000,1.00327868852
39738,39744,41643,6,1899,2,36000,1.00315955766
39753,39759,41385,6,1626,2,36000,1.0036900369
39754,39765,41112,11,1347,2,36000,1.00816629547
39756,39770,41165,14,1395,2,36000,1.01003584229
39771,39777,41496,6,1719,2,36000,1.0034904014
39772,39783,41455,11,1672,2,36000,1.00657894737
39787,39794,41352,7,1558,2,36000,1.00449293967
39803,39809,41543,6,1734,2,36000,1.00346020761
39804,39815,41744,11,1929,2,36000,1.0057024365
39915,39921,41697,6,1776,2,36000,1.00337837838
39986,39992,41849,6,1857,2,36000,1.00323101777
39987,39998,41683,11,1685,2,36000,1.00652818991
40002,40009,41849,7,1840,2,36000,1.00380434783
40004,40015,41848,11,1833,2,36000,1.00600109111
40037,40043,41831,6,1788,2,36000,1.0033557047
40089,40096,41937,7,1841,2,36000,1.00380228137
40111,40117,41690,6,1573,2,36000,1.00381436745
40139,40146,41993,7,1847,2,36000,1.00378992962
40186,40192,41873,6,1681,2,36000,1.00356930399
40201,40207,42018,6,1811,2,36000,1.00331308669
40217,40223,41942,6,1719,2,36000,1.0034904014
40218,40229,42091,11,1862,2,36000,1.00590762621
40278,40285,41983,7,1698,2,36000,1.00412249706
40294,40300,41962,6,1662,2,36000,1.0036101083
40295,40306,42088,11,1782,2,36000,1.00617283951
40317,40323,42066,6,1743,2,36000,1.00344234079
40335,40341,42130,6,1789,2,36000,1.00335382895
40371,40377,42420,6,2043,2,36000,1.00293685756
40388,40394,42268,6,1874,2,36000,1.00320170758
40389,40400,42359,11,1959,2,36000,1.00561510975
40411,40416,42143,5,1727,2,36000,1.00289519398
40412,40422,42353,10,1931,2,36000,1.0051786639
40437,40443,42089,6,1646,2,36000,1.00364520049
40488,40494,42329,6,1835,2,36000,1.00326975477
40504,40510,42247,6,1737,2,36000,1.00345423143
40519,40525,42243,6,1718,2,36000,1.00349243306
40521,40531,42462,10,1931,2,36000,1.0051786639
40577,40583,42417,6,1834,2,36000,1.00327153762
40593,40599,42345,6,1746,2,36000,1.00343642612
40594,40605,42361,11,1756,2,36000,1.0062642369
40595,40610,42228,15,1618,2,36000,1.00927070457
40674,40680,42701,6,2021,2,36000,1.00296882731
40689,40695,42055,6,1360,2,36000,1.00441176471
40713,40720,42582,7,1862,2,36000,1.0037593985
40715,40726,42404,11,1678,2,36000,1.00655542312
40731,40737,42535,6,1798,2,36000,1.00333704116
40732,40743,42588,11,1845,2,36000,1.00596205962
40733,40748,42763,15,2015,2,36000,1.00744416873
40755,40761,42713,6,1952,2,36000,1.00307377049
40773,40779,42624,6,1845,2,36000,1.00325203252
40775,40785,42527,10,1742,2,36000,1.00574052813
40790,40796,42547,6,1751,2,36000,1.00342661336
40791,40802,42209,11,1407,2,36000,1.00781805259
40813,40819,42746,6,1927,2,36000,1.00311364816
40843,40850,42015,7,1165,2,36000,1.00600858369
40889,40895,42615,6,1720,2,36000,1.00348837209
40946,40952,42006,6,1054,2,36000,1.00569259962
40961,40967,42792,6,1825,2,36000,1.00328767123
41070,41076,42907,6,1831,2,36000,1.00327689787
41095,41101,42915,6,1814,2,36000,1.0033076075
41113,41119,42979,6,1860,2,36000,1.00322580645
41140,41146,42966,6,1820,2,36000,1.0032967033
41162,41168,42918,6,1750,2,36000,1.00342857143
41177,41184,42902,7,1718,2,36000,1.00407450524
41179,41190,43062,11,1872,2,36000,1.00587606838
41180,41195,42971,15,1776,2,36000,1.00844594595
41196,41201,42193,5,992,2,36000,1.00504032258
41197,41207,43064,10,1857,2,36000,1.00538502962
41198,41212,43053,14,1841,2,36000,1.00760456274
41200,41217,42701,17,1484,2,36000,1.01145552561
41276,41282,43087,6,1805,2,36000,1.00332409972
41291,41297,42898,6,1601,2,36000,1.00374765771
41307,41313,43157,6,1844,2,36000,1.0032537961
41308,41319,42504,11,1185,2,36000,1.00928270042
41324,41330,43097,6,1767,2,36000,1.00339558574
41342,41348,43581,6,2233,2,36000,1.0026869682
41357,41363,43412,6,2049,2,36000,1.00292825769
41358,41369,43284,11,1915,2,36000,1.00574412533
41374,41380,42831,6,1451,2,36000,1.00413507926
41389,41395,43139,6,1744,2,36000,1.00344036697
41456,41462,42840,6,1378,2,36000,1.00435413643
41501,41507,43207,6,1700,2,36000,1.00352941176
41541,41547,42879,6,1332,2,36000,1.0045045045
41557,41563,43148,6,1585,2,36000,1.00378548896
41572,41578,43374,6,1796,2,36000,1.00334075724
41573,41584,43472,11,1888,2,36000,1.00582627119
41637,41643,43023,6,1380,2,36000,1.00434782609
41652,41658,43521,6,1863,2,36000,1.00322061192
41687,41693,43625,6,1932,2,36000,1.00310559006
41705,41711,43610,6,1899,2,36000,1.00315955766
41706,41717,43681,11,1964,2,36000,1.00560081466
41744,41750,43631,6,1881,2,36000,1.00318979266
41833,41839,43197,6,1358,2,36000,1.00441826215
41848,41855,43664,7,1809,2,36000,1.00386954118
41850,41860,42951,10,1091,2,36000,1.00916590284
41866,41872,43657,6,1785,2,36000,1.00336134454
41881,41887,43754,6,1867,2,36000,1.00321371184
41941,41947,43715,6,1768,2,36000,1.00339366516
41957,41963,43359,6,1396,2,36000,1.00429799427
41973,41979,43797,6,1818,2,36000,1.00330033003
41994,42000,43901,6,1901,2,36000,1.00315623356
41995,42006,43992,11,1986,2,36000,1.0055387714
42011,42017,43713,6,1696,2,36000,1.00353773585
42027,42034,43817,7,1783,2,36000,1.00392596747
42029,42040,43717,11,1677,2,36000,1.00655933214
42059,42065,43905,6,1840,2,36000,1.00326086957
42078,42084,43779,6,1695,2,36000,1.00353982301
42085,42091,45726,6,3635,2,3600,1.00165061898
42095,42101,43926,6,1825,2,36000,1.00328767123
42097,42108,43954,11,1846,2,36000,1.0059588299
42098,42113,43934,15,1821,2,36000,1.00823723229
42120,42126,301367,6,259241,2,259200,1.00002314449
42137,42143,44014,6,1871,2,36000,1.00320684126
42153,42159,43990,6,1831,2,36000,1.00327689787
42204,42210,43971,6,1761,2,36000,1.00340715503
42205,42216,44048,11,1832,2,36000,1.00600436681
42206,42221,44009,15,1788,2,36000,1.00838926174
42208,42226,43360,18,1134,2,36000,1.01587301587
42209,42231,43959,22,1728,2,36000,1.01273148148
42210,42237,44210,27,1973,2,36000,1.01368474404
42212,42243,44283,31,2040,2,36000,1.01519607843
42213,42248,43928,35,1680,2,36000,1.02083333333
42214,42253,43352,39,1099,2,36000,1.03548680619
42216,42259,43973,43,1714,2,36000,1.02508751459
42217,42264,43239,47,975,2,36000,1.04820512821
42218,42269,44443,51,2174,2,36000,1.02345906164
42220,42274,43915,54,1641,2,36000,1.03290676417
42221,42279,43624,58,1345,2,36000,1.04312267658
42222,42285,44146,63,1861,2,36000,1.03385276733
42223,42290,44354,67,2064,2,36000,1.03246124031
42225,42295,44040,70,1745,2,36000,1.04011461318
42226,42300,44198,74,1898,2,36000,1.03898840885
42227,42305,43761,78,1456,2,36000,1.05357142857
42229,42310,44480,81,2170,2,36000,1.03732718894
42230,42316,44255,86,1939,2,36000,1.04435275915
42231,42321,44250,90,1929,2,36000,1.0466562986
42233,42326,43407,93,1081,2,36000,1.08603145236
42234,42331,44030,97,1699,2,36000,1.0570924073
42235,42336,44036,101,1700,2,36000,1.05941176471
42236,42342,44162,106,1820,2,36000,1.05824175824
42253,42348,44090,95,1742,2,36000,1.05453501722
42254,42353,43997,99,1644,2,36000,1.0602189781
42255,42359,44157,104,1798,2,36000,1.05784204672
42257,42364,44233,107,1869,2,36000,1.05724986624
42272,42369,44363,97,1994,2,36000,1.04864593781
42320,42379,101880,59,59501,1,64800,1.00099157997
42331,42374,44097,43,1723,2,36000,1.02495647127
42346,42385,44224,39,1839,2,36000,1.02120717781
42364,42390,44194,26,1804,2,36000,1.01441241685
42365,42396,44236,31,1840,2,36000,1.01684782609
42367,42401,43576,34,1175,2,36000,1.02893617021
42409,42415,43724,6,1309,2,36000,1.00458365164
42426,42432,43394,6,962,2,36000,1.00623700624
42427,42438,43789,11,1351,2,36000,1.00814211695
42464,42470,44098,6,1628,2,36000,1.00368550369
42504,42510,44377,6,1867,2,36000,1.00321371184
42529,42536,44391,7,1855,2,36000,1.00377358491
42545,42551,44311,6,1760,2,36000,1.00340909091
42561,42567,44476,6,1909,2,36000,1.00314300681
42584,42590,44337,6,1747,2,36000,1.00343445907
42601,42607,43838,6,1231,2,36000,1.00487408611
42607,42614,42644,7,30,1,7200,1.23333333333
42617,42624,44444,7,1820,2,36000,1.00384615385
42633,42639,44184,6,1545,2,36000,1.00388349515
42703,42709,44499,6,1790,2,36000,1.00335195531
42704,42715,44542,11,1827,2,36000,1.00602079912
42721,42727,44696,6,1969,2,36000,1.0030472321
42723,42733,42763,10,30,1,43200,1.33333333333
42751,42757,44321,6,1564,2,36000,1.00383631714
42768,42774,44809,6,2035,2,36000,1.00294840295
42796,42802,44660,6,1858,2,36000,1.00322927879
42832,42839,44872,7,2033,2,36000,1.00344318741
42848,42854,44615,6,1761,2,36000,1.00340715503
42882,42888,44868,6,1980,2,36000,1.00303030303
42901,42907,44669,6,1762,2,36000,1.00340522134
42917,42924,44723,7,1799,2,36000,1.00389105058
42919,42930,44506,11,1576,2,36000,1.00697969543
42920,42935,44797,15,1862,2,36000,1.00805585392
42921,42940,44689,19,1749,2,36000,1.01086335049
42952,42958,44772,6,1814,2,36000,1.0033076075
42967,42973,44756,6,1783,2,36000,1.00336511497
42982,42988,44688,6,1700,2,36000,1.00352941176
42984,42994,44863,10,1869,2,36000,1.00535045479
43031,43036,44790,5,1754,2,36000,1.00285062714
43055,43061,44732,6,1671,2,36000,1.00359066427
43071,43077,44886,6,1809,2,36000,1.00331674959
43072,43083,44882,11,1799,2,36000,1.00611450806
43088,43094,44733,6,1639,2,36000,1.00366076876
43104,43110,45027,6,1917,2,36000,1.00312989045
43140,43146,44946,6,1800,2,36000,1.00333333333
43156,43162,44510,6,1348,2,36000,1.00445103858
43171,43177,44937,6,1760,2,36000,1.00340909091
43200,43206,44845,6,1639,2,36000,1.00366076876
43216,43222,45107,6,1885,2,36000,1.00318302387
43243,43249,45070,6,1821,2,36000,1.00329489292
43286,43292,45189,6,1897,2,36000,1.00316288877
43352,43358,45334,6,1976,2,36000,1.00303643725
43370,43376,45284,6,1908,2,36000,1.00314465409
43371,43382,45160,11,1778,2,36000,1.00618672666
43388,43394,45273,6,1879,2,36000,1.00319318787
43406,43412,45144,6,1732,2,36000,1.00346420323
43407,43418,45382,11,1964,2,36000,1.00560081466
43422,43429,45218,7,1789,2,36000,1.00391280045
43477,43483,45413,6,1930,2,36000,1.00310880829
43523,43529,45305,6,1776,2,36000,1.00337837838
43553,43800,57519,247,13719,32,356400,1.01800422771
43578,43584,45558,6,1974,2,36000,1.00303951368
43593,43599,45529,6,1930,2,36000,1.00310880829
43612,43618,45778,6,2160,2,36000,1.00277777778
43627,43633,45380,6,1747,2,36000,1.00343445907
43628,43639,45408,11,1769,2,36000,1.00621820237
43644,43650,45550,6,1900,2,36000,1.00315789474
43659,43665,45630,6,1965,2,36000,1.00305343511
43674,43681,45650,7,1969,2,36000,1.00355510411
43690,43696,45510,6,1814,2,36000,1.0033076075
43715,43721,45700,6,1979,2,36000,1.00303183426
43731,43737,45562,6,1825,2,36000,1.00328767123
43732,43743,45217,11,1474,2,36000,1.00746268657
43733,43748,45489,15,1741,2,36000,1.00861573808
43755,43761,45634,6,1873,2,36000,1.00320341698
43772,43778,45571,6,1793,2,36000,1.0033463469
43787,43793,45574,6,1781,2,36000,1.00336889388
43804,43810,45484,6,1674,2,36000,1.00358422939
43806,43816,45596,10,1780,2,36000,1.00561797753
43821,43827,45713,6,1886,2,36000,1.00318133616
43839,43845,45705,6,1860,2,36000,1.00322580645
43906,43911,45859,5,1948,2,36000,1.00256673511
43907,43917,45853,10,1936,2,36000,1.00516528926
43923,43929,45694,6,1765,2,36000,1.00339943343
43940,43946,45659,6,1713,2,36000,1.00350262697
43942,43952,45705,10,1753,2,36000,1.00570450656
43943,43957,45777,14,1820,2,36000,1.00769230769
43959,43965,45874,6,1909,2,36000,1.00314300681
43961,43971,45788,10,1817,2,36000,1.00550357733
43978,43984,45839,6,1855,2,36000,1.00323450135
43979,43990,45783,11,1793,2,36000,1.00613496933
43996,44001,45782,5,1781,2,36000,1.00280741157
43997,44007,45851,10,1844,2,36000,1.00542299349
44013,44019,45960,6,1941,2,36000,1.00309119011
44014,44025,46040,11,2015,2,36000,1.00545905707
44030,44036,45740,6,1704,2,36000,1.00352112676
44031,44042,46009,11,1967,2,36000,1.0055922725
44047,44053,45778,6,1725,2,36000,1.00347826087
44048,44059,46196,11,2137,2,36000,1.0051474029
44064,44070,45189,6,1119,2,36000,1.00536193029
44093,44099,46014,6,1915,2,36000,1.00313315927
44110,44116,46039,6,1923,2,36000,1.0031201248
44111,44122,45977,11,1855,2,36000,1.00592991914
44146,44153,45953,7,1800,2,36000,1.00388888889
44162,44168,45793,6,1625,2,36000,1.00369230769
44163,44174,46080,11,1906,2,36000,1.00577124869
44185,44191,45978,6,1787,2,36000,1.00335758254
44205,44212,46052,7,1840,2,36000,1.00380434783
44207,44218,45909,11,1691,2,36000,1.00650502661
44222,44228,46193,6,1965,2,36000,1.00305343511
44238,44244,46254,6,2010,2,36000,1.00298507463
44239,44250,46453,11,2203,2,36000,1.0049931911
44241,44255,46199,14,1944,2,36000,1.00720164609
44256,44262,46052,6,1790,2,36000,1.00335195531
44258,44268,46066,10,1798,2,36000,1.00556173526
44285,44291,46428,6,2137,2,36000,1.00280767431
44313,44319,46140,6,1821,2,36000,1.00329489292
44328,44334,46229,6,1895,2,36000,1.00316622691
44343,44350,46107,7,1757,2,36000,1.00398406375
44359,44365,46366,6,2001,2,36000,1.00299850075
44374,44381,46160,7,1779,2,36000,1.00393479483
44390,44396,46096,6,1700,2,36000,1.00352941176
44405,44411,46084,6,1673,2,36000,1.00358637179
44444,44450,46167,6,1717,2,36000,1.00349446709
44445,44456,46390,11,1934,2,36000,1.0056876939
44479,44485,46350,6,1865,2,36000,1.00321715818
44481,44491,46432,10,1941,2,36000,1.00515198351
44504,44510,46242,6,1732,2,36000,1.00346420323
44519,44525,46294,6,1769,2,36000,1.00339174675
44520,44531,46269,11,1738,2,36000,1.00632911392
44545,44551,46282,6,1731,2,36000,1.00346620451
44616,44622,46299,6,1677,2,36000,1.00357781753
44662,44669,46293,7,1624,2,36000,1.00431034483
44678,44684,46590,6,1906,2,36000,1.00314795383
44693,44699,46746,6,2047,2,36000,1.00293111871
44694,44705,46412,11,1707,2,36000,1.0064440539
44711,44717,46589,6,1872,2,36000,1.00320512821
44728,44733,46483,5,1750,2,36000,1.00285714286
44744,44751,46474,7,1723,2,36000,1.00406268137
44746,44757,46737,11,1980,2,36000,1.00555555556
44769,44775,46674,6,1899,2,36000,1.00315955766
44788,44794,46661,6,1867,2,36000,1.00321371184
44809,44815,46687,6,1872,2,36000,1.00320512821
44810,44821,46561,11,1740,2,36000,1.00632183908
44812,44826,46823,14,1997,2,36000,1.00701051577
44850,44856,46512,6,1656,2,36000,1.00362318841
44868,44874,46762,6,1888,2,36000,1.0031779661
44869,44880,46666,11,1786,2,36000,1.00615901456
44886,44892,46827,6,1935,2,36000,1.00310077519
44887,44898,46324,11,1426,2,36000,1.00771388499
44889,44903,46416,14,1513,2,36000,1.00925313946
44940,44946,46708,6,1762,2,36000,1.00340522134
44958,44964,46566,6,1602,2,36000,1.00374531835
45033,45040,46790,7,1750,2,36000,1.004
45071,45077,46909,6,1832,2,36000,1.00327510917
45108,45114,46842,6,1728,2,36000,1.00347222222
45145,45151,46833,6,1682,2,36000,1.00356718193
45160,45166,47200,6,2034,2,36000,1.00294985251
45192,45198,47214,6,2016,2,36000,1.00297619048
45193,45204,47091,11,1887,2,36000,1.00582935877
45218,45225,47076,7,1851,2,36000,1.0037817396
45220,45231,47132,11,1901,2,36000,1.0057864282
45279,45285,47054,6,1769,2,36000,1.00339174675
45295,45301,47024,6,1723,2,36000,1.00348229832
45311,45317,46512,6,1195,2,36000,1.0050209205
45336,45342,47229,6,1887,2,36000,1.00317965024
45384,45390,47487,6,2097,2,36000,1.00286123033
45385,45396,46979,11,1583,2,36000,1.00694883133
45410,45416,47324,6,1908,2,36000,1.00314465409
45426,45432,47358,6,1926,2,36000,1.0031152648
45487,45493,47166,6,1673,2,36000,1.00358637179
45502,45509,47338,7,1829,2,36000,1.00382722799
45518,45524,47262,6,1738,2,36000,1.00345224396
45533,45539,47507,6,1968,2,36000,1.00304878049
45552,45558,47497,6,1939,2,36000,1.00309437855
45568,45574,47394,6,1820,2,36000,1.0032967033
45569,45580,47325,11,1745,2,36000,1.00630372493
45585,45592,47375,7,1783,2,36000,1.00392596747
45587,45597,47279,10,1682,2,36000,1.00594530321
45603,45609,47524,6,1915,2,36000,1.00313315927
45632,45638,47561,6,1923,2,36000,1.0031201248
45634,45644,47455,10,1811,2,36000,1.00552181115
45652,45659,47598,7,1939,2,36000,1.0036101083
45669,45675,47501,6,1826,2,36000,1.00328587076
45695,45701,47516,6,1815,2,36000,1.00330578512
45718,45724,47500,6,1776,2,36000,1.00337837838
45720,45730,47517,10,1787,2,36000,1.0055959709
45721,45735,47398,14,1663,2,36000,1.00841852075
45722,45740,47608,18,1868,2,36000,1.0096359743
45745,45751,47095,6,1344,2,36000,1.00446428571
45782,45787,47599,5,1812,2,36000,1.0027593819
45783,45793,47522,10,1729,2,36000,1.00578368999
45784,45799,47756,15,1957,2,36000,1.00766479305
45786,45804,47446,18,1642,2,36000,1.01096224117
45787,45809,47772,22,1963,2,36000,1.01120733571
45803,45815,47845,12,2030,2,36000,1.00591133005
45804,45820,47527,16,1707,2,36000,1.0093731693
45841,45847,47560,6,1713,2,36000,1.00350262697
45857,45863,47607,6,1744,2,36000,1.00344036697
45858,45869,47726,11,1857,2,36000,1.00592353258
45874,45880,47348,6,1468,2,36000,1.00408719346
45875,45886,47656,11,1770,2,36000,1.00621468927
45909,45916,48009,7,2093,2,36000,1.00334448161
45953,45959,47259,6,1300,2,36000,1.00461538462
45971,45977,47841,6,1864,2,36000,1.00321888412
45988,45994,47883,6,1889,2,36000,1.00317628375
45989,46000,47972,11,1972,2,36000,1.00557809331
46011,46018,47765,7,1747,2,36000,1.00400686892
46029,46035,47166,6,1131,2,36000,1.00530503979
46052,46059,47636,7,1577,2,36000,1.00443880786
46054,46065,47940,11,1875,2,36000,1.00586666667
46055,46070,47765,15,1695,2,36000,1.00884955752
46056,46076,47975,20,1899,2,36000,1.01053185887
46077,46083,47916,6,1833,2,36000,1.00327332242
46093,46099,48094,6,1995,2,36000,1.0030075188
46094,46105,47987,11,1882,2,36000,1.00584484591
46110,46116,47880,6,1764,2,36000,1.00340136054
46111,46122,47624,11,1502,2,36000,1.00732356858
46144,46150,47947,6,1797,2,36000,1.00333889816
46162,46168,48049,6,1881,2,36000,1.00318979266
46178,46184,47889,6,1705,2,36000,1.00351906158
46193,46199,48066,6,1867,2,36000,1.00321371184
46209,46215,48170,6,1955,2,36000,1.00306905371
46210,46221,48095,11,1874,2,36000,1.00586979723
46231,46237,48139,6,1902,2,36000,1.00315457413
46246,46252,48341,6,2089,2,36000,1.00287218765
46267,46273,48116,6,1843,2,36000,1.00325556158
46269,46279,48336,10,2057,2,36000,1.00486144871
46270,46284,48104,14,1820,2,36000,1.00769230769
46271,46290,48093,19,1803,2,36000,1.01053799224
46272,46296,48122,24,1826,2,36000,1.01314348302
46274,46304,48132,30,1828,2,36000,1.01641137856
46275,46310,48192,35,1882,2,36000,1.01859723698
46276,46315,47568,39,1253,2,36000,1.03112529928
46278,46335,48175,57,1840,2,36000,1.03097826087
46279,46361,48101,82,1740,2,36000,1.04712643678
46280,46378,48221,98,1843,2,36000,1.05317417254
46296,46401,47887,105,1486,2,36000,1.07065948856
46298,46423,48424,125,2001,2,36000,1.06246876562
46299,46429,48167,130,1738,2,36000,1.0747986191
46301,46439,48342,138,1903,2,36000,1.0725170783
46319,46445,48396,126,1951,2,36000,1.0645822655
46335,46464,48396,129,1932,2,36000,1.06677018634
46353,46485,48382,132,1897,2,36000,1.06958355298
46369,46494,48250,125,1756,2,36000,1.07118451025
46391,46522,48317,131,1795,2,36000,1.07298050139
46418,46528,48618,110,2090,2,36000,1.05263157895
46419,46572,48331,153,1759,2,36000,1.08698123934
46437,46578,48361,141,1783,2,36000,1.07908020191
46439,46600,48219,161,1619,2,36000,1.0994441013
46454,46606,48651,152,2045,2,36000,1.07432762836
46479,46672,48494,193,1822,2,36000,1.10592755214
46495,46678,48466,183,1788,2,36000,1.10234899329
46513,46685,48449,172,1764,2,36000,1.09750566893
46515,46698,48765,183,2067,2,36000,1.0885341074
46562,46719,48513,157,1794,2,36000,1.08751393534
46577,46749,48620,172,1871,2,36000,1.09192944949
46593,46757,48203,164,1446,2,36000,1.11341632089
46595,46774,48569,179,1795,2,36000,1.09972144847
46663,46801,48527,138,1726,2,36000,1.07995365006
46679,46834,48444,155,1610,2,36000,1.09627329193
46680,46841,48726,161,1885,2,36000,1.08541114058
46703,46847,48833,144,1986,2,36000,1.07250755287
46719,46854,48715,135,1861,2,36000,1.07254164428
46738,46920,48868,182,1948,2,36000,1.09342915811
46753,46990,48909,237,1919,2,36000,1.12350182387
46769,47035,49074,266,2039,2,36000,1.13045610593
46792,47065,48811,273,1746,2,36000,1.15635738832
46824,47087,48847,263,1760,2,36000,1.14943181818
46841,47102,49096,261,1994,2,36000,1.13089267803
46842,47108,49047,266,1939,2,36000,1.13718411552
46859,47143,49241,284,2098,2,36000,1.13536701621
46912,47177,48857,265,1680,2,36000,1.15773809524
46980,47182,48852,202,1670,2,36000,1.12095808383
47026,47212,48953,186,1741,2,36000,1.10683515221
47057,47225,49108,168,1883,2,36000,1.08921933086
47078,47240,49040,162,1800,2,36000,1.09
47094,47270,49363,176,2093,2,36000,1.08408982322
47095,47276,49079,181,1803,2,36000,1.10038824182
47135,47290,49275,155,1985,2,36000,1.07808564232
47169,47335,48495,166,1160,2,36000,1.14310344828
47171,47341,49250,170,1909,2,36000,1.08905185961
47202,47349,49338,147,1989,2,36000,1.07390648567
47217,47359,49487,142,2128,2,36000,1.06672932331
47232,47369,49152,137,1783,2,36000,1.07683679192
47260,47386,49210,126,1824,2,36000,1.06907894737
47276,47405,49159,129,1754,2,36000,1.07354618016
47291,47411,49100,120,1689,2,36000,1.07104795737
47325,47457,49176,132,1719,2,36000,1.07678883072
47326,47466,49445,140,1979,2,36000,1.07074279939
47342,47498,49621,156,2123,2,36000,1.07348092322
47357,47508,49615,151,2107,2,36000,1.07166587565
47373,47514,49313,141,1799,2,36000,1.07837687604
47388,47519,49518,131,1999,2,36000,1.06553276638
47407,47525,49400,118,1875,2,36000,1.06293333333
47408,47531,49250,123,1719,2,36000,1.07155322862
47451,47536,49307,85,1771,2,36000,1.04799548278
47466,47542,49345,76,1803,2,36000,1.04215196894
47487,47547,49189,60,1642,2,36000,1.0365408039
47503,47553,49255,50,1702,2,36000,1.02937720329
47505,47571,49340,66,1769,2,36000,1.03730921425
47506,47577,49595,71,2018,2,36000,1.03518334985
47523,47583,49577,60,1994,2,36000,1.03009027081
47525,47610,49516,85,1906,2,36000,1.04459601259
47526,47615,49495,89,1880,2,36000,1.04734042553
47527,47621,49343,94,1722,2,36000,1.05458768873
47529,47626,49330,97,1704,2,36000,1.05692488263
47545,47635,49422,90,1787,2,36000,1.05036373811
47563,47647,49383,84,1736,2,36000,1.04838709677
47565,47667,49542,102,1875,2,36000,1.0544
47580,47737,49580,157,1843,2,36000,1.08518719479
47599,47767,49842,168,2075,2,36000,1.08096385542
47600,47776,49438,176,1662,2,36000,1.10589651023
47619,47781,48915,162,1134,2,36000,1.14285714286
47621,47787,49626,166,1839,2,36000,1.09026644916
47638,47853,49958,215,2105,2,36000,1.10213776722
47640,47859,49683,219,1824,2,36000,1.12006578947
47659,47891,49851,232,1960,2,36000,1.11836734694
47729,47897,49259,168,1362,2,36000,1.12334801762
47758,47903,49656,145,1753,2,36000,1.08271534512
47774,47908,49528,134,1620,2,36000,1.08271604938
47775,47927,49793,152,1866,2,36000,1.08145766345
47776,47951,49694,175,1743,2,36000,1.10040160643
47842,47959,49432,117,1473,2,36000,1.07942973523
47858,47975,49826,117,1851,2,36000,1.06320907618
47889,47984,49967,95,1983,2,36000,1.0479072113
47891,47990,49762,99,1772,2,36000,1.05586907449
47892,47998,49822,106,1824,2,36000,1.05811403509
47893,48020,49697,127,1677,2,36000,1.07573047108
47918,48061,50085,143,2024,2,36000,1.07065217391
47943,48077,49897,134,1820,2,36000,1.07362637363
47959,48105,50129,146,2024,2,36000,1.07213438735
47975,48110,50116,135,2006,2,36000,1.06729810568
47976,48116,49873,140,1757,2,36000,1.0796812749
47992,48121,50651,129,2530,2,36000,1.05098814229
48010,48127,49859,117,1732,2,36000,1.06755196305
48050,48133,49825,83,1692,2,36000,1.04905437352
48068,48138,49909,70,1771,2,36000,1.0395256917
48097,48144,49537,47,1393,2,36000,1.03374012922
48098,48150,49938,52,1788,2,36000,1.02908277405
48099,48179,49839,80,1660,2,36000,1.04819277108
48116,48185,49974,69,1789,2,36000,1.03856903298
48118,48190,49966,72,1776,2,36000,1.04054054054
48119,48203,49983,84,1780,2,36000,1.04719101124
48135,48214,49887,79,1673,2,36000,1.04722056186
48137,48230,49941,93,1711,2,36000,1.05435417884
48152,48236,50006,84,1770,2,36000,1.04745762712
48168,48262,50009,94,1747,2,36000,1.05380652547
48183,48328,49827,145,1499,2,36000,1.0967311541
48185,48342,49954,157,1612,2,36000,1.09739454094
48200,48348,50468,148,2120,2,36000,1.06981132075
48218,48354,50450,136,2096,2,36000,1.06488549618
48234,48359,50333,125,1974,2,36000,1.06332320162
48235,48372,50104,137,1732,2,36000,1.07909930716
48252,48393,50184,141,1791,2,36000,1.07872696817
48319,48407,50493,88,2086,2,36000,1.04218600192
48335,48412,50293,77,1881,2,36000,1.04093567251
48353,48435,50203,82,1768,2,36000,1.0463800905
48354,48455,50117,101,1662,2,36000,1.06077015644
48356,48461,50311,105,1850,2,36000,1.05675675676
48371,48478,50144,107,1666,2,36000,1.06422569028
48387,48505,50196,118,1691,2,36000,1.06978119456
48403,48511,50269,108,1758,2,36000,1.0614334471
48404,48524,50289,120,1765,2,36000,1.06798866856
48429,48538,50273,109,1735,2,36000,1.06282420749
48449,48822,50584,373,1762,2,36000,1.21169125993
48450,48844,50676,394,1832,2,36000,1.21506550218
48469,48859,50884,390,2025,2,36000,1.19259259259
48499,48865,50520,366,1655,2,36000,1.22114803625
48500,48876,50498,376,1622,2,36000,1.23181257707
48517,48882,50843,365,1961,2,36000,1.18612952575
48532,48920,50508,388,1588,2,36000,1.2443324937
48563,48776,48860,213,84,14,7980,3.53571428571
48572,48926,50652,354,1726,2,36000,1.20509849363
48619,48964,50772,345,1808,2,36000,1.19081858407
48634,49016,50835,382,1819,2,36000,1.21000549753
48655,49026,50454,371,1428,2,36000,1.25980392157
48716,49032,51092,316,2060,2,36000,1.15339805825
48734,49037,51031,303,1994,2,36000,1.1519558676
48768,49042,50872,274,1830,2,36000,1.14972677596
48814,49047,50904,233,1857,2,36000,1.12547119009
48836,49058,50856,222,1798,2,36000,1.1234705228
48852,49090,50826,238,1736,2,36000,1.13709677419
48853,49170,51112,317,1942,2,36000,1.16323377961
48858,49021,49031,163,10,1,900,17.3
48865,48871,49004,6,133,14,7980,1.04511278195
48869,49188,51056,319,1868,2,36000,1.17077087794
48870,49200,51076,330,1876,2,36000,1.17590618337
48912,49221,51084,309,1863,2,36000,1.16586151369
48927,49252,50987,325,1735,2,36000,1.18731988473
48956,49260,51245,304,1985,2,36000,1.15314861461
49002,49052,49061,50,9,1,900,5.9
49013,49163,49374,150,211,14,7980,1.71090047393
49044,49266,50883,222,1617,2,36000,1.13729128015
49060,49272,51220,212,1948,2,36000,1.10882956879
49076,49277,51096,201,1819,2,36000,1.11050027488
49092,49286,51018,194,1732,2,36000,1.11200923788
49109,49319,51114,210,1795,2,36000,1.11699164345
49110,49325,51228,215,1903,2,36000,1.11297950604
49111,49342,51123,231,1781,2,36000,1.12970241437
49151,49349,51152,198,1803,2,36000,1.10981697171
49167,49355,50655,188,1300,2,36000,1.14461538462
49184,49360,51188,176,1828,2,36000,1.09628008753
49202,49366,50805,164,1439,2,36000,1.11396803336
49219,49374,51233,155,1859,2,36000,1.0833781603
49244,49390,51208,146,1818,2,36000,1.0803080308
49262,49395,50632,133,1237,2,36000,1.10751818917
49263,49401,51141,138,1740,2,36000,1.07931034483
49265,49406,51267,141,1861,2,36000,1.07576571736
49266,49411,51390,145,1979,2,36000,1.07326932794
49282,49416,50803,134,1387,2,36000,1.09661139149
49311,49422,51285,111,1863,2,36000,1.05958132045
49326,49445,51271,119,1826,2,36000,1.06516976999
49343,49456,51340,113,1884,2,36000,1.05997876858
49345,49506,51328,161,1822,2,36000,1.08836443469
49346,49527,51431,181,1904,2,36000,1.09506302521
49347,49539,51123,192,1584,2,36000,1.12121212121
49363,49554,51275,191,1721,2,36000,1.11098198722
49365,49588,51333,223,1745,2,36000,1.12779369628
49371,49385,49398,14,13,1,900,2.07692307692
49380,49548,49782,168,234,14,7980,1.71794871795
49384,49594,51337,210,1743,2,36000,1.12048192771
49403,49606,51296,203,1690,2,36000,1.1201183432
49428,49626,51432,198,1806,2,36000,1.1096345515
49444,49632,51262,188,1630,2,36000,1.11533742331
49445,49638,51667,193,2029,2,36000,1.09512074914
49461,49667,51514,206,1847,2,36000,1.1115322144
49489,49694,51474,205,1780,2,36000,1.11516853933
49505,49705,51591,200,1886,2,36000,1.10604453871
49522,49711,51575,189,1864,2,36000,1.10139484979
49523,49773,51547,250,1774,2,36000,1.14092446449
49539,49804,51571,265,1767,2,36000,1.14997170345
49541,49836,51700,295,1864,2,36000,1.15826180258
49556,49841,51847,285,2006,2,36000,1.14207377866
49579,49852,51493,273,1641,2,36000,1.16636197441
49581,49859,51626,278,1767,2,36000,1.15732880589
49597,49864,51962,267,2098,2,36000,1.12726406101
49617,49870,51621,253,1751,2,36000,1.14448886351
49633,49875,51803,242,1928,2,36000,1.1255186722
49634,49881,51750,247,1869,2,36000,1.13215623328
49659,49887,51717,228,1830,2,36000,1.12459016393
49684,49899,51655,215,1756,2,36000,1.12243735763
49700,49921,51642,221,1721,2,36000,1.12841371296
49701,49926,51837,225,1911,2,36000,1.11773940345
49765,49949,51865,184,1916,2,36000,1.09603340292
49780,49847,49853,67,6,1,900,7.3
49788,49793,50046,5,253,14,7980,1.01976284585
49796,49955,51671,159,1716,2,36000,1.09265734266
49825,49966,51754,141,1788,2,36000,1.0788590604
49826,49972,51950,146,1978,2,36000,1.07381193124
49827,49978,51929,151,1951,2,36000,1.07739620707
49846,49983,51757,137,1774,2,36000,1.07722660654
49847,49989,51764,142,1775,2,36000,1.08
49848,49995,51776,147,1781,2,36000,1.08253790006
49868,50018,51818,150,1800,2,36000,1.08333333333
49870,50024,51812,154,1788,2,36000,1.08612975391
49885,50115,51727,230,1612,2,36000,1.14267990074
49901,50120,52149,219,2029,2,36000,1.10793494332
49902,50127,51929,225,1802,2,36000,1.12486126526
49917,50133,51994,216,1861,2,36000,1.11606663084
49938,50140,51917,202,1777,2,36000,1.1136747327
49953,50155,52167,202,2012,2,36000,1.10039761431
49978,50196,52011,218,1815,2,36000,1.12011019284
49979,50207,51928,228,1721,2,36000,1.13248111563
49980,50214,51869,234,1655,2,36000,1.1413897281
49982,50280,52197,298,1917,2,36000,1.15545122587
49983,50286,52075,303,1789,2,36000,1.16936836221
50003,50300,52247,297,1947,2,36000,1.15254237288
50023,50306,52175,283,1869,2,36000,1.15141787052
50024,50324,51991,300,1667,2,36000,1.1799640072
50039,50096,50104,57,8,1,900,6.5
50051,50057,50313,6,256,14,7980,1.0234375
50086,50334,52051,248,1717,2,36000,1.14443797321
50107,50340,52303,233,1963,2,36000,1.11869587366
50123,50345,52015,222,1670,2,36000,1.13293413174
50124,50350,51784,226,1434,2,36000,1.15760111576
50140,50355,52181,215,1826,2,36000,1.11774370208
50155,50361,52423,206,2062,2,36000,1.09990300679
50186,50509,52319,323,1810,2,36000,1.17845303867
50201,50531,52364,330,1833,2,36000,1.18003273322
50217,50595,52535,378,1940,2,36000,1.19484536082
50273,50644,52557,371,1913,2,36000,1.19393622582
50275,50662,52501,387,1839,2,36000,1.21044045677
50294,50668,52330,374,1662,2,36000,1.22503008424
50295,50673,52372,378,1699,2,36000,1.22248381401
50307,50329,50372,22,43,1,900,1.51162790698
50321,50519,50756,198,237,14,7980,1.83544303797
50331,50688,52489,357,1801,2,36000,1.19822320933
50349,50767,52519,418,1752,2,36000,1.23858447489
50455,50772,52588,317,1816,2,36000,1.17455947137
50457,50777,52360,320,1583,2,36000,1.20214782059
50477,50783,52524,306,1741,2,36000,1.17576105686
50496,50788,52659,292,1871,2,36000,1.15606627472
50518,50798,52273,280,1475,2,36000,1.18983050847
50520,50814,52737,294,1923,2,36000,1.15288611544
50537,50837,51950,300,1113,2,36000,1.26954177898
50586,50855,52727,269,1872,2,36000,1.1436965812
50633,50867,52269,234,1402,2,36000,1.16690442225
50651,50883,52697,232,1814,2,36000,1.12789415656
50652,50893,52727,241,1834,2,36000,1.13140676118
50668,50900,53003,232,2103,2,36000,1.11031859249
50684,50915,52531,231,1616,2,36000,1.14294554455
50754,50793,50799,39,6,1,900,4.5
50762,51152,51376,390,224,14,7980,2.74107142857
50776,51030,52968,254,1938,2,36000,1.1310629515
50804,51067,52373,263,1306,2,36000,1.20137825421
50819,51087,52897,268,1810,2,36000,1.14806629834
50835,51095,52865,260,1770,2,36000,1.14689265537
50836,51107,52861,271,1754,2,36000,1.15450399088
50855,51123,52925,268,1802,2,36000,1.1487236404
50870,51129,53096,259,1967,2,36000,1.13167259786
50886,51135,53012,249,1877,2,36000,1.1326584976
50887,51140,52810,253,1670,2,36000,1.15149700599
50889,51157,52995,268,1838,2,36000,1.14581066376
50904,51163,52917,259,1754,2,36000,1.14766248575
50990,51199,53128,209,1929,2,36000,1.10834629342
51022,51219,52988,197,1769,2,36000,1.11136235161
51037,51231,53006,194,1775,2,36000,1.10929577465
51056,51240,52705,184,1465,2,36000,1.12559726962
51078,51246,53114,168,1868,2,36000,1.08993576017
51095,51256,52922,161,1666,2,36000,1.09663865546
51096,51273,53115,177,1842,2,36000,1.09609120521
51097,51279,53410,182,2131,2,36000,1.08540591272
51113,51285,53230,172,1945,2,36000,1.08843187661
51129,51291,52829,162,1538,2,36000,1.10533159948
51130,51297,53069,167,1772,2,36000,1.09424379233
51132,51307,53239,175,1932,2,36000,1.09057971014
51148,51340,53082,192,1742,2,36000,1.11021814007
51164,51346,53139,182,1793,2,36000,1.10150585611
51191,51352,53142,161,1790,2,36000,1.08994413408
51210,51357,53213,147,1856,2,36000,1.07920258621
51225,51392,53140,167,1748,2,36000,1.09553775744
51246,51398,53185,152,1787,2,36000,1.08505875769
51247,51403,53343,156,1940,2,36000,1.08041237113
51248,51408,53386,160,1978,2,36000,1.08088978766
51267,51413,53220,146,1807,2,36000,1.08079690094
51268,51418,52765,150,1347,2,36000,1.11135857461
51294,51442,52837,148,1395,2,36000,1.10609318996
51295,51448,53118,153,1670,2,36000,1.09161676647
51296,51558,53368,262,1810,2,36000,1.14475138122
51316,51582,53304,266,1722,2,36000,1.15447154472
51334,51632,53375,298,1743,2,36000,1.17096959266
51335,51638,53601,303,1963,2,36000,1.1543555782
51352,51653,53477,301,1824,2,36000,1.16502192982
51353,51666,53517,313,1851,2,36000,1.16909778498
51374,51387,51392,13,5,1,900,1.8
51383,51602,51824,219,222,14,7980,1.98648648649
51393,51678,52836,285,1158,2,36000,1.24611398964
51433,51684,53323,251,1639,2,36000,1.15314215985
51434,51711,53476,277,1765,2,36000,1.15694050992
51477,51728,53610,251,1882,2,36000,1.13336875664
51495,51738,53454,243,1716,2,36000,1.14160839161
51517,51761,53681,244,1920,2,36000,1.12708333333
51548,51767,53628,219,1861,2,36000,1.11767866738
51574,51773,53918,199,2145,2,36000,1.09277389277
51590,51779,53561,189,1782,2,36000,1.10606060606
51592,51787,53627,195,1840,2,36000,1.10597826087
51624,51796,53532,172,1736,2,36000,1.09907834101
51640,51814,53636,174,1822,2,36000,1.09549945115
51656,51824,53730,168,1906,2,36000,1.08814270724
51657,51848,53768,191,1920,2,36000,1.09947916667
51673,51853,53639,180,1786,2,36000,1.10078387458
51675,51859,53818,184,1959,2,36000,1.09392547218
51702,51876,54400,174,2524,2,36000,1.06893819334
51718,51882,53427,164,1545,2,36000,1.10614886731
51734,51928,53621,194,1693,2,36000,1.11458948612
51752,51939,53952,187,2013,2,36000,1.09289617486
51769,51945,53519,176,1574,2,36000,1.11181702668
51771,51950,54099,179,2149,2,36000,1.08329455561
51772,51961,53680,189,1719,2,36000,1.10994764398
51791,51966,53851,175,1885,2,36000,1.09283819629
51792,51973,53954,181,1981,2,36000,1.09136799596
51808,52002,53840,194,1838,2,36000,1.10554951034
51822,51830,51837,8,7,1,900,1.5
51823,52008,53772,185,1764,2,36000,1.10487528345
51824,52022,53726,198,1704,2,36000,1.1161971831
51830,51836,52085,6,249,14,7980,1.02409638554
51840,52028,53445,188,1417,2,36000,1.13267466478
51855,52062,53918,207,1856,2,36000,1.11153017241
51871,52086,53751,215,1665,2,36000,1.12912912913
51873,52101,54109,228,2008,2,36000,1.11354581673
51920,52107,53981,187,1874,2,36000,1.09978655283
51936,52112,54065,176,1953,2,36000,1.09011776754
51937,52117,53945,180,1828,2,36000,1.09846827133
51939,52122,53745,183,1623,2,36000,1.11275415896
51959,52127,54013,168,1886,2,36000,1.08907741251
51960,52208,54003,248,1795,2,36000,1.13816155989
51976,52281,53968,305,1687,2,36000,1.18079430943
51995,52315,54083,320,1768,2,36000,1.18099547511
51996,52330,54152,334,1822,2,36000,1.18331503842
52012,52341,54012,329,1671,2,36000,1.19688809096
52027,52371,54124,344,1753,2,36000,1.19623502567
52052,52377,54167,325,1790,2,36000,1.18156424581
52075,52383,54348,308,1965,2,36000,1.15674300254
52084,52096,52118,12,22,1,900,1.54545454545
52094,52287,52507,193,220,14,7980,1.87727272727
52151,52389,54150,238,1761,2,36000,1.13515048268
52169,52435,54360,266,1925,2,36000,1.13818181818
52185,52501,54276,316,1775,2,36000,1.17802816901
52186,52512,54480,326,1968,2,36000,1.1656504065
52202,52523,53720,321,1197,2,36000,1.26817042607
52248,52528,54383,280,1855,2,36000,1.15094339623
52270,52533,54411,263,1878,2,36000,1.14004259851
52285,52539,54396,254,1857,2,36000,1.13677975229
52304,52544,54394,240,1850,2,36000,1.12972972973
52322,52549,54596,227,2047,2,36000,1.11089399121
52338,52670,54493,332,1823,2,36000,1.18211738892
52362,52708,54586,346,1878,2,36000,1.18423855165
52378,52716,54625,338,1909,2,36000,1.17705605029
52379,52738,54580,359,1842,2,36000,1.19489685125
52380,52743,54206,363,1463,2,36000,1.24812030075
52426,52749,54940,323,2191,2,36000,1.14742126883
52491,52777,54752,286,1975,2,36000,1.14481012658
52505,52518,52531,13,13,1,900,2.0
52507,52821,54714,314,1893,2,36000,1.16587427364
52514,52599,52839,85,240,14,7980,1.35416666667
52524,52840,54561,316,1721,2,36000,1.1836141778
52526,52847,54325,321,1478,2,36000,1.21718538566
52544,52858,54362,314,1504,2,36000,1.20877659574
52545,52876,54597,331,1721,2,36000,1.19233004067
52562,52881,55061,319,2180,2,36000,1.14633027523
52591,52908,54829,317,1921,2,36000,1.16501821968
52659,52934,54722,275,1788,2,36000,1.15380313199
52700,52940,54827,240,1887,2,36000,1.12718600954
52717,52946,54395,229,1449,2,36000,1.15804002761
52733,52980,54873,247,1893,2,36000,1.13048071844
52734,52999,54375,265,1376,2,36000,1.1925872093
52749,53006,54826,257,1820,2,36000,1.14120879121
52768,53015,54855,247,1840,2,36000,1.13423913043
52811,53021,54901,210,1880,2,36000,1.11170212766
52832,53027,54818,195,1791,2,36000,1.10887772194
52837,52928,52935,91,7,1,900,9.8
52845,52853,53099,8,246,14,7980,1.0325203252
52848,53080,54904,232,1824,2,36000,1.12719298246
52849,53093,55133,244,2040,2,36000,1.11960784314
52865,53107,55107,242,2000,2,36000,1.121
52866,53118,54894,252,1776,2,36000,1.14189189189
52901,53124,54913,223,1789,2,36000,1.12465064282
52920,53129,55041,209,1912,2,36000,1.10930962343
52935,53134,54688,199,1554,2,36000,1.12805662806
52936,53139,54806,203,1667,2,36000,1.12177564487
52970,53144,54808,174,1664,2,36000,1.10456730769
52989,53150,54950,161,1800,2,36000,1.08944444444
53005,53156,54933,151,1777,2,36000,1.08497467642
53006,53224,55210,218,1986,2,36000,1.10976837865
53025,53232,55138,207,1906,2,36000,1.10860440714
53027,53241,55011,214,1770,2,36000,1.1209039548
53070,53250,55044,180,1794,2,36000,1.10033444816
53085,53315,55066,230,1751,2,36000,1.13135351228
53097,53113,53121,16,8,1,900,2.4
53101,53334,55059,233,1725,2,36000,1.13507246377
53110,53196,53431,86,235,14,7980,1.36595744681
53116,53354,55140,238,1786,2,36000,1.13325867861
53118,53379,54784,261,1405,2,36000,1.18576512456
53134,53386,55076,252,1690,2,36000,1.14911242604
53135,53397,56197,262,2800,2,36000,1.09357142857
53155,53422,55328,267,1906,2,36000,1.14008394544
53156,53455,55271,299,1816,2,36000,1.16464757709
53157,53461,55264,304,1803,2,36000,1.16860787576
53189,53467,55248,278,1781,2,36000,1.1560920831
53217,53487,55339,270,1852,2,36000,1.14578833693
53233,53493,55244,260,1751,2,36000,1.1484865791
53235,53528,55355,293,1827,2,36000,1.16037219485
53250,53534,55388,284,1854,2,36000,1.15318230852
53305,53543,55378,238,1835,2,36000,1.12970027248
53325,53572,55295,247,1723,2,36000,1.14335461405
53344,53612,55331,268,1719,2,36000,1.1559045957
53372,53621,55508,249,1887,2,36000,1.1319554849
53388,53632,55312,244,1680,2,36000,1.14523809524
53389,53638,55507,249,1869,2,36000,1.13322632424
53411,53644,54772,233,1128,2,36000,1.20656028369
53428,53438,53444,10,6,1,900,1.6
53430,53650,55219,220,1569,2,36000,1.14021669853
53437,53444,53661,7,217,14,7980,1.03225806452
53448,53655,55460,207,1805,2,36000,1.11468144044
53464,53697,55512,233,1815,2,36000,1.12837465565
53479,53708,55589,229,1881,2,36000,1.12174375332
53481,53731,55574,250,1843,2,36000,1.13564839935
53517,53738,55425,221,1687,2,36000,1.1310017783
53533,53744,55647,211,1903,2,36000,1.11087756174
53534,53757,55594,223,1837,2,36000,1.12139357648
53562,53763,55784,201,2021,2,36000,1.09945571499
53602,53779,55672,177,1893,2,36000,1.09350237718
53617,53785,55709,168,1924,2,36000,1.08731808732
53633,53829,55663,196,1834,2,36000,1.10687022901
53634,53852,55663,218,1811,2,36000,1.12037548316
53636,53862,55633,226,1771,2,36000,1.12761151892
53651,53931,55153,280,1222,2,36000,1.22913256956
53652,53936,55971,284,2035,2,36000,1.13955773956
53658,53691,53697,33,6,1,900,3.9
53666,53672,53915,6,243,14,7980,1.02469135802
53681,53942,55657,261,1715,2,36000,1.15218658892
53682,53947,55707,265,1760,2,36000,1.15056818182
53722,53952,55769,230,1817,2,36000,1.12658227848
53737,53957,56010,220,2053,2,36000,1.10716025329
53739,53963,55768,224,1805,2,36000,1.12409972299
53754,53969,55882,215,1913,2,36000,1.11238891793
53756,53979,55577,223,1598,2,36000,1.1395494368
53771,54014,55687,243,1673,2,36000,1.14524805738
53787,54077,55457,290,1380,2,36000,1.21014492754
53821,54094,55945,273,1851,2,36000,1.14748784441
53843,54110,56125,267,2015,2,36000,1.13250620347
53858,54120,55908,262,1788,2,36000,1.14653243848
53912,53926,53937,14,11,1,900,2.27272727273
53919,54135,55982,216,1847,2,36000,1.11694639957
53920,54162,56102,242,1940,2,36000,1.12474226804
53923,54024,54261,101,237,14,7980,1.42616033755
53946,54168,55889,222,1721,2,36000,1.12899477048
53964,54179,55862,215,1683,2,36000,1.12774806892
53965,54217,56361,252,2144,2,36000,1.11753731343
53981,54277,55973,296,1696,2,36000,1.17452830189
53996,54282,56242,286,1960,2,36000,1.14591836735
54012,54288,56208,276,1920,2,36000,1.14375
54013,54293,55936,280,1643,2,36000,1.17041996348
54029,54298,56068,269,1770,2,36000,1.15197740113
54066,54303,56261,237,1958,2,36000,1.12104187947
54084,54336,55928,252,1592,2,36000,1.15829145729
54100,54359,56240,259,1881,2,36000,1.13769271664
54115,54371,56017,256,1646,2,36000,1.15552855407
54131,54377,56143,246,1766,2,36000,1.13929784824
54153,54405,56271,252,1866,2,36000,1.13504823151
54154,54411,56260,257,1849,2,36000,1.13899405084
54170,54416,56049,246,1633,2,36000,1.15064298836
54212,54492,56238,280,1746,2,36000,1.16036655212
54258,54272,54277,14,5,1,900,1.9
54267,54504,54725,237,221,14,7980,2.07239819005
54279,54572,55982,293,1410,2,36000,1.20780141844
54326,54591,56368,265,1777,2,36000,1.14912774339
54352,54597,56463,245,1866,2,36000,1.13129689175
54371,54608,56585,237,1977,2,36000,1.11987860395
54373,54613,56430,240,1817,2,36000,1.13208585581
54388,54637,56535,249,1898,2,36000,1.13119072708
54390,54699,56480,309,1781,2,36000,1.17349803481
54406,54726,56627,320,1901,2,36000,1.1683324566
54407,54750,56510,343,1760,2,36000,1.19488636364
54409,54763,56561,354,1798,2,36000,1.19688542825
54410,54783,56672,373,1889,2,36000,1.197458973
54426,54795,56080,369,1285,2,36000,1.28715953307
54482,54818,56716,336,1898,2,36000,1.177028451
54498,54824,56613,326,1789,2,36000,1.18222470654
54563,54830,56574,267,1744,2,36000,1.15309633028
54582,54837,56575,255,1738,2,36000,1.14672036824
54605,54843,56735,238,1892,2,36000,1.12579281184
54606,54848,56604,242,1756,2,36000,1.13781321185
54608,54866,56697,258,1831,2,36000,1.14090660841
54628,54885,56868,257,1983,2,36000,1.12960161372
54690,54905,56765,215,1860,2,36000,1.11559139785
54715,54912,56764,197,1852,2,36000,1.10637149028
54723,54733,54738,10,5,1,900,1.5
54730,54918,56476,188,1558,2,36000,1.12066752246
54731,54739,54973,8,234,14,7980,1.03418803419
54753,54924,56416,171,1492,2,36000,1.11461126005
54775,54944,56838,169,1894,2,36000,1.08922914467
54790,54951,56871,161,1920,2,36000,1.08385416667
54809,54961,56799,152,1838,2,36000,1.08269858542
54810,54989,56771,179,1782,2,36000,1.10044893378
54826,54994,56865,168,1871,2,36000,1.08979155532
54827,54999,56099,172,1100,2,36000,1.15636363636
54843,55005,56654,162,1649,2,36000,1.0982413584
54844,55010,56810,166,1800,2,36000,1.09222222222
54860,55015,56821,155,1806,2,36000,1.08582502769
54876,55022,56704,146,1682,2,36000,1.08680142687
54895,55055,56740,160,1685,2,36000,1.09495548961
54916,55072,57178,156,2106,2,36000,1.07407407407
54917,55078,56523,161,1445,2,36000,1.11141868512
54918,55119,57135,201,2016,2,36000,1.09970238095
54934,55144,56954,210,1810,2,36000,1.11602209945
54950,55222,57016,272,1794,2,36000,1.15161649944
54951,55230,57266,279,2036,2,36000,1.13703339882
54971,54984,54991,13,7,1,900,2.0
54981,55164,55396,183,232,14,7980,1.78879310345
55012,55255,57084,243,1829,2,36000,1.13285948606
55043,55261,57067,218,1806,2,36000,1.12070874862
55059,55276,56894,217,1618,2,36000,1.13411619283
55060,55283,56258,223,975,2,36000,1.22871794872
55086,55306,56945,220,1639,2,36000,1.13422818792
55087,55324,57283,237,1959,2,36000,1.12098009188
55088,55339,56672,251,1333,2,36000,1.18829707427
55111,55345,57165,234,1820,2,36000,1.12857142857
55136,55351,57069,215,1718,2,36000,1.12514551804
55151,55366,56736,215,1370,2,36000,1.15693430657
55153,55389,57246,236,1857,2,36000,1.12708669898
55154,55399,57273,245,1874,2,36000,1.13073639274
55213,55412,57124,199,1712,2,36000,1.11623831776
55228,55418,57094,190,1676,2,36000,1.11336515513
55247,55423,57119,176,1696,2,36000,1.10377358491
55262,55428,57326,166,1898,2,36000,1.08746048472
55278,55433,57189,155,1756,2,36000,1.08826879271
55279,55438,56662,159,1224,2,36000,1.12990196078
55297,55443,57352,146,1909,2,36000,1.07647983237
55313,55471,57236,158,1765,2,36000,1.0895184136
55329,55520,57133,191,1613,2,36000,1.11841289523
55344,55589,57135,245,1546,2,36000,1.15847347995
55346,55644,57370,298,1726,2,36000,1.17265353418
55361,55659,57561,298,1902,2,36000,1.15667718191
55380,55668,56727,288,1059,2,36000,1.27195467422
55394,55407,55414,13,7,1,900,2.0
55395,55674,57265,279,1591,2,36000,1.17536140792
55403,55606,55838,203,232,14,7980,1.875
55426,55679,57652,253,1973,2,36000,1.12823112012
55460,55685,57472,225,1787,2,36000,1.12590934527
55461,55698,57554,237,1856,2,36000,1.12769396552
55508,55718,57430,210,1712,2,36000,1.1226635514
55523,55724,57417,201,1693,2,36000,1.1187241583
55525,55779,57376,254,1597,2,36000,1.1590482154
55579,55785,57628,206,1843,2,36000,1.11177428106
55580,55795,57623,215,1828,2,36000,1.11761487965
55596,55854,57712,258,1858,2,36000,1.13885898816
55597,55859,57577,262,1718,2,36000,1.15250291036
55635,55865,57734,230,1869,2,36000,1.12306046014
55654,55870,57690,216,1820,2,36000,1.11868131868
55674,55875,57635,201,1760,2,36000,1.11420454545
55676,55880,57363,204,1483,2,36000,1.13755900202
55677,55885,57921,208,2036,2,36000,1.1021611002
55678,55891,57817,213,1926,2,36000,1.11059190031
55694,55897,57921,203,2024,2,36000,1.10029644269
55712,55903,57218,191,1315,2,36000,1.14524714829
55713,55940,57148,227,1208,2,36000,1.18791390728
55770,56022,58039,252,2017,2,36000,1.12493802677
55772,56028,57956,256,1928,2,36000,1.13278008299
55787,56060,57777,273,1717,2,36000,1.15899825277
55836,55849,55855,13,6,1,900,1.9
55844,55993,56232,149,239,14,7980,1.62343096234
55861,56079,57819,218,1740,2,36000,1.12528735632
55886,56091,57840,205,1749,2,36000,1.11720983419
55901,56110,57661,209,1551,2,36000,1.13475177305
55917,56116,58121,199,2005,2,36000,1.09925187032
55932,56136,57928,204,1792,2,36000,1.11383928571
55948,56154,57921,206,1767,2,36000,1.11658177702
55949,56208,57947,259,1739,2,36000,1.14893617021
55974,56220,57894,246,1674,2,36000,1.14695340502
55975,56249,58212,274,1963,2,36000,1.13958227203
55993,56260,58238,267,1978,2,36000,1.13498483316
55994,56265,58172,271,1907,2,36000,1.14210802307
56016,56272,58126,256,1854,2,36000,1.1380798274
56018,56277,58360,259,2083,2,36000,1.12433989438
56054,56283,58014,229,1731,2,36000,1.13229347198
56069,56288,58015,219,1727,2,36000,1.12680949624
56085,56373,58257,288,1884,2,36000,1.15286624204
56101,56380,58291,279,1911,2,36000,1.14599686028
56118,56427,58184,309,1757,2,36000,1.17586795674
56134,56442,58285,308,1843,2,36000,1.167118828
56150,56475,58351,325,1876,2,36000,1.17324093817
56199,56481,58246,282,1765,2,36000,1.1597733711
56215,56486,58344,271,1858,2,36000,1.14585575888
56229,56255,56261,26,6,1,900,3.2
56238,56243,56459,5,216,14,7980,1.02314814815
56240,56491,58334,251,1843,2,36000,1.13619099295
56241,56496,58242,255,1746,2,36000,1.14604810997
56258,56501,58326,243,1825,2,36000,1.13315068493
56259,56506,57662,247,1156,2,36000,1.21366782007
56276,56513,58265,237,1752,2,36000,1.1352739726
56277,56534,58262,257,1728,2,36000,1.14872685185
56278,56585,58308,307,1723,2,36000,1.17817759721
56363,56591,58339,228,1748,2,36000,1.13043478261
56380,56616,58529,236,1913,2,36000,1.12336644015
56417,56638,58555,221,1917,2,36000,1.11528429838
56433,56665,58095,232,1430,2,36000,1.16223776224
56458,56470,56476,12,6,1,900,1.8
56464,56673,58430,209,1757,2,36000,1.11895276039
56467,56625,56846,158,221,14,7980,1.7149321267
56480,56683,58412,203,1729,2,36000,1.11740890688
56481,56688,57905,207,1217,2,36000,1.1700903862
56514,56708,58544,194,1836,2,36000,1.10566448802
56529,56715,58453,186,1738,2,36000,1.10701956272
56545,56727,58595,182,1868,2,36000,1.09743040685
56565,56738,58377,173,1639,2,36000,1.10555216595
56584,56746,58748,162,2002,2,36000,1.08091908092
56586,56751,58417,165,1666,2,36000,1.09903961585
56587,56758,58616,171,1858,2,36000,1.09203444564
56606,56775,58611,169,1836,2,36000,1.09204793028
56621,56781,58557,160,1776,2,36000,1.09009009009
56637,56787,58170,150,1383,2,36000,1.10845986985
56655,56810,58679,155,1869,2,36000,1.08293204922
56671,56821,58512,150,1691,2,36000,1.08870490834
56686,56832,58592,146,1760,2,36000,1.08295454545
56688,56849,58741,161,1892,2,36000,1.08509513742
56703,56863,58557,160,1694,2,36000,1.09445100354
56719,56868,58729,149,1861,2,36000,1.08006448146
56720,56874,58898,154,2024,2,36000,1.07608695652
56737,56879,58606,142,1727,2,36000,1.08222350898
56738,56884,58753,146,1869,2,36000,1.07811663991
56739,56889,58779,150,1890,2,36000,1.07936507937
56755,56894,58372,139,1478,2,36000,1.09404600812
56770,56966,58901,196,1935,2,36000,1.10129198966
56772,57027,58893,255,1866,2,36000,1.13665594855
56788,57095,59125,307,2030,2,36000,1.15123152709
56804,57105,58802,301,1697,2,36000,1.17737183265
56821,57130,59134,309,2004,2,36000,1.15419161677
56822,57136,58855,314,1719,2,36000,1.18266433973
56841,57144,59165,303,2021,2,36000,1.14992577932
56844,56858,56867,14,9,1,900,2.3
56855,57081,57313,226,232,14,7980,1.97413793103
56867,57150,58911,283,1761,2,36000,1.16070414537
56868,57155,59069,287,1914,2,36000,1.1499477534
56886,57161,59018,275,1857,2,36000,1.14808831449
56902,57177,59026,275,1849,2,36000,1.14872904273
56945,57189,58938,244,1749,2,36000,1.13950829045
56961,57200,59077,239,1877,2,36000,1.1273308471
57016,57229,58961,213,1732,2,36000,1.12297921478
57068,57247,59231,179,1984,2,36000,1.09022177419
57085,57257,59293,172,2036,2,36000,1.08447937132
57087,57276,58973,189,1697,2,36000,1.1113730112
57102,57282,59059,180,1777,2,36000,1.10129431626
57123,57288,59059,165,1771,2,36000,1.09316770186
57141,57294,59186,153,1892,2,36000,1.08086680761
57142,57342,59301,200,1959,2,36000,1.10209290454
57143,57363,59296,220,1933,2,36000,1.11381272633
57144,57374,58993,230,1619,2,36000,1.14206300185
57160,57381,59108,221,1727,2,36000,1.12796757383
57175,57387,59450,212,2063,2,36000,1.10276296655
57191,57428,59115,237,1687,2,36000,1.14048606995
57192,57441,59299,249,1858,2,36000,1.13401506997
57222,57483,59245,261,1762,2,36000,1.14812712826
57239,57565,59488,326,1923,2,36000,1.16952678107
57255,57582,59504,327,1922,2,36000,1.17013527575
57270,57588,59370,318,1782,2,36000,1.17845117845
57272,57664,59464,392,1800,2,36000,1.21777777778
57291,57788,59227,497,1439,2,36000,1.34537873523
57293,57828,59626,535,1798,2,36000,1.29755283648
57311,57337,57343,26,6,1,900,3.2
57320,57325,57556,5,231,14,7980,1.02164502165
57329,57833,59593,504,1760,2,36000,1.28636363636
57354,57838,59626,484,1788,2,36000,1.2706935123
57369,57844,59626,475,1782,2,36000,1.26655443322
57385,57851,59244,466,1393,2,36000,1.33452979182
57386,57905,59626,519,1721,2,36000,1.30156885532
57420,57916,59626,496,1710,2,36000,1.29005847953
57436,57932,59626,496,1694,2,36000,1.29279811098
57472,57937,59626,465,1689,2,36000,1.27531083481
57554,57577,57585,23,8,1,900,3.1
57555,57942,59626,387,1684,2,36000,1.22980997625
57563,57571,57792,8,221,14,7980,1.03619909502
57571,57949,59626,378,1677,2,36000,1.22540250447
57586,57958,59626,372,1668,2,36000,1.22302158273
57605,58048,66017,443,7969,32,356400,1.05559041285
57623,57968,59626,345,1658,2,36000,1.20808202654
57639,58025,59449,386,1424,2,36000,1.27106741573
57640,58031,59626,391,1595,2,36000,1.24514106583
57656,58132,59626,476,1494,2,36000,1.31860776439
57672,58183,59626,511,1443,2,36000,1.35412335412
57673,58224,59626,551,1402,2,36000,1.39300998573
57692,58259,59626,567,1367,2,36000,1.41477688369
57713,58269,59626,556,1357,2,36000,1.40972733972
57735,58275,59626,540,1351,2,36000,1.39970392302
57778,58280,59626,502,1346,2,36000,1.37295690936
57790,57796,57812,6,16,1,900,1.375
57800,57806,58037,6,231,14,7980,1.02597402597
57820,58297,59626,477,1329,2,36000,1.35891647856
57821,58303,59626,482,1323,2,36000,1.36432350718
57843,58319,59626,476,1307,2,36000,1.36419280796
57896,58337,59626,441,1289,2,36000,1.34212567882
57911,58345,59626,434,1281,2,36000,1.33879781421
57929,58351,59626,422,1275,2,36000,1.33098039216
57931,58357,59626,426,1269,2,36000,1.33569739953
57932,58363,59626,431,1263,2,36000,1.34125098971
57933,58371,59626,438,1255,2,36000,1.34900398406
57949,58383,59626,434,1243,2,36000,1.34915526951
57965,58389,59626,424,1237,2,36000,1.34276475344
58018,58423,59626,405,1203,2,36000,1.33665835411
58019,58429,59626,410,1197,2,36000,1.3425229741
58036,58042,58049,6,7,1,900,1.3
58041,58435,59626,394,1191,2,36000,1.33081444165
58045,58253,58472,208,219,14,7980,1.9497716895
58096,58440,59626,344,1186,2,36000,1.29005059022
58121,58445,59626,324,1181,2,36000,1.27434377646
58137,58451,59626,314,1175,2,36000,1.26723404255
58171,58456,59626,285,1170,2,36000,1.24358974359
58172,58461,59626,289,1165,2,36000,1.24806866953
58188,58466,59626,278,1160,2,36000,1.23965517241
58212,58471,59626,259,1155,2,36000,1.22424242424
58240,58477,59626,237,1149,2,36000,1.20626631854
58257,58482,59626,225,1144,2,36000,1.19667832168
58258,58487,59626,229,1139,2,36000,1.20105355575
58259,58492,59626,233,1134,2,36000,1.20546737213
58275,58497,59626,222,1129,2,36000,1.19663418955
58276,58502,59626,226,1124,2,36000,1.20106761566
58292,58508,59626,216,1118,2,36000,1.19320214669
58293,58513,59626,220,1113,2,36000,1.19766397125
58308,58530,59626,222,1096,2,36000,1.20255474453
58327,58535,59626,208,1091,2,36000,1.1906507791
58343,58541,59626,198,1085,2,36000,1.18248847926
58344,58546,59626,202,1080,2,36000,1.18703703704
58360,58555,59626,195,1071,2,36000,1.18207282913
58362,58566,59626,204,1060,2,36000,1.19245283019
58363,58572,59595,209,1023,2,36000,1.20430107527
58380,58577,59626,197,1049,2,36000,1.18779790276
58381,58603,59626,222,1023,2,36000,1.21700879765
58413,58609,59626,196,1017,2,36000,1.19272369715
58429,58622,59626,193,1004,2,36000,1.1922310757
58430,58627,59626,197,999,2,36000,1.1971971972
58455,58634,59626,179,992,2,36000,1.18044354839
58470,58525,58530,55,5,1,900,6.0
58479,58519,58744,40,225,14,7980,1.17777777778
58515,58691,59626,176,935,2,36000,1.18823529412
58531,58740,59626,209,886,2,36000,1.23589164786
58546,58752,59626,206,874,2,36000,1.2356979405
58566,58769,59626,203,857,2,36000,1.23687281214
58567,58775,59626,208,851,2,36000,1.24441833137
58569,58790,59626,221,836,2,36000,1.26435406699
58594,58814,59626,220,812,2,36000,1.27093596059
58610,58866,59626,256,760,2,36000,1.33684210526
58611,58904,59626,293,722,2,36000,1.40581717452
58627,58910,59626,283,716,2,36000,1.39525139665
58628,58916,59626,288,710,2,36000,1.40563380282
58681,58922,59626,241,704,2,36000,1.34232954545
58732,58949,59626,217,677,2,36000,1.32053175775
58739,58764,58769,25,5,1,900,3.0
58749,58758,58998,9,240,14,7980,1.0375
58750,58972,59626,222,654,2,36000,1.33944954128
58751,58984,59626,233,642,2,36000,1.36292834891
58767,59010,59626,243,616,2,36000,1.39448051948
58782,59029,59627,247,598,2,36000,1.41304347826
58804,59037,59627,233,590,2,36000,1.39491525424
58857,59070,59627,213,557,2,36000,1.38240574506
58901,59075,59627,174,552,2,36000,1.3152173913
58902,59081,59627,179,546,2,36000,1.32783882784
58903,59088,59627,185,539,2,36000,1.34322820037
58919,59120,59627,201,507,2,36000,1.39644970414
58941,59126,59627,185,501,2,36000,1.36926147705
58962,59136,59627,174,491,2,36000,1.35437881874
58978,59146,59627,168,481,2,36000,1.34927234927
58992,59005,59011,13,6,1,900,1.9
58996,59176,59627,180,451,2,36000,1.39911308204
59002,59016,59236,14,220,14,7980,1.06363636364
59021,59197,59627,176,430,2,36000,1.40930232558
59036,59239,59627,203,388,2,36000,1.52319587629
59062,59245,59627,183,382,2,36000,1.47905759162
59063,59262,59627,199,365,2,36000,1.54520547945
59079,59268,59627,189,359,2,36000,1.52646239554
59080,59304,59627,224,323,2,36000,1.69349845201
59110,59310,59627,200,317,2,36000,1.6309148265
59126,59315,59627,189,312,2,36000,1.60576923077
59127,59322,59627,195,305,2,36000,1.6393442623
59143,59381,59627,238,246,2,36000,1.9674796748
59164,59461,59627,297,166,2,36000,2.78915662651
59183,59466,59627,283,161,2,36000,2.75776397516
59229,59475,59627,246,152,2,36000,2.61842105263
59231,59493,59627,262,134,2,36000,2.9552238806
59234,59257,59266,23,9,1,900,3.2
59243,59251,59477,8,226,14,7980,1.03539823009
59248,59499,59627,251,128,2,36000,2.9609375
59249,59504,59627,255,123,2,36000,3.07317073171
59294,59509,59627,215,118,2,36000,2.82203389831
59310,59514,59627,204,113,2,36000,2.80530973451
59312,59519,59627,207,108,2,36000,2.91666666667
59313,59524,59627,211,103,2,36000,3.04854368932
59372,59531,59627,159,96,2,36000,2.65625
59475,59488,59501,13,13,1,900,2.0
59484,59639,59871,155,232,14,7980,1.66810344828
59715,59721,61432,6,1711,2,36000,1.00350672122
59716,59727,60861,11,1134,2,36000,1.00970017637
59717,59732,61335,15,1603,2,36000,1.00935745477
59719,59737,61447,18,1710,2,36000,1.01052631579
59720,59742,61440,22,1698,2,36000,1.01295641932
59722,59748,61358,26,1610,2,36000,1.01614906832
59724,59753,61330,29,1577,2,36000,1.01838934686
59725,59758,61367,33,1609,2,36000,1.02050963331
59727,59763,61548,36,1785,2,36000,1.02016806723
59728,59769,61696,41,1927,2,36000,1.02127659574
59730,59774,61536,44,1762,2,36000,1.02497162316
59732,59779,61496,47,1717,2,36000,1.02737332557
59733,59784,61560,51,1776,2,36000,1.02871621622
59736,59790,61411,54,1621,2,36000,1.0333127699
59737,59795,61310,58,1515,2,36000,1.03828382838
59740,59800,61395,60,1595,2,36000,1.03761755486
59743,59806,61561,63,1755,2,36000,1.0358974359
59745,59811,61456,66,1645,2,36000,1.04012158055
59747,59816,61918,69,2102,2,36000,1.03282588011
59749,59821,61569,72,1748,2,36000,1.04118993135
59751,59827,61626,76,1799,2,36000,1.04224569205
59752,59832,61700,80,1868,2,36000,1.04282655246
59754,59837,61461,83,1624,2,36000,1.05110837438
59756,59842,61550,86,1708,2,36000,1.05035128806
59757,59847,61446,90,1599,2,36000,1.05628517824
59759,59853,61470,94,1617,2,36000,1.05813234385
59761,59858,61500,97,1642,2,36000,1.05907429963
59762,59864,61718,102,1854,2,36000,1.05501618123
59763,59869,61548,106,1679,2,36000,1.06313281715
59765,59875,61620,110,1745,2,36000,1.06303724928
59767,59880,61589,113,1709,2,36000,1.06612053833
59771,59885,61569,114,1684,2,36000,1.067695962
59774,59890,61469,116,1579,2,36000,1.07346421786
59777,59895,61518,118,1623,2,36000,1.07270486753
59779,59901,61410,122,1509,2,36000,1.08084824387
59781,59906,61827,125,1921,2,36000,1.0650702759
59783,59911,61608,128,1697,2,36000,1.07542722451
59785,59916,61686,131,1770,2,36000,1.07401129944
59787,59921,61638,134,1717,2,36000,1.07804309843
59788,59926,61742,138,1816,2,36000,1.07599118943
59790,59932,61568,142,1636,2,36000,1.08679706601
59792,59937,61759,145,1822,2,36000,1.07958287596
59793,59942,61738,149,1796,2,36000,1.08296213808
59795,59947,61406,152,1459,2,36000,1.10418094585
59797,59952,61512,155,1560,2,36000,1.09935897436
59798,59958,61675,160,1717,2,36000,1.09318578917
59800,59963,61719,163,1756,2,36000,1.09282460137
59801,59979,61569,178,1590,2,36000,1.11194968553
59803,59985,61803,182,1818,2,36000,1.100110011
59804,59990,61652,186,1662,2,36000,1.1119133574
59806,59995,61618,189,1623,2,36000,1.11645101664
59808,60000,60992,192,992,2,36000,1.1935483871
59809,60005,61708,196,1703,2,36000,1.11509101585
59811,60011,61643,200,1632,2,36000,1.12254901961
59812,60016,61604,204,1588,2,36000,1.12846347607
59814,60021,61570,207,1549,2,36000,1.13363460297
59816,60026,61773,210,1747,2,36000,1.12020606754
59817,60031,61794,214,1763,2,36000,1.12138400454
59819,60036,61624,217,1588,2,36000,1.13664987406
59821,60042,61855,221,1813,2,36000,1.12189740761
59822,60047,62211,225,2164,2,36000,1.103974122
59824,60052,61789,228,1737,2,36000,1.13126079447
59825,60057,61717,232,1660,2,36000,1.13975903614
59827,60062,62307,235,2245,2,36000,1.10467706013
59828,60068,61901,240,1833,2,36000,1.13093289689
59830,60073,61848,243,1775,2,36000,1.13690140845
59831,60078,61775,247,1697,2,36000,1.1455509723
59832,60083,61865,251,1782,2,36000,1.14085297419
59834,60088,61909,254,1821,2,36000,1.13948380011
59835,60093,61862,258,1769,2,36000,1.14584511023
59837,60099,61561,262,1462,2,36000,1.17920656635
59838,60104,61775,266,1671,2,36000,1.1591861161
59840,60109,61548,269,1439,2,36000,1.18693537179
59841,60114,61855,273,1741,2,36000,1.15680643308
59842,60119,61872,277,1753,2,36000,1.15801483172
59844,60124,61270,280,1146,2,36000,1.24432809773
59845,60130,61758,285,1628,2,36000,1.17506142506
59847,60135,61887,288,1752,2,36000,1.16438356164
59848,60140,61941,292,1801,2,36000,1.16213214881
59849,60145,61833,296,1688,2,36000,1.17535545024
59851,60150,61841,299,1691,2,36000,1.17681845062
59852,60155,61774,303,1619,2,36000,1.18715256331
59854,60161,62138,307,1977,2,36000,1.15528578655
59855,60166,61814,311,1648,2,36000,1.18871359223
59857,60171,61838,314,1667,2,36000,1.18836232753
59858,60176,62071,318,1895,2,36000,1.16781002639
59859,60181,61875,322,1694,2,36000,1.19008264463
59861,60187,61857,326,1670,2,36000,1.19520958084
59862,60192,62154,330,1962,2,36000,1.16819571865
59864,60197,62002,333,1805,2,36000,1.18448753463
59865,60202,62097,337,1895,2,36000,1.17783641161
59866,60207,61902,341,1695,2,36000,1.201179941
59868,60212,61462,344,1250,2,36000,1.2752
59869,59974,59980,105,6,1,900,11.1
59869,60218,61943,349,1725,2,36000,1.20231884058
59870,60223,61876,353,1653,2,36000,1.21355111918
59872,60228,62193,356,1965,2,36000,1.18117048346
59873,60233,62026,360,1793,2,36000,1.20078081428
59874,60238,62077,364,1839,2,36000,1.1979336596
59876,60243,61956,367,1713,2,36000,1.21424401635
59877,60249,61882,372,1633,2,36000,1.22780159216
59878,59969,60219,91,250,14,7980,1.364
59878,60254,62124,376,1870,2,36000,1.20106951872
59880,60259,62029,379,1770,2,36000,1.21412429379
59881,60264,61932,383,1668,2,36000,1.22961630695
59882,60269,61809,387,1540,2,36000,1.2512987013
59884,60528,62550,644,2022,2,36000,1.31849653808
59885,60533,62400,648,1867,2,36000,1.34708087841
59886,60539,62395,653,1856,2,36000,1.35183189655
59888,60544,62347,656,1803,2,36000,1.3638380477
59889,60549,62174,660,1625,2,36000,1.40615384615
59890,60554,62395,664,1841,2,36000,1.36067354699
59892,60559,62348,667,1789,2,36000,1.37283398547
59893,61162,62912,1269,1750,2,36000,1.72514285714
59894,61167,62987,1273,1820,2,36000,1.69945054945
59896,61281,63206,1385,1925,2,36000,1.71948051948
59897,61321,63110,1424,1789,2,36000,1.79597540525
60215,60281,60286,66,5,1,900,7.1
60226,60276,60516,50,240,14,7980,1.20833333333
60512,60518,60561,6,43,1,900,1.13953488372
60863,61341,63164,478,1823,2,36000,1.26220515634
60994,61347,63258,353,1911,2,36000,1.18472004186
61271,61368,63159,97,1791,2,36000,1.05415968733
61310,61378,62993,68,1615,2,36000,1.04210526316
61332,61406,63108,74,1702,2,36000,1.04347826087
61347,61417,63107,70,1690,2,36000,1.04142011834
61362,61423,63366,61,1943,2,36000,1.03139475039
61376,61428,63224,52,1796,2,36000,1.0289532294
61397,61443,63303,46,1860,2,36000,1.0247311828
61411,61451,63185,40,1734,2,36000,1.02306805075
61413,61457,63298,44,1841,2,36000,1.02390005432
61414,61463,63379,49,1916,2,36000,1.02557411273
61432,61469,63184,37,1715,2,36000,1.02157434402
61446,61475,63281,29,1806,2,36000,1.01605758583
61448,61480,63426,32,1946,2,36000,1.01644398767
61449,61487,63289,38,1802,2,36000,1.02108768036
61464,61492,63222,28,1730,2,36000,1.0161849711
61465,61507,63307,42,1800,2,36000,1.02333333333
61467,61513,63297,46,1784,2,36000,1.02578475336
61481,61523,63144,42,1621,2,36000,1.02590993214
61483,61529,63234,46,1705,2,36000,1.02697947214
61497,61548,63287,51,1739,2,36000,1.02932719954
61512,61559,63403,47,1844,2,36000,1.02548806941
61514,61564,63047,50,1483,2,36000,1.03371544167
61528,61570,63495,42,1925,2,36000,1.02181818182
61543,61575,63441,32,1866,2,36000,1.01714898178
61559,61582,63358,23,1776,2,36000,1.01295045045
61560,61588,63460,28,1872,2,36000,1.01495726496
61562,61593,63294,31,1701,2,36000,1.01822457378
61563,61598,63513,35,1915,2,36000,1.0182767624
61580,61604,63380,24,1776,2,36000,1.01351351351
61582,61609,63477,27,1868,2,36000,1.01445396146
61583,61615,63454,32,1839,2,36000,1.01740076128
61584,61620,63334,36,1714,2,36000,1.02100350058
61586,61625,63319,39,1694,2,36000,1.02302243211
61587,61641,63541,54,1900,2,36000,1.02842105263
61588,61647,63551,59,1904,2,36000,1.03098739496
61590,61653,63537,63,1884,2,36000,1.03343949045
61605,61631,63373,26,1742,2,36000,1.01492537313
61606,61636,63419,30,1783,2,36000,1.01682557487
61622,61664,63461,42,1797,2,36000,1.02337228715
61623,61670,63352,47,1682,2,36000,1.02794292509
61624,61675,64123,51,2448,2,36000,1.02083333333
61626,61658,62861,32,1203,2,36000,1.02660016625
61641,61686,63415,45,1729,2,36000,1.02602660497
61642,61697,63654,55,1957,2,36000,1.02810424119
61657,61707,63564,50,1857,2,36000,1.02692514809
61659,61713,63551,54,1838,2,36000,1.02937976061
61677,61719,63516,42,1797,2,36000,1.02337228715
61692,61729,63558,37,1829,2,36000,1.02022963368
61707,61734,63640,27,1906,2,36000,1.01416579224
61708,61740,63517,32,1777,2,36000,1.01800787845
61723,61749,63548,26,1799,2,36000,1.0144524736
61724,61755,63518,31,1763,2,36000,1.01758366421
61726,61770,63566,44,1796,2,36000,1.02449888641
61727,61775,63636,48,1861,2,36000,1.02579258463
61742,61784,63650,42,1866,2,36000,1.02250803859
61743,61790,63643,47,1853,2,36000,1.02536427415
61762,61795,63539,33,1744,2,36000,1.01892201835
61764,61801,63589,37,1788,2,36000,1.0206935123
61779,61807,63527,28,1720,2,36000,1.01627906977
61781,61812,63674,31,1862,2,36000,1.01664876477
61782,61818,63538,36,1720,2,36000,1.02093023256
61783,61824,63629,41,1805,2,36000,1.02271468144
61798,61830,63740,32,1910,2,36000,1.0167539267
61799,61838,63749,39,1911,2,36000,1.02040816327
61814,61845,63712,31,1867,2,36000,1.01660417783
61816,61851,63637,35,1786,2,36000,1.0195968645
61817,61857,63732,40,1875,2,36000,1.02133333333
61832,61863,63663,31,1800,2,36000,1.01722222222
61850,61869,63860,19,1991,2,36000,1.00954294324
61851,61874,63527,23,1653,2,36000,1.01391409558
61853,61879,63759,26,1880,2,36000,1.01382978723
61854,61886,63807,32,1921,2,36000,1.01665799063
61872,61891,63676,19,1785,2,36000,1.0106442577
61874,61896,63704,22,1808,2,36000,1.01216814159
61875,61902,63586,27,1684,2,36000,1.01603325416
61877,61907,63816,30,1909,2,36000,1.01571503405
61878,61913,63648,35,1735,2,36000,1.02017291066
61879,61918,63638,39,1720,2,36000,1.0226744186
61900,61924,63838,24,1914,2,36000,1.01253918495
61902,61929,64011,27,2082,2,36000,1.01296829971
61903,61935,63590,32,1655,2,36000,1.01933534743
61904,61941,63904,37,1963,2,36000,1.01884870097
61927,61947,63879,20,1932,2,36000,1.01035196687
61928,61953,63695,25,1742,2,36000,1.01435132032
61929,61959,63713,30,1754,2,36000,1.01710376283
61931,61967,63882,36,1915,2,36000,1.01879895561
61950,62013,63925,63,1912,2,36000,1.03294979079
61952,62037,63619,85,1582,2,36000,1.05372945638
61953,62043,63925,90,1882,2,36000,1.04782146652
61968,62082,64048,114,1966,2,36000,1.05798575788
62003,62088,63977,85,1889,2,36000,1.0449973531
62026,62108,64044,82,1936,2,36000,1.0423553719
62041,62135,64141,94,2006,2,36000,1.04685942173
62072,62149,63299,77,1150,2,36000,1.06695652174
62090,62166,64225,76,2059,2,36000,1.0369111219
62109,62185,63911,76,1726,2,36000,1.04403244496
62125,62204,64196,79,1992,2,36000,1.03965863454
62140,62223,64235,83,2012,2,36000,1.04125248509
62155,62318,64197,163,1879,2,36000,1.08674827036
62176,62358,64112,182,1754,2,36000,1.10376282782
62194,62364,64301,170,1937,2,36000,1.08776458441
62212,62406,64161,194,1755,2,36000,1.11054131054
62309,62411,64179,102,1768,2,36000,1.05769230769
62348,62417,64162,69,1745,2,36000,1.03954154728
62349,63004,64843,655,1839,2,36000,1.35617183252
62395,63125,65081,730,1956,2,36000,1.37321063395
62396,63155,65090,759,1935,2,36000,1.39224806202
62411,63170,65080,759,1910,2,36000,1.39738219895
62417,63119,63216,702,97,14,7980,8.23711340206
62551,63176,65038,625,1862,2,36000,1.33566058002
62863,63196,65074,333,1878,2,36000,1.17731629393
62915,63201,65184,286,1983,2,36000,1.14422592032
62987,63222,64904,235,1682,2,36000,1.13971462545
63002,63234,64941,232,1707,2,36000,1.13591095489
63047,63240,65162,193,1922,2,36000,1.10041623309
63108,63246,64670,138,1424,2,36000,1.09691011236
63110,63269,65308,159,2039,2,36000,1.07797940167
63125,63293,65124,168,1831,2,36000,1.09175314036
63146,63299,64554,153,1255,2,36000,1.1219123506
63161,63305,65189,144,1884,2,36000,1.07643312102
63176,63310,64996,134,1686,2,36000,1.07947805457
63191,63321,65066,130,1745,2,36000,1.07449856734
63193,63327,65224,134,1897,2,36000,1.07063784924
63207,63332,64537,125,1205,2,36000,1.10373443983
63212,63217,63226,5,9,1,900,1.4
63221,63228,63312,7,84,14,7980,1.08333333333
63222,63337,65424,115,2087,2,36000,1.05510301869
63237,63348,65147,111,1799,2,36000,1.06170094497
63239,63354,65116,115,1762,2,36000,1.06526674234
63258,63360,65203,102,1843,2,36000,1.05534454693
63283,63366,64669,83,1303,2,36000,1.06369915579
63298,63372,65086,74,1714,2,36000,1.04317386231
63299,63378,65253,79,1875,2,36000,1.04213333333
63300,63384,64998,84,1614,2,36000,1.05204460967
63302,63390,65196,88,1806,2,36000,1.04872646733
63303,63396,65279,93,1883,2,36000,1.04938927244
63310,63316,63326,6,10,1,900,1.6
63318,63419,65189,101,1770,2,36000,1.05706214689
63318,63343,63408,25,65,14,7980,1.38461538462
63320,63431,65228,111,1797,2,36000,1.06176961603
63321,63436,65163,115,1727,2,36000,1.06658946149
63322,63443,65281,121,1838,2,36000,1.06583242655
63340,63452,65404,112,1952,2,36000,1.05737704918
63356,63465,65215,109,1750,2,36000,1.06228571429
63371,63472,65445,101,1973,2,36000,1.05119107957
63373,63478,65141,105,1663,2,36000,1.06313890559
63388,63489,65334,101,1845,2,36000,1.05474254743
63389,63507,65378,118,1871,2,36000,1.06306787814
63391,63524,65341,133,1817,2,36000,1.07319757843
63406,63530,65383,124,1853,2,36000,1.06691851052
63406,63414,63440,8,26,1,900,1.30769230769
63415,63425,63648,10,223,14,7980,1.04484304933
63422,63535,65490,113,1955,2,36000,1.05780051151
63424,63541,65398,117,1857,2,36000,1.06300484653
63441,63547,65312,106,1765,2,36000,1.06005665722
63443,63552,65142,109,1590,2,36000,1.06855345912
63471,63559,65417,88,1858,2,36000,1.04736275565
63473,63564,65513,91,1949,2,36000,1.04669061057
63474,63569,65442,95,1873,2,36000,1.05072076882
63491,63575,65139,84,1564,2,36000,1.0537084399
63506,63580,65444,74,1864,2,36000,1.03969957082
63522,63586,65594,64,2008,2,36000,1.03187250996
63524,63591,65546,67,1955,2,36000,1.03427109974
63525,63597,64803,72,1206,2,36000,1.05970149254
63526,63602,65132,76,1530,2,36000,1.04967320261
63555,63607,65371,52,1764,2,36000,1.02947845805
63556,63613,65644,57,2031,2,36000,1.02806499261
63557,63618,65423,61,1805,2,36000,1.03379501385
63559,63624,65417,65,1793,2,36000,1.03625209147
63560,63630,65454,70,1824,2,36000,1.03837719298
63562,63640,65692,78,2052,2,36000,1.03801169591
63563,63648,65429,85,1781,2,36000,1.04772599663
63565,63653,65123,88,1470,2,36000,1.05986394558
63566,63664,64767,98,1103,2,36000,1.08884859474
63583,63670,65410,87,1740,2,36000,1.05
63585,63675,64994,90,1319,2,36000,1.06823351024
63586,63680,65550,94,1870,2,36000,1.05026737968
63604,63685,65419,81,1734,2,36000,1.04671280277
63605,63690,65493,85,1803,2,36000,1.04714364947
63607,63695,65690,88,1995,2,36000,1.04411027569
63624,63701,65450,77,1749,2,36000,1.04402515723
63640,63706,65496,66,1790,2,36000,1.03687150838
63641,63711,65265,70,1554,2,36000,1.04504504505
63643,63716,65560,73,1844,2,36000,1.03958785249
63644,63744,65560,100,1816,2,36000,1.0550660793
63645,63749,65362,104,1613,2,36000,1.06447613143
63646,63659,63672,13,13,1,900,2.0
63655,64172,64392,517,220,14,7980,3.35
63661,63722,65007,61,1285,2,36000,1.04747081712
63662,63728,65759,66,2031,2,36000,1.03249630724
63663,63733,65567,70,1834,2,36000,1.03816793893
63665,63738,65276,73,1538,2,36000,1.04746423927
63680,63755,65612,75,1857,2,36000,1.04038772213
63682,63761,65533,79,1772,2,36000,1.04458239278
63683,63770,65527,87,1757,2,36000,1.04951622083
63702,63818,64748,116,930,2,36000,1.1247311828
63719,63827,65762,108,1935,2,36000,1.05581395349
63720,63849,65877,129,2028,2,36000,1.06360946746
63721,63871,65667,150,1796,2,36000,1.08351893096
63736,63890,65664,154,1774,2,36000,1.08680947012
63752,63896,65440,144,1544,2,36000,1.0932642487
63753,63915,65825,162,1910,2,36000,1.08481675393
63769,63922,65735,153,1813,2,36000,1.08439051296
63808,63935,65569,127,1634,2,36000,1.07772337821
63823,63941,65885,118,1944,2,36000,1.06069958848
63841,63988,66103,147,2115,2,36000,1.0695035461
63862,64023,65930,161,1907,2,36000,1.08442579969
63880,64055,65703,175,1648,2,36000,1.10618932039
63895,64061,65912,166,1851,2,36000,1.08968125338
63911,64152,65980,241,1828,2,36000,1.1318380744
63912,64178,65313,266,1135,2,36000,1.23436123348
63928,64191,66100,263,1909,2,36000,1.13776846517
63929,64207,65936,278,1729,2,36000,1.16078658184
63979,64213,66170,234,1957,2,36000,1.11957077159
64013,64236,65906,223,1670,2,36000,1.13353293413
64046,64246,66105,200,1859,2,36000,1.10758472297
64061,64312,66040,251,1728,2,36000,1.14525462963
64115,64554,66229,439,1675,2,36000,1.26208955224
64130,64565,66465,435,1900,2,36000,1.22894736842
64145,64643,66508,498,1865,2,36000,1.26702412869
64163,64648,66566,485,1918,2,36000,1.25286757039
64165,64653,66397,488,1744,2,36000,1.27981651376
64180,64658,66398,478,1740,2,36000,1.27471264368
64198,64664,66675,466,2011,2,36000,1.2317255097
64199,64669,66556,470,1887,2,36000,1.24907260201
64227,64674,65964,447,1290,2,36000,1.34651162791
64243,64759,66880,516,2121,2,36000,1.243281471
64301,64854,66617,553,1763,2,36000,1.31366988088
64389,64549,64556,160,7,1,900,16.7
64397,64403,64632,6,229,14,7980,1.02620087336
64538,64915,66967,377,2052,2,36000,1.18372319688
64557,64953,66826,396,1873,2,36000,1.21142552056
64630,64636,64642,6,6,1,900,1.2
64639,65010,65232,371,222,14,7980,2.67117117117
64670,65018,66757,348,1739,2,36000,1.20011500863
64671,65049,66826,378,1777,2,36000,1.21271806415
64749,65079,66771,330,1692,2,36000,1.19503546099
64770,65085,66879,315,1794,2,36000,1.17558528428
64804,65091,66773,287,1682,2,36000,1.17063020214
64844,65097,66881,253,1784,2,36000,1.1418161435
64906,65102,66873,196,1771,2,36000,1.11067193676
64950,65108,66521,158,1413,2,36000,1.11181882519
64998,65128,66976,130,1848,2,36000,1.07034632035
64999,65134,66851,135,1717,2,36000,1.07862550961
65001,65140,66939,139,1799,2,36000,1.0772651473
65016,65146,67164,130,2018,2,36000,1.06442021804
65040,65152,66842,112,1690,2,36000,1.06627218935
65075,65157,66809,82,1652,2,36000,1.04963680387
65077,65163,66460,86,1297,2,36000,1.06630686199
65094,65168,66842,74,1674,2,36000,1.04420549582
65095,65174,67086,79,1912,2,36000,1.04131799163
65097,65180,66803,83,1623,2,36000,1.05113986445
65098,65195,66271,97,1076,2,36000,1.09014869888
65117,65201,66999,84,1798,2,36000,1.0467185762
65132,65206,67050,74,1844,2,36000,1.04013015184
65134,65212,67077,78,1865,2,36000,1.0418230563
65135,65218,67210,83,1992,2,36000,1.04166666667
65155,65226,67057,71,1831,2,36000,1.0387766248
65156,65241,66962,85,1721,2,36000,1.0493898896
65158,65252,67084,94,1832,2,36000,1.05131004367
65159,65265,67119,106,1854,2,36000,1.05717367853
65174,65276,67205,102,1929,2,36000,1.05287713841
65175,65287,67005,112,1718,2,36000,1.06519208382
65190,65293,67280,103,1987,2,36000,1.05183694011
65192,65298,67200,106,1902,2,36000,1.05573080967
65193,65319,67224,126,1905,2,36000,1.06614173228
65208,65325,67095,117,1770,2,36000,1.06610169492
65209,65330,67101,121,1771,2,36000,1.06832298137
65225,65346,67237,121,1891,2,36000,1.0639873083
65226,65352,67191,126,1839,2,36000,1.06851549755
65229,65236,65247,7,11,1,900,1.63636363636
65240,65247,65467,7,220,14,7980,1.03181818182
65242,65373,67090,131,1717,2,36000,1.07629586488
65260,65382,67241,122,1859,2,36000,1.06562668101
65276,65389,67481,113,2092,2,36000,1.05401529637
65277,65395,67269,118,1874,2,36000,1.06296691569
65293,65410,67161,117,1751,2,36000,1.06681896059
65294,65416,67454,122,2038,2,36000,1.0598626104
65309,65422,67425,113,2003,2,36000,1.05641537693
65324,65428,67280,104,1852,2,36000,1.05615550756
65326,65433,67319,107,1886,2,36000,1.05673382821
65341,65439,67318,98,1879,2,36000,1.05215540181
65342,65444,67225,102,1781,2,36000,1.05727119596
65364,65450,67174,86,1724,2,36000,1.04988399072
65379,65456,67167,77,1711,2,36000,1.04500292227
65380,65461,67031,81,1570,2,36000,1.05159235669
65395,65466,67307,71,1841,2,36000,1.03856599674
65412,65471,67390,59,1919,2,36000,1.03074517978
65414,65477,67131,63,1654,2,36000,1.03808948005
65415,65494,67202,79,1708,2,36000,1.0462529274
65437,65499,67487,62,1988,2,36000,1.03118712274
65439,65505,67247,66,1742,2,36000,1.03788748565
65440,65510,67251,70,1741,2,36000,1.04020677771
65442,65517,66981,75,1464,2,36000,1.0512295082
65443,65524,67455,81,1931,2,36000,1.04194717763
65445,65538,67417,93,1879,2,36000,1.04949441192
65461,65545,67320,84,1775,2,36000,1.04732394366
65462,65557,67262,95,1705,2,36000,1.05571847507
65464,65563,67213,99,1650,2,36000,1.06
65465,65489,65496,24,7,1,900,3.1
65465,65570,67517,105,1947,2,36000,1.05392912173
65466,65576,67401,110,1825,2,36000,1.0602739726
65468,65582,67492,114,1910,2,36000,1.05968586387
65473,65483,65710,10,227,14,7980,1.04405286344
65492,65587,67232,95,1645,2,36000,1.05775075988
65508,65605,67597,97,1992,2,36000,1.04869477912
65509,65624,67082,115,1458,2,36000,1.07887517147
65524,65655,67541,131,1886,2,36000,1.06945917285
65539,65675,67575,136,1900,2,36000,1.07157894737
65540,65681,67590,141,1909,2,36000,1.07386066003
65555,65701,67671,146,1970,2,36000,1.07411167513
65557,65707,67585,150,1878,2,36000,1.07987220447
65573,65715,67566,142,1851,2,36000,1.07671528903
65574,65726,67558,152,1832,2,36000,1.08296943231
65575,65732,67477,157,1745,2,36000,1.0899713467
65577,65737,67670,160,1933,2,36000,1.08277289188
65595,65742,67840,147,2098,2,36000,1.07006673022
65613,65747,67418,134,1671,2,36000,1.08019150209
65647,65752,67504,105,1752,2,36000,1.05993150685
65662,65758,67748,96,1990,2,36000,1.04824120603
65678,65771,67192,93,1421,2,36000,1.0654468684
65695,65777,67535,82,1758,2,36000,1.04664391354
65696,65888,67652,192,1764,2,36000,1.10884353741
65706,65721,65737,15,16,1,900,1.9375
65714,65896,67641,182,1745,2,36000,1.10429799427
65717,66472,66694,755,222,14,7980,4.4009009009
65735,65918,67705,183,1787,2,36000,1.10240626749
65760,65924,67954,164,2030,2,36000,1.08078817734
65775,65941,67608,166,1667,2,36000,1.09958008398
65827,65947,67720,120,1773,2,36000,1.06768189509
65878,65991,68320,113,2329,2,36000,1.04851867754
65893,66111,67901,218,1790,2,36000,1.1217877095
65908,66117,68081,209,1964,2,36000,1.10641547862
65923,66122,67919,199,1797,2,36000,1.11074012243
65938,66182,68116,244,1934,2,36000,1.12616339193
65940,66240,68104,300,1864,2,36000,1.16094420601
65964,66282,68164,318,1882,2,36000,1.16896918172
65982,66478,68280,496,1802,2,36000,1.27524972253
66042,66519,68299,477,1780,2,36000,1.26797752809
66103,66532,68395,429,1863,2,36000,1.23027375201
66104,66568,68536,464,1968,2,36000,1.23577235772
66120,66577,68505,457,1928,2,36000,1.23703319502
66172,66628,68348,456,1720,2,36000,1.26511627907
66230,66686,68547,456,1861,2,36000,1.245029554
66273,66705,68530,432,1825,2,36000,1.23671232877
66403,66710,68481,307,1771,2,36000,1.17334839074
66404,66716,68744,312,2028,2,36000,1.15384615385
66463,66721,68637,258,1916,2,36000,1.13465553236
66480,66726,68617,246,1891,2,36000,1.13008989952
66509,66731,68623,222,1892,2,36000,1.11733615222
66523,66736,68712,213,1976,2,36000,1.10779352227
66558,66821,68681,263,1860,2,36000,1.14139784946
66575,66858,68719,283,1861,2,36000,1.15206878023
66618,66864,68564,246,1700,2,36000,1.14470588235
66679,66891,68839,212,1948,2,36000,1.10882956879
66691,66697,66711,6,14,1,900,1.42857142857
66702,66853,67085,151,232,14,7980,1.65086206897
66758,66934,68695,176,1761,2,36000,1.09994321408
66773,66939,68671,166,1732,2,36000,1.09584295612
66774,66945,68644,171,1699,2,36000,1.10064743967
66805,66951,68760,146,1809,2,36000,1.08070757324
66820,66973,68714,153,1741,2,36000,1.08788052843
66835,66979,68764,144,1785,2,36000,1.08067226891
66836,66929,394400,93,327471,32,356400,1.00028399461
66837,66987,69034,150,2047,2,36000,1.07327796776
66856,66993,68847,137,1854,2,36000,1.07389428263
66857,67010,68784,153,1774,2,36000,1.08624577227
66859,67016,68766,157,1750,2,36000,1.08971428571
66878,67042,68816,164,1774,2,36000,1.0924464487
66896,67062,68883,166,1821,2,36000,1.09115870401
66897,67068,68930,171,1862,2,36000,1.09183673469
66899,67088,68778,189,1690,2,36000,1.11183431953
66940,67099,69261,159,2162,2,36000,1.07354301573
66963,67110,68960,147,1850,2,36000,1.07945945946
66978,67116,68869,138,1753,2,36000,1.07872219053
66980,67121,68891,141,1770,2,36000,1.07966101695
66997,67127,68697,130,1570,2,36000,1.08280254777
67013,67132,68830,119,1698,2,36000,1.07008244994
67014,67139,68964,125,1825,2,36000,1.06849315068
67032,67145,68563,113,1418,2,36000,1.07968970381
67053,67172,68925,119,1753,2,36000,1.06788362807
67068,67178,69019,110,1841,2,36000,1.0597501358
67083,67094,67100,11,6,1,900,1.7
67084,67183,68846,99,1663,2,36000,1.05953096813
67085,67189,69024,104,1835,2,36000,1.05667574932
67086,67202,69168,116,1966,2,36000,1.05900305188
67093,67105,67347,12,242,14,7980,1.04958677686
67103,67208,69154,105,1946,2,36000,1.05395683453
67104,67214,69031,110,1817,2,36000,1.06053935058
67105,67224,69043,119,1819,2,36000,1.06542056075
67106,67230,69020,124,1790,2,36000,1.06927374302
67122,67236,68911,114,1675,2,36000,1.06805970149
67137,67241,69189,104,1948,2,36000,1.05338809035
67161,67247,69197,86,1950,2,36000,1.0441025641
67177,67252,69043,75,1791,2,36000,1.0418760469
67178,67257,68917,79,1660,2,36000,1.04759036145
67179,67264,68994,85,1730,2,36000,1.04913294798
67194,67269,69030,75,1761,2,36000,1.04258943782
67196,67275,69105,79,1830,2,36000,1.04316939891
67212,67280,68874,68,1594,2,36000,1.04265997491
67213,67286,68755,73,1469,2,36000,1.04969366916
67214,67291,69103,77,1812,2,36000,1.04249448124
67216,67298,69040,82,1742,2,36000,1.04707233065
67232,67303,69259,71,1956,2,36000,1.03629856851
67233,67318,69071,85,1753,2,36000,1.04848830576
67234,67328,68618,94,1290,2,36000,1.07286821705
67236,67335,69003,99,1668,2,36000,1.05935251799
67252,67340,69109,88,1769,2,36000,1.04974561899
67253,67358,69093,105,1735,2,36000,1.06051873199
67254,67363,69138,109,1775,2,36000,1.0614084507
67256,67369,69118,113,1749,2,36000,1.06460834763
67271,67374,69135,103,1761,2,36000,1.05848949461
67273,67379,69281,106,1902,2,36000,1.05573080967
67288,67384,69276,96,1892,2,36000,1.05073995772
67289,67389,69473,100,2084,2,36000,1.04798464491
67307,67402,69614,95,2212,2,36000,1.04294755877
67322,67413,69473,91,2060,2,36000,1.04417475728
67324,67429,69367,105,1938,2,36000,1.05417956656
67325,67489,69261,164,1772,2,36000,1.09255079007
67345,67351,67359,6,8,1,900,1.4
67353,67570,67790,217,220,14,7980,1.98636363636
67392,67499,68757,107,1258,2,36000,1.08505564388
67407,67505,69239,98,1734,2,36000,1.05651672434
67423,67528,69482,105,1954,2,36000,1.05373592631
67424,67546,69366,122,1820,2,36000,1.06703296703
67439,67552,69360,113,1808,2,36000,1.0625
67457,67577,69361,120,1784,2,36000,1.06726457399
67458,67586,69407,128,1821,2,36000,1.07029104887
67479,67596,69593,117,1997,2,36000,1.05858788182
67495,67602,69407,107,1805,2,36000,1.05927977839
67497,67608,69290,111,1682,2,36000,1.06599286564
67498,67619,69486,121,1867,2,36000,1.06480985538
67513,67652,69485,139,1833,2,36000,1.07583196945
67528,67663,69481,135,1818,2,36000,1.07425742574
67544,67681,69100,137,1419,2,36000,1.09654686399
67545,67687,69518,142,1831,2,36000,1.07755324959
67560,67716,69434,156,1718,2,36000,1.0908032596
67576,67731,69632,155,1901,2,36000,1.08153603367
67577,67760,69650,183,1890,2,36000,1.09682539683
67592,67806,69479,214,1673,2,36000,1.12791392708
67594,67811,69715,217,1904,2,36000,1.11397058824
67609,67817,69577,208,1760,2,36000,1.11818181818
67611,67822,69570,211,1748,2,36000,1.12070938215
67641,67827,69575,186,1748,2,36000,1.10640732265
67656,67832,69655,176,1823,2,36000,1.09654415798
67672,67837,69632,165,1795,2,36000,1.09192200557
67673,67931,69816,258,1885,2,36000,1.13687002653
67709,67965,69843,256,1878,2,36000,1.13631522897
67725,68114,70041,389,1927,2,36000,1.20186818889
67749,68128,70190,379,2062,2,36000,1.18380213385
67787,67801,67813,14,12,1,900,2.16666666667
67796,68516,68668,720,152,14,7980,5.73684210526
67841,68291,70205,450,1914,2,36000,1.23510971787
67904,68310,70152,406,1842,2,36000,1.22041259501
67923,68331,70240,408,1909,2,36000,1.21372446307
67958,68359,70241,401,1882,2,36000,1.21307120085
68084,68541,70355,457,1814,2,36000,1.25192943771
68108,68548,70422,440,1874,2,36000,1.23479188901
68124,68559,70537,435,1978,2,36000,1.21991911021
68168,68575,70379,407,1804,2,36000,1.2256097561
68281,68580,69929,299,1349,2,36000,1.22164566345
68299,68629,69829,330,1200,2,36000,1.275
68323,68634,70658,311,2024,2,36000,1.15365612648
68350,68640,70396,290,1756,2,36000,1.16514806378
68398,68648,70490,250,1842,2,36000,1.13572204126
68481,68655,70541,174,1886,2,36000,1.09225874867
68505,68679,70462,174,1783,2,36000,1.09758833427
68532,68684,70443,152,1759,2,36000,1.08641273451
68547,68689,70614,142,1925,2,36000,1.07376623377
68549,68695,70539,146,1844,2,36000,1.07917570499
68564,68700,70742,136,2042,2,36000,1.0666013712
68565,68705,70656,140,1951,2,36000,1.07175807278
68618,68710,70638,92,1928,2,36000,1.04771784232
68619,68723,70782,104,2059,2,36000,1.05050995629
68634,68729,70645,95,1916,2,36000,1.04958246347
68649,68735,70602,86,1867,2,36000,1.046063203
68650,68768,70372,118,1604,2,36000,1.07356608479
68666,68672,68679,6,7,1,900,1.3
68672,68779,70664,107,1885,2,36000,1.05676392573
68674,68774,69040,100,266,14,7980,1.37593984962
68687,68785,70627,98,1842,2,36000,1.05320304017
68703,68791,70667,88,1876,2,36000,1.04690831557
68704,68797,70740,93,1943,2,36000,1.04786412764
68719,68827,70569,108,1742,2,36000,1.06199770379
68720,68841,70538,121,1697,2,36000,1.07130229817
68722,68850,70659,128,1809,2,36000,1.07075732449
68746,68857,70610,111,1753,2,36000,1.06332002282
68762,68863,70610,101,1747,2,36000,1.05781339439
68763,68880,70597,117,1717,2,36000,1.06814210833
68765,68886,70505,121,1619,2,36000,1.07473749228
68780,68894,70848,114,1954,2,36000,1.05834186285
68781,68902,70771,121,1869,2,36000,1.06474050294
68783,68922,70691,139,1769,2,36000,1.07857546637
68798,68929,70585,131,1656,2,36000,1.07910628019
68819,68936,70986,117,2050,2,36000,1.05707317073
68834,68942,70807,108,1865,2,36000,1.05790884718
68849,68972,70955,123,1983,2,36000,1.06202723147
68850,68978,70532,128,1554,2,36000,1.08236808237
68852,69006,70952,154,1946,2,36000,1.07913669065
68870,69014,70841,144,1827,2,36000,1.07881773399
68884,69030,70957,146,1927,2,36000,1.07576543851
68886,69036,70887,150,1851,2,36000,1.08103727715
68901,69041,70261,140,1220,2,36000,1.11475409836
68916,69052,70669,136,1617,2,36000,1.08410636982
68932,69058,71010,126,1952,2,36000,1.06454918033
68933,69063,71297,130,2234,2,36000,1.0581915846
68934,69075,70896,141,1821,2,36000,1.07742998353
68962,69080,71001,118,1921,2,36000,1.06142634045
68979,69085,70615,106,1530,2,36000,1.06928104575
68997,69091,71006,94,1915,2,36000,1.04908616188
69013,69104,70961,91,1857,2,36000,1.04900376952
69031,69111,70961,80,1850,2,36000,1.04324324324
69032,69117,70875,85,1758,2,36000,1.04835039818
69033,69122,71059,89,1937,2,36000,1.04594734125
69035,69128,70844,93,1716,2,36000,1.0541958042
69036,69134,70845,98,1711,2,36000,1.05727644652
69037,69047,69055,10,8,1,900,1.8
69037,69147,71160,110,2013,2,36000,1.05464480874
69046,69069,69288,23,219,14,7980,1.10502283105
69054,69153,70582,99,1429,2,36000,1.06927921624
69055,69165,71647,110,2482,2,36000,1.0443190975
69056,69179,70920,123,1741,2,36000,1.07064905227
69071,69200,71023,129,1823,2,36000,1.07076247943
69097,69208,70862,111,1654,2,36000,1.06711003628
69117,69250,70883,133,1633,2,36000,1.0814451929
69119,69270,71233,151,1963,2,36000,1.07692307692
69120,69276,71245,156,1969,2,36000,1.07922803454
69121,69281,71090,160,1809,2,36000,1.08844665561
69123,69287,71201,164,1914,2,36000,1.08568443051
69142,69298,71260,156,1962,2,36000,1.07951070336
69144,69309,71167,165,1858,2,36000,1.08880516685
69158,69371,70999,213,1628,2,36000,1.13083538084
69174,69377,71284,203,1907,2,36000,1.10644992134
69192,69382,71194,190,1812,2,36000,1.10485651214
69207,69388,71331,181,1943,2,36000,1.09315491508
69241,69418,71124,177,1706,2,36000,1.10375146542
69261,69439,71325,178,1886,2,36000,1.09437963945
69262,69451,71306,189,1855,2,36000,1.10188679245
69263,69485,71123,222,1638,2,36000,1.13553113553
69279,69490,71240,211,1750,2,36000,1.12057142857
69285,69293,69301,8,8,1,900,1.6
69294,69304,69564,10,260,14,7980,1.03846153846
69295,69496,71284,201,1788,2,36000,1.11241610738
69296,69501,71316,205,1815,2,36000,1.1129476584
69362,69507,71261,145,1754,2,36000,1.082668187
69363,69512,71350,149,1838,2,36000,1.0810663765
69379,69518,71422,139,1904,2,36000,1.07300420168
69380,69529,71178,149,1649,2,36000,1.0903577926
69468,69580,71339,112,1759,2,36000,1.06367254122
69469,69586,71384,117,1798,2,36000,1.06507230256
69470,69591,71521,121,1930,2,36000,1.06269430052
69505,69596,71482,91,1886,2,36000,1.04825026511
69507,69601,71427,94,1826,2,36000,1.05147864184
69508,69606,71430,98,1824,2,36000,1.05372807018
69509,69611,71481,102,1870,2,36000,1.05454545455
69511,69618,71524,107,1906,2,36000,1.05613850997
69512,69625,71475,113,1850,2,36000,1.06108108108
69513,69643,71687,130,2044,2,36000,1.06360078278
69534,69661,71412,127,1751,2,36000,1.07252998287
69558,69575,69606,17,31,1,900,1.54838709677
69570,69840,70082,270,242,14,7980,2.11570247934
69575,69827,71703,252,1876,2,36000,1.13432835821
69576,69855,71707,279,1852,2,36000,1.15064794816
69599,69940,71834,341,1894,2,36000,1.18004223865
69601,70052,72089,451,2037,2,36000,1.22140402553
69616,70098,71858,482,1760,2,36000,1.27386363636
69632,70103,71877,471,1774,2,36000,1.26550169109
69633,70109,72026,476,1917,2,36000,1.24830464267
69652,70114,72055,462,1941,2,36000,1.23802163833
69668,70119,71621,451,1502,2,36000,1.30026631158
69717,70124,71802,407,1678,2,36000,1.24255065554
69819,70129,71855,310,1726,2,36000,1.17960602549
69840,70217,72060,377,1843,2,36000,1.20455778622
69856,70250,72046,394,1796,2,36000,1.21937639198
69930,70273,71739,343,1466,2,36000,1.23396998636
70042,70384,72095,342,1711,2,36000,1.19988310929
70080,70093,70101,13,8,1,900,2.1
70088,70517,70740,429,223,14,7980,2.92376681614
70153,70391,72205,238,1814,2,36000,1.13120176406
70192,70407,72284,215,1877,2,36000,1.11454448588
70208,70433,71925,225,1492,2,36000,1.15080428954
70242,70454,72304,212,1850,2,36000,1.11459459459
70243,70543,72543,300,2000,2,36000,1.15
70262,70549,72423,287,1874,2,36000,1.15314834578
70357,70554,72200,197,1646,2,36000,1.11968408262
70375,70561,72389,186,1828,2,36000,1.10175054705
70390,70566,72337,176,1771,2,36000,1.09937888199
70405,70580,72349,175,1769,2,36000,1.09892594686
70424,70594,72396,170,1802,2,36000,1.09433962264
70445,70600,72238,155,1638,2,36000,1.09462759463
70463,70609,72487,146,1878,2,36000,1.07774227902
70491,70615,72368,124,1753,2,36000,1.07073588135
70509,70621,72186,112,1565,2,36000,1.07156549521
70535,70626,72463,91,1837,2,36000,1.04953728906
70553,70632,72431,79,1799,2,36000,1.04391328516
70554,70637,72366,83,1729,2,36000,1.04800462695
70556,70643,72515,87,1872,2,36000,1.04647435897
70557,70649,71633,92,984,2,36000,1.09349593496
70572,70656,72359,84,1703,2,36000,1.04932472108
70590,70667,72437,77,1770,2,36000,1.04350282486
70591,70673,72538,82,1865,2,36000,1.04396782842
70607,70678,72728,71,2050,2,36000,1.03463414634
70608,70684,71843,76,1159,2,36000,1.06557377049
70626,70689,72489,63,1800,2,36000,1.035
70627,70695,72475,68,1780,2,36000,1.03820224719
70628,70702,72517,74,1815,2,36000,1.04077134986
70630,70757,72399,127,1642,2,36000,1.07734470158
70647,70764,72572,117,1808,2,36000,1.06471238938
70650,70782,72360,132,1578,2,36000,1.08365019011
70651,70793,72412,142,1619,2,36000,1.08770846201
70675,70818,72643,143,1825,2,36000,1.07835616438
70676,70852,72595,176,1743,2,36000,1.10097532989
70677,70858,72655,181,1797,2,36000,1.10072342794
70679,70863,72413,184,1550,2,36000,1.11870967742
70680,70869,72717,189,1848,2,36000,1.10227272727
70681,70875,72639,194,1764,2,36000,1.10997732426
70700,70887,72790,187,1903,2,36000,1.09826589595
70737,70743,70751,6,8,1,900,1.4
70742,70894,71893,152,999,2,36000,1.15215215215
70744,70900,72929,156,2029,2,36000,1.07688516511
70746,70752,70982,6,230,14,7980,1.02608695652
70772,70907,72805,135,1898,2,36000,1.07112750263
70787,70931,72837,144,1906,2,36000,1.07555089192
70808,70963,72742,155,1779,2,36000,1.08712759978
70841,70969,72799,128,1830,2,36000,1.06994535519
70857,70974,72760,117,1786,2,36000,1.06550951848
70858,70980,72706,122,1726,2,36000,1.07068366165
70860,70985,72905,125,1920,2,36000,1.06510416667
70877,70997,72652,120,1655,2,36000,1.07250755287
70878,71007,72719,129,1712,2,36000,1.07535046729
70897,71013,72924,116,1911,2,36000,1.06070120356
70898,71018,73053,120,2035,2,36000,1.05896805897
70899,71023,72887,124,1864,2,36000,1.06652360515
70921,71028,72834,107,1806,2,36000,1.0592469546
70952,71033,72834,81,1801,2,36000,1.04497501388
70967,71045,72743,78,1698,2,36000,1.04593639576
70969,71050,72874,81,1824,2,36000,1.04440789474
70970,71101,72998,131,1897,2,36000,1.06905640485
70971,71134,73094,163,1960,2,36000,1.08316326531
70979,70992,71000,13,8,1,900,2.1
70987,71040,72954,53,1914,2,36000,1.0276907001
70988,71212,71449,224,237,14,7980,1.94514767932
71003,71140,72731,137,1591,2,36000,1.08610936518
71004,71172,73055,168,1883,2,36000,1.08921933086
71019,71205,73022,186,1817,2,36000,1.10236653825
71021,71244,73318,223,2074,2,36000,1.1075216972
71036,71252,72860,216,1608,2,36000,1.13432835821
71060,71258,73146,198,1888,2,36000,1.10487288136
71091,71272,72948,181,1676,2,36000,1.10799522673
71126,71278,73049,152,1771,2,36000,1.08582721626
71127,71295,73403,168,2108,2,36000,1.07969639469
71161,71300,73243,139,1943,2,36000,1.07153885744
71176,71308,73099,132,1791,2,36000,1.07370184255
71193,71317,73144,124,1827,2,36000,1.06787082649
71194,71327,73071,133,1744,2,36000,1.07626146789
71209,71336,73228,127,1892,2,36000,1.06712473573
71234,71343,73345,109,2002,2,36000,1.05444555445
71249,71350,73416,101,2066,2,36000,1.04888673766
71251,71361,73343,110,1982,2,36000,1.05549949546
71266,71396,73217,130,1821,2,36000,1.07138934651
71267,71424,73223,157,1799,2,36000,1.08727070595
71286,71434,73245,148,1811,2,36000,1.08172280508
71287,71440,73064,153,1624,2,36000,1.09421182266
71303,71446,73619,143,2173,2,36000,1.06580763921
71318,71460,73316,142,1856,2,36000,1.07650862069
71319,71465,73171,146,1706,2,36000,1.08558030481
71335,71471,73246,136,1775,2,36000,1.07661971831
71336,71476,73363,140,1887,2,36000,1.0741918389
71352,71481,73217,129,1736,2,36000,1.07430875576
71354,71486,73424,132,1938,2,36000,1.06811145511
71389,71491,73261,102,1770,2,36000,1.05762711864
71419,71497,73547,78,2050,2,36000,1.03804878049
71434,71535,73216,101,1681,2,36000,1.06008328376
71436,71644,73501,208,1857,2,36000,1.11200861605
71437,71658,73656,221,1998,2,36000,1.11061061061
71447,71453,71462,6,9,1,900,1.5
71456,71855,72089,399,234,14,7980,2.70512820513
71477,71698,73529,221,1831,2,36000,1.12069907155
71492,71714,73544,222,1830,2,36000,1.12131147541
71494,71750,73050,256,1300,2,36000,1.19692307692
71521,71845,73687,324,1842,2,36000,1.17589576547
71536,71866,73660,330,1794,2,36000,1.18394648829
71624,71872,73732,248,1860,2,36000,1.13333333333
71639,71888,73679,249,1791,2,36000,1.13902847571
71655,71904,73499,249,1595,2,36000,1.15611285266
71688,71936,73823,248,1887,2,36000,1.13142554319
71703,72038,73719,335,1681,2,36000,1.1992861392
71718,72057,73875,339,1818,2,36000,1.18646864686
71741,72066,74004,325,1938,2,36000,1.16769865841
71806,72072,73894,266,1822,2,36000,1.14599341383
71837,72105,73966,268,1861,2,36000,1.14400859753
71852,72111,73906,259,1795,2,36000,1.14428969359
71868,72116,73952,248,1836,2,36000,1.13507625272
71869,72121,73975,252,1854,2,36000,1.1359223301
71889,72126,73937,237,1811,2,36000,1.13086692435
71904,72131,74032,227,1901,2,36000,1.1194108364
71926,72136,73991,210,1855,2,36000,1.11320754717
72028,72143,74182,115,2039,2,36000,1.05640019617
72046,72216,74016,170,1800,2,36000,1.09444444444
72062,72249,73957,187,1708,2,36000,1.10948477752
72063,72296,74128,233,1832,2,36000,1.12718340611
72086,72100,72116,14,16,1,900,1.875
72090,72348,74046,258,1698,2,36000,1.1519434629
72095,72469,72686,374,217,14,7980,2.72350230415
72107,72360,73997,253,1637,2,36000,1.15455100794
72187,72370,74279,183,1909,2,36000,1.0958617077
72203,72376,74139,173,1763,2,36000,1.09812819058
72218,72382,74186,164,1804,2,36000,1.09090909091
72239,72387,74219,148,1832,2,36000,1.0807860262
72286,72400,74114,114,1714,2,36000,1.06651108518
72306,72407,74640,101,2233,2,36000,1.04523063144
72339,72413,73825,74,1412,2,36000,1.05240793201
72354,72423,74244,69,1821,2,36000,1.03789126853
72369,72429,74259,60,1830,2,36000,1.03278688525
72371,72475,74007,104,1532,2,36000,1.06788511749
72372,72486,74208,114,1722,2,36000,1.06620209059
72373,72499,73726,126,1227,2,36000,1.10268948655
72391,72505,74528,114,2023,2,36000,1.05635195255
72406,72527,74212,121,1685,2,36000,1.07181008902
72408,72532,74341,124,1809,2,36000,1.0685461581
72423,72549,74473,126,1924,2,36000,1.06548856549
72424,72555,74410,131,1855,2,36000,1.07061994609
72440,72583,74597,143,2014,2,36000,1.07100297915
72441,72606,74321,165,1715,2,36000,1.09620991254
72442,72651,74595,209,1944,2,36000,1.10751028807
72463,72657,74563,194,1906,2,36000,1.1017838405
72478,72663,74444,185,1781,2,36000,1.10387422796
72494,72669,74578,175,1909,2,36000,1.09167103195
72495,72702,74503,207,1801,2,36000,1.11493614659
72516,72708,74489,192,1781,2,36000,1.10780460415
72518,72713,74637,195,1924,2,36000,1.10135135135
72541,72718,74560,177,1842,2,36000,1.09609120521
72542,72723,73796,181,1073,2,36000,1.16868592731
72573,72728,74487,155,1759,2,36000,1.08811824901
72595,72733,73757,138,1024,2,36000,1.134765625
72640,72740,74507,100,1767,2,36000,1.05659309564
72655,72747,74609,92,1862,2,36000,1.04940923738
72657,72754,74568,97,1814,2,36000,1.05347298787
72658,72771,74625,113,1854,2,36000,1.06094929881
72684,72697,72703,13,6,1,900,1.9
72692,72816,73061,124,245,14,7980,1.50612244898
72706,72845,74826,139,1981,2,36000,1.07016658253
72721,72850,74393,129,1543,2,36000,1.08360337006
72723,72857,75256,134,2399,2,36000,1.05585660692
72738,72872,74606,134,1734,2,36000,1.07727797001
72740,72886,74588,146,1702,2,36000,1.08578143361
72756,72898,74798,142,1900,2,36000,1.07473684211
72758,72916,74791,158,1875,2,36000,1.08426666667
72773,72935,74682,162,1747,2,36000,1.09273039496
72791,72941,74306,150,1365,2,36000,1.10989010989
72806,72959,74730,153,1771,2,36000,1.086391869
72807,72965,75278,158,2313,2,36000,1.06830955469
72835,73009,74867,174,1858,2,36000,1.09364908504
72836,73033,74763,197,1730,2,36000,1.11387283237
72851,73060,74767,209,1707,2,36000,1.12243702402
72866,73066,74720,200,1654,2,36000,1.12091898428
72881,73071,75021,190,1950,2,36000,1.09743589744
72896,73076,75102,180,2026,2,36000,1.08884501481
72911,73083,74799,172,1716,2,36000,1.10023310023
72927,73088,74579,161,1491,2,36000,1.10798122066
72942,73093,74813,151,1720,2,36000,1.08779069767
72959,73099,74974,140,1875,2,36000,1.07466666667
72960,73104,74742,144,1638,2,36000,1.08791208791
73000,73109,74905,109,1796,2,36000,1.06069042316
73025,73114,74886,89,1772,2,36000,1.05022573363
73054,78203,78205,5149,2,2,3540,515.1
73055,73119,74905,64,1786,2,36000,1.03583426652
73056,73125,74877,69,1752,2,36000,1.03938356164
73057,73131,74939,74,1808,2,36000,1.04092920354
73059,73136,75008,77,1872,2,36000,1.04113247863
73075,73155,75090,80,1935,2,36000,1.04134366925
73076,73161,74880,85,1719,2,36000,1.04944735311
73094,73183,74956,89,1773,2,36000,1.05019740553
73110,73227,75031,117,1804,2,36000,1.06485587583
73149,73233,75033,84,1800,2,36000,1.04666666667
73150,73238,74928,88,1690,2,36000,1.05207100592
73172,73244,74969,72,1725,2,36000,1.04173913043
73218,73249,75069,31,1820,2,36000,1.01703296703
73219,73255,75034,36,1779,2,36000,1.02023608769
73220,73261,75089,41,1828,2,36000,1.02242888403
73222,73266,74983,44,1717,2,36000,1.02562609202
73242,73272,75119,30,1847,2,36000,1.0162425555
73259,73327,74549,68,1222,2,36000,1.05564648118
73261,73333,75432,72,2099,2,36000,1.03430204859
73262,73354,75296,92,1942,2,36000,1.0473738414
73277,73360,75254,83,1894,2,36000,1.04382259768
73319,73374,75345,55,1971,2,36000,1.02790461695
73320,73415,75195,95,1780,2,36000,1.05337078652
73345,73427,75461,82,2034,2,36000,1.04031465093
73360,73436,74793,76,1357,2,36000,1.05600589536
73375,73510,75425,135,1915,2,36000,1.07049608355
73406,73516,75505,110,1989,2,36000,1.05530417295
73424,73540,75394,116,1854,2,36000,1.06256742179
73425,73555,74446,130,891,2,36000,1.14590347924
73502,73561,75329,59,1768,2,36000,1.03337104072
73504,73630,75049,126,1419,2,36000,1.088794926
73531,73667,75565,136,1898,2,36000,1.07165437302
73546,73673,75438,127,1765,2,36000,1.07195467422
73561,73691,75397,130,1706,2,36000,1.07620164127
73620,73699,75373,79,1674,2,36000,1.04719235364
73657,73730,75012,73,1282,2,36000,1.05694227769
73673,73737,75590,64,1853,2,36000,1.03453858608
73689,73743,75401,54,1658,2,36000,1.03256936068
73690,73768,75575,78,1807,2,36000,1.04316546763
73721,73807,75713,86,1906,2,36000,1.04512067156
73737,73834,75859,97,2025,2,36000,1.04790123457
73738,73840,75781,102,1941,2,36000,1.05255023184
73757,73886,75829,129,1943,2,36000,1.06639217705
73797,73905,75703,108,1798,2,36000,1.06006674082
73826,73911,75881,85,1970,2,36000,1.04314720812
73827,73917,75776,90,1859,2,36000,1.04841312534
73877,73949,75817,72,1868,2,36000,1.03854389722
73895,73964,76014,69,2050,2,36000,1.03365853659
73911,73970,75055,59,1085,2,36000,1.05437788018
73938,73986,76145,48,2159,2,36000,1.02223251505
73954,73991,75807,37,1816,2,36000,1.02037444934
73970,74003,75903,33,1900,2,36000,1.01736842105
73971,74009,75819,38,1810,2,36000,1.02099447514
73986,74015,75963,29,1948,2,36000,1.01488706366
74003,74021,75975,18,1954,2,36000,1.00921187308
74004,74027,75741,23,1714,2,36000,1.01341890315
74021,74044,76087,23,2043,2,36000,1.01125795399
74022,74057,75860,35,1803,2,36000,1.01941209096
74023,74125,75814,102,1689,2,36000,1.06039076377
74038,74139,76090,101,1951,2,36000,1.05176832394
74054,74150,76012,96,1862,2,36000,1.05155746509
74116,74194,75880,78,1686,2,36000,1.0462633452
74131,74200,76001,69,1801,2,36000,1.03831204886
74146,74219,76019,73,1800,2,36000,1.04055555556
74183,74225,75934,42,1709,2,36000,1.02457577531
74199,74231,75971,32,1740,2,36000,1.0183908046
74215,74255,76058,40,1803,2,36000,1.02218524681
74216,74270,76164,54,1894,2,36000,1.02851108765
74232,74290,76447,58,2157,2,36000,1.02688919796
74247,74317,76364,70,2047,2,36000,1.03419638495
74262,74332,76107,70,1775,2,36000,1.03943661972
74281,74352,76127,71,1775,2,36000,1.04
74309,74404,76218,95,1814,2,36000,1.05237045204
74324,74422,76258,98,1836,2,36000,1.05337690632
74343,74455,76316,112,1861,2,36000,1.06018269747
74396,74461,76326,65,1865,2,36000,1.03485254692
74411,74485,75622,74,1137,2,36000,1.06508355321
74446,74498,76252,52,1754,2,36000,1.02964652223
74448,74504,76453,56,1949,2,36000,1.02873268343
74476,74515,76284,39,1769,2,36000,1.02204635387
74492,74521,76438,29,1917,2,36000,1.01512780386
74493,74539,76068,46,1529,2,36000,1.03008502289
74510,74560,76517,50,1957,2,36000,1.02554931017
74511,74571,76467,60,1896,2,36000,1.03164556962
74531,74577,76280,46,1703,2,36000,1.02701115678
74551,74583,76457,32,1874,2,36000,1.01707577375
74567,74589,76170,22,1581,2,36000,1.01391524352
74569,74595,76436,26,1841,2,36000,1.01412275937
74570,74601,76469,31,1868,2,36000,1.01659528908
74587,74607,76462,20,1855,2,36000,1.01078167116
74588,74613,76533,25,1920,2,36000,1.01302083333
74605,74619,76319,14,1700,2,36000,1.00823529412
74606,74625,76597,19,1972,2,36000,1.00963488844
74608,74636,76557,28,1921,2,36000,1.0145757418
74609,74648,76436,39,1788,2,36000,1.02181208054
74625,74654,76459,29,1805,2,36000,1.01606648199
74626,74693,76392,67,1699,2,36000,1.03943496174
74643,74731,76798,88,2067,2,36000,1.04257377842
74644,74741,76612,97,1871,2,36000,1.05184393373
74685,74754,76585,69,1831,2,36000,1.03768432551
74722,74774,76633,52,1859,2,36000,1.02797202797
74743,74780,76619,37,1839,2,36000,1.02011963023
74744,74802,76696,58,1894,2,36000,1.03062302006
74765,74808,76718,43,1910,2,36000,1.02251308901
74780,74814,76730,34,1916,2,36000,1.01774530271
74797,74819,76869,22,2050,2,36000,1.01073170732
74799,74826,76642,27,1816,2,36000,1.01486784141
74800,74837,76005,37,1168,2,36000,1.03167808219
74816,74879,76686,63,1807,2,36000,1.03486441616
74818,74888,76828,70,1940,2,36000,1.03608247423
74833,74894,76772,61,1878,2,36000,1.03248136315
74868,74900,76832,32,1932,2,36000,1.016563147
74890,74916,76670,26,1754,2,36000,1.01482326112
74891,74921,76742,30,1821,2,36000,1.01647446458
74892,74940,76801,48,1861,2,36000,1.02579258463
74910,74951,76658,41,1707,2,36000,1.02401874634
74912,74967,76699,55,1732,2,36000,1.0317551963
74932,74980,77023,48,2043,2,36000,1.0234948605
74948,74986,76810,38,1824,2,36000,1.02083333333
74962,74994,76660,32,1666,2,36000,1.01920768307
74979,75019,76748,40,1729,2,36000,1.02313475998
74980,75025,76784,45,1759,2,36000,1.02558271745
74995,75032,76827,37,1795,2,36000,1.02061281337
75011,75042,76966,31,1924,2,36000,1.01611226611
75027,75048,76961,21,1913,2,36000,1.01097752222
75029,75053,76818,24,1765,2,36000,1.01359773371
75045,75061,76803,16,1742,2,36000,1.00918484501
75046,75067,76952,21,1885,2,36000,1.01114058355
75047,75080,77065,33,1985,2,36000,1.01662468514
75063,75101,76309,38,1208,2,36000,1.03145695364
75065,75106,77112,41,2006,2,36000,1.02043868395
75080,75113,77007,33,1894,2,36000,1.01742344245
75098,75130,76935,32,1805,2,36000,1.01772853186
75099,75207,77172,108,1965,2,36000,1.05496183206
75114,75265,77210,151,1945,2,36000,1.07763496144
75130,75271,77259,141,1988,2,36000,1.07092555332
75191,75289,77409,98,2120,2,36000,1.04622641509
75255,75307,77133,52,1826,2,36000,1.02847754655
75271,75341,77359,70,2018,2,36000,1.03468780971
75286,75356,77173,70,1817,2,36000,1.03852504128
75301,75384,77360,83,1976,2,36000,1.04200404858
75332,75405,77336,73,1931,2,36000,1.0378042465
75347,75411,77129,64,1718,2,36000,1.03725261932
75375,75417,77301,42,1884,2,36000,1.02229299363
75397,75436,77369,39,1933,2,36000,1.0201758924
75398,75444,77427,46,1983,2,36000,1.023197176
75414,75450,77121,36,1671,2,36000,1.02154398564
75429,75473,77330,44,1857,2,36000,1.02369413032
75445,75516,77199,71,1683,2,36000,1.0421865716
75446,75575,77432,129,1857,2,36000,1.06946688207
75462,75586,77087,124,1501,2,36000,1.08261159227
75508,75602,77388,94,1786,2,36000,1.05263157895
75570,75633,77563,63,1930,2,36000,1.03264248705
75585,75714,77821,129,2107,2,36000,1.0612244898
75600,75725,77807,125,2082,2,36000,1.06003842459
75622,75752,77210,130,1458,2,36000,1.08916323731
75705,75787,77635,82,1848,2,36000,1.04437229437
75721,75793,77983,72,2190,2,36000,1.03287671233
75743,75819,76842,76,1023,2,36000,1.0742913001
75780,75825,77655,45,1830,2,36000,1.02459016393
75795,75831,77754,36,1923,2,36000,1.01872074883
75810,75836,77634,26,1798,2,36000,1.01446051168
75827,75842,77821,15,1979,2,36000,1.00757958565
75828,75870,77797,42,1927,2,36000,1.0217955371
75829,75876,77600,47,1724,2,36000,1.02726218097
75845,75891,77750,46,1859,2,36000,1.02474448628
75861,75897,77744,36,1847,2,36000,1.01949106659
75862,75914,77683,52,1769,2,36000,1.0293951385
75881,75945,77756,64,1811,2,36000,1.03533959139
75882,75974,77865,92,1891,2,36000,1.04865150714
75904,75982,77764,78,1782,2,36000,1.04377104377
75934,75988,77682,54,1694,2,36000,1.0318772137
75965,76013,77702,48,1689,2,36000,1.02841918295
75980,76019,77805,39,1786,2,36000,1.02183650616
75982,76025,77744,43,1719,2,36000,1.02501454334
76004,76030,77712,26,1682,2,36000,1.01545778835
76025,76037,77961,12,1924,2,36000,1.00623700624
76026,76069,78060,43,1991,2,36000,1.02159718734
76027,76079,77783,52,1704,2,36000,1.03051643192
76029,76098,77874,69,1776,2,36000,1.03885135135
76064,76104,77916,40,1812,2,36000,1.02207505519
76079,76118,78039,39,1921,2,36000,1.02030192608
76097,76139,78101,42,1962,2,36000,1.02140672783
76099,76156,77521,57,1365,2,36000,1.04175824176
76114,76175,77738,61,1563,2,36000,1.0390275112
76131,76181,77992,50,1811,2,36000,1.02760905577
76149,76229,78078,80,1849,2,36000,1.04326663061
76166,76263,77997,97,1734,2,36000,1.05594002307
76181,76269,77949,88,1680,2,36000,1.05238095238
76224,76291,78112,67,1821,2,36000,1.0367929709
76252,76297,78140,45,1843,2,36000,1.02441671188
76267,76320,78077,53,1757,2,36000,1.03016505407
76282,76327,78209,45,1882,2,36000,1.02391073326
76298,76333,78251,35,1918,2,36000,1.01824817518
76314,76339,78220,25,1881,2,36000,1.01329080276
76330,76375,78263,45,1888,2,36000,1.02383474576
76331,76403,78192,72,1789,2,36000,1.04024594746
76333,76447,78184,114,1737,2,36000,1.06563039724
76364,76452,78001,88,1549,2,36000,1.05681084571
76395,76458,78410,63,1952,2,36000,1.03227459016
76436,76463,78291,27,1828,2,36000,1.0147702407
76437,76470,77615,33,1145,2,36000,1.0288209607
76454,76475,78356,21,1881,2,36000,1.01116427432
76455,76480,78534,25,2054,2,36000,1.01217137293
76456,76486,78291,30,1805,2,36000,1.01662049861
76474,76491,78368,17,1877,2,36000,1.00905700586
76475,76497,78318,22,1821,2,36000,1.01208127403
76477,76528,78471,51,1943,2,36000,1.02624806999
76478,76544,78675,66,2131,2,36000,1.03097137494
76479,76568,78410,89,1842,2,36000,1.04831704669
76520,76597,78453,77,1856,2,36000,1.04148706897
76537,76608,78381,71,1773,2,36000,1.04004512126
76563,76623,78408,60,1785,2,36000,1.03361344538
76586,76631,78446,45,1815,2,36000,1.02479338843
76602,76644,78382,42,1738,2,36000,1.02416570771
76617,76653,78620,36,1967,2,36000,1.01830198271
76633,76670,78810,37,2140,2,36000,1.01728971963
76648,76676,78416,28,1740,2,36000,1.01609195402
76650,76682,78456,32,1774,2,36000,1.01803833145
76665,76698,78722,33,2024,2,36000,1.01630434783
76667,76707,78614,40,1907,2,36000,1.02097535396
76682,76713,78428,31,1715,2,36000,1.01807580175
76698,76729,78631,31,1902,2,36000,1.01629863302
76699,76742,78729,43,1987,2,36000,1.02164066432
76714,76753,78416,39,1663,2,36000,1.02345159351
76730,76759,78808,29,2049,2,36000,1.01415324549
76745,76783,78593,38,1810,2,36000,1.02099447514
76747,76795,78565,48,1770,2,36000,1.02711864407
76762,76809,78784,47,1975,2,36000,1.02379746835
76778,76815,78585,37,1770,2,36000,1.0209039548
76793,76820,78604,27,1784,2,36000,1.01513452915
76811,76827,78756,16,1929,2,36000,1.00829445308
76812,76833,78641,21,1808,2,36000,1.01161504425
76814,76839,78735,25,1896,2,36000,1.01318565401
76815,76844,78530,29,1686,2,36000,1.0172004745
76832,76850,78641,18,1791,2,36000,1.01005025126
76833,76856,78533,23,1677,2,36000,1.0137149672
76834,76880,78804,46,1924,2,36000,1.02390852391
76836,76946,78759,110,1813,2,36000,1.06067291782
76851,76963,78814,112,1851,2,36000,1.0605078336
76870,76972,78872,102,1900,2,36000,1.05368421053
76938,76978,78821,40,1843,2,36000,1.0217037439
76953,77018,78955,65,1937,2,36000,1.03355704698
76969,77033,78472,64,1439,2,36000,1.04447533009
76970,77076,78971,106,1895,2,36000,1.05593667546
77012,77098,78850,86,1752,2,36000,1.04908675799
77028,77123,78893,95,1770,2,36000,1.05367231638
77068,77133,78774,65,1641,2,36000,1.03960999391
77090,77140,78996,50,1856,2,36000,1.02693965517
77114,77146,78820,32,1674,2,36000,1.01911589008
77130,77185,78993,55,1808,2,36000,1.03042035398
77132,77190,79102,58,1912,2,36000,1.03033472803
77147,77210,79165,63,1955,2,36000,1.03222506394
77176,77221,79146,45,1925,2,36000,1.02337662338
77177,77226,78357,49,1131,2,36000,1.0433244916
77202,77232,79110,30,1878,2,36000,1.01597444089
77218,77270,79196,52,1926,2,36000,1.02699896158
77219,77312,79199,93,1887,2,36000,1.0492845787
77259,77341,79418,82,2077,2,36000,1.03948001926
77303,77347,79243,44,1896,2,36000,1.02320675105
77331,77370,79313,39,1943,2,36000,1.02007205353
77348,77376,79301,28,1925,2,36000,1.01454545455
77364,77382,79292,18,1910,2,36000,1.00942408377
77365,77399,78760,34,1361,2,36000,1.02498163115
77381,77420,79371,39,1951,2,36000,1.01998974885
77396,77438,79662,42,2224,2,36000,1.01888489209
77411,77444,79380,33,1936,2,36000,1.01704545455
77430,77533,79528,103,1995,2,36000,1.05162907268
77445,77574,79481,129,1907,2,36000,1.06764551652
77522,77611,79671,89,2060,2,36000,1.0432038835
77567,77627,79603,60,1976,2,36000,1.03036437247
77603,77645,79498,42,1853,2,36000,1.02266594711
77619,77651,79563,32,1912,2,36000,1.01673640167
77635,77666,79545,31,1879,2,36000,1.01649813731
77636,77693,79486,57,1793,2,36000,1.03179029559
77661,77699,79526,38,1827,2,36000,1.02079912425
77689,77714,79556,25,1842,2,36000,1.01357220413
77691,77724,79372,33,1648,2,36000,1.02002427184
77710,77749,79534,39,1785,2,36000,1.0218487395
77725,77755,79583,30,1828,2,36000,1.01641137856
77741,77760,79401,19,1641,2,36000,1.01157830591
77757,77767,79527,10,1760,2,36000,1.00568181818
77759,77772,79521,13,1749,2,36000,1.00743281875
77760,77795,79623,35,1828,2,36000,1.01914660832
77761,77778,79530,17,1752,2,36000,1.00970319635
77762,77783,79766,21,1983,2,36000,1.01059001513
77782,77808,79601,26,1793,2,36000,1.01450083659
77802,77816,79826,14,2010,2,36000,1.00696517413
77803,77822,79649,19,1827,2,36000,1.01039956212
77823,77831,79069,8,1238,2,36000,1.00646203554
77824,77837,79730,13,1893,2,36000,1.00686740623
77825,77877,79825,52,1948,2,36000,1.02669404517
77827,77886,79625,59,1739,2,36000,1.03392754457
77868,77928,79710,60,1782,2,36000,1.03367003367
77883,77960,79725,77,1765,2,36000,1.04362606232
77920,77972,79678,52,1706,2,36000,1.03048065651
77951,78003,79890,52,1887,2,36000,1.02755696873
77966,77994,79812,28,1818,2,36000,1.01540154015
77988,78009,79758,21,1749,2,36000,1.01200686106
78004,78015,79887,11,1872,2,36000,1.00587606838
78006,78050,79834,44,1784,2,36000,1.02466367713
78007,78071,80006,64,1935,2,36000,1.0330749354
78040,78088,79293,48,1205,2,36000,1.0398340249
78062,78093,79971,31,1878,2,36000,1.01650692226
78079,78113,79730,34,1617,2,36000,1.02102659246
78080,78123,80012,43,1889,2,36000,1.02276336686
78099,78151,79906,52,1755,2,36000,1.02962962963
78114,78196,79606,82,1410,2,36000,1.05815602837
78142,78232,80039,90,1807,2,36000,1.0498063088
78185,78263,80024,78,1761,2,36000,1.04429301533
78192,78483,78506,291,23,14,7980,13.652173913
78200,78302,80116,102,1814,2,36000,1.05622932745
78215,78330,80103,115,1773,2,36000,1.06486181613
78230,78368,79751,138,1383,2,36000,1.09978308026
78253,78392,80295,139,1903,2,36000,1.07304256437
78269,78398,79883,129,1485,2,36000,1.08686868687
78290,78419,80348,129,1929,2,36000,1.06687402799
78305,78425,80366,120,1941,2,36000,1.06182380216
78321,78430,80432,109,2002,2,36000,1.05444555445
78360,78436,80157,76,1721,2,36000,1.04416037188
78362,78441,80140,79,1699,2,36000,1.04649793996
78377,78447,80388,70,1941,2,36000,1.0360638846
78393,78457,80162,64,1705,2,36000,1.03753665689
78394,78464,80147,70,1683,2,36000,1.04159239453
78411,78470,80381,59,1911,2,36000,1.03087388802
78412,78488,80422,76,1934,2,36000,1.03929679421
78414,78518,80329,104,1811,2,36000,1.057426836
78431,78523,80459,92,1936,2,36000,1.04752066116
78432,78528,80327,96,1799,2,36000,1.05336297943
78433,78533,80355,100,1822,2,36000,1.05488474204
78449,78539,80497,90,1958,2,36000,1.04596527068
78465,78544,80375,79,1831,2,36000,1.04314582196
78466,78549,80419,83,1870,2,36000,1.04438502674
78483,78555,80363,72,1808,2,36000,1.03982300885
78484,78560,80579,76,2019,2,36000,1.03764239723
78531,78565,80447,34,1882,2,36000,1.01806588735
78547,78576,80397,29,1821,2,36000,1.01592531576
78548,78596,79748,48,1152,2,36000,1.04166666667
78566,78604,80043,38,1439,2,36000,1.02640722724
78585,78616,80341,31,1725,2,36000,1.01797101449
78600,78625,80574,25,1949,2,36000,1.01282709082
78616,78631,80611,15,1980,2,36000,1.00757575758
78617,78642,80466,25,1824,2,36000,1.01370614035
78633,78652,80427,19,1775,2,36000,1.01070422535
78634,78657,80444,23,1787,2,36000,1.01287073307
78650,78686,80566,36,1880,2,36000,1.01914893617
78651,78734,80633,83,1899,2,36000,1.04370721432
78676,78741,80697,65,1956,2,36000,1.03323108384
78725,78747,80876,22,2129,2,36000,1.0103334899
78742,78767,80614,25,1847,2,36000,1.01353546291
78743,78773,80590,30,1817,2,36000,1.01651073198
78758,78778,80649,20,1871,2,36000,1.01068947087
78777,78785,80673,8,1888,2,36000,1.00423728814
78778,78795,80766,17,1971,2,36000,1.00862506342
78779,78815,80818,36,2003,2,36000,1.01797304044
78799,78821,80628,22,1807,2,36000,1.01217487548
78823,78829,80707,6,1878,2,36000,1.00319488818
78824,78835,80687,11,1852,2,36000,1.00593952484
78825,78840,79958,15,1118,2,36000,1.01341681574
78826,78845,80905,19,2060,2,36000,1.00922330097
78828,78861,80732,33,1871,2,36000,1.01763762694
78829,78883,80559,54,1676,2,36000,1.03221957041
78851,78904,80747,53,1843,2,36000,1.02875746066
78873,78966,80973,93,2007,2,36000,1.04633781764
78891,78983,80926,92,1943,2,36000,1.0473494596
78959,79004,80969,45,1965,2,36000,1.02290076336
78974,79010,80699,36,1689,2,36000,1.02131438721
78996,79080,80716,84,1636,2,36000,1.05134474328
78998,79113,81022,115,1909,2,36000,1.06024096386
79070,79121,81015,51,1894,2,36000,1.02692713833
79108,79158,81094,50,1936,2,36000,1.02582644628
79123,79177,81071,54,1894,2,36000,1.02851108765
79148,79207,81089,59,1882,2,36000,1.03134962806
79166,79213,80875,47,1662,2,36000,1.02827918171
79197,79254,81221,57,1967,2,36000,1.0289781393
79214,79303,80347,89,1044,2,36000,1.08524904215
79245,79309,81110,64,1801,2,36000,1.03553581344
79296,79315,81131,19,1816,2,36000,1.01046255507
79297,79325,81205,28,1880,2,36000,1.01489361702
79313,79382,81318,69,1936,2,36000,1.03564049587
79314,79388,81326,74,1938,2,36000,1.03818369453
79377,79394,81416,17,2022,2,36000,1.00840751731
79378,79412,81088,34,1676,2,36000,1.02028639618
79396,79429,81239,33,1810,2,36000,1.0182320442
79413,79492,81611,79,2119,2,36000,1.03728173667
79430,79498,81298,68,1800,2,36000,1.03777777778
79483,79509,81232,26,1723,2,36000,1.01508995937
79498,79533,81370,35,1837,2,36000,1.01905280348
79499,79539,80842,40,1303,2,36000,1.03069838833
79529,79544,81296,15,1752,2,36000,1.00856164384
79530,79550,81515,20,1965,2,36000,1.01017811705
79531,79556,81317,25,1761,2,36000,1.01419647927
79533,79561,81175,28,1614,2,36000,1.01734820322
79550,79567,81372,17,1805,2,36000,1.00941828255
79551,79572,81201,21,1629,2,36000,1.01289134438
79552,79578,81406,26,1828,2,36000,1.01422319475
79568,79595,81325,27,1730,2,36000,1.01560693642
79570,79612,81349,42,1737,2,36000,1.02417962003
79586,79618,81577,32,1959,2,36000,1.01633486473
79602,79623,81218,21,1595,2,36000,1.0131661442
79603,79634,81532,31,1898,2,36000,1.01633298209
79622,79640,81543,18,1903,2,36000,1.00945874934
79639,79660,81514,21,1854,2,36000,1.01132686084
79640,79674,81679,34,2005,2,36000,1.01695760599
79656,79682,81660,26,1978,2,36000,1.0131445905
79672,79689,81494,17,1805,2,36000,1.00941828255
79673,79721,81390,48,1669,2,36000,1.02875973637
79689,79736,81455,47,1719,2,36000,1.0273414776
79713,79742,81639,29,1897,2,36000,1.01528729573
79728,79747,81554,19,1807,2,36000,1.01051466519
79744,79760,81627,16,1867,2,36000,1.00856989823
79745,79766,81752,21,1986,2,36000,1.01057401813
79761,79772,81470,11,1698,2,36000,1.00647820966
79762,79778,81515,16,1737,2,36000,1.00921128382
79763,79823,81614,60,1791,2,36000,1.03350083752
79779,79836,81732,57,1896,2,36000,1.03006329114
79813,79842,81549,29,1707,2,36000,1.01698886936
79829,79848,81223,19,1375,2,36000,1.01381818182
79830,79895,81617,65,1722,2,36000,1.03774680604
79845,79901,81455,56,1554,2,36000,1.03603603604
79885,79906,81749,21,1843,2,36000,1.01139446555
79901,79918,81832,17,1914,2,36000,1.00888192268
79903,79969,81870,66,1901,2,36000,1.03471856917
79918,79982,82047,64,2065,2,36000,1.03099273608
79958,80018,81550,60,1532,2,36000,1.03916449086
79973,80024,81886,51,1862,2,36000,1.02738990333
80007,80035,81433,28,1398,2,36000,1.0200286123
80023,80050,81787,27,1737,2,36000,1.01554404145
80039,80056,82035,17,1979,2,36000,1.00859019707
80041,80115,81977,74,1862,2,36000,1.03974221267
80057,80127,81789,70,1662,2,36000,1.0421179302
80109,80150,81893,41,1743,2,36000,1.02352266208
80130,80158,82047,28,1889,2,36000,1.01482265749
80145,80173,81902,28,1729,2,36000,1.01619433198
80161,80306,82334,145,2028,2,36000,1.07149901381
80162,80178,82229,16,2051,2,36000,1.00780107265
80178,80339,82328,161,1989,2,36000,1.08094519859
80298,80345,81996,47,1651,2,36000,1.0284675954
80329,80353,82071,24,1718,2,36000,1.01396973225
80331,80359,82279,28,1920,2,36000,1.01458333333
80357,80365,82125,8,1760,2,36000,1.00454545455
80358,80371,82547,13,2176,2,36000,1.00597426471
80360,80377,82036,17,1659,2,36000,1.01024713683
80361,80382,81359,21,977,2,36000,1.02149437052
80384,80391,82113,7,1722,2,36000,1.00406504065
80386,80397,82294,11,1897,2,36000,1.00579862941
80387,80403,82367,16,1964,2,36000,1.00814663951
80388,80409,82133,21,1724,2,36000,1.01218097448
80405,80431,82343,26,1912,2,36000,1.01359832636
80406,80437,82132,31,1695,2,36000,1.01828908555
80422,80442,82404,20,1962,2,36000,1.01019367992
80423,80449,82370,26,1921,2,36000,1.01353461739
80439,80455,82135,16,1680,2,36000,1.00952380952
80440,80461,82265,21,1804,2,36000,1.01164079823
80456,80470,82444,14,1974,2,36000,1.00709219858
80458,80478,82228,20,1750,2,36000,1.01142857143
80476,80509,81982,33,1473,2,36000,1.02240325866
80478,80570,82415,92,1845,2,36000,1.04986449864
80500,80577,82458,77,1881,2,36000,1.04093567251
80562,80585,82757,23,2172,2,36000,1.0105893186
80578,80591,82296,13,1705,2,36000,1.00762463343
80580,80602,82320,22,1718,2,36000,1.01280558789
80596,80623,82378,27,1755,2,36000,1.01538461538
80597,80629,82428,32,1799,2,36000,1.01778765981
80612,80639,82199,27,1560,2,36000,1.01730769231
80628,80645,82444,17,1799,2,36000,1.00944969427
80629,80660,82605,31,1945,2,36000,1.01593830334
80645,80684,82466,39,1782,2,36000,1.02188552189
80660,80699,82729,39,2030,2,36000,1.01921182266
80676,80708,82791,32,2083,2,36000,1.01536245799
80691,80714,82568,23,1854,2,36000,1.01240560949
80707,80720,82534,13,1814,2,36000,1.00716648291
80708,80727,82624,19,1897,2,36000,1.01001581444
80710,80744,82650,34,1906,2,36000,1.01783840504
80726,80758,81874,32,1116,2,36000,1.02867383513
80741,80777,82689,36,1912,2,36000,1.01882845188
80756,80829,82684,73,1855,2,36000,1.03935309973
80775,80853,82685,78,1832,2,36000,1.04257641921
80819,80886,82858,67,1972,2,36000,1.03397565923
80844,80892,82703,48,1811,2,36000,1.02650469354
80879,80916,83046,37,2130,2,36000,1.01737089202
80881,80937,82770,56,1833,2,36000,1.03055100927
80906,80980,82880,74,1900,2,36000,1.03894736842
80928,80986,82799,58,1813,2,36000,1.03199117485
80971,81026,82879,55,1853,2,36000,1.02968159741
80987,81034,82976,47,1942,2,36000,1.02420185376
81017,81082,82591,65,1509,2,36000,1.04307488403
81033,81099,82877,66,1778,2,36000,1.03712035996
81073,81105,83171,32,2066,2,36000,1.01548886738
81088,81110,82881,22,1771,2,36000,1.01242236025
81090,81121,83015,31,1894,2,36000,1.01636747624
81105,81142,83278,37,2136,2,36000,1.01732209738
81120,81186,82898,66,1712,2,36000,1.03855140187
81135,81212,82620,77,1408,2,36000,1.0546875
81175,81218,83070,43,1852,2,36000,1.02321814255
81200,81229,83263,29,2034,2,36000,1.01425762045
81216,81235,83117,19,1882,2,36000,1.01009564293
81232,81241,83390,9,2149,2,36000,1.00418799442
81233,81247,82869,14,1622,2,36000,1.00863131936
81234,81253,83081,19,1828,2,36000,1.01039387309
81250,81307,83190,57,1883,2,36000,1.0302708444
81251,81313,83032,62,1719,2,36000,1.03606748109
81297,81328,83229,31,1901,2,36000,1.01630720673
81313,81334,83313,21,1979,2,36000,1.01061141991
81329,81340,83218,11,1878,2,36000,1.00585729499
81331,81345,83024,14,1679,2,36000,1.00833829661
81332,81360,83297,28,1937,2,36000,1.01445534331
81333,81370,83162,37,1792,2,36000,1.02064732143
81352,81382,83194,30,1812,2,36000,1.01655629139
81368,81388,82403,20,1015,2,36000,1.0197044335
81383,81401,83264,18,1863,2,36000,1.00966183575
81385,81418,83637,33,2219,2,36000,1.01487156377
81400,81427,84112,27,2685,2,36000,1.01005586592
81415,81444,82544,29,1100,2,36000,1.02636363636
81431,81466,83327,35,1861,2,36000,1.01880709296
81447,81471,83413,24,1942,2,36000,1.01235839341
81462,81481,83271,19,1790,2,36000,1.01061452514
81464,81506,83328,42,1822,2,36000,1.02305159166
81482,81525,83493,43,1968,2,36000,1.0218495935
81498,81531,83408,33,1877,2,36000,1.01758124667
81524,81536,83313,12,1777,2,36000,1.00675295442
81525,81554,83375,29,1821,2,36000,1.01592531576
81526,81543,83216,17,1673,2,36000,1.01016138673
81544,81560,83331,16,1771,2,36000,1.00903444382
81545,81566,83226,21,1660,2,36000,1.01265060241
81563,81572,83482,9,1910,2,36000,1.00471204188
81564,81588,83334,24,1746,2,36000,1.01374570447
81566,81622,82831,56,1209,2,36000,1.04631927213
81581,81628,83484,47,1856,2,36000,1.02532327586
81612,81633,83404,21,1771,2,36000,1.01185770751
81628,81639,83491,11,1852,2,36000,1.00593952484
81629,81650,83355,21,1705,2,36000,1.01231671554
81630,81671,83504,41,1833,2,36000,1.02236770322
81646,81690,83603,44,1913,2,36000,1.02300052274
81661,81743,83743,82,2000,2,36000,1.041
81680,81761,83616,81,1855,2,36000,1.04366576819
81733,81767,83567,34,1800,2,36000,1.01888888889
81752,81798,83611,46,1813,2,36000,1.02537231109
81767,81804,83539,37,1735,2,36000,1.02132564841
81794,81843,83560,49,1717,2,36000,1.02853814793
81795,81881,83653,86,1772,2,36000,1.04853273138
81835,81887,83865,52,1978,2,36000,1.02628918099
81875,81898,83559,23,1661,2,36000,1.01384708007
81877,81904,83743,27,1839,2,36000,1.01468189233
81897,81914,83743,17,1829,2,36000,1.00929469656
81899,81988,83904,89,1916,2,36000,1.04645093946
81915,81994,83906,79,1912,2,36000,1.04131799163
81979,82007,83957,28,1950,2,36000,1.01435897436
81994,82046,84073,52,2027,2,36000,1.02565367538
82009,82052,83723,43,1671,2,36000,1.02573309396
82038,82059,83859,21,1800,2,36000,1.01166666667
82039,82064,83992,25,1928,2,36000,1.01296680498
82055,82082,83863,27,1781,2,36000,1.01516002246
82057,82124,84126,67,2002,2,36000,1.03346653347
82072,82136,83960,64,1824,2,36000,1.0350877193
82115,82144,84159,29,2015,2,36000,1.01439205955
82130,82149,84052,19,1903,2,36000,1.00998423542
82146,82155,83797,9,1642,2,36000,1.00548112058
82148,82210,84066,62,1856,2,36000,1.03340517241
82149,82239,84151,90,1912,2,36000,1.04707112971
82201,82245,84161,44,1916,2,36000,1.02296450939
82230,82276,84135,46,1859,2,36000,1.02474448628
82231,82291,84349,60,2058,2,36000,1.02915451895
82272,82305,84146,33,1841,2,36000,1.01792504074
82287,82311,84013,24,1702,2,36000,1.01410105758
82303,82331,83817,28,1486,2,36000,1.01884253028
82304,82339,84370,35,2031,2,36000,1.0172328902
82323,82345,84100,22,1755,2,36000,1.01253561254
82339,82355,84156,16,1801,2,36000,1.00888395336
82340,82378,84418,38,2040,2,36000,1.01862745098
82356,82384,84288,28,1904,2,36000,1.01470588235
82372,82390,84361,18,1971,2,36000,1.00913242009
82373,82414,84264,41,1850,2,36000,1.02216216216
82388,82420,84328,32,1908,2,36000,1.01677148847
82404,82426,84208,22,1782,2,36000,1.01234567901
82405,82439,84405,34,1966,2,36000,1.01729399797
82423,82455,84408,32,1953,2,36000,1.01638504864
82440,82460,84118,20,1658,2,36000,1.01206272618
82459,82470,84446,11,1976,2,36000,1.00556680162
82461,82477,84330,16,1853,2,36000,1.00863464652
82462,82545,84420,83,1875,2,36000,1.04426666667
82478,82556,84573,78,2017,2,36000,1.038671294
82534,82562,84643,28,2081,2,36000,1.01345506968
82550,82579,84449,29,1870,2,36000,1.01550802139
82551,82602,84463,51,1861,2,36000,1.02740462117
82571,82616,84554,45,1938,2,36000,1.02321981424
82593,82632,84334,39,1702,2,36000,1.02291421857
82608,82638,84557,30,1919,2,36000,1.01563314226
82623,82661,84466,38,1805,2,36000,1.02105263158
82639,82700,84750,61,2050,2,36000,1.02975609756
82655,82705,84615,50,1910,2,36000,1.02617801047
82687,82711,84684,24,1973,2,36000,1.01216421693
82689,82717,84572,28,1855,2,36000,1.01509433962
82708,82740,84545,32,1805,2,36000,1.01772853186
82709,82769,84749,60,1980,2,36000,1.0303030303
82731,82781,84516,50,1735,2,36000,1.0288184438
82758,82803,84751,45,1948,2,36000,1.02310061602
82774,82810,83986,36,1176,2,36000,1.0306122449
82792,82842,84702,50,1860,2,36000,1.02688172043
82808,82869,84523,61,1654,2,36000,1.03688029021
82833,82880,84676,47,1796,2,36000,1.02616926503
82860,82888,84711,28,1823,2,36000,1.01535929786
82876,82894,84870,18,1976,2,36000,1.00910931174
82877,82899,84757,22,1858,2,36000,1.01184068891
82893,82905,84760,12,1855,2,36000,1.0064690027
82895,82911,84879,16,1968,2,36000,1.0081300813
82896,82987,84990,91,2003,2,36000,1.04543185222
82911,83026,84082,115,1056,2,36000,1.10890151515
82977,83036,84789,59,1753,2,36000,1.03365658871
83015,83043,84648,28,1605,2,36000,1.01744548287
83031,83057,85097,26,2040,2,36000,1.01274509804
83046,83081,85128,35,2047,2,36000,1.01709819248
83047,83093,85126,46,2033,2,36000,1.02262666011
83075,83128,85245,53,2117,2,36000,1.02503542749
83090,83173,84985,83,1812,2,36000,1.04580573951
83118,83182,85195,64,2013,2,36000,1.03179334327
83166,83201,85078,35,1877,2,36000,1.01864677677
83181,83207,85074,26,1867,2,36000,1.01392608463
83197,83227,84998,30,1771,2,36000,1.01693958216
83198,83233,84936,35,1703,2,36000,1.02055196712
83217,83239,84419,22,1180,2,36000,1.0186440678
83233,83245,84874,12,1629,2,36000,1.0073664825
83234,83274,85099,40,1825,2,36000,1.02191780822
83236,83280,85000,44,1720,2,36000,1.02558139535
83267,83286,85112,19,1826,2,36000,1.01040525739
83268,83292,85134,24,1842,2,36000,1.01302931596
83284,83308,85294,24,1986,2,36000,1.01208459215
83285,83324,84612,39,1288,2,36000,1.03027950311
83301,83329,85192,28,1863,2,36000,1.01502952228
83316,83338,85337,22,1999,2,36000,1.01100550275
83317,83344,85227,27,1883,2,36000,1.01433882103
83334,83349,85093,15,1744,2,36000,1.00860091743
83335,83355,85209,20,1854,2,36000,1.01078748652
83336,83367,85414,31,2047,2,36000,1.01514411334
83338,83387,85099,49,1712,2,36000,1.02862149533
83357,83401,85325,44,1924,2,36000,1.02286902287
83380,83415,85092,35,1677,2,36000,1.02087060227
83397,83421,85234,24,1813,2,36000,1.01323772752
83416,83427,85114,11,1687,2,36000,1.0065204505
83417,83496,85263,79,1767,2,36000,1.04470854556
83418,83501,85436,83,1935,2,36000,1.04289405685
83486,83507,84765,21,1258,2,36000,1.01669316375
83487,83512,85013,25,1501,2,36000,1.01665556296
83503,83518,85327,15,1809,2,36000,1.00829187396
83505,83550,85495,45,1945,2,36000,1.02313624679
83506,83570,85628,64,2058,2,36000,1.03109815355
83540,83576,85339,36,1763,2,36000,1.02041973908
83562,83582,85658,20,2076,2,36000,1.00963391137
83564,83615,85448,51,1833,2,36000,1.02782324059
83582,83622,85413,40,1791,2,36000,1.02233389168
83603,83628,85418,25,1790,2,36000,1.01396648045
83619,83648,85491,29,1843,2,36000,1.01573521432
83620,83665,85627,45,1962,2,36000,1.02293577982
83639,83734,85505,95,1771,2,36000,1.05364201016
83654,83755,85838,101,2083,2,36000,1.04848775804
83725,83760,85524,35,1764,2,36000,1.01984126984
83745,83766,85570,21,1804,2,36000,1.01164079823
83747,83809,85559,62,1750,2,36000,1.03542857143
83748,83828,85655,80,1827,2,36000,1.04378762999
83801,83870,85700,69,1830,2,36000,1.03770491803
83819,83876,85695,57,1819,2,36000,1.03133589885
83859,83881,85490,22,1609,2,36000,1.01367308888
83874,83916,85778,42,1862,2,36000,1.02255639098
83876,83922,85675,46,1753,2,36000,1.02624073018
83907,83968,85440,61,1472,2,36000,1.04144021739
83908,83974,85857,66,1883,2,36000,1.03505045141
83959,84435,84437,476,2,2,3540,47.8
83959,83997,85753,38,1756,2,36000,1.02164009112
83961,84003,85513,42,1510,2,36000,1.02781456954
83989,84024,85823,35,1799,2,36000,1.01945525292
84004,84063,86064,59,2001,2,36000,1.02948525737
84019,84077,85865,58,1788,2,36000,1.03243847875
84054,84084,85946,30,1862,2,36000,1.01611170784
84071,84093,85520,22,1427,2,36000,1.01541695865
84088,84111,86095,23,1984,2,36000,1.01159274194
84089,84124,85888,35,1764,2,36000,1.01984126984
84105,84130,85870,25,1740,2,36000,1.01436781609
84120,84137,85893,17,1756,2,36000,1.00968109339
84122,84146,86002,24,1856,2,36000,1.01293103448
84137,84157,86087,20,1930,2,36000,1.0103626943
84138,84163,85973,25,1810,2,36000,1.0138121547
84154,84169,86034,15,1865,2,36000,1.00804289544
84155,84175,86120,20,1945,2,36000,1.01028277635
84171,84181,86036,10,1855,2,36000,1.00539083558
84173,84219,86069,46,1850,2,36000,1.02486486486
84174,84275,86320,101,2045,2,36000,1.04938875306
84211,84299,86191,88,1892,2,36000,1.04651162791
84270,84340,85670,70,1330,2,36000,1.05263157895
84289,84346,86092,57,1746,2,36000,1.03264604811
84330,84351,86178,21,1827,2,36000,1.01149425287
84345,84360,86051,15,1691,2,36000,1.00887049083
84346,84372,86236,26,1864,2,36000,1.01394849785
84363,84381,86077,18,1696,2,36000,1.01061320755
84364,84416,86316,52,1900,2,36000,1.02736842105
84380,84422,86330,42,1908,2,36000,1.02201257862
84405,84430,86350,25,1920,2,36000,1.01302083333
84428,84441,86274,13,1833,2,36000,1.00709219858
84430,84449,86047,19,1598,2,36000,1.01188986233
84431,84457,86527,26,2070,2,36000,1.01256038647
84432,84463,86235,31,1772,2,36000,1.01749435666
84447,84474,86322,27,1848,2,36000,1.01461038961
84463,84480,86243,17,1763,2,36000,1.00964265457
84465,84528,86244,63,1716,2,36000,1.03671328671
84480,84535,86281,55,1746,2,36000,1.03150057274
84517,84556,86508,39,1952,2,36000,1.0199795082
84533,84565,86352,32,1787,2,36000,1.01790710688
84548,84571,86425,23,1854,2,36000,1.01240560949
84563,84583,86728,20,2145,2,36000,1.00932400932
84565,84589,86487,24,1898,2,36000,1.01264488936
84580,84624,86454,44,1830,2,36000,1.02404371585
84581,84630,86579,49,1949,2,36000,1.025141098
84613,84655,86574,42,1919,2,36000,1.02188639917
84628,84661,86356,33,1695,2,36000,1.01946902655
84644,84687,86374,43,1687,2,36000,1.02548903379
84659,84696,86337,37,1641,2,36000,1.0225472273
84679,84713,86447,34,1734,2,36000,1.01960784314
84694,84723,86463,29,1740,2,36000,1.01666666667
84713,84760,86793,47,2033,2,36000,1.02311854402
84714,84766,86721,52,1955,2,36000,1.02659846547
84750,84771,86547,21,1776,2,36000,1.01182432432
84752,84777,86527,25,1750,2,36000,1.01428571429
84753,84782,86434,29,1652,2,36000,1.01755447942
84772,84789,86510,17,1721,2,36000,1.00987797792
84773,84801,86605,28,1804,2,36000,1.0155210643
84775,84881,86950,106,2069,2,36000,1.05123247946
84790,84887,86643,97,1756,2,36000,1.05523917995
84872,84893,86761,21,1868,2,36000,1.01124197002
84888,84947,86821,59,1874,2,36000,1.03148345784
84889,84996,86789,107,1793,2,36000,1.0596765198
84938,85002,86899,64,1897,2,36000,1.03373748023
84987,85009,86793,22,1784,2,36000,1.01233183857
85004,85015,86983,11,1968,2,36000,1.00558943089
85005,85024,86906,19,1882,2,36000,1.01009564293
85006,85085,86821,79,1736,2,36000,1.04550691244
85022,85091,87017,69,1926,2,36000,1.03582554517
85075,85104,86964,29,1860,2,36000,1.01559139785
85091,85109,86833,18,1724,2,36000,1.01044083527
85107,85115,86806,8,1691,2,36000,1.00473092844
85109,85120,86909,11,1789,2,36000,1.00614868642
85110,85127,86406,17,1279,2,36000,1.01329163409
85111,85132,86861,21,1729,2,36000,1.01214574899
85113,85137,87094,24,1957,2,36000,1.01226366888
85129,85143,86896,14,1753,2,36000,1.00798630918
85131,85148,86246,17,1098,2,36000,1.01548269581
85132,85155,86978,23,1823,2,36000,1.0126165661
85133,85204,86907,71,1703,2,36000,1.04169113329
85148,85210,87074,62,1864,2,36000,1.03326180258
85195,85220,86995,25,1775,2,36000,1.01408450704
85196,85238,87250,42,2012,2,36000,1.02087475149
85211,85245,87046,34,1801,2,36000,1.01887840089
85230,85256,86808,26,1552,2,36000,1.01675257732
85245,85274,87010,29,1736,2,36000,1.01670506912
85247,85305,87181,58,1876,2,36000,1.03091684435
85265,85336,87253,71,1917,2,36000,1.03703703704
85298,85342,87040,44,1698,2,36000,1.02591283863
85328,85348,87176,20,1828,2,36000,1.01094091904
85330,85354,87193,24,1839,2,36000,1.01305057096
85345,85425,87365,80,1940,2,36000,1.0412371134
85347,85430,87428,83,1998,2,36000,1.04154154154
85415,85436,87321,21,1885,2,36000,1.01114058355
85416,85448,87488,32,2040,2,36000,1.01568627451
85432,85454,87352,22,1898,2,36000,1.01159114858
85447,85460,87428,13,1968,2,36000,1.00660569106
85449,85501,87514,52,2013,2,36000,1.02583209141
85450,85507,87004,57,1497,2,36000,1.0380761523
85493,85512,87271,19,1759,2,36000,1.01080159181
85495,85518,87067,23,1549,2,36000,1.01484828922
85510,85524,87555,14,2031,2,36000,1.00689315608
85511,85531,87467,20,1936,2,36000,1.01033057851
85528,85537,87221,9,1684,2,36000,1.00534441805
85529,85570,87491,41,1921,2,36000,1.02134305049
85531,85581,87445,50,1864,2,36000,1.02682403433
85561,85638,87437,77,1799,2,36000,1.04280155642
85577,85644,87599,67,1955,2,36000,1.03427109974
85630,85666,87354,36,1688,2,36000,1.02132701422
85631,85672,87637,41,1965,2,36000,1.02086513995
85656,85681,87691,25,2010,2,36000,1.01243781095
85673,85687,87458,14,1771,2,36000,1.00790513834
85674,85706,87153,32,1447,2,36000,1.02211472011
85691,85712,87439,21,1727,2,36000,1.01215981471
85693,85765,87856,72,2091,2,36000,1.03443328551
85708,85789,87440,81,1651,2,36000,1.04906117505
85754,85834,87772,80,1938,2,36000,1.04127966976
85778,85849,87880,71,2031,2,36000,1.0349581487
85824,85868,87641,44,1773,2,36000,1.02481669487
85841,85876,87623,35,1747,2,36000,1.02003434459
85859,85882,87648,23,1766,2,36000,1.01302378256
85875,85899,87842,24,1943,2,36000,1.01235203294
85876,85905,87794,29,1889,2,36000,1.01535203812
85892,85957,87923,65,1966,2,36000,1.03306205493
85908,85985,87797,77,1812,2,36000,1.04249448124
85948,86013,87791,65,1778,2,36000,1.03655793026
85974,86045,87948,71,1903,2,36000,1.0373095113
86004,86051,87898,47,1847,2,36000,1.02544667028
86035,86062,87695,27,1633,2,36000,1.01653398653
86051,86067,87824,16,1757,2,36000,1.00910643142
86052,86075,88030,23,1955,2,36000,1.01176470588
86068,86081,87716,13,1635,2,36000,1.00795107034
86069,86088,88133,19,2045,2,36000,1.00929095355
86085,86098,87932,13,1834,2,36000,1.00708833152
86086,86104,87719,18,1615,2,36000,1.01114551084
86103,86110,87948,7,1838,2,36000,1.00380848749
86104,86131,88094,27,1963,2,36000,1.01375445746
86106,86189,88117,83,1928,2,36000,1.04304979253
86121,86203,88031,82,1828,2,36000,1.04485776805
86179,86246,87918,67,1672,2,36000,1.04007177033
86194,86252,88077,58,1825,2,36000,1.03178082192
86244,86258,88090,14,1832,2,36000,1.0076419214
86246,86263,88132,17,1869,2,36000,1.00909577314
86247,86269,87480,22,1211,2,36000,1.01816680429
86248,86285,88649,37,2364,2,36000,1.01565143824
86266,86292,88188,26,1896,2,36000,1.01371308017
86282,86328,88178,46,1850,2,36000,1.02486486486
86284,86334,88150,50,1816,2,36000,1.02753303965
86318,86339,88118,21,1779,2,36000,1.01180438449
86336,86346,88363,10,2017,2,36000,1.00495785821
86337,86352,88164,15,1812,2,36000,1.0082781457
86339,86361,88317,22,1956,2,36000,1.01124744376
86354,86372,88517,18,2145,2,36000,1.00839160839
86356,86367,87358,11,991,2,36000,1.01109989909
86357,86385,88256,28,1871,2,36000,1.01496525922
86373,86417,88374,44,1957,2,36000,1.02248339295
86390,86436,88291,46,1855,2,36000,1.02479784367
86411,86445,88279,34,1834,2,36000,1.0185387132
86427,86458,88305,31,1847,2,36000,1.01678397401
86442,86465,88363,23,1898,2,36000,1.01211801897
86458,86475,88102,17,1627,2,36000,1.01044867855
86459,86498,87731,39,1233,2,36000,1.03163017032
86475,86519,88590,44,2071,2,36000,1.02124577499
86490,86525,88406,35,1881,2,36000,1.01860712387
86512,86538,88654,26,2116,2,36000,1.01228733459
86513,86543,88381,30,1838,2,36000,1.01632208923
86529,86559,88578,30,2019,2,36000,1.01485884101
86530,86585,88537,55,1952,2,36000,1.02817622951
86548,86591,88578,43,1987,2,36000,1.02164066432
86576,86616,88452,40,1836,2,36000,1.02178649237
86591,86654,87884,63,1230,2,36000,1.0512195122
86606,86732,88660,126,1928,2,36000,1.0653526971
86643,86740,88681,97,1941,2,36000,1.04997424008
86721,86772,88668,51,1896,2,36000,1.02689873418
86737,86800,88703,63,1903,2,36000,1.0331056227
86763,86806,88650,43,1844,2,36000,1.02331887202
86790,86811,88591,21,1780,2,36000,1.01179775281
86806,86817,88568,11,1751,2,36000,1.0062821245
86807,86823,88651,16,1828,2,36000,1.00875273523
86809,86834,88860,25,2026,2,36000,1.01233958539
86825,86839,88779,14,1940,2,36000,1.00721649485
86826,86845,88381,19,1536,2,36000,1.01236979167
86827,86872,88604,45,1732,2,36000,1.02598152425
86842,86907,88986,65,2079,2,36000,1.03126503127
86861,86913,88582,52,1669,2,36000,1.03115638107
86899,86919,88668,20,1749,2,36000,1.01143510577
86915,86925,88883,10,1958,2,36000,1.0051072523
86916,86930,88889,14,1959,2,36000,1.00714650332
86917,86961,88947,44,1986,2,36000,1.0221550856
86919,86975,88761,56,1786,2,36000,1.0313549832
86952,86990,88892,38,1902,2,36000,1.01997896951
86967,86996,87924,29,928,2,36000,1.03125
86984,87006,88841,22,1835,2,36000,1.01198910082
86986,87015,89091,29,2076,2,36000,1.01396917148
87009,87021,88734,12,1713,2,36000,1.00700525394
87011,87028,88770,17,1742,2,36000,1.00975889782
87027,87057,88755,30,1698,2,36000,1.01766784452
87028,87105,88925,77,1820,2,36000,1.04230769231
87029,87369,87411,340,42,14,7980,9.09523809524
87043,87268,89198,225,1930,2,36000,1.11658031088
87059,87282,89309,223,2027,2,36000,1.1100148002
87077,87438,89341,361,1903,2,36000,1.18970047294
87078,87192,337458,114,250266,2,345600,1.00045551533
87078,87443,89261,365,1818,2,36000,1.20077007701
87079,87363,393978,284,306615,2,345600,1.00092624301
87079,87204,432820,125,345616,2,345600,1.00036167307
87079,87332,117805,253,30473,2,345600,1.00830243166
87079,87262,119049,183,31787,2,345600,1.0057570705
87079,87376,117273,297,29897,2,345600,1.0099341071
87079,87232,343486,153,256254,2,345600,1.00059706385
87080,87432,346138,352,258706,2,345600,1.00136061784
87080,87422,116340,342,28918,2,345600,1.01182654402
87080,87427,138113,347,50686,2,345600,1.00684607189
87097,87448,89248,351,1800,2,36000,1.195
87156,87453,89141,297,1688,2,36000,1.1759478673
87179,87459,89378,280,1919,2,36000,1.14590932777
87197,87465,89218,268,1753,2,36000,1.15288077581
87198,87470,89205,272,1735,2,36000,1.15677233429
87223,87475,89381,252,1906,2,36000,1.13221406086
87251,87480,89310,229,1830,2,36000,1.12513661202
87267,87485,89470,218,1985,2,36000,1.10982367758
87283,87491,89411,208,1920,2,36000,1.10833333333
87323,87496,89300,173,1804,2,36000,1.09589800443
87357,87502,89943,145,2441,2,36000,1.05940188447
87358,87508,89256,150,1748,2,36000,1.08581235698
87374,87513,89337,139,1824,2,36000,1.07620614035
87375,87525,89513,150,1988,2,36000,1.0754527163
87428,87566,89486,138,1920,2,36000,1.071875
87429,87610,89636,181,2026,2,36000,1.08933859822
87446,87634,89422,188,1788,2,36000,1.10514541387
87447,87649,89595,202,1946,2,36000,1.10380267215
87449,87655,89384,206,1729,2,36000,1.11914401388
87450,87661,89365,211,1704,2,36000,1.12382629108
87465,87702,89587,237,1885,2,36000,1.12572944297
87481,87708,89441,227,1733,2,36000,1.13098672822
87483,87727,89601,244,1874,2,36000,1.13020277481
87500,87733,89663,233,1930,2,36000,1.1207253886
87501,87742,89761,241,2019,2,36000,1.11936602278
87517,87783,89606,266,1823,2,36000,1.14591332968
87557,87802,89661,245,1859,2,36000,1.13179128564
87600,87808,89646,208,1838,2,36000,1.11316648531
87625,87813,89601,188,1788,2,36000,1.10514541387
87640,87835,89654,195,1819,2,36000,1.10720175921
87656,87853,89807,197,1954,2,36000,1.10081883316
87657,87867,89669,210,1802,2,36000,1.11653718091
87693,87891,89765,198,1874,2,36000,1.10565635005
87709,87897,89626,188,1729,2,36000,1.10873337189
87725,87909,89767,184,1858,2,36000,1.09903121636
87726,87929,89622,203,1693,2,36000,1.11990549321
87743,87935,89961,192,2026,2,36000,1.09476801579
87777,87940,89827,163,1887,2,36000,1.08638049815
87793,87946,89695,153,1749,2,36000,1.08747855918
87809,87959,89756,150,1797,2,36000,1.08347245409
87810,87964,89666,154,1702,2,36000,1.09048178613
87825,88041,89749,216,1708,2,36000,1.12646370023
87845,88047,89846,202,1799,2,36000,1.11228460256
87861,88088,89449,227,1361,2,36000,1.16678912564
87883,88101,89567,218,1466,2,36000,1.14870395634
87885,88107,89855,222,1748,2,36000,1.12700228833
87900,88113,90006,213,1893,2,36000,1.11251980983
87919,88128,89946,209,1818,2,36000,1.11496149615
87935,88134,90027,199,1893,2,36000,1.10512414157
87936,88143,90127,207,1984,2,36000,1.10433467742
87938,88267,90142,329,1875,2,36000,1.17546666667
87954,88291,89988,337,1697,2,36000,1.19858573954
87955,88302,90255,347,1953,2,36000,1.17767537122
88033,88316,90250,283,1934,2,36000,1.14632885212
88034,88328,90214,294,1886,2,36000,1.1558854719
88077,88374,90086,297,1712,2,36000,1.17348130841
88092,88379,90123,287,1744,2,36000,1.16456422018
88108,88385,90199,277,1814,2,36000,1.15270121279
88110,88417,90049,307,1632,2,36000,1.1881127451
88125,88463,90327,338,1864,2,36000,1.1813304721
88126,88495,90180,369,1685,2,36000,1.21899109792
88141,88392,88478,251,86,14,9960,3.91860465116
88142,88500,90333,358,1833,2,36000,1.19530823786
88143,88506,90189,363,1683,2,36000,1.21568627451
88158,88511,90345,353,1834,2,36000,1.19247546347
88173,88516,90296,343,1780,2,36000,1.19269662921
88189,88521,89725,332,1204,2,36000,1.27574750831
88190,88526,90276,336,1750,2,36000,1.192
88258,88595,90396,337,1801,2,36000,1.18711826763
88282,88601,90347,319,1746,2,36000,1.18270332188
88297,88607,90603,310,1996,2,36000,1.15531062124
88313,88616,90396,303,1780,2,36000,1.1702247191
88330,88659,90544,329,1885,2,36000,1.17453580902
88367,88670,90382,303,1712,2,36000,1.17698598131
88368,88676,90012,308,1336,2,36000,1.23053892216
88384,88682,90749,298,2067,2,36000,1.14417029511
88386,88687,90567,301,1880,2,36000,1.16010638298
88387,88694,90598,307,1904,2,36000,1.1612394958
88407,88714,90897,307,2183,2,36000,1.14063215758
88457,88745,90510,288,1765,2,36000,1.16317280453
88476,88490,88510,14,20,1,900,1.7
88485,88665,88754,180,89,14,9960,3.02247191011
88521,88770,90697,249,1927,2,36000,1.12921639855
88539,88775,90809,236,2034,2,36000,1.11602753196
88570,88780,91050,210,2270,2,36000,1.09251101322
88586,88785,90240,199,1455,2,36000,1.13676975945
88587,88790,90651,203,1861,2,36000,1.10908113917
88589,88796,90538,207,1742,2,36000,1.11882893226
88610,88801,90602,191,1801,2,36000,1.10605219323
88612,88807,90652,195,1845,2,36000,1.10569105691
88613,88813,90689,200,1876,2,36000,1.1066098081
88651,88900,90931,249,2031,2,36000,1.12259970458
88652,88906,90620,254,1714,2,36000,1.14819136523
88653,88936,90893,283,1957,2,36000,1.14460909555
88671,88958,90919,287,1961,2,36000,1.14635390107
88673,88997,90813,324,1816,2,36000,1.17841409692
88674,89102,90911,428,1809,2,36000,1.23659480376
88675,89153,90858,478,1705,2,36000,1.28035190616
88691,89209,91274,518,2065,2,36000,1.25084745763
88707,89217,91174,510,1957,2,36000,1.26060296372
88736,89230,91157,494,1927,2,36000,1.25635703166
88750,88764,88769,14,5,1,900,1.9
88758,89260,91285,502,2025,2,36000,1.24790123457
88760,89612,89756,852,144,14,9960,6.91666666667
88774,89267,90990,493,1723,2,36000,1.28612884504
88776,89273,90950,497,1677,2,36000,1.29636255218
88791,89312,90955,521,1643,2,36000,1.31710286062
88841,89320,91493,479,2173,2,36000,1.22043258168
88862,89326,91307,464,1981,2,36000,1.23422513882
88885,89349,91256,464,1907,2,36000,1.24331410593
88901,89355,91369,454,2014,2,36000,1.22542204568
88902,89376,91042,474,1666,2,36000,1.28451380552
88927,89389,91121,462,1732,2,36000,1.26674364896
88948,89395,91091,447,1696,2,36000,1.26356132075
88988,89400,91227,412,1827,2,36000,1.22550629447
89092,89422,91577,330,2155,2,36000,1.15313225058
89144,89433,91279,289,1846,2,36000,1.15655471289
89202,89452,91199,250,1747,2,36000,1.14310246136
89227,89460,90768,233,1308,2,36000,1.17813455657
89229,89481,91320,252,1839,2,36000,1.13703099511
89250,89498,91127,248,1629,2,36000,1.15224063843
89266,89525,91242,259,1717,2,36000,1.15084449621
89267,89578,91519,311,1941,2,36000,1.16022668727
89304,89598,91454,294,1856,2,36000,1.15840517241
89320,89606,90811,286,1205,2,36000,1.23734439834
89321,89618,91454,297,1836,2,36000,1.16176470588
89336,89633,91602,297,1969,2,36000,1.15083798883
89352,89639,91391,287,1752,2,36000,1.16381278539
89367,89647,91290,280,1643,2,36000,1.17041996348
89383,89657,91417,274,1760,2,36000,1.15568181818
89385,89665,91548,280,1883,2,36000,1.14869888476
89400,89672,91628,272,1956,2,36000,1.1390593047
89415,89678,91297,263,1619,2,36000,1.16244595429
89431,89683,91515,252,1832,2,36000,1.13755458515
89446,89689,91576,243,1887,2,36000,1.12877583466
89461,89706,91635,245,1929,2,36000,1.12700881286
89477,89736,91547,259,1811,2,36000,1.14301490889
89492,89765,91804,273,2039,2,36000,1.13388916135
89514,89776,91651,262,1875,2,36000,1.13973333333
89572,89783,91782,211,1999,2,36000,1.10555277639
89591,89789,91718,198,1929,2,36000,1.10264385692
89611,89794,91596,183,1802,2,36000,1.10155382908
89613,89819,91626,206,1807,2,36000,1.11400110681
89614,89838,91693,224,1855,2,36000,1.12075471698
89615,89858,91656,243,1798,2,36000,1.13515016685
89632,89866,91600,234,1734,2,36000,1.13494809689
89633,89932,91741,299,1809,2,36000,1.16528468767
89653,89938,91827,285,1889,2,36000,1.15087347803
89654,89943,91702,289,1759,2,36000,1.16429789653
89680,89948,91753,268,1805,2,36000,1.14847645429
89682,89953,91930,271,1977,2,36000,1.13707637835
89683,89958,91705,275,1747,2,36000,1.1574127075
89684,89963,91662,279,1699,2,36000,1.16421424367
89685,89970,91745,285,1775,2,36000,1.16056338028
89701,89975,92051,274,2076,2,36000,1.13198458574
89729,90017,91878,288,1861,2,36000,1.15475550779
89749,89760,89765,11,5,1,900,1.6
89751,90039,91930,288,1891,2,36000,1.15230037017
89757,89771,89916,14,145,14,9960,1.09655172414
89768,90060,91983,292,1923,2,36000,1.15184607384
89769,90134,92073,365,1939,2,36000,1.18824136153
89770,90140,92069,370,1929,2,36000,1.19180922758
89772,90192,91964,420,1772,2,36000,1.23702031603
89811,90200,91941,389,1741,2,36000,1.22343480758
89828,90211,92184,383,1973,2,36000,1.19412062848
89847,90226,92070,379,1844,2,36000,1.20553145336
89862,90251,91961,389,1710,2,36000,1.22748538012
89912,89927,89935,15,8,1,900,2.3
89922,90615,90828,693,213,14,9960,4.25352112676
89945,90261,92101,316,1840,2,36000,1.17173913043
89961,90267,92162,306,1895,2,36000,1.16147757256
89962,90288,91485,326,1197,2,36000,1.27234753551
89989,90307,91704,318,1397,2,36000,1.22763063708
90008,90338,91997,330,1659,2,36000,1.19891500904
90023,90344,91275,321,931,2,36000,1.3447905478
90038,90356,92600,318,2244,2,36000,1.14171122995
90054,90362,92295,308,1933,2,36000,1.15933781686
90088,90394,92188,306,1794,2,36000,1.17056856187
90125,90407,92186,282,1779,2,36000,1.15851602024
90140,90414,92180,274,1766,2,36000,1.15515288788
90155,90522,92406,367,1884,2,36000,1.19479830149
90182,90839,90928,657,89,14,7980,8.38202247191
90183,90549,92319,366,1770,2,36000,1.20677966102
90199,90555,92227,356,1672,2,36000,1.21291866029
90200,90578,92769,378,2191,2,36000,1.17252396166
90216,90609,92570,393,1961,2,36000,1.20040795512
90241,90632,92446,391,1814,2,36000,1.21554575524
90260,90662,92321,402,1659,2,36000,1.24231464738
90261,90668,92575,407,1907,2,36000,1.21342422653
90277,90700,92573,423,1873,2,36000,1.22584089696
90295,90822,92648,527,1826,2,36000,1.28860898138
90330,90850,92784,520,1934,2,36000,1.26887280248
90350,90855,92735,505,1880,2,36000,1.26861702128
90352,90860,92711,508,1851,2,36000,1.27444624527
90353,90865,92739,512,1874,2,36000,1.27321237994
90385,90870,92601,485,1731,2,36000,1.28018486424
90415,90876,92697,461,1821,2,36000,1.25315760571
90416,90904,92842,488,1938,2,36000,1.25180598555
90511,90910,92792,399,1882,2,36000,1.21200850159
90539,90923,92635,384,1712,2,36000,1.22429906542
90555,90930,92920,375,1990,2,36000,1.18844221106
90570,90945,92788,375,1843,2,36000,1.20347259902
90602,90966,92673,364,1707,2,36000,1.21323960164
90603,90972,92688,369,1716,2,36000,1.21503496503
90621,91002,92860,381,1858,2,36000,1.20505920344
90622,91058,93029,436,1971,2,36000,1.22120750888
90655,91064,93002,409,1938,2,36000,1.21104231166
90656,91102,93096,446,1994,2,36000,1.22367101304
90691,91132,92948,441,1816,2,36000,1.24284140969
90707,91138,92959,431,1821,2,36000,1.23668314113
90751,91173,92985,422,1812,2,36000,1.23289183223
90769,91186,93177,417,1991,2,36000,1.20944249121
90810,91210,92991,400,1781,2,36000,1.22459292532
90825,91238,93020,413,1782,2,36000,1.2317620651
90827,91253,93125,426,1872,2,36000,1.22756410256
90828,90844,90849,16,5,1,900,2.1
90835,90939,91162,104,223,14,9960,1.466367713
90860,91267,93106,407,1839,2,36000,1.22131593257
90895,91285,92987,390,1702,2,36000,1.22914218566
90910,91296,93119,386,1823,2,36000,1.21173889194
90926,90961,90966,35,5,1,900,4.0
90926,91302,93127,376,1825,2,36000,1.20602739726
90927,91317,92973,390,1656,2,36000,1.23550724638
90935,91180,91264,245,84,14,7980,3.91666666667
90943,91331,93277,388,1946,2,36000,1.19938335046
90959,91428,93438,469,2010,2,36000,1.23333333333
90960,91496,93316,536,1820,2,36000,1.29450549451
90991,91504,93490,513,1986,2,36000,1.2583081571
91043,91526,93430,483,1904,2,36000,1.25367647059
91058,91537,93558,479,2021,2,36000,1.2370113805
91092,91564,93359,472,1795,2,36000,1.26295264624
91123,91569,93428,446,1859,2,36000,1.23991393222
91139,91575,93404,436,1829,2,36000,1.23838162931
91159,91580,93300,421,1720,2,36000,1.24476744186
91159,91168,91175,9,7,1,900,1.6
91169,91276,91523,107,247,14,9960,1.43319838057
91175,91585,93338,410,1753,2,36000,1.23388476897
91200,91590,93560,390,1970,2,36000,1.19796954315
91228,91595,93183,367,1588,2,36000,1.23110831234
91244,91600,93427,356,1827,2,36000,1.19485495348
91259,91607,93388,348,1781,2,36000,1.19539584503
91261,91291,91295,30,4,1,900,3.4
91270,91465,91552,195,87,14,7980,3.24137931034
91275,91612,93556,337,1944,2,36000,1.17335390947
91276,91637,92952,361,1315,2,36000,1.27452471483
91293,91643,93485,350,1842,2,36000,1.19001085776
91295,91667,93538,372,1871,2,36000,1.1988241582
91296,91672,93559,376,1887,2,36000,1.19925808161
91312,91678,93400,366,1722,2,36000,1.21254355401
91313,91704,93692,391,1988,2,36000,1.19668008048
91329,91713,93345,384,1632,2,36000,1.23529411765
91373,91719,92601,346,882,2,36000,1.39229024943
91396,91724,93619,328,1895,2,36000,1.17308707124
91417,91730,93501,313,1771,2,36000,1.17673630717
91455,91752,93570,297,1818,2,36000,1.16336633663
91456,91758,93612,302,1854,2,36000,1.16289104639
91489,91764,93649,275,1885,2,36000,1.14588859416
91506,91799,93820,293,2021,2,36000,1.1449777338
91520,91532,91556,12,24,1,900,1.5
91522,91804,93376,282,1572,2,36000,1.17938931298
91523,91809,93468,286,1659,2,36000,1.17239300784
91528,91543,91777,15,234,14,9960,1.0641025641
91548,91558,91582,10,24,1,900,1.41666666667
91557,91815,93357,258,1542,2,36000,1.1673151751
91558,91820,92997,262,1177,2,36000,1.22259983008
91561,91693,91778,132,85,14,7980,2.55294117647
91596,91825,93815,229,1990,2,36000,1.11507537688
91597,91837,93094,240,1257,2,36000,1.19093078759
91599,91842,93629,243,1787,2,36000,1.13598209289
91618,91847,93587,229,1740,2,36000,1.1316091954
91619,91889,93584,270,1695,2,36000,1.1592920354
91636,91941,93840,305,1899,2,36000,1.16061084781
91637,91953,93650,316,1697,2,36000,1.18621096052
91638,91972,93568,334,1596,2,36000,1.20927318296
91655,91978,93814,323,1836,2,36000,1.17592592593
91656,91994,93802,338,1808,2,36000,1.18694690265
91673,92008,93738,335,1730,2,36000,1.1936416185
91697,92066,94172,369,2106,2,36000,1.17521367521
91713,92077,93921,364,1844,2,36000,1.19739696312
91714,92082,93111,368,1029,2,36000,1.35762876579
91715,92089,94075,374,1986,2,36000,1.18831822759
91731,92094,93913,363,1819,2,36000,1.19956019791
91747,92100,93939,353,1839,2,36000,1.19195214791
91748,92113,93901,365,1788,2,36000,1.20413870246
91764,92174,93977,410,1803,2,36000,1.22739877981
91775,91789,91795,14,6,1,900,2.0
91776,91794,91801,18,7,1,900,2.5
91783,91831,92056,48,225,14,9960,1.21333333333
91783,92192,93884,409,1692,2,36000,1.24172576832
91784,92072,92150,288,78,14,7980,4.69230769231
91805,92198,93372,393,1174,2,36000,1.33475298126
91830,92203,93918,373,1715,2,36000,1.21749271137
91880,92210,93756,330,1546,2,36000,1.21345407503
91933,92238,94059,305,1821,2,36000,1.1674903899
91935,92307,94040,372,1733,2,36000,1.21465666474
91950,92330,94095,380,1765,2,36000,1.21529745042
91966,92417,94211,451,1794,2,36000,1.251393534
91968,92441,94243,473,1802,2,36000,1.26248612653
91983,92457,94229,474,1772,2,36000,1.26749435666
91999,92581,94383,582,1802,2,36000,1.32297447281
92052,92587,94543,535,1956,2,36000,1.27351738241
92054,92060,92067,6,7,1,900,1.3
92061,92161,92425,100,264,14,9960,1.37878787879
92071,92592,94325,521,1733,2,36000,1.30063473745
92072,92612,94424,540,1812,2,36000,1.29801324503
92088,92617,94421,529,1804,2,36000,1.29323725055
92103,92647,94371,544,1724,2,36000,1.31554524362
92148,92154,92168,6,14,1,900,1.42857142857
92158,92436,92521,278,85,14,7980,4.27058823529
92168,92660,94414,492,1754,2,36000,1.28050171038
92187,92684,94406,497,1722,2,36000,1.28861788618
92188,92699,94523,511,1824,2,36000,1.28015350877
92189,92709,94323,520,1614,2,36000,1.32218091698
92206,92722,94489,516,1767,2,36000,1.29202037351
92228,92746,94517,518,1771,2,36000,1.29249011858
92297,92752,94547,455,1795,2,36000,1.25348189415
92320,92780,94739,460,1959,2,36000,1.23481368045
92335,92798,94929,463,2131,2,36000,1.21726888785
92409,92809,94947,400,2138,2,36000,1.18709073901
92422,92429,92435,7,6,1,900,1.3
92431,92532,92788,101,256,14,9960,1.39453125
92447,92814,94683,367,1869,2,36000,1.19636169074
92519,92525,92533,6,8,1,900,1.4
92529,92804,92936,275,132,14,7980,3.08333333333
92571,92820,94689,249,1869,2,36000,1.13322632424
92586,92853,94716,267,1863,2,36000,1.14331723027
92588,92871,94633,283,1762,2,36000,1.16061293984
92604,92931,94854,327,1923,2,36000,1.17004680187
92605,92959,94824,354,1865,2,36000,1.18981233244
92607,92965,94756,358,1791,2,36000,1.19988833054
92636,92971,94908,335,1937,2,36000,1.17294785751
92652,92985,94963,333,1978,2,36000,1.16835187058
92676,92996,94616,320,1620,2,36000,1.1975308642
92694,93002,94809,308,1807,2,36000,1.17044825678
92712,93007,94805,295,1798,2,36000,1.16407119021
92713,93032,94861,319,1829,2,36000,1.17441224713
92738,93040,94887,302,1847,2,36000,1.16350839199
92753,93105,94923,352,1818,2,36000,1.19361936194
92774,93111,95035,337,1924,2,36000,1.17515592516
92786,92792,92799,6,7,1,900,1.3
92790,93117,94976,327,1859,2,36000,1.17590102205
92792,93123,94885,331,1762,2,36000,1.18785471056
92794,92948,93196,154,248,14,9960,1.62096774194
92808,93131,94822,323,1691,2,36000,1.19101123596
92845,93137,94867,292,1730,2,36000,1.16878612717
92864,93143,94850,279,1707,2,36000,1.16344463972
92923,93188,95039,265,1851,2,36000,1.14316585629
92934,92941,92948,7,7,1,900,1.4
92943,93207,93340,264,133,14,7980,2.98496240602
92951,93195,94982,244,1787,2,36000,1.13654168998
92967,93215,95002,248,1787,2,36000,1.13878007834
92968,93220,94559,252,1339,2,36000,1.18820014937
92984,93288,95041,304,1753,2,36000,1.17341699943
92986,93311,95012,325,1701,2,36000,1.19106407995
93005,93327,95074,322,1747,2,36000,1.18431597023
93007,93350,95265,343,1915,2,36000,1.17911227154
93008,93361,95109,353,1748,2,36000,1.20194508009
93009,93370,95158,361,1788,2,36000,1.201901566
93026,93383,95067,357,1684,2,36000,1.21199524941
93043,93400,95250,357,1850,2,36000,1.19297297297
93099,93412,95159,313,1747,2,36000,1.17916428163
93101,93418,95555,317,2137,2,36000,1.1483387927
93117,93442,95471,325,2029,2,36000,1.1601774273
93118,93449,95324,331,1875,2,36000,1.17653333333
93134,93497,95447,363,1950,2,36000,1.18615384615
93136,93503,95179,367,1676,2,36000,1.21897374702
93137,93512,95433,375,1921,2,36000,1.19521082769
93182,93549,95282,367,1733,2,36000,1.21177149452
93192,93201,93211,9,10,1,900,1.9
93199,93568,95438,369,1870,2,36000,1.19732620321
93203,93356,93610,153,254,14,9960,1.60236220472
93281,93574,95341,293,1767,2,36000,1.16581777023
93303,93579,95532,276,1953,2,36000,1.14132104455
93318,93591,95635,273,2044,2,36000,1.13356164384
93338,93344,93350,6,6,1,900,1.2
93340,93597,95696,257,2099,2,36000,1.12243925679
93347,93585,93736,238,151,14,7980,2.5761589404
93355,93603,95340,248,1737,2,36000,1.14277489925
93373,93627,95425,254,1798,2,36000,1.14126807564
93374,93638,95469,264,1831,2,36000,1.14418350628
93375,93644,95354,269,1710,2,36000,1.15730994152
93391,93660,95183,269,1523,2,36000,1.17662508207
93393,93666,96057,273,2391,2,36000,1.11417816813
93409,93704,95454,295,1750,2,36000,1.16857142857
93410,93752,95725,342,1973,2,36000,1.17334009123
93436,93758,95466,322,1708,2,36000,1.18852459016
93437,93763,95606,326,1843,2,36000,1.17688551275
93438,93768,95584,330,1816,2,36000,1.18171806167
93459,93773,95107,314,1334,2,36000,1.23538230885
93476,93778,95725,302,1947,2,36000,1.1551104263
93492,93783,95907,291,2124,2,36000,1.13700564972
93493,93790,95470,297,1680,2,36000,1.17678571429
93509,93795,95563,286,1768,2,36000,1.16176470588
93539,93813,95621,274,1808,2,36000,1.15154867257
93560,93825,95607,265,1782,2,36000,1.14870931538
93561,93831,95669,270,1838,2,36000,1.14689880305
93562,93852,95640,290,1788,2,36000,1.16219239374
93564,93895,95808,331,1913,2,36000,1.1730266597
93580,93902,95615,322,1713,2,36000,1.18797431407
93581,93912,96002,331,2090,2,36000,1.15837320574
93596,93924,95831,328,1907,2,36000,1.17199790246
93598,93930,95914,332,1984,2,36000,1.16733870968
93607,93633,93638,26,5,1,900,3.1
93613,93936,95823,323,1887,2,36000,1.17117117117
93615,93621,93879,6,258,14,9960,1.02325581395
93628,93950,95879,322,1929,2,36000,1.16692586833
93630,93988,95893,358,1905,2,36000,1.18792650919
93652,94052,95887,400,1835,2,36000,1.21798365123
93654,94074,95862,420,1788,2,36000,1.23489932886
93694,94086,95754,392,1668,2,36000,1.23501199041
93734,93747,93751,13,4,1,900,1.7
93740,94106,96086,366,1980,2,36000,1.18484848485
93743,93890,94064,147,174,14,7980,1.84482758621
93758,94183,96358,425,2175,2,36000,1.19540229885
93803,94222,96224,419,2002,2,36000,1.20929070929
93819,94240,96097,421,1857,2,36000,1.2267097469
93820,94254,95962,434,1708,2,36000,1.25409836066
93838,94334,96000,496,1666,2,36000,1.29771908764
93840,94345,96096,505,1751,2,36000,1.28840662479
93876,93882,93891,6,9,1,900,1.5
93885,94080,94332,195,252,14,9960,1.77380952381
93889,94383,96202,494,1819,2,36000,1.27157778999
93905,94394,96362,489,1968,2,36000,1.24847560976
93921,94417,96267,496,1850,2,36000,1.26810810811
93922,94425,96255,503,1830,2,36000,1.27486338798
93923,94432,96387,509,1955,2,36000,1.26035805627
93944,94438,95942,494,1504,2,36000,1.32845744681
93979,94500,96252,521,1752,2,36000,1.29737442922
94043,94528,96550,485,2022,2,36000,1.23986152324
94062,94068,94078,6,10,1,900,1.6
94062,94534,96301,472,1767,2,36000,1.26711941143
94071,94351,94566,280,215,14,7980,2.3023255814
94077,94554,96573,477,2019,2,36000,1.23625557207
94096,94560,96299,464,1739,2,36000,1.2668200115
94179,94570,96495,391,1925,2,36000,1.20311688312
94212,94628,96587,416,1959,2,36000,1.21235324145
94234,94644,96047,410,1403,2,36000,1.29223093371
94249,94694,96595,445,1901,2,36000,1.23408732246
94324,94700,96744,376,2044,2,36000,1.18395303327
94330,94340,94345,10,5,1,900,1.5
94338,94582,94834,244,252,14,9960,1.96825396825
94339,94727,96729,388,2002,2,36000,1.19380619381
94372,94750,96657,378,1907,2,36000,1.19821709491
94388,94767,96629,379,1862,2,36000,1.20354457573
94406,94816,96604,410,1788,2,36000,1.2293064877
94422,94822,96580,400,1758,2,36000,1.22753128555
94423,94834,96831,411,1997,2,36000,1.20580871307
94439,94845,96762,406,1917,2,36000,1.21178925404
94491,94861,96599,370,1738,2,36000,1.21288837745
94519,94867,96884,348,2017,2,36000,1.17253346554
94534,94873,96943,339,2070,2,36000,1.16376811594
94550,94879,96749,329,1870,2,36000,1.17593582888
94552,94896,96677,344,1781,2,36000,1.19314991578
94566,94576,94596,10,20,1,900,1.5
94568,94902,96723,334,1821,2,36000,1.18341570566
94582,94852,94985,270,133,14,7980,3.03007518797
94617,94919,96923,302,2004,2,36000,1.15069860279
94635,94934,96380,299,1446,2,36000,1.20677731674
94685,94942,96714,257,1772,2,36000,1.14503386005
94701,94958,96707,257,1749,2,36000,1.14694110921
94716,94974,96851,258,1877,2,36000,1.13745338306
94742,94994,96680,252,1686,2,36000,1.14946619217
94761,95005,96718,244,1713,2,36000,1.14244016346
94807,95013,95847,206,834,2,36000,1.24700239808
94823,95023,96673,200,1650,2,36000,1.12121212121
94824,95046,96790,222,1744,2,36000,1.12729357798
94833,94840,94849,7,9,1,900,1.6
94839,95052,96878,213,1826,2,36000,1.11664841183
94842,95000,95245,158,245,14,9960,1.64489795918
94856,95057,96808,201,1751,2,36000,1.11479154769
94857,95078,96945,221,1867,2,36000,1.11837171934
94872,95085,96864,213,1779,2,36000,1.1197301855
94874,95118,97001,244,1883,2,36000,1.12958045672
94890,95124,96833,234,1709,2,36000,1.13692217671
94891,95169,97147,278,1978,2,36000,1.14054600607
94910,95175,96939,265,1764,2,36000,1.15022675737
94925,95190,97228,265,2038,2,36000,1.13002944063
94940,95196,97081,256,1885,2,36000,1.13580901857
94956,95262,97125,306,1863,2,36000,1.16425120773
94971,95276,96949,305,1673,2,36000,1.18230723252
94983,94988,94994,5,6,1,900,1.1
94987,95293,97106,306,1813,2,36000,1.16878102592
94988,95335,96930,347,1595,2,36000,1.21755485893
94992,95256,95482,264,226,14,7980,2.16814159292
95003,95351,97228,348,1877,2,36000,1.18540223761
95019,95357,97120,338,1763,2,36000,1.19171866137
95037,95365,97199,328,1834,2,36000,1.17884405671
95053,95413,97186,360,1773,2,36000,1.20304568528
95054,95436,97235,382,1799,2,36000,1.21234018899
95069,95444,97179,375,1735,2,36000,1.21613832853
95085,95450,97244,365,1794,2,36000,1.20345596433
95110,95455,97290,345,1835,2,36000,1.18801089918
95111,95461,97330,350,1869,2,36000,1.1872659176
95160,95467,97324,307,1857,2,36000,1.16532040926
95161,95481,97186,320,1705,2,36000,1.18768328446
95180,95486,97122,306,1636,2,36000,1.18704156479
95195,95497,97600,302,2103,2,36000,1.1436043747
95243,95249,95260,6,11,1,900,1.54545454545
95252,95503,95748,251,245,14,9960,2.02448979592
95252,95508,97419,256,1911,2,36000,1.13396127682
95267,95544,97606,277,2062,2,36000,1.13433559651
95284,95566,97472,282,1906,2,36000,1.14795383001
95326,95575,97337,249,1762,2,36000,1.14131668558
95342,95619,97505,277,1886,2,36000,1.14687168611
95343,95627,97394,284,1767,2,36000,1.16072439162
95359,95633,97369,274,1736,2,36000,1.15783410138
95427,95646,97475,219,1829,2,36000,1.11973756151
95444,95652,97507,208,1855,2,36000,1.11212938005
95445,95681,97470,236,1789,2,36000,1.13191727222
95461,95709,97651,248,1942,2,36000,1.12770339856
95462,95736,97437,274,1701,2,36000,1.16108171664
95479,95741,97607,262,1866,2,36000,1.14040728832
95480,95765,97667,285,1902,2,36000,1.14984227129
95480,95492,95499,12,7,1,900,1.9
95481,95771,97645,290,1874,2,36000,1.15474919957
95483,95819,97691,336,1872,2,36000,1.17948717949
95492,95760,95976,268,216,14,7980,2.24074074074
95534,95835,97716,301,1881,2,36000,1.16002126528
95556,95842,97724,286,1882,2,36000,1.15196599362
95571,95858,97654,287,1796,2,36000,1.15979955457
95586,95873,97606,287,1733,2,36000,1.16560877092
95609,95891,97830,282,1939,2,36000,1.14543579165
95610,95898,97670,288,1772,2,36000,1.1625282167
95626,95904,97622,278,1718,2,36000,1.16181606519
95627,95919,97807,292,1888,2,36000,1.15466101695
95643,95925,97854,282,1929,2,36000,1.14618973561
95644,95953,97705,309,1752,2,36000,1.17636986301
95672,95973,97852,301,1879,2,36000,1.16019159127
95696,95992,97791,296,1799,2,36000,1.16453585325
95697,95703,95856,6,153,1,3600,1.03921568627
95727,96011,97885,284,1874,2,36000,1.151547492
95729,96017,97788,288,1771,2,36000,1.16261998871
95746,95752,95757,6,5,1,900,1.1
95755,95987,96214,232,227,14,9960,2.02202643172
95756,96059,97799,303,1740,2,36000,1.17413793103
95808,96069,97971,261,1902,2,36000,1.13722397476
95824,96097,97901,273,1804,2,36000,1.15133037694
95840,96107,98001,267,1894,2,36000,1.14097148891
95856,96113,97846,257,1733,2,36000,1.14829774957
95872,96214,98042,342,1828,2,36000,1.18708971554
95887,96250,98071,363,1821,2,36000,1.19934102142
95888,96263,98094,375,1831,2,36000,1.20480611688
95904,96269,98052,365,1783,2,36000,1.20471116096
95920,96278,98136,358,1858,2,36000,1.1926803014
95922,96310,98277,388,1967,2,36000,1.19725470259
95943,96316,98063,373,1747,2,36000,1.21350887235
95965,96369,98184,404,1815,2,36000,1.22258953168
95974,95980,95986,6,6,1,900,1.2
95984,96225,96485,241,260,14,7980,1.92692307692
96002,96375,98379,373,2004,2,36000,1.18612774451
96003,96391,97838,388,1447,2,36000,1.26814098134
96034,96040,96366,6,326,1,3600,1.01840490798
96049,96398,98299,349,1901,2,36000,1.18358758548
96065,96550,98224,485,1674,2,36000,1.28972520908
96086,96556,98241,470,1685,2,36000,1.27893175074
96102,96562,98507,460,1945,2,36000,1.23650385604
96103,96584,98356,481,1772,2,36000,1.27144469526
96204,96591,97631,387,1040,2,36000,1.37211538462
96213,96235,96239,22,4,1,900,2.6
96221,96496,96721,275,225,14,9960,2.22222222222
96227,96598,98424,371,1826,2,36000,1.20317634173
96254,96606,98360,352,1754,2,36000,1.20068415051
96270,96612,98344,342,1732,2,36000,1.1974595843
96271,96618,98340,347,1722,2,36000,1.20150987224
96300,96640,98460,340,1820,2,36000,1.18681318681
96315,96669,98717,354,2048,2,36000,1.1728515625
96358,96685,98602,327,1917,2,36000,1.17057902973
96373,96691,98587,318,1896,2,36000,1.16772151899
96389,96696,98194,307,1498,2,36000,1.20493991989
96390,96718,98818,328,2100,2,36000,1.15619047619
96482,96489,96495,7,6,1,900,1.3
96493,96736,96998,243,262,14,7980,1.92748091603
96498,96730,98181,232,1451,2,36000,1.15988973122
96550,96741,98696,191,1955,2,36000,1.09769820972
96575,96747,98734,172,1987,2,36000,1.08656265727
96591,96753,98642,162,1889,2,36000,1.0857596612
96593,96764,98509,171,1745,2,36000,1.09799426934
96609,96769,98808,160,2039,2,36000,1.07846983816
96610,96775,98593,165,1818,2,36000,1.09075907591
96611,96802,98707,191,1905,2,36000,1.10026246719
96630,96819,98613,189,1794,2,36000,1.10535117057
96658,96843,98717,185,1874,2,36000,1.09871931697
96675,96849,98598,174,1749,2,36000,1.09948542024
96690,96862,98625,172,1763,2,36000,1.09756097561
96692,96875,98647,183,1772,2,36000,1.1032731377
96708,96889,98629,181,1740,2,36000,1.10402298851
96719,96725,96731,6,6,1,900,1.2
96722,96758,97585,36,827,1,3600,1.04353083434
96724,96895,99237,171,2342,2,36000,1.07301451751
96725,96934,98766,209,1832,2,36000,1.11408296943
96726,96941,98809,215,1868,2,36000,1.11509635974
96727,97009,97258,282,249,14,9960,2.13253012048
96742,96950,98592,208,1642,2,36000,1.12667478685
96758,96956,99194,198,2238,2,36000,1.08847184987
96759,96961,98791,202,1830,2,36000,1.11038251366
96774,96968,98700,194,1732,2,36000,1.11200923788
96792,97031,98910,239,1879,2,36000,1.12719531666
96811,97092,98741,281,1649,2,36000,1.17040630685
96832,97117,98763,285,1646,2,36000,1.17314702309
96848,97131,99034,283,1903,2,36000,1.14871255912
96863,97137,98972,274,1835,2,36000,1.14931880109
96879,97142,98937,263,1795,2,36000,1.14651810585
96880,97158,99023,278,1865,2,36000,1.1490616622
96896,97190,99016,294,1826,2,36000,1.16100766703
96924,97197,99039,273,1842,2,36000,1.14820846906
96940,97202,99040,262,1838,2,36000,1.14254624592
96941,97210,98886,269,1676,2,36000,1.16050119332
96957,97239,98971,282,1732,2,36000,1.16281755196
96959,97244,99166,285,1922,2,36000,1.1482830385
96960,97250,99035,290,1785,2,36000,1.16246498599
96996,97015,97019,19,4,1,900,2.3
97003,97256,99166,253,1910,2,36000,1.13246073298
97006,97269,97496,263,227,14,7980,2.15859030837
97082,97302,99142,220,1840,2,36000,1.11956521739
97107,97341,99018,234,1677,2,36000,1.13953488372
97123,97348,98999,225,1651,2,36000,1.13628104179
97125,97354,99232,229,1878,2,36000,1.12193823216
97140,97380,99133,240,1753,2,36000,1.13690815744
97155,97405,99194,250,1789,2,36000,1.13974287311
97180,97430,99135,250,1705,2,36000,1.14662756598
97196,97448,99193,252,1745,2,36000,1.14441260745
97197,97481,99340,284,1859,2,36000,1.15277030662
97212,97487,99290,275,1803,2,36000,1.15252357182
97231,97492,98906,261,1414,2,36000,1.18458274399
97232,97516,99846,284,2330,2,36000,1.12188841202
97248,97522,99495,274,1973,2,36000,1.13887480993
97249,97611,99276,362,1665,2,36000,1.21741741742
97253,97335,97340,82,5,1,900,8.7
97260,97507,97725,247,218,14,9960,2.13302752294
97293,97617,99395,324,1778,2,36000,1.1822272216
97326,97622,99488,296,1866,2,36000,1.15862808146
97342,97629,99379,287,1750,2,36000,1.164
97343,97635,99375,292,1740,2,36000,1.16781609195
97371,97657,99640,286,1983,2,36000,1.14422592032
97395,97662,99372,267,1710,2,36000,1.15614035088
97420,97668,99614,248,1946,2,36000,1.12744090442
97439,97673,99539,234,1866,2,36000,1.12540192926
97473,97679,99543,206,1864,2,36000,1.11051502146
97475,97685,99591,210,1906,2,36000,1.11017838405
97490,97702,99679,212,1977,2,36000,1.10723318159
97494,97595,97601,101,6,1,900,10.7
97502,97739,97980,237,241,14,7980,1.98340248963
97509,97716,99565,207,1849,2,36000,1.11195240671
97511,97727,99505,216,1778,2,36000,1.1214848144
97600,97744,99484,144,1740,2,36000,1.08275862069
97616,97799,99550,183,1751,2,36000,1.1045117076
97618,97805,99446,187,1641,2,36000,1.11395490555
97619,97811,99637,192,1826,2,36000,1.10514786418
97635,97818,99691,183,1873,2,36000,1.09770421783
97636,97841,99800,205,1959,2,36000,1.10464522716
97652,97849,99874,197,2025,2,36000,1.09728395062
97653,97857,99651,204,1794,2,36000,1.11371237458
97669,97863,99572,194,1709,2,36000,1.11351667642
97670,97869,99524,199,1655,2,36000,1.12024169184
97671,97897,99736,226,1839,2,36000,1.12289287656
97693,97912,99341,219,1429,2,36000,1.15325402379
97708,97988,99954,280,1966,2,36000,1.14242115972
97723,97733,97737,10,4,1,900,1.4
97724,98012,99929,288,1917,2,36000,1.15023474178
97725,98053,99954,328,1901,2,36000,1.17254076802
97735,97994,98220,259,226,14,9960,2.14601769912
97790,98063,99824,273,1761,2,36000,1.15502555366
97791,98075,99680,284,1605,2,36000,1.1769470405
97807,98082,100011,275,1929,2,36000,1.14256091239
97808,98105,99684,297,1579,2,36000,1.18809373021
97830,98148,100032,318,1884,2,36000,1.16878980892
97846,98192,99800,346,1608,2,36000,1.21517412935
97848,98198,100136,350,1938,2,36000,1.18059855521
97864,98205,100168,341,1963,2,36000,1.17371370352
97866,98237,100041,371,1804,2,36000,1.205654102
97887,98252,100199,365,1947,2,36000,1.18746789933
97902,98288,99475,386,1187,2,36000,1.3251895535
97973,98310,100118,337,1808,2,36000,1.18639380531
97978,97983,97988,5,5,1,900,1.0
97985,98231,98483,246,252,14,7980,1.97619047619
98001,98352,99900,351,1548,2,36000,1.22674418605
98046,98358,99995,312,1637,2,36000,1.19059254734
98061,98367,100621,306,2254,2,36000,1.13575865129
98076,98373,100283,297,1910,2,36000,1.1554973822
98078,98390,100379,312,1989,2,36000,1.1568627451
98096,98436,100285,340,1849,2,36000,1.1838831801
98140,98471,101221,331,2750,2,36000,1.12036363636
98183,98519,100283,336,1764,2,36000,1.19047619048
98199,98525,100290,326,1765,2,36000,1.18470254958
98201,98598,100289,397,1691,2,36000,1.23477232407
98218,98224,98230,6,6,1,900,1.2
98226,98604,100367,378,1763,2,36000,1.21440726035
98231,98494,98720,263,226,14,9960,2.16371681416
98244,98609,100369,365,1760,2,36000,1.20738636364
98278,98615,100375,337,1760,2,36000,1.19147727273
98299,98620,100198,321,1578,2,36000,1.20342205323
98343,98627,100710,284,2083,2,36000,1.13634181469
98344,98636,100551,292,1915,2,36000,1.15248041775
98360,98642,100285,282,1643,2,36000,1.17163724893
98361,98653,100585,292,1932,2,36000,1.15113871636
98380,98659,100509,279,1850,2,36000,1.15081081081
98426,98707,100516,281,1809,2,36000,1.15533443892
98461,98713,100398,252,1685,2,36000,1.14955489614
98481,98487,98495,6,8,1,900,1.4
98494,98731,98970,237,239,14,7980,1.99163179916
98510,98719,100686,209,1967,2,36000,1.10625317743
98511,98736,100780,225,2044,2,36000,1.11007827789
98588,98741,100662,153,1921,2,36000,1.0796460177
98605,98748,99980,143,1232,2,36000,1.11607142857
98606,98754,100558,148,1804,2,36000,1.08203991131
98607,98774,100491,167,1717,2,36000,1.09726266744
98609,98780,100689,171,1909,2,36000,1.08957569408
98624,98802,100771,178,1969,2,36000,1.09040121889
98640,98819,100750,179,1931,2,36000,1.09269808389
98642,98825,100773,183,1948,2,36000,1.09394250513
98657,98831,100791,174,1960,2,36000,1.0887755102
98658,98897,100595,239,1698,2,36000,1.14075382803
98698,98917,100857,219,1940,2,36000,1.11288659794
98713,98923,100856,210,1933,2,36000,1.10863942059
98715,98948,100843,233,1895,2,36000,1.12295514512
98717,98725,98730,8,5,1,900,1.3
98727,98981,99211,254,230,14,9960,2.10434782609
98731,98987,100717,256,1730,2,36000,1.14797687861
98732,98992,100825,260,1833,2,36000,1.14184397163
98748,99011,100882,263,1871,2,36000,1.14056654196
98749,99028,100941,279,1913,2,36000,1.14584422373
98765,99034,100927,269,1893,2,36000,1.14210248283
98777,98786,98902,9,116,1,3600,1.0775862069
98780,99039,100884,259,1845,2,36000,1.14037940379
98795,99045,100948,250,1903,2,36000,1.13137151865
98811,99051,101004,240,1953,2,36000,1.12288786482
98812,99056,100880,244,1824,2,36000,1.13377192982
98828,99061,100796,233,1735,2,36000,1.13429394813
98886,99144,101138,258,1994,2,36000,1.12938816449
98908,99150,100935,242,1785,2,36000,1.13557422969
98923,99156,100543,233,1387,2,36000,1.16798846431
98938,99177,101171,239,1994,2,36000,1.11985957874
98967,98974,98981,7,7,1,900,1.4
98973,99196,100971,223,1775,2,36000,1.12563380282
98974,99204,100946,230,1742,2,36000,1.13203214696
98980,99222,99477,242,255,14,7980,1.94901960784
99002,99210,100957,208,1747,2,36000,1.11906124785
99018,99215,100937,197,1722,2,36000,1.1144018583
99020,99250,101185,230,1935,2,36000,1.1188630491
99038,99261,101304,223,2043,2,36000,1.10915320607
99040,99287,101162,247,1875,2,36000,1.13173333333
99041,99301,101126,260,1825,2,36000,1.14246575342
99042,99351,101230,309,1879,2,36000,1.16444917509
99044,99357,101215,313,1858,2,36000,1.16846071044
99065,99071,99381,6,310,1,3600,1.01935483871
99137,99383,101102,246,1719,2,36000,1.14310645724
99139,99389,101097,250,1708,2,36000,1.14637002342
99154,99400,101166,246,1766,2,36000,1.13929784824
99170,99406,101189,236,1783,2,36000,1.13236118901
99171,99457,101238,286,1781,2,36000,1.16058394161
99190,99498,100749,308,1251,2,36000,1.24620303757
99205,99504,101324,299,1820,2,36000,1.16428571429
99207,99509,101238,302,1729,2,36000,1.17466743783
99210,99244,99250,34,6,1,900,4.0
99218,99492,99708,274,216,14,9960,2.26851851852
99227,99394,99564,167,170,1,3600,1.98235294118
99234,99515,101353,281,1838,2,36000,1.1528835691
99249,99521,101450,272,1929,2,36000,1.14100570244
99277,99535,101414,258,1879,2,36000,1.13730707823
99292,99550,101335,258,1785,2,36000,1.14453781513
99341,99556,101582,215,2026,2,36000,1.10612043435
99343,99562,101480,219,1918,2,36000,1.114181439
99374,99576,101315,202,1739,2,36000,1.1161587119
99390,99598,101424,208,1826,2,36000,1.1139101862
99391,99604,100908,213,1304,2,36000,1.16334355828
99406,99625,101455,219,1830,2,36000,1.11967213115
99447,99648,101473,201,1825,2,36000,1.1101369863
99477,99486,99493,9,7,1,900,1.6
99478,99654,101435,176,1781,2,36000,1.09882088714
99488,99721,99951,233,230,14,7980,2.01304347826
99493,99687,101479,194,1792,2,36000,1.10825892857
99495,99693,101538,198,1845,2,36000,1.10731707317
99511,99698,101330,187,1632,2,36000,1.11458333333
99512,99704,101758,192,2054,2,36000,1.09347614411
99527,99709,101487,182,1778,2,36000,1.10236220472
99543,99747,101627,204,1880,2,36000,1.1085106383
99544,99811,101611,267,1800,2,36000,1.14833333333
99559,99816,101646,257,1830,2,36000,1.14043715847
99576,99835,101932,259,2097,2,36000,1.12350977587
99577,99858,101498,281,1640,2,36000,1.17134146341
99592,99885,101969,293,2084,2,36000,1.1405950096
99614,99911,101743,297,1832,2,36000,1.16211790393
99639,99940,101875,301,1935,2,36000,1.15555555556
99655,99975,101737,320,1762,2,36000,1.18161180477
99656,99986,101934,330,1948,2,36000,1.16940451745
99681,99992,101904,311,1912,2,36000,1.16265690377
99682,100007,101804,325,1797,2,36000,1.18085698386
99698,100023,101811,325,1788,2,36000,1.18176733781
99699,100043,102091,344,2048,2,36000,1.16796875
99707,99715,99723,8,8,1,900,1.6
99718,99963,100185,245,222,14,9960,2.1036036036
99733,99739,100081,6,342,1,3600,1.01754385965
99737,100052,101745,315,1693,2,36000,1.18606024808
99802,100129,101985,327,1856,2,36000,1.17618534483
99803,100147,102113,344,1966,2,36000,1.17497456765
99824,100179,102014,355,1835,2,36000,1.19346049046
99828,100091,100674,263,583,1,3600,1.45111492281
99846,100215,101942,369,1727,2,36000,1.21366531558
99874,100225,101972,351,1747,2,36000,1.20091585575
99902,100295,102087,393,1792,2,36000,1.21930803571
99932,100300,102218,368,1918,2,36000,1.19186652763
99949,99970,99974,21,4,1,900,2.5
99955,100306,102071,351,1765,2,36000,1.19886685552
99956,100311,102156,355,1845,2,36000,1.19241192412
99957,100197,100408,240,211,14,7980,2.13744075829
99981,100317,101990,336,1673,2,36000,1.20083682008
99997,100322,102231,325,1909,2,36000,1.1702462022
100012,100378,102267,366,1889,2,36000,1.19375330863
100034,100384,102251,350,1867,2,36000,1.18746652384
100049,100390,102126,341,1736,2,36000,1.19642857143
100120,100395,102185,275,1790,2,36000,1.15363128492
100138,100410,102157,272,1747,2,36000,1.15569547796
100170,100518,102331,348,1813,2,36000,1.19194704909
100183,100209,100214,26,5,1,900,3.1
100192,100420,100647,228,227,14,9960,2.00440528634
100198,100524,102352,326,1828,2,36000,1.17833698031
100213,100530,102295,317,1765,2,36000,1.17960339943
100285,100554,102549,269,1995,2,36000,1.13483709273
100287,100562,102504,275,1942,2,36000,1.14160659114
100288,100569,102706,281,2137,2,36000,1.13149274684
100289,100596,102342,307,1746,2,36000,1.17583046964
100305,100606,102275,301,1669,2,36000,1.18034751348
100307,100632,102486,325,1854,2,36000,1.17529665588
100369,100673,102729,304,2056,2,36000,1.14785992218
100370,100697,102383,327,1686,2,36000,1.19395017794
100386,100703,102651,317,1948,2,36000,1.16273100616
100387,100721,102768,334,2047,2,36000,1.16316560821
100402,100729,102416,327,1687,2,36000,1.19383521043
100406,100502,100507,96,5,1,900,10.1
100414,100658,100902,244,244,14,7980,2.0
100436,100708,101542,272,834,1,3600,1.32613908873
100492,100760,102419,268,1659,2,36000,1.16154309825
100511,100766,102613,255,1847,2,36000,1.13806172171
100526,100782,102529,256,1747,2,36000,1.14653692044
100545,100788,102167,243,1379,2,36000,1.1762146483
100560,100794,102657,234,1863,2,36000,1.12560386473
100562,100802,102805,240,2003,2,36000,1.1198202696
100587,100808,102853,221,2045,2,36000,1.10806845966
100602,100836,102730,234,1894,2,36000,1.12354804646
100624,100855,102648,231,1793,2,36000,1.12883435583
100645,100685,100692,40,7,1,900,4.7
100653,100913,101133,260,220,14,9960,2.18181818182
100664,100867,102692,203,1825,2,36000,1.11123287671
100686,100873,102672,187,1799,2,36000,1.10394663702
100701,100891,102813,190,1922,2,36000,1.098855359
100717,100897,102890,180,1993,2,36000,1.09031610637
100718,100902,102764,184,1862,2,36000,1.09881847476
100750,100919,102959,169,2040,2,36000,1.08284313725
100751,100947,102728,196,1781,2,36000,1.11005053341
100773,100953,102846,180,1893,2,36000,1.09508716323
100774,100958,102669,184,1711,2,36000,1.10753945061
100791,100964,102904,173,1940,2,36000,1.08917525773
100792,100969,102432,177,1463,2,36000,1.12098427888
100808,100975,102693,167,1718,2,36000,1.09720605355
100826,100981,102761,155,1780,2,36000,1.08707865169
100845,100987,103039,142,2052,2,36000,1.06920077973
100860,101015,103035,155,2020,2,36000,1.07673267327
100861,101108,102905,247,1797,2,36000,1.13745130774
100880,101114,102894,234,1780,2,36000,1.13146067416
100896,101150,103040,254,1890,2,36000,1.13439153439
100898,101156,102874,258,1718,2,36000,1.15017462165
100901,100938,100943,37,5,1,900,4.2
100911,101144,101360,233,216,14,7980,2.0787037037
100913,101173,103013,260,1840,2,36000,1.14130434783
100928,101179,102952,251,1773,2,36000,1.1415679639
100944,101185,102932,241,1747,2,36000,1.13795077275
100946,101196,102822,250,1626,2,36000,1.15375153752
100947,101202,102902,255,1700,2,36000,1.15
100963,101226,103107,263,1881,2,36000,1.13981924508
100964,101232,103582,268,2350,2,36000,1.11404255319
100966,101242,102766,276,1524,2,36000,1.1811023622
100981,101249,103235,268,1986,2,36000,1.13494461229
101006,101254,103043,248,1789,2,36000,1.13862493013
101098,101315,103085,217,1770,2,36000,1.12259887006
101113,101326,103353,213,2027,2,36000,1.10508140109
101128,101335,103383,207,2048,2,36000,1.10107421875
101131,101137,101143,6,6,1,900,1.2
101139,101372,101596,233,224,14,9960,2.04017857143
101144,101341,103051,197,1710,2,36000,1.11520467836
101162,101347,103454,185,2107,2,36000,1.08780256289
101178,101364,103193,186,1829,2,36000,1.10169491525
101179,101435,103352,256,1917,2,36000,1.1335419927
101196,101441,103394,245,1953,2,36000,1.12544802867
101197,101447,103348,250,1901,2,36000,1.13150973172
101216,101461,103420,245,1959,2,36000,1.12506380807
101232,101467,103501,235,2034,2,36000,1.11553588987
101233,101484,102943,251,1459,2,36000,1.17203564085
101249,101490,103237,241,1747,2,36000,1.13795077275
101250,101496,103278,246,1782,2,36000,1.13804713805
101306,101502,103309,196,1807,2,36000,1.1084670725
101322,101509,103191,187,1682,2,36000,1.11117717004
101338,101550,103291,212,1741,2,36000,1.12176909822
101339,101593,103727,254,2134,2,36000,1.11902530459
101341,101622,103481,281,1859,2,36000,1.15115653577
101356,101638,103538,282,1900,2,36000,1.14842105263
101358,101425,101430,67,5,1,900,7.2
101367,101607,101860,240,253,14,7980,1.94861660079
101418,101658,103741,240,2083,2,36000,1.11521843495
101433,101748,103853,315,2105,2,36000,1.14964370546
101449,101754,103481,305,1727,2,36000,1.17660683266
101450,101760,103652,310,1892,2,36000,1.16384778013
101466,101769,103678,303,1909,2,36000,1.1587218439
101484,101815,103562,331,1747,2,36000,1.18946765884
101485,101822,103619,337,1797,2,36000,1.18753478019
101487,101886,103750,399,1864,2,36000,1.21405579399
101503,101915,103853,412,1938,2,36000,1.21259029928
101504,101943,103796,439,1853,2,36000,1.23691311387
101541,101949,103988,408,2039,2,36000,1.2000980873
101584,101955,103795,371,1840,2,36000,1.20163043478
101595,101601,101609,6,8,1,900,1.4
101607,101871,102088,264,217,14,9960,2.21658986175
101612,101980,103908,368,1928,2,36000,1.19087136929
101627,101986,103856,359,1870,2,36000,1.19197860963
101649,101997,104081,348,2084,2,36000,1.1669865643
101739,102003,103728,264,1725,2,36000,1.15304347826
101754,102025,103849,271,1824,2,36000,1.1485745614
101756,102082,104031,326,1949,2,36000,1.16726526424
101771,102098,103989,327,1891,2,36000,1.17292437864
101805,102109,104268,304,2159,2,36000,1.14080592867
101820,102124,103990,304,1866,2,36000,1.1629153269
101859,101865,101872,6,7,1,900,1.3
101870,102104,102339,234,235,14,7980,1.99574468085
101876,102137,103957,261,1820,2,36000,1.14340659341
101907,102167,103756,260,1589,2,36000,1.16362492133
101935,102173,103994,238,1821,2,36000,1.130697419
101936,102179,104058,243,1879,2,36000,1.12932410857
101952,102196,103993,244,1797,2,36000,1.13578185865
101970,102229,104064,259,1835,2,36000,1.14114441417
101986,102242,104293,256,2051,2,36000,1.12481716236
101987,102262,104009,275,1747,2,36000,1.1574127075
102002,102278,104267,276,1989,2,36000,1.13876319759
102017,102286,104250,269,1964,2,36000,1.13696537678
102076,102306,104138,230,1832,2,36000,1.12554585153
102086,102092,102099,6,7,1,900,1.3
102091,102348,104178,257,1830,2,36000,1.14043715847
102093,102359,104143,266,1784,2,36000,1.14910313901
102096,102354,102586,258,232,14,9960,2.11206896552
102114,102365,104275,251,1910,2,36000,1.13141361257
102130,102395,104376,265,1981,2,36000,1.13377082282
102157,102427,104115,270,1688,2,36000,1.15995260664
102159,102433,104134,274,1701,2,36000,1.16108171664
102174,102443,104326,269,1883,2,36000,1.14285714286
102190,102497,104305,307,1808,2,36000,1.16980088496
102221,102515,104258,294,1743,2,36000,1.1686746988
102236,102540,104243,304,1703,2,36000,1.17850851439
102252,102560,104425,308,1865,2,36000,1.16514745308
102270,102624,104540,354,1916,2,36000,1.18475991649
102285,102659,104541,374,1882,2,36000,1.19872476089
102301,102665,104551,364,1886,2,36000,1.19300106045
102334,102671,104931,337,2260,2,36000,1.14911504425
102337,102343,102349,6,6,1,900,1.2
102348,102598,102809,250,211,14,7980,2.18483412322
102350,102680,104631,330,1951,2,36000,1.1691440287
102365,102686,104621,321,1935,2,36000,1.16589147287
102384,102703,104704,319,2001,2,36000,1.15942028986
102418,102709,104541,291,1832,2,36000,1.15884279476
102433,102721,104575,288,1854,2,36000,1.15533980583
102434,102739,104482,305,1743,2,36000,1.17498565691
102487,102745,104561,258,1816,2,36000,1.14207048458
102507,102750,104621,243,1871,2,36000,1.12987707108
102532,102772,104720,240,1948,2,36000,1.12320328542
102550,102778,104437,228,1659,2,36000,1.13743218807
102585,102592,102599,7,7,1,900,1.4
102599,102824,103054,225,230,14,9960,1.97826086957
102615,102783,104829,168,2046,2,36000,1.08211143695
102650,102790,104604,140,1814,2,36000,1.07717750827
102666,102818,104614,152,1796,2,36000,1.0846325167
102667,102829,104590,162,1761,2,36000,1.09199318569
102683,102835,104859,152,2024,2,36000,1.07509881423
102684,102857,104598,173,1741,2,36000,1.09936817921
102700,102864,104574,164,1710,2,36000,1.09590643275
102702,102885,104706,183,1821,2,36000,1.10049423394
102705,102715,102829,10,114,1,3600,1.08771929825
102717,102901,104704,184,1803,2,36000,1.10205213533
102733,102907,104685,174,1778,2,36000,1.09786276715
102734,102913,104597,179,1684,2,36000,1.10629453682
102735,102919,104670,184,1751,2,36000,1.10508280982
102764,102924,104697,160,1773,2,36000,1.09024252679
102765,102943,104927,178,1984,2,36000,1.08971774194
102781,102954,104769,173,1815,2,36000,1.09531680441
102783,102964,104652,181,1688,2,36000,1.10722748815
102805,102811,102818,6,7,1,900,1.3
102807,102971,104916,164,1945,2,36000,1.08431876607
102813,103065,103307,252,242,14,7980,2.04132231405
102823,103025,104882,202,1857,2,36000,1.10877759828
102824,103047,105069,223,2022,2,36000,1.11028684471
102846,103053,104993,207,1940,2,36000,1.10670103093
102862,103058,105011,196,1953,2,36000,1.10035842294
102863,102870,102981,7,111,1,1800,1.06306306306
102877,103076,104759,199,1683,2,36000,1.11824123589
102892,103081,105017,189,1936,2,36000,1.09762396694
102909,103096,104842,187,1746,2,36000,1.10710194731
102910,103118,104866,208,1748,2,36000,1.11899313501
102912,103203,105170,291,1967,2,36000,1.14794102694
102913,103209,105104,296,1895,2,36000,1.1562005277
102935,103246,105056,311,1810,2,36000,1.17182320442
102951,103252,104954,301,1702,2,36000,1.17685076381
102966,103289,105124,323,1835,2,36000,1.17602179837
102968,103302,105043,334,1741,2,36000,1.19184376795
103006,103012,103329,6,317,1,3600,1.01892744479
103014,103329,105108,315,1779,2,36000,1.17706576728
103036,103359,105224,323,1865,2,36000,1.17319034853
103052,103365,105518,313,2153,2,36000,1.14537854157
103052,103070,103077,18,7,1,900,2.5
103053,103370,105139,317,1769,2,36000,1.1791972866
103055,103395,105223,340,1828,2,36000,1.18599562363
103056,103405,105251,349,1846,2,36000,1.18905742145
103064,103318,103536,254,218,14,9960,2.16513761468
103087,103431,105304,344,1873,2,36000,1.18366257341
103109,103466,105389,357,1923,2,36000,1.1856474259
103192,103492,105323,300,1831,2,36000,1.1638448935
103207,103497,105372,290,1875,2,36000,1.15466666667
103236,103512,105213,276,1701,2,36000,1.16225749559
103251,103554,105452,303,1898,2,36000,1.15964172813
103276,103573,105114,297,1541,2,36000,1.19273199221
103282,103339,103454,57,115,1,1800,1.49565217391
103291,103593,105435,302,1842,2,36000,1.16395222584
103306,103324,103330,18,6,1,900,2.4
103310,103631,105560,321,1929,2,36000,1.16640746501
103316,103548,103764,232,216,14,7980,2.07407407407
103350,103663,105591,313,1928,2,36000,1.16234439834
103366,103689,105709,323,2020,2,36000,1.1599009901
103367,103737,105573,370,1836,2,36000,1.20152505447
103386,103744,105404,358,1660,2,36000,1.2156626506
103401,103752,105712,351,1960,2,36000,1.17908163265
103423,103761,105621,338,1860,2,36000,1.18172043011
103457,103768,105553,311,1785,2,36000,1.17422969188
103483,103806,105049,323,1243,2,36000,1.25985518906
103484,103812,105198,328,1386,2,36000,1.23665223665
103503,103860,105729,357,1869,2,36000,1.19101123596
103536,103542,103550,6,8,1,900,1.4
103539,103866,105654,327,1788,2,36000,1.18288590604
103549,103780,104029,231,249,14,9960,1.92771084337
103565,103872,105739,307,1867,2,36000,1.16443492234
103583,103878,105567,295,1689,2,36000,1.17465956187
103621,103920,105646,299,1726,2,36000,1.17323290846
103655,103968,105839,313,1871,2,36000,1.16729021913
103680,103999,105797,319,1798,2,36000,1.17741935484
103730,104005,105756,275,1751,2,36000,1.15705311251
103731,104010,105900,279,1890,2,36000,1.14761904762
103747,104016,105825,269,1809,2,36000,1.14870093975
103763,104021,105408,258,1387,2,36000,1.18601297765
103764,104027,105813,263,1786,2,36000,1.14725643897
103764,103774,103780,10,6,1,900,1.6
103770,103791,104386,21,595,1,3600,1.03529411765
103775,104040,104294,265,254,14,7980,2.04330708661
103796,104046,106011,250,1965,2,36000,1.1272264631
103797,104069,105980,272,1911,2,36000,1.14233385662
103850,104075,105952,225,1877,2,36000,1.11987213639
103866,104092,106091,226,1999,2,36000,1.11305652826
103868,104126,105904,258,1778,2,36000,1.14510686164
103869,104145,105921,276,1776,2,36000,1.15540540541
103911,104151,105995,240,1844,2,36000,1.13015184382
103960,104157,105759,197,1602,2,36000,1.12297128589
103989,104189,105393,200,1204,2,36000,1.16611295681
103990,104254,106144,264,1890,2,36000,1.13968253968
104006,104261,106276,255,2015,2,36000,1.12655086849
104008,104269,106205,261,1936,2,36000,1.13481404959
104009,104278,106099,269,1821,2,36000,1.1477210324
104025,104284,105843,259,1559,2,36000,1.16613213598
104027,104033,104040,6,7,1,900,1.3
104035,104310,104535,275,225,14,9960,2.22222222222
104040,104290,106052,250,1762,2,36000,1.14188422247
104062,104304,106244,242,1940,2,36000,1.12474226804
104077,104316,106031,239,1715,2,36000,1.13935860058
104092,104353,106308,261,1955,2,36000,1.13350383632
104097,104103,104608,6,505,1,1800,1.01188118812
104116,104387,106250,271,1863,2,36000,1.14546430488
104135,104436,106179,301,1743,2,36000,1.17269076305
104151,104448,105831,297,1383,2,36000,1.2147505423
104152,104493,106306,341,1813,2,36000,1.18808604523
104180,104552,106334,372,1782,2,36000,1.20875420875
104245,104557,106521,312,1964,2,36000,1.15885947047
104260,104563,106367,303,1804,2,36000,1.16796008869
104262,104569,106226,307,1657,2,36000,1.18527459264
104278,104575,106329,297,1754,2,36000,1.169327252
104280,104585,106300,305,1715,2,36000,1.1778425656
104281,104591,106608,310,2017,2,36000,1.15369360436
104294,104337,104342,43,5,1,900,4.8
104296,104601,106377,305,1776,2,36000,1.17173423423
104303,104546,104764,243,218,14,7980,2.11467889908
104312,104609,106582,297,1973,2,36000,1.15053218449
104328,104614,106338,286,1724,2,36000,1.16589327146
104377,104620,106784,243,2164,2,36000,1.11229205176
104427,104626,106487,199,1861,2,36000,1.10693175712
104442,104632,106441,190,1809,2,36000,1.10503040354
104485,104637,106596,152,1959,2,36000,1.07759060745
104534,104540,104548,6,8,1,900,1.4
104541,104644,106803,103,2159,2,36000,1.04770727189
104543,104663,106563,120,1900,2,36000,1.06315789474
104543,104780,105010,237,230,14,9960,2.03043478261
104544,104682,106384,138,1702,2,36000,1.08108108108
104560,104696,106509,136,1813,2,36000,1.0750137893
104576,104708,106439,132,1731,2,36000,1.07625649913
104578,104715,106429,137,1714,2,36000,1.07992998833
104579,104720,106664,141,1944,2,36000,1.0725308642
104595,104727,106531,132,1804,2,36000,1.07317073171
104611,104733,106639,122,1906,2,36000,1.06400839454
104612,104774,106564,162,1790,2,36000,1.0905027933
104614,104785,106637,171,1852,2,36000,1.09233261339
104631,104840,106768,209,1928,2,36000,1.10840248963
104632,104853,106762,221,1909,2,36000,1.1157674175
104633,104870,106761,237,1891,2,36000,1.12533051296
104634,104877,106579,243,1702,2,36000,1.14277320799
104654,104894,106721,240,1827,2,36000,1.13136288998
104672,104928,106697,256,1769,2,36000,1.14471452798
104688,104938,106840,250,1902,2,36000,1.13144058885
104705,104944,106569,239,1625,2,36000,1.14707692308
104706,104965,106804,259,1839,2,36000,1.14083741164
104707,105005,107019,298,2014,2,36000,1.14796425025
104723,105027,106871,304,1844,2,36000,1.16485900217
104724,105034,106923,310,1889,2,36000,1.16410799365
104761,105054,106891,293,1837,2,36000,1.15949918345
104762,104768,104774,6,6,1,900,1.2
104775,105022,105268,247,246,14,7980,2.00406504065
104777,105060,106916,283,1856,2,36000,1.15247844828
104833,105067,106643,234,1576,2,36000,1.14847715736
104848,105081,106821,233,1740,2,36000,1.13390804598
104864,105115,106997,251,1882,2,36000,1.13336875664
104879,105121,106917,242,1796,2,36000,1.13474387528
104895,105127,107046,232,1919,2,36000,1.12089630016
104916,105136,107037,220,1901,2,36000,1.11572856391
104933,105150,106872,217,1722,2,36000,1.12601626016
104934,105182,107088,248,1906,2,36000,1.13011542497
104956,105209,106980,253,1771,2,36000,1.14285714286
104996,105224,106966,228,1742,2,36000,1.13088404133
105009,105016,105023,7,7,1,900,1.4
105012,105234,107007,222,1773,2,36000,1.12521150592
105018,105279,105496,261,217,14,9960,2.20276497696
105027,105240,107002,213,1762,2,36000,1.12088535755
105046,105262,107064,216,1802,2,36000,1.11986681465
105062,105315,107187,253,1872,2,36000,1.13514957265
105063,105334,107131,271,1797,2,36000,1.15080690039
105079,105383,107233,304,1850,2,36000,1.16432432432
105107,105401,107589,294,2188,2,36000,1.13436928702
105108,105407,107066,299,1659,2,36000,1.18022905365
105124,105417,107142,293,1725,2,36000,1.16985507246
105125,105423,107171,298,1748,2,36000,1.1704805492
105141,105446,107265,305,1819,2,36000,1.16767454645
105172,105463,107307,291,1844,2,36000,1.15780911063
105199,105530,107452,331,1922,2,36000,1.17221644121
105214,105564,107449,350,1885,2,36000,1.18567639257
105230,105571,107667,341,2096,2,36000,1.16269083969
105231,105578,107546,347,1968,2,36000,1.17632113821
105253,105584,107524,331,1940,2,36000,1.1706185567
105265,105272,105279,7,7,1,900,1.4
105274,105507,105751,233,244,14,7980,1.95491803279
105305,105603,107468,298,1865,2,36000,1.15978552279
105324,105632,107503,308,1871,2,36000,1.16461785142
105373,105658,107623,285,1965,2,36000,1.14503816794
105392,105665,107510,273,1845,2,36000,1.14796747967
105408,105720,107701,312,1981,2,36000,1.15749621403
105409,105726,107683,317,1957,2,36000,1.16198262647
105411,105740,107520,329,1780,2,36000,1.18483146067
105439,105751,107684,312,1933,2,36000,1.16140713916
105454,105769,107688,315,1919,2,36000,1.16414799375
105495,105501,105508,6,7,1,900,1.3
105506,105763,105980,257,217,14,9960,2.18433179724
105519,105775,107642,256,1867,2,36000,1.13711837172
105556,105809,108053,253,2244,2,36000,1.11274509804
105572,105824,107844,252,2020,2,36000,1.12475247525
105573,105837,107667,264,1830,2,36000,1.14426229508
105589,105843,107572,254,1729,2,36000,1.14690572585
105604,105850,107551,246,1701,2,36000,1.14462081129
105622,105856,107680,234,1824,2,36000,1.12828947368
105647,105911,107784,264,1873,2,36000,1.14095034704
105662,105917,107668,255,1751,2,36000,1.14563106796
105709,105932,107686,223,1754,2,36000,1.12713797035
105724,105963,107761,239,1798,2,36000,1.13292547275
105741,105996,107906,255,1910,2,36000,1.1335078534
105742,106006,107943,264,1937,2,36000,1.13629323696
105749,105757,105765,8,8,1,900,1.6
105757,106022,107873,265,1851,2,36000,1.14316585629
105759,105991,106237,232,246,14,7980,1.94308943089
105773,106042,107768,269,1726,2,36000,1.15585168019
105800,106063,108019,263,1956,2,36000,1.13445807771
105816,106102,108055,286,1953,2,36000,1.14644137225
105833,106110,107920,277,1810,2,36000,1.15303867403
105834,106155,107929,321,1774,2,36000,1.1809470124
105850,106191,108004,341,1813,2,36000,1.18808604523
105852,106216,108023,364,1807,2,36000,1.20143884892
105895,106237,108181,342,1944,2,36000,1.17592592593
105910,106258,108025,348,1767,2,36000,1.19694397284
105925,106264,108320,339,2056,2,36000,1.16488326848
105953,106287,108036,334,1749,2,36000,1.19096626644
105979,105985,105991,6,6,1,900,1.2
105980,106311,108101,331,1790,2,36000,1.18491620112
105989,106252,106468,263,216,14,9960,2.21759259259
105996,106317,108240,321,1923,2,36000,1.16692667707
106012,106323,108153,311,1830,2,36000,1.16994535519
106033,106341,108137,308,1796,2,36000,1.1714922049
106055,106347,108182,292,1835,2,36000,1.1591280654
106092,106353,108157,261,1804,2,36000,1.14467849224
106107,106378,108270,271,1892,2,36000,1.1432346723
106144,106389,108187,245,1798,2,36000,1.1362625139
106177,106183,106235,6,52,1,1800,1.11538461538
106181,106395,108081,214,1686,2,36000,1.12692763938
106206,106440,108235,234,1795,2,36000,1.13036211699
106228,106450,108227,222,1777,2,36000,1.12492965672
106235,106246,106254,11,8,1,900,1.9
106247,106456,108404,209,1948,2,36000,1.10728952772
106250,106479,106693,229,214,14,7980,2.07009345794
106262,106498,108511,236,2013,2,36000,1.1172379533
106277,106520,108370,243,1850,2,36000,1.13135135135
106302,106532,108305,230,1773,2,36000,1.12972363226
106318,106542,108381,224,1839,2,36000,1.12180532898
106319,106574,108403,255,1829,2,36000,1.13942044833
106335,106580,108294,245,1714,2,36000,1.14294049008
106337,106585,108015,248,1430,2,36000,1.17342657343
106352,106592,108566,240,1974,2,36000,1.12158054711
106370,106598,108537,228,1939,2,36000,1.11758638473
106385,106611,108546,226,1935,2,36000,1.11679586563
106387,106619,108673,232,2054,2,36000,1.1129503408
106430,106648,108485,218,1837,2,36000,1.11867174741
106445,106654,108416,209,1762,2,36000,1.11861520999
106447,106659,108304,212,1645,2,36000,1.12887537994
106466,106473,106479,7,6,1,900,1.3
106475,106705,106959,230,254,14,9960,1.90551181102
106490,106675,108590,185,1915,2,36000,1.09660574413
106511,106711,108726,200,2015,2,36000,1.09925558313
106527,106732,108636,205,1904,2,36000,1.10766806723
106538,106548,106626,10,78,1,1800,1.12820512821
106542,106772,108646,230,1874,2,36000,1.1227321238
106564,106778,108674,214,1896,2,36000,1.11286919831
106581,106784,108647,203,1863,2,36000,1.1089640365
106582,106795,108578,213,1783,2,36000,1.1194615816
106583,106814,108558,231,1744,2,36000,1.13245412844
106599,106820,108626,221,1806,2,36000,1.12236987818
106599,106605,106719,6,114,1,1800,1.05263157895
106600,106832,108669,232,1837,2,36000,1.12629286881
106616,106851,108658,235,1807,2,36000,1.13004980631
106641,106882,108897,241,2015,2,36000,1.11960297767
106643,106888,108694,245,1806,2,36000,1.13565891473
106658,106902,108704,244,1802,2,36000,1.13540510544
106673,106927,108647,254,1720,2,36000,1.1476744186
106692,106699,106706,7,7,1,900,1.4
106698,106933,108774,235,1841,2,36000,1.12764801738
106703,106971,107218,268,247,14,7980,2.08502024291
106723,106939,108481,216,1542,2,36000,1.14007782101
106764,106977,108777,213,1800,2,36000,1.11833333333
106765,106991,108662,226,1671,2,36000,1.13524835428
106780,107008,108990,228,1982,2,36000,1.11503531786
106795,107014,108889,219,1875,2,36000,1.1168
106811,107020,108480,209,1460,2,36000,1.14315068493
106813,107030,108875,217,1845,2,36000,1.11761517615
106828,107048,108918,220,1870,2,36000,1.11764705882
106844,107057,108934,213,1877,2,36000,1.11347895578
106871,107075,108961,204,1886,2,36000,1.10816542948
106873,107081,108854,208,1773,2,36000,1.11731528483
106891,107099,109113,208,2014,2,36000,1.10327706058
106917,107142,108847,225,1705,2,36000,1.13196480938
106918,107154,108986,236,1832,2,36000,1.1288209607
106934,107183,109285,249,2102,2,36000,1.11845861085
106959,106965,106972,6,7,1,900,1.3
106967,107198,109417,231,2219,2,36000,1.10410094637
106968,107230,107465,262,235,14,9960,2.11489361702
106983,107244,109018,261,1774,2,36000,1.14712514092
106999,107276,109118,277,1842,2,36000,1.15038002172
107015,107318,108959,303,1641,2,36000,1.18464351005
107016,107459,109280,443,1821,2,36000,1.24327292696
107031,107471,109382,440,1911,2,36000,1.23024594453
107035,107041,107154,6,113,1,1800,1.05309734513
107047,107484,109321,437,1837,2,36000,1.23788786064
107049,107514,109458,465,1944,2,36000,1.23919753086
107064,107521,109446,457,1925,2,36000,1.2374025974
107080,107532,109216,452,1684,2,36000,1.26840855107
107095,107538,109498,443,1960,2,36000,1.22602040816
107132,107557,109362,425,1805,2,36000,1.23545706371
107147,107563,109335,416,1772,2,36000,1.23476297968
107172,107584,109361,412,1777,2,36000,1.231851435
107188,107601,109549,413,1948,2,36000,1.21201232033
107216,107222,107230,6,8,1,900,1.4
107227,107478,107695,251,217,14,7980,2.15668202765
107234,107635,109688,401,2053,2,36000,1.19532391622
107269,107653,109398,384,1745,2,36000,1.22005730659
107310,107677,109513,367,1836,2,36000,1.19989106754
107452,107683,109494,231,1811,2,36000,1.12755383766
107453,107688,109391,235,1703,2,36000,1.13799177921
107458,107466,107474,8,8,1,900,1.6
107467,107727,107960,260,233,14,9960,2.11587982833
107473,107694,109524,221,1830,2,36000,1.12076502732
107480,107490,107781,10,291,1,1800,1.03436426117
107504,107699,109416,195,1717,2,36000,1.11357018055
107519,107710,109250,191,1540,2,36000,1.12402597403
107535,107715,109249,180,1534,2,36000,1.11734028683
107536,107721,109475,185,1754,2,36000,1.1054732041
107552,107732,109513,180,1781,2,36000,1.1010668164
107554,107772,109619,218,1847,2,36000,1.1180292366
107573,107779,109818,206,2039,2,36000,1.10102991663
107591,107796,109690,205,1894,2,36000,1.10823653643
107625,107855,109608,230,1753,2,36000,1.13120365088
107644,107884,110128,240,2244,2,36000,1.10695187166
107670,107917,109994,247,2077,2,36000,1.11892152143
107671,107931,109714,260,1783,2,36000,1.14582164891
107673,107940,109704,267,1764,2,36000,1.15136054422
107689,107954,109559,265,1605,2,36000,1.16510903427
107691,108015,109983,324,1968,2,36000,1.16463414634
107692,108031,109850,339,1819,2,36000,1.18636613524
107693,107705,107712,12,7,1,900,1.9
107693,108038,110020,345,1982,2,36000,1.17406659939
107695,108043,109852,348,1809,2,36000,1.19237147595
107702,107971,108218,269,247,14,7980,2.08906882591
107710,108049,109939,339,1890,2,36000,1.17936507937
107763,108055,109921,292,1866,2,36000,1.15648445874
107778,108064,110033,286,1969,2,36000,1.14525139665
107794,108070,109845,276,1775,2,36000,1.15549295775
107835,107841,108339,6,498,1,1800,1.01204819277
107846,108092,109789,246,1697,2,36000,1.14496169711
107874,108112,109907,238,1795,2,36000,1.13259052925
107908,108149,109957,241,1808,2,36000,1.13329646018
107923,108164,110136,241,1972,2,36000,1.12221095335
107939,108170,110014,231,1844,2,36000,1.12527114967
107955,108192,109889,237,1697,2,36000,1.13965822039
107957,108026,108033,69,7,1,900,7.6
107970,108229,108459,259,230,14,9960,2.12608695652
108005,108198,109840,193,1642,2,36000,1.11753958587
108022,108203,110064,181,1861,2,36000,1.09725953788
108023,108244,109960,221,1716,2,36000,1.12878787879
108040,108251,110295,211,2044,2,36000,1.10322896282
108041,108256,110076,215,1820,2,36000,1.11813186813
108043,108281,109985,238,1704,2,36000,1.1396713615
108058,108305,110094,247,1789,2,36000,1.13806595864
108060,108315,110218,255,1903,2,36000,1.13399894903
108085,108321,110005,236,1684,2,36000,1.14014251781
108103,108331,110163,228,1832,2,36000,1.12445414847
108138,108381,110141,243,1760,2,36000,1.13806818182
108153,108392,110245,239,1853,2,36000,1.12898003238
108169,108414,110192,245,1778,2,36000,1.13779527559
108186,108420,110327,234,1907,2,36000,1.12270582066
108187,108427,110396,240,1969,2,36000,1.1218892839
108202,108491,110214,289,1723,2,36000,1.16773070226
108215,108239,108244,24,5,1,900,2.9
108223,108471,108686,248,215,14,7980,2.15348837209
108230,108497,110446,267,1949,2,36000,1.13699332991
108246,108502,110240,256,1738,2,36000,1.14729574223
108248,108522,110403,274,1881,2,36000,1.1456671983
108269,108548,110321,279,1773,2,36000,1.15736040609
108302,108557,110410,255,1853,2,36000,1.1376146789
108318,108569,110431,251,1862,2,36000,1.13480128894
108319,108577,110549,258,1972,2,36000,1.130831643
108334,108589,110655,255,2066,2,36000,1.12342691191
108371,108601,110483,230,1882,2,36000,1.12221041445
108386,108637,110370,251,1733,2,36000,1.1448355453
108405,108647,110526,242,1879,2,36000,1.12879191059
108407,108657,110698,250,2041,2,36000,1.12248897599
108422,108663,110526,241,1863,2,36000,1.1293612453
108459,108465,108474,6,9,1,900,1.5
108472,108704,108960,232,256,14,9960,1.90625
108480,108668,110832,188,2164,2,36000,1.08687615527
108497,108675,110925,178,2250,2,36000,1.07911111111
108498,108680,110420,182,1740,2,36000,1.10459770115
108513,108687,110322,174,1635,2,36000,1.10642201835
108539,108692,110328,153,1636,2,36000,1.0935207824
108555,108698,110615,143,1917,2,36000,1.07459572248
108571,108716,110350,145,1634,2,36000,1.08873929009
108572,108721,110479,149,1758,2,36000,1.08475540387
108588,108727,110454,139,1727,2,36000,1.08048639259
108589,108737,110523,148,1786,2,36000,1.08286674132
108626,108785,110539,159,1754,2,36000,1.09064994299
108642,108791,110791,149,2000,2,36000,1.0745
108659,108859,110724,200,1865,2,36000,1.1072386059
108661,108865,110830,204,1965,2,36000,1.10381679389
108662,108886,110689,224,1803,2,36000,1.12423738214
108663,108901,110687,238,1786,2,36000,1.13325867861
108680,108908,110706,228,1798,2,36000,1.12680756396
108681,108929,110672,248,1743,2,36000,1.14228341939
108683,108945,110770,262,1825,2,36000,1.14356164384
108684,108981,110784,297,1803,2,36000,1.16472545757
108684,108710,108715,26,5,1,900,3.1
108693,108976,109219,283,243,14,7980,2.1646090535
108699,108988,110652,289,1664,2,36000,1.17367788462
108715,108997,110708,282,1711,2,36000,1.16481589714
108731,109003,110790,272,1787,2,36000,1.15221040851
108774,109029,110926,255,1897,2,36000,1.1344227728
108790,109124,110937,334,1813,2,36000,1.18422504137
108848,109130,111191,282,2061,2,36000,1.13682678311
108864,109227,111108,363,1881,2,36000,1.19298245614
108880,109266,111123,386,1857,2,36000,1.20786214324
108895,109279,111135,384,1856,2,36000,1.20689655172
108911,109291,111072,380,1781,2,36000,1.21336327906
108926,109297,111311,371,2014,2,36000,1.18421052632
108942,109332,111174,390,1842,2,36000,1.21172638436
108956,108969,108977,13,8,1,900,2.1
108962,109346,111016,384,1670,2,36000,1.22994011976
108964,109372,111225,408,1853,2,36000,1.22018348624
108965,109233,109487,268,254,14,9960,2.05511811024
108989,109378,111143,389,1765,2,36000,1.22039660057
109005,109393,111341,388,1948,2,36000,1.19917864476
109021,109402,111143,381,1741,2,36000,1.21883974727
109114,109410,111438,296,2028,2,36000,1.1459566075
109129,109428,111466,299,2038,2,36000,1.1467124632
109216,109433,111398,217,1965,2,36000,1.11043256997
109217,109260,109268,43,8,1,900,5.1
109225,109498,109747,273,249,14,7980,2.09638554217
109251,109457,111416,206,1959,2,36000,1.10515569168
109252,109470,111376,218,1906,2,36000,1.11437565582
109283,109486,111147,203,1661,2,36000,1.12221553281
109299,109511,111364,212,1853,2,36000,1.11440906638
109324,109522,111175,198,1653,2,36000,1.11978221416
109339,109528,111520,189,1992,2,36000,1.09487951807
109364,109533,110863,169,1330,2,36000,1.12706766917
109365,109540,111428,175,1888,2,36000,1.09269067797
109384,109560,111612,176,2052,2,36000,1.08576998051
109399,109570,111290,171,1720,2,36000,1.09941860465
109400,109619,111435,219,1816,2,36000,1.12059471366
109419,109630,111663,211,2033,2,36000,1.10378750615
109421,109699,111469,278,1770,2,36000,1.15706214689
109448,109705,111382,257,1677,2,36000,1.15324985092
109464,109715,111574,251,1859,2,36000,1.13501882733
109479,109726,111446,247,1720,2,36000,1.14360465116
109485,109505,109511,20,6,1,900,2.6
109495,109758,109975,263,217,14,9960,2.21198156682
109495,109823,111795,328,1972,2,36000,1.16632860041
109511,109829,111642,318,1813,2,36000,1.17539988969
109527,109851,111647,324,1796,2,36000,1.18040089087
109528,109857,111607,329,1750,2,36000,1.188
109530,109863,111748,333,1885,2,36000,1.17665782493
109551,109868,111639,317,1771,2,36000,1.17899491813
109567,109900,111776,333,1876,2,36000,1.17750533049
109608,109918,111741,310,1823,2,36000,1.17004936917
109624,109932,111934,308,2002,2,36000,1.15384615385
109689,109951,111752,262,1801,2,36000,1.14547473626
109705,109969,111951,264,1982,2,36000,1.1331987891
109706,109975,111822,269,1847,2,36000,1.14564158094
109722,110001,111876,279,1875,2,36000,1.1488
109745,109801,109812,56,11,1,900,6.09090909091
109755,109986,110236,231,250,14,7980,1.924
109791,110008,111856,217,1848,2,36000,1.11742424242
109819,110014,111712,195,1698,2,36000,1.1148409894
109841,110020,111735,179,1715,2,36000,1.10437317784
109857,110026,111820,169,1794,2,36000,1.09420289855
109858,110032,111945,174,1913,2,36000,1.09095661265
109860,110044,111845,184,1801,2,36000,1.10216546363
109891,110075,111829,184,1754,2,36000,1.10490307868
109909,110087,111923,178,1836,2,36000,1.09694989107
109924,110105,111902,181,1797,2,36000,1.10072342794
109940,110139,112118,199,1979,2,36000,1.10055583628
109959,110147,111847,188,1700,2,36000,1.11058823529
109960,110153,111870,193,1717,2,36000,1.11240535818
109973,109996,110001,23,5,1,900,2.8
109981,110248,110477,267,229,14,9960,2.16593886463
109987,110174,112046,187,1872,2,36000,1.09989316239
109988,110203,112063,215,1860,2,36000,1.11559139785
110004,110225,111979,221,1754,2,36000,1.1259977195
110021,110231,112216,210,1985,2,36000,1.10579345088
110022,110254,112165,232,1911,2,36000,1.12140240712
110023,110278,112040,255,1762,2,36000,1.14472190692
110039,110306,112280,267,1974,2,36000,1.13525835866
110066,110332,112051,266,1719,2,36000,1.15474112856
110082,110338,112207,256,1869,2,36000,1.13697164259
110097,110343,112216,246,1873,2,36000,1.1313400961
110128,110349,112147,221,1798,2,36000,1.12291434928
110133,115322,115375,5189,53,1,1800,98.9056603774
110144,110362,112055,218,1693,2,36000,1.12876550502
110145,110382,112171,237,1789,2,36000,1.13247624371
110164,110408,112336,244,1928,2,36000,1.1265560166
110195,110415,112272,220,1857,2,36000,1.11847065159
110217,110421,112401,204,1980,2,36000,1.10303030303
110219,110432,112300,213,1868,2,36000,1.11402569593
110234,110260,110266,26,6,1,900,3.2
110244,110488,110709,244,221,14,7980,2.10407239819
110244,110443,112255,199,1812,2,36000,1.10982339956
110260,110458,112338,198,1880,2,36000,1.10531914894
110297,110465,111448,168,983,2,36000,1.17090539166
110322,110499,112204,177,1705,2,36000,1.10381231672
110323,110511,112659,188,2148,2,36000,1.08752327747
110340,110534,112313,194,1779,2,36000,1.10905002811
110341,110540,112443,199,1903,2,36000,1.10457172885
110357,110545,112557,188,2012,2,36000,1.09343936382
110372,110551,112230,179,1679,2,36000,1.10661107802
110397,110560,112444,163,1884,2,36000,1.08651804671
110413,110626,112557,213,1931,2,36000,1.11030554117
110415,110664,112530,249,1866,2,36000,1.13344051447
110430,110670,112646,240,1976,2,36000,1.12145748988
110446,110683,112564,237,1881,2,36000,1.12599681021
110447,110698,112675,251,1977,2,36000,1.12696004047
110463,110704,112407,241,1703,2,36000,1.14151497358
110475,110494,110500,19,6,1,900,2.5
110481,110710,112651,229,1941,2,36000,1.11798042246
110485,110723,110966,238,243,14,9960,1.97942386831
110497,110717,112589,220,1872,2,36000,1.11752136752
110525,110728,112472,203,1744,2,36000,1.11639908257
110527,110753,112949,226,2196,2,36000,1.1029143898
110543,110781,112624,238,1843,2,36000,1.12913727618
110545,110795,112719,250,1924,2,36000,1.12993762994
110560,110801,112509,241,1708,2,36000,1.14110070258
110617,110807,112729,190,1922,2,36000,1.098855359
110654,110841,112735,187,1894,2,36000,1.09873284055
110669,110847,112730,178,1883,2,36000,1.09453000531
110685,110874,112423,189,1549,2,36000,1.12201420271
110701,110936,113029,235,2093,2,36000,1.11227902532
110702,110942,112742,240,1800,2,36000,1.13333333333
110704,110948,112824,244,1876,2,36000,1.13006396588
110707,110735,110742,28,7,1,900,3.5
110716,110977,111184,261,207,14,7980,2.26086956522
110719,111045,112876,326,1831,2,36000,1.17804478427
110721,111084,112800,363,1716,2,36000,1.21153846154
110736,111119,112888,383,1769,2,36000,1.21650650085
110771,111134,113246,363,2112,2,36000,1.171875
110787,111147,112882,360,1735,2,36000,1.20749279539
110802,111154,112893,352,1739,2,36000,1.20241518114
110804,111159,112878,355,1719,2,36000,1.20651541594
110830,111166,112938,336,1772,2,36000,1.18961625282
110845,111185,112997,340,1812,2,36000,1.18763796909
110864,111203,112234,339,1031,2,36000,1.32880698351
110927,111210,113007,283,1797,2,36000,1.15748469672
110928,111236,113077,308,1841,2,36000,1.16730038023
110943,111301,113167,358,1866,2,36000,1.19185423365
110964,111028,111034,64,6,1,900,7.0
110972,111197,111431,225,234,14,9960,1.96153846154
111017,111322,113323,305,2001,2,36000,1.15242378811
111070,111352,113340,282,1988,2,36000,1.14185110664
111110,111375,113265,265,1890,2,36000,1.14021164021
111126,111387,113479,261,2092,2,36000,1.12476099426
111142,111393,113163,251,1770,2,36000,1.1418079096
111144,111409,113275,265,1866,2,36000,1.14201500536
111159,111427,113199,268,1772,2,36000,1.15124153499
111160,111451,113450,291,1999,2,36000,1.14557278639
111176,111456,113409,280,1953,2,36000,1.14336917563
111178,111462,113298,284,1836,2,36000,1.15468409586
111182,111191,111198,9,7,1,900,1.6
111191,111445,111694,254,249,14,7980,2.02008032129
111193,111467,113166,274,1699,2,36000,1.16127133608
111227,111472,113249,245,1777,2,36000,1.13787281936
111292,111479,113352,187,1873,2,36000,1.09983982915
111310,111485,113363,175,1878,2,36000,1.09318423855
111341,111531,113370,190,1839,2,36000,1.10331702012
111366,111585,113381,219,1796,2,36000,1.1219376392
111381,111618,113420,237,1802,2,36000,1.13152053274
111396,111624,113588,228,1964,2,36000,1.11608961303
111412,111650,113581,238,1931,2,36000,1.12325220093
111428,111439,111447,11,8,1,900,1.9
111429,111656,113426,227,1770,2,36000,1.12824858757
111430,111662,113208,232,1546,2,36000,1.15006468305
111437,111706,111954,269,248,14,9960,2.08467741935
111447,111674,113512,227,1838,2,36000,1.12350380849
111448,111740,113678,292,1938,2,36000,1.15067079463
111449,111746,113525,297,1779,2,36000,1.16694772344
111466,111753,113453,287,1700,2,36000,1.16882352941
111482,111759,113410,277,1651,2,36000,1.16777710478
111483,111765,113438,282,1673,2,36000,1.168559474
111520,111787,113577,267,1790,2,36000,1.14916201117
111576,111806,113726,230,1920,2,36000,1.11979166667
111608,111831,113687,223,1856,2,36000,1.12015086207
111623,111837,113784,214,1947,2,36000,1.10991268618
111642,111843,113692,201,1849,2,36000,1.10870740941
111658,111857,113786,199,1929,2,36000,1.10316226024
111659,111862,113707,203,1845,2,36000,1.11002710027
111675,111868,113805,193,1937,2,36000,1.09963861642
111692,111723,111729,31,6,1,900,3.7
111701,111968,112176,267,208,14,7980,2.28365384615
111712,111881,113722,169,1841,2,36000,1.0917979359
111737,111887,113417,150,1530,2,36000,1.09803921569
111754,111914,113772,160,1858,2,36000,1.08611410118
111756,111934,113801,178,1867,2,36000,1.09534011784
111757,111945,113905,188,1960,2,36000,1.09591836735
111779,111956,113953,177,1997,2,36000,1.08863294942
111797,111962,113944,165,1982,2,36000,1.08324924319
111822,112006,113645,184,1639,2,36000,1.11226357535
111837,112051,113756,214,1705,2,36000,1.12551319648
111839,112057,113818,218,1761,2,36000,1.12379329926
111854,112063,113914,209,1851,2,36000,1.11291193949
111855,112069,113210,214,1141,2,36000,1.18755477651
111857,112075,113731,218,1656,2,36000,1.13164251208
111873,112130,113966,257,1836,2,36000,1.13997821351
111888,112158,113996,270,1838,2,36000,1.14689880305
111903,112177,114049,274,1872,2,36000,1.14636752137
111925,112183,114084,258,1901,2,36000,1.13571804314
111941,112221,114265,280,2044,2,36000,1.13698630137
111951,111990,111995,39,5,1,900,4.4
111956,112227,114147,271,1920,2,36000,1.14114583333
111958,112232,114045,274,1813,2,36000,1.15113072256
111959,112189,112422,230,233,14,9960,1.98712446352
111980,112238,114146,258,1908,2,36000,1.13522012579
112041,112244,114086,203,1842,2,36000,1.1102062975
112058,112250,114065,192,1815,2,36000,1.10578512397
112059,112266,114188,207,1922,2,36000,1.10770031217
112060,112283,114117,223,1834,2,36000,1.12159214831
112076,112291,114130,215,1839,2,36000,1.11691136487
112119,112311,114221,192,1910,2,36000,1.10052356021
112149,112325,114127,176,1802,2,36000,1.09766925638
112167,112347,114163,180,1816,2,36000,1.09911894273
112174,112215,112222,41,7,1,900,4.8
112183,112353,114198,170,1845,2,36000,1.09214092141
112183,112434,112683,251,249,14,7980,2.00803212851
112205,112412,114252,207,1840,2,36000,1.1125
112220,112418,114255,198,1837,2,36000,1.10778443114
112222,112454,114279,232,1825,2,36000,1.12712328767
112223,112460,114264,237,1804,2,36000,1.13137472284
112239,112465,114592,226,2127,2,36000,1.10625293841
112240,112484,114181,244,1697,2,36000,1.14378314673
112256,112521,114483,265,1962,2,36000,1.13506625892
112274,112541,114451,267,1910,2,36000,1.13979057592
112290,112568,114336,278,1768,2,36000,1.157239819
112305,112573,114590,268,2017,2,36000,1.1328705999
112320,112579,114461,259,1882,2,36000,1.13761955367
112339,112601,114500,262,1899,2,36000,1.13796735124
112340,112635,114328,295,1693,2,36000,1.174246899
112403,112657,114591,254,1934,2,36000,1.13133402275
112418,112663,114094,245,1431,2,36000,1.17120894479
112420,112440,112444,20,4,1,900,2.4
112430,112694,112906,264,212,14,9960,2.24528301887
112434,112670,114552,236,1882,2,36000,1.12539851222
112451,112705,114458,254,1753,2,36000,1.14489446663
112452,112730,114506,278,1776,2,36000,1.15653153153
112474,112741,114714,267,1973,2,36000,1.13532691333
112511,112746,114687,235,1941,2,36000,1.12107161257
112533,112752,114728,219,1976,2,36000,1.11082995951
112558,112758,114426,200,1668,2,36000,1.11990407674
112559,112811,114660,252,1849,2,36000,1.13628988643
112576,112835,114629,259,1794,2,36000,1.14437012263
112591,112887,114014,296,1127,2,36000,1.26264418811
112626,112893,114501,267,1608,2,36000,1.16604477612
112648,112898,114729,250,1831,2,36000,1.13653741125
112664,112904,114680,240,1776,2,36000,1.13513513514
112665,112909,114587,244,1678,2,36000,1.14541120381
112677,112686,112694,9,8,1,900,1.7
112681,112960,115009,279,2049,2,36000,1.13616398243
112686,112917,113169,231,252,14,7980,1.91666666667
112721,112968,114891,247,1923,2,36000,1.12844513781
112737,113009,114872,272,1863,2,36000,1.14600107354
112738,113018,114736,280,1718,2,36000,1.16298020955
112740,113040,114715,300,1675,2,36000,1.17910447761
112755,113088,114955,333,1867,2,36000,1.17836100696
112802,113185,115078,383,1893,2,36000,1.20232435288
112827,113190,115146,363,1956,2,36000,1.18558282209
112876,113197,114989,321,1792,2,36000,1.17912946429
112892,113211,114940,319,1729,2,36000,1.18449971082
112894,113220,114614,326,1394,2,36000,1.23385939742
112895,113226,114891,331,1665,2,36000,1.1987987988
112904,112949,112957,45,8,1,900,5.3
112911,113257,114983,346,1726,2,36000,1.20046349942
112912,113180,113404,268,224,14,9960,2.19642857143
112939,113263,114891,324,1628,2,36000,1.19901719902
112954,113277,115142,323,1865,2,36000,1.17319034853
112998,113286,115266,288,1980,2,36000,1.14545454545
113013,113309,115113,296,1804,2,36000,1.16407982262
113032,113334,115794,302,2460,2,36000,1.12276422764
113078,113351,115280,273,1929,2,36000,1.14152410575
113166,113363,115248,197,1885,2,36000,1.10450928382
113167,113174,113182,7,8,1,900,1.5
113168,113374,115311,206,1937,2,36000,1.10635002581
113169,113381,115209,212,1828,2,36000,1.11597374179
113176,113415,113663,239,248,14,7980,1.96370967742
113202,113392,115658,190,2266,2,36000,1.08384819064
113218,113420,115285,202,1865,2,36000,1.10831099196
113219,113426,115304,207,1878,2,36000,1.11022364217
113247,113437,115175,190,1738,2,36000,1.10932105869
113248,113444,115428,196,1984,2,36000,1.09879032258
113267,113450,115654,183,2204,2,36000,1.08303085299
113283,113456,115236,173,1780,2,36000,1.09719101124
113298,113462,115252,164,1790,2,36000,1.09162011173
113323,113468,114947,145,1479,2,36000,1.09803921569
113341,113490,115578,149,2088,2,36000,1.07136015326
113357,113523,115375,166,1852,2,36000,1.08963282937
113373,113536,115379,163,1843,2,36000,1.08844275638
113375,113588,115375,213,1787,2,36000,1.11919418019
113390,113594,115319,204,1725,2,36000,1.11826086957
113400,113432,113440,32,8,1,900,4.0
113409,113674,113899,265,225,14,9960,2.17777777778
113410,113600,115613,190,2013,2,36000,1.09438648783
113411,113657,115624,246,1967,2,36000,1.12506354855
113429,113698,115512,269,1814,2,36000,1.14829106946
113430,113704,115399,274,1695,2,36000,1.1616519174
113431,113710,115595,279,1885,2,36000,1.14801061008
113447,113718,115611,271,1893,2,36000,1.14315900687
113463,113733,115572,270,1839,2,36000,1.14681892333
113465,113739,115313,274,1574,2,36000,1.17407878018
113480,113745,115423,265,1678,2,36000,1.1579261025
113515,113767,115546,252,1779,2,36000,1.14165261383
113530,113783,115235,253,1452,2,36000,1.17424242424
113577,113795,115584,218,1789,2,36000,1.12185578535
113593,113801,115526,208,1725,2,36000,1.12057971014
113594,113812,115807,218,1995,2,36000,1.10927318296
113648,113818,114930,170,1112,2,36000,1.15287769784
113660,113689,113696,29,7,1,900,3.6
113670,113910,114151,240,241,14,7980,1.99585062241
113679,113830,115848,151,2018,2,36000,1.07482656095
113695,113925,116189,230,2264,2,36000,1.10159010601
113696,113933,115653,237,1720,2,36000,1.13779069767
113712,113955,116245,243,2290,2,36000,1.10611353712
113728,113965,115688,237,1723,2,36000,1.13755078352
113730,113977,115920,247,1943,2,36000,1.12712300566
113745,114007,115841,262,1834,2,36000,1.14285714286
113761,114025,115881,264,1856,2,36000,1.14224137931
113777,114056,115779,279,1723,2,36000,1.16192687174
113799,114062,115831,263,1769,2,36000,1.14867156586
113800,114076,115903,276,1827,2,36000,1.15106732348
113816,114095,115886,279,1791,2,36000,1.15577889447
113818,114101,115976,283,1875,2,36000,1.15093333333
113833,114107,116000,274,1893,2,36000,1.14474379292
113896,113916,113922,20,6,1,900,2.6
113904,114163,114396,259,233,14,9960,2.11158798283
113908,114128,116158,220,2030,2,36000,1.10837438424
113931,114139,116250,208,2111,2,36000,1.09853150166
113946,114145,116016,199,1871,2,36000,1.10636023517
113962,114168,116035,206,1867,2,36000,1.11033743974
113978,114174,116017,196,1843,2,36000,1.10634834509
113996,114185,115898,189,1713,2,36000,1.11033274956
114015,114192,115913,177,1721,2,36000,1.10284718187
114046,114199,116110,153,1911,2,36000,1.08006279435
114061,114209,116109,148,1900,2,36000,1.07789473684
114077,114232,116013,155,1781,2,36000,1.08702975856
114093,114263,116321,170,2058,2,36000,1.08260447036
114095,114269,116070,174,1801,2,36000,1.09661299278
114111,114275,116085,164,1810,2,36000,1.09060773481
114127,114281,116227,154,1946,2,36000,1.07913669065
114128,114291,116061,163,1770,2,36000,1.09209039548
114144,114339,116266,195,1927,2,36000,1.10119356513
114149,114157,114174,8,17,1,900,1.47058823529
114160,114407,114492,247,85,14,7980,3.90588235294
114164,114347,116147,183,1800,2,36000,1.10166666667
114166,114437,116064,271,1627,2,36000,1.16656422864
114167,114469,116184,302,1715,2,36000,1.17609329446
114184,114475,116435,291,1960,2,36000,1.14846938776
114200,114481,116178,281,1697,2,36000,1.16558632882
114202,114494,116297,292,1803,2,36000,1.16195230172
114223,114511,116614,288,2103,2,36000,1.13694721826
114255,114522,116280,267,1758,2,36000,1.15187713311
114256,114529,116322,273,1793,2,36000,1.15225878416
114273,114564,116319,291,1755,2,36000,1.16581196581
114274,114598,116356,324,1758,2,36000,1.1843003413
114290,114604,116561,314,1957,2,36000,1.16044966786
114331,114609,116422,278,1813,2,36000,1.15333701048
114347,114615,116431,268,1816,2,36000,1.14757709251
114393,114462,114470,69,8,1,900,7.7
114401,114503,114757,102,254,14,9960,1.40157480315
114429,114625,116416,196,1791,2,36000,1.10943606924
114451,114640,116571,189,1931,2,36000,1.0978767478
114467,114672,116570,205,1898,2,36000,1.10800842993
114468,114691,116419,223,1728,2,36000,1.12905092593
114484,114698,116736,214,2038,2,36000,1.10500490677
114490,114517,114518,27,1,1,900,2.8
114503,114725,116530,222,1805,2,36000,1.12299168975
114504,114731,116784,227,2053,2,36000,1.11056989771
114520,114739,116488,219,1749,2,36000,1.12521440823
114558,114745,116429,187,1684,2,36000,1.11104513064
114591,114751,116658,160,1907,2,36000,1.08390141584
114592,114902,116618,310,1716,2,36000,1.18065268065
114594,114907,116823,313,1916,2,36000,1.1633611691
114595,114912,116753,317,1841,2,36000,1.1721890277
114618,114918,116809,300,1891,2,36000,1.15864621893
114633,114941,116680,308,1739,2,36000,1.1771132835
114661,114951,116784,290,1833,2,36000,1.15821058374
114681,114958,116705,277,1747,2,36000,1.15855752719
114697,114967,116851,270,1884,2,36000,1.14331210191
114715,114994,116599,279,1605,2,36000,1.1738317757
114717,115018,116731,301,1713,2,36000,1.17571511967
114736,115024,116881,288,1857,2,36000,1.15508885299
114738,115090,116970,352,1880,2,36000,1.18723404255
114739,115124,117104,385,1980,2,36000,1.19444444444
114754,114883,114892,129,9,1,900,13.8
114762,114768,114993,6,225,14,9960,1.02666666667
114874,115154,117015,280,1861,2,36000,1.15045674369
114894,115160,117063,266,1903,2,36000,1.13977929585
114895,115186,116779,291,1593,2,36000,1.18267419962
114896,115221,117509,325,2288,2,36000,1.14204545455
114931,115252,117096,321,1844,2,36000,1.17407809111
114948,115264,117207,316,1943,2,36000,1.16263510036
114949,115269,117016,320,1747,2,36000,1.18317115054
114964,115275,117138,311,1863,2,36000,1.16693505099
114983,115281,116965,298,1684,2,36000,1.17695961995
114991,115000,115007,9,7,1,900,1.6
114998,115006,115238,8,232,14,9960,1.03448275862
114998,115291,117145,293,1854,2,36000,1.15803667745
115014,115297,117109,283,1812,2,36000,1.15618101545
115080,115315,117115,235,1800,2,36000,1.13055555556
115238,115247,115254,9,7,1,900,1.6
115250,115258,115491,8,233,14,9960,1.03433476395
115490,115496,115505,6,9,1,900,1.5
115503,115510,115743,7,233,14,9960,1.03004291845
115716,115722,115805,6,83,1,1800,1.07228915663
115742,115748,115756,6,8,1,900,1.4
115756,115762,115983,6,221,14,9960,1.02714932127
115982,115987,115995,5,8,1,900,1.3
115993,116000,116219,7,219,14,9960,1.03196347032
116085,116091,118004,6,1913,2,36000,1.00313643492
116086,116097,117803,11,1706,2,36000,1.00644783118
116102,116109,118148,7,2039,2,36000,1.00343305542
116118,116124,117954,6,1830,2,36000,1.00327868852
116119,116130,117884,11,1754,2,36000,1.0062713797
116150,116156,118042,6,1886,2,36000,1.00318133616
116165,116172,117986,7,1814,2,36000,1.00385887541
116181,116187,118079,6,1892,2,36000,1.00317124736
116196,116202,117880,6,1678,2,36000,1.00357568534
116197,116208,117200,11,992,2,36000,1.01108870968
116217,116223,116233,6,10,1,900,1.6
116225,116230,116455,5,225,14,9960,1.02222222222
116228,116236,118116,8,1880,2,36000,1.00425531915
116247,116253,118210,6,1957,2,36000,1.00306591722
116262,116268,118261,6,1993,2,36000,1.00301053688
116277,116283,118104,6,1821,2,36000,1.00329489292
116292,116298,117875,6,1577,2,36000,1.00380469245
116308,116314,117942,6,1628,2,36000,1.00368550369
116323,116329,118170,6,1841,2,36000,1.00325909832
116325,116335,117998,10,1663,2,36000,1.0060132291
116326,116340,118227,14,1887,2,36000,1.00741918389
116357,116363,118142,6,1779,2,36000,1.00337268128
116418,116424,118158,6,1734,2,36000,1.00346020761
116419,116430,118252,11,1822,2,36000,1.00603732162
116436,116442,118091,6,1649,2,36000,1.00363856883
116437,116448,118249,11,1801,2,36000,1.00610771793
116438,116453,118172,15,1719,2,36000,1.00872600349
116440,116458,118266,18,1808,2,36000,1.00995575221
116453,116465,116474,12,9,1,900,2.1
116465,116471,116646,6,175,14,9960,1.03428571429
116489,116495,118427,6,1932,2,36000,1.00310559006
116529,116535,118288,6,1753,2,36000,1.00342270394
116563,116569,118343,6,1774,2,36000,1.00338218715
116579,116585,118550,6,1965,2,36000,1.00305343511
116580,116591,118493,11,1902,2,36000,1.00578338591
116602,116608,118554,6,1946,2,36000,1.00308324769
116617,116624,118284,7,1660,2,36000,1.00421686747
116619,116629,118240,10,1611,2,36000,1.00620732464
116643,116649,116657,6,8,1,900,1.4
116648,116655,118020,7,1365,2,7200,1.00512820513
116658,116665,118540,7,1875,2,36000,1.00373333333
116660,116671,116812,11,141,14,9960,1.0780141844
116683,116690,118699,7,2009,2,36000,1.00348432056
116708,116714,118511,6,1797,2,36000,1.00333889816
116733,116739,118398,6,1659,2,36000,1.00361663653
116748,116754,118352,6,1598,2,36000,1.00375469337
116763,116769,118707,6,1938,2,36000,1.00309597523
116778,116789,117078,11,289,1,1800,1.03806228374
116778,116784,118552,6,1768,2,36000,1.00339366516
116794,116800,118810,6,2010,2,36000,1.00298507463
116795,116806,118613,11,1807,2,36000,1.00608743774
116810,116816,118610,6,1794,2,36000,1.00334448161
116811,116822,116828,11,6,1,900,1.7
116821,116828,116965,7,137,14,9960,1.05109489051
116826,116834,118527,8,1693,2,36000,1.00472533963
116853,116859,118602,6,1743,2,36000,1.00344234079
116883,116890,118609,7,1719,2,36000,1.00407213496
116963,116974,118741,11,1767,2,36000,1.00622524052
116963,116969,116977,6,8,1,900,1.4
116970,116980,117130,10,150,14,9960,1.06666666667
116979,116986,118814,7,1828,2,36000,1.00382932166
117016,117022,118122,6,1100,2,36000,1.00545454545
117017,117028,118861,11,1833,2,36000,1.00600109111
117064,117070,118789,6,1719,2,36000,1.0034904014
117098,117104,118806,6,1702,2,36000,1.00352526439
117113,117119,119016,6,1897,2,36000,1.00316288877
117115,117125,118811,10,1686,2,36000,1.0059311981
117128,117135,117142,7,7,1,900,1.4
117130,117141,118711,11,1570,2,36000,1.00700636943
117142,117148,117322,6,174,14,9960,1.03448275862
117146,117154,118894,8,1740,2,36000,1.00459770115
117147,117159,118792,12,1633,2,36000,1.00734843846
117200,117206,119018,6,1812,2,36000,1.00331125828
117215,117221,118938,6,1717,2,36000,1.00349446709
117318,117324,118866,6,1542,2,14400,1.00389105058
117320,117330,117337,10,7,1,900,1.7
117327,117336,117476,9,140,14,9960,1.06428571429
117432,117438,118944,6,1506,2,14400,1.00398406375
117442,117449,118980,7,1531,2,14400,1.00457217505
117453,117459,118964,6,1505,2,14400,1.00398671096
117464,117470,119005,6,1535,2,14400,1.00390879479
117474,117481,117489,7,8,1,900,1.5
117474,117486,118945,12,1459,2,14400,1.00822481151
117482,117492,117712,10,220,14,9960,1.04545454545
117509,117515,119494,6,1979,2,36000,1.00303183426
117521,117527,119333,6,1806,2,36000,1.00332225914
117522,117533,119398,11,1865,2,36000,1.00589812332
117523,117538,119358,15,1820,2,36000,1.00824175824
117525,117543,119322,18,1779,2,36000,1.01011804384
117526,117549,119379,23,1830,2,36000,1.01256830601
117527,117554,119214,27,1660,2,36000,1.01626506024
117529,117560,119548,31,1988,2,36000,1.01559356137
117530,117565,119472,35,1907,2,36000,1.01835343471
117531,117571,119288,40,1717,2,36000,1.02329644729
117533,117576,119412,43,1836,2,36000,1.0234204793
117534,117581,119405,47,1824,2,36000,1.02576754386
117535,117586,119503,51,1917,2,36000,1.02660406886
117536,117591,119450,55,1859,2,36000,1.02958579882
117538,117597,119447,59,1850,2,36000,1.03189189189
117539,117602,119315,63,1713,2,36000,1.03677758319
117540,117607,119568,67,1961,2,36000,1.03416624171
117542,117612,119350,70,1738,2,36000,1.04027617952
117543,117617,119439,74,1822,2,36000,1.04061470911
117544,117623,119262,79,1639,2,36000,1.04820012203
117546,117628,119584,82,1956,2,36000,1.04192229039
117710,117716,117723,6,7,1,900,1.3
117718,117724,117967,6,243,14,9960,1.02469135802
117805,117811,119575,6,1764,2,36000,1.00340136054
117877,117883,119536,6,1653,2,36000,1.00362976407
117892,117898,119624,6,1726,2,36000,1.00347624565
117893,117904,119573,11,1669,2,36000,1.00659077292
117943,117949,119665,6,1716,2,36000,1.0034965035
117959,117965,119899,6,1934,2,36000,1.00310237849
117966,117972,117980,6,8,1,900,1.4
117980,117986,118157,6,171,14,9960,1.0350877193
117987,117993,119845,6,1852,2,36000,1.00323974082
118002,118008,119867,6,1859,2,36000,1.00322754169
118018,118024,119826,6,1802,2,36000,1.00332963374
118043,118049,119860,6,1811,2,36000,1.00331308669
118080,118086,119718,6,1632,2,36000,1.00367647059
118095,118101,119862,6,1761,2,36000,1.00340715503
118111,118117,120058,6,1941,2,36000,1.00309119011
118126,118132,119925,6,1793,2,36000,1.0033463469
118127,118138,120013,11,1875,2,36000,1.00586666667
118142,118149,120003,7,1854,2,36000,1.00377562028
118156,118162,118169,6,7,1,900,1.3
118158,118168,119971,10,1803,2,36000,1.0055463117
118160,118173,119883,13,1710,2,36000,1.00760233918
118164,118184,137761,20,19577,2,108000,1.00102160699
118169,118179,118354,10,175,14,9960,1.05714285714
118176,118190,120258,14,2068,2,36000,1.00676982592
118177,118196,119951,19,1755,2,36000,1.01082621083
118211,118218,119904,7,1686,2,36000,1.00415183867
118227,118233,120035,6,1802,2,36000,1.00332963374
118243,118249,119464,6,1215,2,36000,1.0049382716
118259,118265,120073,6,1808,2,36000,1.00331858407
118260,118271,120649,11,2378,2,36000,1.00462573591
118277,118283,120211,6,1928,2,36000,1.0031120332
118278,118289,119957,11,1668,2,36000,1.00659472422
118294,118300,120001,6,1701,2,36000,1.00352733686
118295,118306,119897,11,1591,2,36000,1.00691389063
118345,118351,120045,6,1694,2,36000,1.00354191263
118353,118359,118367,6,8,1,900,1.4
118361,118367,120042,6,1675,2,36000,1.00358208955
118368,118374,118586,6,212,14,9960,1.02830188679
118398,118404,120236,6,1832,2,36000,1.00327510917
118429,118435,120051,6,1616,2,36000,1.00371287129
118493,118499,120288,6,1789,2,36000,1.00335382895
118512,118518,120209,6,1691,2,36000,1.00354819633
118528,118534,120400,6,1866,2,36000,1.00321543408
118545,118551,120222,6,1671,2,36000,1.00359066427
118562,118568,120142,6,1574,2,36000,1.00381194409
118563,118574,120656,11,2082,2,36000,1.00528338136
118564,118579,120360,15,1781,2,36000,1.0084222347
118583,118590,118598,7,8,1,900,1.5
118591,118597,118818,6,221,14,9960,1.02714932127
118605,118611,120521,6,1910,2,36000,1.00314136126
118621,118627,120500,6,1873,2,36000,1.00320341698
118622,118633,120570,11,1937,2,36000,1.00567888487
118623,118638,120541,15,1903,2,36000,1.00788229112
118699,118705,120304,6,1599,2,36000,1.00375234522
118715,118721,120706,6,1985,2,36000,1.00302267003
118716,118727,120456,11,1729,2,36000,1.00636205899
118742,118748,120617,6,1869,2,36000,1.00321027287
118792,118799,120645,7,1846,2,36000,1.00379198267
118794,118804,120822,10,2018,2,36000,1.00495540139
118809,118816,120527,7,1711,2,36000,1.00409117475
118811,118822,120543,11,1721,2,36000,1.00639163277
118817,118828,118834,11,6,1,900,1.7
118827,118839,120630,12,1791,2,36000,1.0067001675
118827,118834,119045,7,211,14,9960,1.03317535545
118828,118844,120746,16,1902,2,36000,1.00841219769
118862,118868,120628,6,1760,2,36000,1.00340909091
118896,118902,120707,6,1805,2,36000,1.00332409972
118939,118945,120673,6,1728,2,36000,1.00347222222
119016,119022,120719,6,1697,2,36000,1.00353565115
119033,119039,120748,6,1709,2,36000,1.00351082504
119041,119047,119055,6,8,1,900,1.4
119049,119056,119230,7,174,14,9960,1.04022988506
119213,119219,121266,6,2047,2,36000,1.00293111871
119228,119234,119241,6,7,1,900,1.3
119240,119246,119412,6,166,14,9960,1.03614457831
119263,119269,121008,6,1739,2,36000,1.00345025877
119289,119295,121229,6,1934,2,36000,1.00310237849
119317,119324,121216,7,1892,2,36000,1.00369978858
119333,119339,121092,6,1753,2,36000,1.00342270394
119348,119355,120811,7,1456,2,36000,1.00480769231
119364,119370,121246,6,1876,2,36000,1.00319829424
119366,119376,121236,10,1860,2,36000,1.00537634409
119381,119387,121309,6,1922,2,36000,1.00312174818
119401,119407,121447,6,2040,2,36000,1.00294117647
119411,119418,119426,7,8,1,900,1.5
119417,119424,121262,7,1838,2,36000,1.00380848749
119418,119429,121319,11,1890,2,36000,1.00582010582
119423,119475,119642,52,167,14,9960,1.31137724551
119440,119446,120525,6,1079,2,36000,1.00556070436
119456,119462,121352,6,1890,2,36000,1.00317460317
119457,119468,121296,11,1828,2,36000,1.00601750547
119473,119481,121098,8,1617,2,36000,1.00494743352
119474,119486,120908,12,1422,2,36000,1.00843881857
119493,119499,121117,6,1618,2,36000,1.00370828183
119509,119515,121381,6,1866,2,36000,1.00321543408
119537,119543,121526,6,1983,2,36000,1.00302571861
119553,119559,121363,6,1804,2,36000,1.00332594235
119568,119574,121271,6,1697,2,36000,1.00353565115
119584,119590,121550,6,1960,2,36000,1.00306122449
119586,119596,121501,10,1905,2,36000,1.00524934383
119587,119601,121498,14,1897,2,36000,1.0073800738
119627,119633,121570,6,1937,2,36000,1.00309757357
119641,119647,119654,6,7,1,900,1.3
119653,119659,119835,6,176,14,9960,1.03409090909
119667,119673,121463,6,1790,2,36000,1.00335195531
119721,119727,121563,6,1836,2,36000,1.00326797386
119829,119835,121732,6,1897,2,36000,1.00316288877
119830,121240,153443,1410,32203,128,36000,1.04378474055
119833,119841,119847,8,6,1,900,1.4
119836,153454,185562,33618,32108,128,36000,2.04702877787
119839,119847,119929,8,82,14,9960,1.09756097561
119847,119853,121672,6,1819,2,36000,1.00329851567
119863,119869,121796,6,1927,2,36000,1.00311364816
119864,119875,121622,11,1747,2,36000,1.0062965083
119880,119886,121766,6,1880,2,36000,1.00319148936
119881,119892,121807,11,1915,2,36000,1.00574412533
119901,119907,121801,6,1894,2,36000,1.00316789863
119902,119913,121783,11,1870,2,36000,1.00588235294
119918,119924,121821,6,1897,2,36000,1.00316288877
119925,119932,119933,7,1,1,900,1.0
119933,119939,121661,6,1722,2,36000,1.00348432056
119952,119958,121629,6,1671,2,36000,1.00359066427
119967,119974,121687,7,1713,2,36000,1.00408639813
119983,119989,121689,6,1700,2,36000,1.00352941176
120002,120008,122066,6,2058,2,36000,1.0029154519
120018,120024,121866,6,1842,2,36000,1.00325732899
120019,120030,121812,11,1782,2,36000,1.00617283951
120038,120049,121421,11,1372,2,36000,1.00801749271
120055,120061,121892,6,1831,2,36000,1.00327689787
120056,120067,121631,11,1564,2,36000,1.00703324808
120057,120072,122031,15,1959,2,36000,1.00765696784
120074,120080,122079,6,1999,2,36000,1.00300150075
120075,120086,122090,11,2004,2,36000,1.00548902196
120146,120151,122034,5,1883,2,36000,1.00265533723
120210,120217,122036,7,1819,2,36000,1.00384826828
120226,120232,121975,6,1743,2,36000,1.00344234079
120227,120536,122312,309,1776,2,36000,1.17398648649
120243,120919,122681,676,1762,2,36000,1.38365493757
120258,121109,122776,851,1667,2,36000,1.51049790042
120290,121128,122806,838,1678,2,36000,1.49940405244
120305,121247,123071,942,1824,2,36000,1.51644736842
120360,121258,123005,898,1747,2,36000,1.51402404121
120374,185573,221610,65199,36037,128,36000,2.80922385326
120400,121282,123024,882,1742,2,36000,1.50631458094
120457,121307,123349,850,2042,2,36000,1.41625857003
120503,121320,123152,817,1832,2,36000,1.44596069869
120522,121363,123172,841,1809,2,36000,1.46489773355
120540,121392,123474,852,2082,2,36000,1.40922190202
120541,121432,123295,891,1863,2,36000,1.47826086957
120542,121459,123232,917,1773,2,36000,1.51720248167
120558,121509,123230,951,1721,2,36000,1.55258570598
120573,121515,123456,942,1941,2,36000,1.48531684699
120617,121537,123312,920,1775,2,36000,1.51830985915
120633,121581,123420,948,1839,2,36000,1.51549755302
120635,121633,123515,998,1882,2,36000,1.5302869288
120650,121640,123318,990,1678,2,36000,1.58998808105
120652,121646,123227,994,1581,2,36000,1.62871600253
120668,121673,123284,1005,1611,2,36000,1.62383612663
120683,121683,123348,1000,1665,2,36000,1.6006006006
120708,121699,123381,991,1682,2,36000,1.58917954816
120710,121705,123433,995,1728,2,36000,1.57581018519
120725,121777,123510,1052,1733,2,36000,1.60703981535
120747,121795,123571,1048,1776,2,36000,1.59009009009
120763,121807,123626,1044,1819,2,36000,1.57394172622
120812,121813,123931,1001,2118,2,36000,1.47261567517
120819,158060,158065,37241,5,4,288000,3724.6
120827,121819,123624,992,1805,2,36000,1.54958448753
120907,121825,123511,918,1686,2,36000,1.54448398577
121008,121832,123399,824,1567,2,36000,1.52584556477
121091,121877,123101,786,1224,2,36000,1.64215686275
121106,121903,123580,797,1677,2,36000,1.47525342874
121122,121987,123650,865,1663,2,36000,1.5201443175
121217,122042,123820,825,1778,2,36000,1.46400449944
121233,122048,123802,815,1754,2,36000,1.46465222349
121249,122053,123763,804,1710,2,36000,1.4701754386
121250,122077,123826,827,1749,2,36000,1.47284162379
121266,122090,123971,824,1881,2,36000,1.43806485912
121267,122101,124144,834,2043,2,36000,1.40822320117
121282,122323,123970,1041,1647,2,36000,1.6320582878
121297,122692,124333,1395,1641,2,36000,1.85009140768
121313,122788,124524,1475,1736,2,36000,1.84965437788
121328,122817,124375,1489,1558,2,36000,1.95571245186
121349,123016,124776,1667,1760,2,36000,1.94715909091
121364,123035,124902,1671,1867,2,36000,1.89501874665
121379,123082,124818,1703,1736,2,36000,1.98099078341
121419,123112,124863,1693,1751,2,36000,1.96687607082
121446,123163,124809,1717,1646,2,36000,2.04313487242
121465,123183,124915,1718,1732,2,36000,1.99191685912
121499,123239,124908,1740,1669,2,36000,2.04254044338
121500,123245,124962,1745,1717,2,36000,2.0163075131
121528,123250,124959,1722,1709,2,36000,2.0076067876
121552,123295,125250,1743,1955,2,36000,1.8915601023
121568,123306,125211,1738,1905,2,36000,1.91233595801
121569,123323,125308,1754,1985,2,36000,1.88362720403
121621,123329,125202,1708,1873,2,36000,1.9119060331
121637,123359,125156,1722,1797,2,36000,1.95826377295
121638,123365,125248,1727,1883,2,36000,1.91715347849
121660,123392,124927,1732,1535,2,36000,2.12833876221
121675,123410,124556,1735,1146,2,36000,2.51396160558
121691,123432,125161,1741,1729,2,36000,2.00694042799
121692,123444,124955,1752,1511,2,36000,2.15949702184
121729,123468,125411,1739,1943,2,36000,1.89500772002
121765,123485,125512,1720,2027,2,36000,1.84854464726
121783,123521,125112,1738,1591,2,36000,2.0923947203
121799,123527,125186,1728,1659,2,36000,2.04159132007
121801,123532,125474,1731,1942,2,36000,1.89134912461
121816,123582,125415,1766,1833,2,36000,1.96344789962
121818,123591,125461,1773,1870,2,36000,1.94812834225
121833,123636,125301,1803,1665,2,36000,2.08288288288
121864,123642,125343,1778,1701,2,36000,2.04526748971
121891,123662,125257,1771,1595,2,36000,2.11034482759
121975,123774,125460,1799,1686,2,36000,2.06702253855
122031,123813,125490,1782,1677,2,36000,2.0626118068
122032,123831,125813,1799,1982,2,36000,1.90766902119
122049,123837,125650,1788,1813,2,36000,1.9862107005
122066,123942,125679,1876,1737,2,36000,2.08002302821
122085,123981,125760,1896,1779,2,36000,2.06576728499
122100,123987,125924,1887,1937,2,36000,1.97418688694
122316,124155,126172,1839,2017,2,36000,1.91175012395
122690,124344,126020,1654,1676,2,36000,1.98687350835
122776,124386,126001,1610,1615,2,36000,1.99690402477
122805,124535,126213,1730,1678,2,36000,2.03098927294
123005,124567,126325,1562,1758,2,36000,1.88850967008
123024,124787,126508,1763,1721,2,36000,2.02440441604
123073,124820,126608,1747,1788,2,36000,1.97706935123
123106,124830,126694,1724,1864,2,36000,1.92489270386
123155,124875,126477,1720,1602,2,36000,2.07365792759
123177,124913,126546,1736,1633,2,36000,2.06307409675
123225,124919,126707,1694,1788,2,36000,1.94742729306
123242,124927,126259,1685,1332,2,36000,2.26501501502
123243,124938,126673,1695,1735,2,36000,1.97694524496
123284,124967,126637,1683,1670,2,36000,2.00778443114
123300,124973,126725,1673,1752,2,36000,1.9549086758
123317,124978,126775,1661,1797,2,36000,1.92431830829
123318,125123,126822,1805,1699,2,36000,2.06238964097
124799,158076,381458,33277,223382,4,604800,1.14896903063
124834,125168,126811,334,1643,2,36000,1.20328667072
124869,125174,126960,305,1786,2,36000,1.17077267637
124902,125197,126866,295,1669,2,36000,1.17675254643
124918,125214,126987,296,1773,2,36000,1.16694867456
124919,125222,126882,303,1660,2,36000,1.18253012048
124935,125259,127108,324,1849,2,36000,1.17522985398
124957,125265,126835,308,1570,2,36000,1.19617834395
124974,125271,126860,297,1589,2,36000,1.18691000629
124975,125312,127090,337,1778,2,36000,1.18953880765
125155,125320,127013,165,1693,2,36000,1.09746012995
125171,125355,127184,184,1829,2,36000,1.10060142154
125173,125422,126929,249,1507,2,36000,1.16522893165
125188,125428,127329,240,1901,2,36000,1.12624934245
125204,125471,127054,267,1583,2,36000,1.16866708781
125220,125477,127311,257,1834,2,36000,1.1401308615
125250,125485,127392,235,1907,2,36000,1.12323020451
125251,125501,127144,250,1643,2,36000,1.15216068168
125267,125523,127404,256,1881,2,36000,1.13609782031
125303,125662,127340,359,1678,2,36000,1.21394517282
125319,125691,127748,372,2057,2,36000,1.18084589208
125344,125771,127397,427,1626,2,36000,1.26260762608
125412,125825,127600,413,1775,2,36000,1.23267605634
125428,125936,127693,508,1757,2,36000,1.2891291975
125461,126012,127959,551,1947,2,36000,1.28299948639
125462,126031,127818,569,1787,2,36000,1.31841074426
125478,126187,127873,709,1686,2,36000,1.42052194543
125494,126224,127882,730,1658,2,36000,1.44028950543
125513,126270,127905,757,1635,2,36000,1.4629969419
125654,126336,128048,682,1712,2,36000,1.39836448598
125682,126488,128217,806,1729,2,36000,1.46616541353
125761,126520,128328,759,1808,2,36000,1.41980088496
125803,158065,158066,32262,1,2,345600,3226.3
125806,158082,158083,32276,1,2,345600,3227.7
125814,126557,128560,743,2003,2,36000,1.37094358462
125817,158111,158112,32294,1,2,345600,3229.5
125925,126619,128184,694,1565,2,36000,1.44345047923
126001,126648,128293,647,1645,2,36000,1.39331306991
126024,126684,128385,660,1701,2,36000,1.38800705467
126174,126705,128541,531,1836,2,36000,1.28921568627
126175,126181,126271,6,90,14,7980,1.06666666667
126216,126718,128300,502,1582,2,36000,1.31731984829
126258,126737,128324,479,1587,2,36000,1.3018273472
126269,126276,126290,7,14,1,900,1.5
126276,126282,126385,6,103,14,7980,1.05825242718
126326,126786,128772,460,1986,2,36000,1.23162134945
126372,126378,126420,6,42,1,900,1.14285714286
126381,126397,126497,16,100,14,7980,1.16
126480,126823,128399,343,1576,2,36000,1.21763959391
126495,126501,126513,6,12,1,900,1.5
126503,126509,126673,6,164,14,7980,1.03658536585
126511,126833,128743,322,1910,2,36000,1.16858638743
126549,126846,128632,297,1786,2,36000,1.16629339306
126611,126871,128562,260,1691,2,36000,1.15375517445
126639,126877,128678,238,1801,2,36000,1.13214880622
126671,126677,126688,6,11,1,900,1.54545454545
126677,126893,128688,216,1795,2,36000,1.12033426184
126680,126690,126928,10,238,14,7980,1.04201680672
126695,126939,129117,244,2178,2,36000,1.11202938476
126711,126971,128691,260,1720,2,36000,1.1511627907
126728,126998,128880,270,1882,2,36000,1.14346439957
126775,127024,128711,249,1687,2,36000,1.14759928868
126812,127065,128961,253,1896,2,36000,1.13343881857
126830,127101,128799,271,1698,2,36000,1.15959952886
126845,127119,128931,274,1812,2,36000,1.15121412804
126861,127175,128942,314,1767,2,36000,1.17770232032
126881,127196,128470,315,1274,2,36000,1.24725274725
126897,127322,129479,425,2157,2,36000,1.19703291609
126926,126932,126943,6,11,1,900,1.54545454545
126929,127341,129169,412,1828,2,36000,1.22538293217
126935,126945,127179,10,234,14,7980,1.04273504274
126963,127351,128909,388,1558,2,36000,1.24903722721
126988,127403,129455,415,2052,2,36000,1.2022417154
127017,127409,128895,392,1486,2,36000,1.26379542396
127055,127415,129254,360,1839,2,36000,1.19575856444
127093,127611,129374,518,1763,2,36000,1.29381735678
127108,127704,129481,596,1777,2,36000,1.33539673607
127171,127759,129502,588,1743,2,36000,1.33734939759
127176,127182,127195,6,13,1,900,1.46153846154
127184,127190,127354,6,164,14,7980,1.03658536585
127186,127829,129328,643,1499,2,36000,1.42895263509
127314,127884,129900,570,2016,2,36000,1.28273809524
127329,127893,129688,564,1795,2,36000,1.31420612813
127345,127917,129598,572,1681,2,36000,1.34027364664
127352,127358,127367,6,9,1,900,1.5
127361,127367,127617,6,250,14,7980,1.024
127397,127971,129713,574,1742,2,36000,1.32950631458
127398,128059,129853,661,1794,2,36000,1.36845039019
127418,128195,129824,777,1629,2,36000,1.47697974217
127600,128228,129573,628,1345,2,36000,1.46691449814
127615,127621,127685,6,64,1,900,1.09375
127623,127629,127972,6,343,14,7980,1.01749271137
127693,128305,130107,612,1802,2,36000,1.33962264151
127715,158128,254205,30413,96077,2,108000,1.31654818531
127749,128311,129976,562,1665,2,36000,1.33753753754
127821,128335,129770,514,1435,2,36000,1.35818815331
127874,128341,129979,467,1638,2,36000,1.2851037851
127906,128396,130047,490,1651,2,36000,1.29678982435
127907,128411,130354,504,1943,2,36000,1.25939269171
127962,128481,130430,519,1949,2,36000,1.26629040534
127970,127977,127990,7,13,1,900,1.53846153846
127978,127983,128227,5,244,14,7980,1.02049180328
128048,128553,130689,505,2136,2,36000,1.23642322097
128193,128572,130370,379,1798,2,36000,1.21078976641
128218,128578,130150,360,1572,2,36000,1.22900763359
128226,128234,128247,8,13,1,900,1.61538461538
128235,128241,128489,6,248,14,7980,1.02419354839
128296,128645,130277,349,1632,2,36000,1.21384803922
128312,128689,130395,377,1706,2,36000,1.22098475967
128328,128699,130462,371,1763,2,36000,1.21043675553
128344,128705,130491,361,1786,2,36000,1.20212765957
128385,128723,130451,338,1728,2,36000,1.19560185185
128412,128754,130387,342,1633,2,36000,1.20943049602
128470,128784,130608,314,1824,2,36000,1.17214912281
128487,128493,128505,6,12,1,900,1.5
128492,128499,135966,7,7467,1,439200,1.00093745815
128495,128505,128758,10,253,14,7980,1.0395256917
128499,135980,135982,7481,2,1,439200,748.3
128544,128810,130611,266,1801,2,36000,1.1476957246
128565,128891,130624,326,1733,2,36000,1.18811309867
128567,128906,130792,339,1886,2,36000,1.17974549311
128632,128920,130776,288,1856,2,36000,1.15517241379
128685,128942,131312,257,2370,2,36000,1.10843881857
128702,128953,130745,251,1792,2,36000,1.14006696429
128720,128973,130807,253,1834,2,36000,1.13794983642
128746,129129,130992,383,1863,2,36000,1.20558239399
128757,128764,128776,7,12,1,900,1.58333333333
128766,128772,129024,6,252,14,7980,1.02380952381
128776,129199,131137,423,1938,2,36000,1.21826625387
128800,129266,131035,466,1769,2,36000,1.26342566422
128882,129339,130963,457,1624,2,36000,1.28140394089
128908,129386,131202,478,1816,2,36000,1.26321585903
128909,129467,131394,558,1927,2,36000,1.28956927867
128943,129489,131665,546,2176,2,36000,1.25091911765
128944,129496,131398,552,1902,2,36000,1.29022082019
128963,129513,131467,550,1954,2,36000,1.28147389969
129022,129028,129040,6,12,1,900,1.5
129030,129036,129312,6,276,14,7980,1.02173913043
129070,241575,320080,112505,78505,2,108000,2.43309343354
129118,129585,131345,467,1760,2,36000,1.26534090909
129197,129614,131238,417,1624,2,36000,1.25677339901
129256,129700,131341,444,1641,2,36000,1.27056672761
129305,129311,129331,6,20,1,900,1.3
129315,129323,129606,8,283,14,7980,1.02826855124
129335,129724,131446,389,1722,2,36000,1.22590011614
129377,129781,131506,404,1725,2,36000,1.23420289855
129456,129835,130979,379,1144,2,36000,1.33129370629
129482,129865,131577,383,1712,2,36000,1.22371495327
129483,129911,131541,428,1630,2,36000,1.26257668712
129502,129988,131522,486,1534,2,36000,1.31681877445
129575,129994,131638,419,1644,2,36000,1.25486618005
129597,130059,131841,462,1782,2,36000,1.25925925926
129603,129609,129621,6,12,1,900,1.5
129611,129620,129931,9,311,14,7980,1.02893890675
129706,130118,131167,412,1049,2,36000,1.39275500477
129721,130162,131651,441,1489,2,36000,1.29617192747
129771,130289,131946,518,1657,2,36000,1.31261315631
129825,130365,132161,540,1796,2,36000,1.30066815145
129854,130382,132351,528,1969,2,36000,1.26815642458
129900,130398,131764,498,1366,2,36000,1.36456808199
129913,129920,129969,7,49,1,900,1.14285714286
129931,129942,130243,11,301,14,7980,1.0365448505
129978,130406,132405,428,1999,2,36000,1.21410705353
129979,130441,132476,462,2035,2,36000,1.22702702703
130050,130462,132254,412,1792,2,36000,1.22991071429
130109,130473,132168,364,1695,2,36000,1.21474926254
130154,130503,132318,349,1815,2,36000,1.19228650138
130240,130247,130261,7,14,1,900,1.5
130248,130254,130518,6,264,14,7980,1.02272727273
130279,130620,132688,341,2068,2,36000,1.16489361702
130357,130626,132536,269,1910,2,36000,1.14083769634
130372,130635,132386,263,1751,2,36000,1.15019988578
130388,130701,132517,313,1816,2,36000,1.17235682819
130404,130756,132649,352,1893,2,36000,1.18594823032
130436,130791,132615,355,1824,2,36000,1.19462719298
130457,130803,132577,346,1774,2,36000,1.19503945885
130473,130818,132375,345,1557,2,36000,1.22157996146
130492,130974,132842,482,1868,2,36000,1.25802997859
130515,130521,130530,6,9,1,900,1.5
130524,130530,130781,6,251,14,7980,1.02390438247
130610,130991,132777,381,1786,2,36000,1.21332586786
130611,131004,133085,393,2081,2,36000,1.1888515137
130627,131046,132760,419,1714,2,36000,1.24445740957
130700,131148,133089,448,1941,2,36000,1.23080886141
130746,131178,132850,432,1672,2,36000,1.25837320574
130775,131214,132933,439,1719,2,36000,1.25538103549
130778,130785,130796,7,11,1,900,1.63636363636
130787,130797,131090,10,293,14,7980,1.03412969283
130795,131249,132939,454,1690,2,36000,1.26863905325
130810,131323,133206,513,1883,2,36000,1.27243759958
130967,131352,133173,385,1821,2,36000,1.21142229544
130983,131363,133046,380,1683,2,36000,1.22578728461
130999,131405,133284,406,1879,2,36000,1.21607237892
131037,131411,133306,374,1895,2,36000,1.19736147757
131088,131094,131106,6,12,1,900,1.5
131096,131102,131345,6,243,14,7980,1.02469135802
131139,131457,133060,318,1603,2,36000,1.19837804117
131178,131478,133361,300,1883,2,36000,1.15932023367
131212,131518,133178,306,1660,2,36000,1.1843373494
131240,131533,133139,293,1606,2,36000,1.18244084682
131314,131552,133425,238,1873,2,36000,1.12706887347
131338,131344,131355,6,11,1,900,1.54545454545
131343,131589,133270,246,1681,2,36000,1.14634146341
131345,131358,131654,13,296,14,7980,1.04391891892
131358,131649,133260,291,1611,2,36000,1.18063314711
131396,131664,133330,268,1666,2,36000,1.16086434574
131411,131676,133505,265,1829,2,36000,1.14488791689
131458,131775,133581,317,1806,2,36000,1.17552602436
131474,131852,133630,378,1778,2,36000,1.2125984252
131508,131958,133677,450,1719,2,36000,1.26178010471
131524,132175,134048,651,1873,2,36000,1.34757074212
131542,132181,134091,639,1910,2,36000,1.33455497382
131580,132266,134028,686,1762,2,36000,1.38933030647
131639,132329,134176,690,1847,2,36000,1.37357877639
131652,131658,131664,6,6,1,900,1.2
131654,132362,134235,708,1873,2,36000,1.37800320342
131660,131670,131932,10,262,14,7980,1.03816793893
131669,132387,134258,718,1871,2,36000,1.38375200428
131764,132397,134094,633,1697,2,36000,1.37301119623
131840,132416,134173,576,1757,2,36000,1.32783153102
131930,131936,131942,6,6,1,900,1.2
131937,131943,132224,6,281,14,7980,1.02135231317
131947,132487,134204,540,1717,2,36000,1.31450203844
132161,132528,134291,367,1763,2,36000,1.20816789563
132163,132169,132171,6,2,2,14400,1.0
132176,132547,134503,371,1956,2,36000,1.18967280164
132223,132229,132237,6,8,1,900,1.4
132235,132241,132503,6,262,14,7980,1.02290076336
132256,132588,134387,332,1799,2,36000,1.18454697054
132318,132626,134524,308,1898,2,36000,1.16227608008
132352,132660,134438,308,1778,2,36000,1.17322834646
132377,132699,134619,322,1920,2,36000,1.16770833333
132392,132771,134824,379,2053,2,36000,1.18460789089
132408,132791,134516,383,1725,2,36000,1.22202898551
132476,132853,134765,377,1912,2,36000,1.19717573222
132500,132506,132513,6,7,1,900,1.3
132508,132514,132781,6,267,14,7980,1.02247191011
132519,132861,134487,342,1626,2,36000,1.21033210332
132538,132944,134588,406,1644,2,36000,1.24695863747
132577,132950,134610,373,1660,2,36000,1.22469879518
132617,133057,134626,440,1569,2,36000,1.28043339707
132655,133076,134805,421,1729,2,36000,1.24349334876
132689,133096,135660,407,2564,2,36000,1.15873634945
132762,133102,134960,340,1858,2,36000,1.18299246502
132778,133150,134843,372,1693,2,36000,1.21972829297
132779,132785,132791,6,6,1,900,1.2
132787,132797,133065,10,268,14,7980,1.03731343284
132845,133184,134928,339,1744,2,36000,1.19438073394
132860,133190,134970,330,1780,2,36000,1.18539325843
132935,133218,134917,283,1699,2,36000,1.16656856975
132950,133271,134849,321,1578,2,36000,1.20342205323
133048,133281,135132,233,1851,2,36000,1.12587790384
133064,133070,133078,6,8,1,900,1.4
133065,133295,135206,230,1911,2,36000,1.12035583464
133072,133082,133359,10,277,14,7980,1.03610108303
133086,133317,134989,231,1672,2,36000,1.13815789474
133102,133341,134900,239,1559,2,36000,1.15330339962
133141,133377,135115,236,1738,2,36000,1.13578826237
133175,133436,135059,261,1623,2,36000,1.16081330869
133190,133516,135276,326,1760,2,36000,1.18522727273
133208,133592,135175,384,1583,2,36000,1.24257738471
133261,133641,135139,380,1498,2,36000,1.25367156208
133276,133689,135533,413,1844,2,36000,1.22396963124
133291,134039,135776,748,1737,2,36000,1.43062751871
133307,134059,135981,752,1922,2,36000,1.3912591051
133331,134103,135941,772,1838,2,36000,1.42002176279
133357,133363,133370,6,7,1,900,1.3
133362,134109,135884,747,1775,2,36000,1.42084507042
133365,133371,133646,6,275,14,7980,1.02181818182
133368,221622,228045,88254,6423,128,36000,14.7403082672
133428,134184,136011,756,1827,2,36000,1.41379310345
133507,134190,135834,683,1644,2,36000,1.41545012165
133584,134216,135934,632,1718,2,36000,1.36786961583
133632,134246,136110,614,1864,2,36000,1.32939914163
133643,133649,133658,6,9,1,900,1.5
133652,133658,133908,6,250,14,7980,1.024
133906,133912,133922,6,10,1,900,1.6
133914,133919,134189,5,270,14,7980,1.01851851852
134187,134196,134207,9,11,1,900,1.81818181818
134195,134202,134445,7,243,14,7980,1.02880658436
134243,134252,134254,9,2,2,14400,1.1
134254,134260,134262,6,2,2,14400,1.0
134264,134270,134271,6,1,2,14400,1.0
134265,134276,134277,11,1,2,14400,1.2
134275,134282,134283,7,1,2,14400,1.0
134286,134297,134298,11,1,2,14400,1.2
134286,134292,134293,6,1,2,14400,1.0
134297,134303,134304,6,1,2,14400,1.0
134297,134308,134309,11,1,2,14400,1.2
134308,134315,134316,7,1,2,14400,1.0
134308,134320,134321,12,1,2,14400,1.3
134319,134326,134327,7,1,2,14400,1.0
134319,134331,134332,12,1,2,14400,1.3
134330,134342,134343,12,1,2,14400,1.3
134330,134337,134338,7,1,2,14400,1.0
134340,134348,134349,8,1,2,14400,1.0
134341,134353,134354,12,1,2,14400,1.3
134351,134359,134360,8,1,2,14400,1.0
134352,134364,134365,12,1,2,14400,1.3
134362,134370,134371,8,1,2,14400,1.0
134363,134375,134376,12,1,2,14400,1.3
134373,134381,134382,8,1,2,14400,1.0
134373,134386,134387,13,1,2,14400,1.4
134384,134392,134393,8,1,2,14400,1.0
134384,134397,134398,13,1,2,14400,1.4
134395,134409,134410,14,1,2,14400,1.5
134397,241682,349720,107285,108038,2,108000,1.9930302301
134406,134420,134421,14,1,2,14400,1.5
134406,134415,134416,9,1,2,14400,1.0
134417,134431,134432,14,1,2,14400,1.5
134417,134426,134427,9,1,2,14400,1.0
134428,134437,134438,9,1,2,14400,1.0
134428,134442,134443,14,1,2,14400,1.5
134438,134448,134449,10,1,2,14400,1.1
134439,134453,134454,14,1,2,14400,1.5
134443,134458,134466,15,8,1,900,2.3
134449,134470,134472,21,2,2,14400,2.3
134450,134465,134723,15,258,14,7980,1.05813953488
134470,134482,134483,12,1,2,14400,1.3
134471,134487,134488,16,1,2,14400,1.7
134481,134493,134494,12,1,2,14400,1.3
134492,134504,134505,12,1,2,14400,1.3
134492,134499,134500,7,1,2,14400,1.0
134503,134516,134517,13,1,2,14400,1.4
134503,134511,134512,8,1,2,14400,1.0
134514,134522,134524,8,2,2,14400,1.0
134514,134527,134528,13,1,2,14400,1.4
134524,134533,134534,9,1,2,14400,1.0
134525,134538,134539,13,1,2,14400,1.4
134535,134545,134546,10,1,2,14400,1.1
134536,134550,134551,14,1,2,14400,1.5
134546,134561,134562,15,1,2,14400,1.6
134546,134556,134557,10,1,2,14400,1.1
134557,134572,134573,15,1,2,14400,1.6
134557,134567,134568,10,1,2,14400,1.1
134568,134578,134579,10,1,2,14400,1.1
134568,134583,134584,15,1,2,14400,1.6
134579,134589,134590,10,1,2,14400,1.1
134579,134594,134595,15,1,2,14400,1.6
134590,134600,134601,10,1,2,14400,1.1
134590,134605,134606,15,1,2,14400,1.6
134601,134617,134619,16,2,2,14400,1.8
134601,134612,134613,11,1,2,14400,1.2
134611,134623,134624,12,1,2,14400,1.3
134622,134634,134635,12,1,2,14400,1.3
134622,134629,134630,7,1,2,14400,1.0
134633,134640,134641,7,1,2,14400,1.0
134635,134657,136369,22,1712,2,36000,1.01285046729
134644,134652,134653,8,1,2,14400,1.0
134654,134663,134664,9,1,2,14400,1.0
134655,134668,134669,13,1,2,14400,1.4
134665,134674,134675,9,1,2,14400,1.0
134666,134679,134680,13,1,2,14400,1.4
134676,134685,134686,9,1,2,14400,1.0
134676,134690,134691,14,1,2,14400,1.5
134687,134702,134703,15,1,2,14400,1.6
134687,134697,134698,10,1,2,14400,1.1
134698,134713,134714,15,1,2,14400,1.6
134698,134708,134714,10,6,2,14400,1.6
134709,134724,134725,15,1,2,14400,1.6
134709,134719,134720,10,1,2,14400,1.1
134720,134735,134736,15,1,2,14400,1.6
134720,134741,134747,21,6,1,900,2.7
134720,134730,134731,10,1,2,14400,1.1
134728,134747,135026,19,279,14,7980,1.06810035842
134731,134752,134753,21,1,2,14400,2.2
134731,134757,134758,26,1,2,14400,2.7
134752,134763,134765,11,2,2,14400,1.3
134762,134769,134770,7,1,2,14400,1.0
134763,134774,134775,11,1,2,14400,1.2
134763,134780,136450,17,1670,2,36000,1.01017964072
134773,134786,134787,13,1,2,14400,1.4
134784,134797,134798,13,1,2,14400,1.4
134784,134792,134793,8,1,2,14400,1.0
134795,134808,134809,13,1,2,14400,1.4
134795,134803,134805,8,2,2,14400,1.0
134806,134814,134815,8,1,2,14400,1.0
134806,134825,136605,19,1780,2,36000,1.0106741573
134806,134819,134820,13,1,2,14400,1.4
134816,134831,134832,15,1,2,14400,1.6
134824,134836,136452,12,1616,2,36000,1.00742574257
134827,134842,134843,15,1,2,14400,1.6
134838,134848,134849,10,1,2,14400,1.1
134838,134853,134854,15,1,2,14400,1.6
134842,134858,136606,16,1748,2,36000,1.00915331808
134849,134864,134865,15,1,2,14400,1.6
134858,134869,136569,11,1700,2,36000,1.00647058824
134869,134875,134876,6,1,2,14400,1.0
134870,134880,134881,10,1,2,14400,1.1
134880,134886,134887,6,1,2,14400,1.0
134880,134891,134892,11,1,2,14400,1.2
134891,134897,134898,6,1,2,14400,1.0
134891,134902,134903,11,1,2,14400,1.2
134901,134913,136609,12,1696,2,36000,1.0070754717
134902,134908,134909,6,1,2,14400,1.0
134912,134919,134920,7,1,2,14400,1.0
134913,134924,134925,11,1,2,14400,1.2
134920,134935,136212,15,1277,2,36000,1.01174628034
134923,134930,134931,7,1,2,14400,1.0
134934,134941,134942,7,1,2,14400,1.0
134934,134946,134947,12,1,2,14400,1.3
134935,134951,136428,16,1477,2,36000,1.01083276913
134945,134958,134959,13,1,2,14400,1.4
134955,134964,134965,9,1,2,14400,1.0
134956,134969,134970,13,1,2,14400,1.4
134963,134980,136545,17,1565,2,36000,1.01086261981
134966,134975,134976,9,1,2,14400,1.0
134977,134991,134992,14,1,2,14400,1.5
134977,134986,134987,9,1,2,14400,1.0
134978,134996,136690,18,1694,2,36000,1.0106257379
134988,135003,135004,15,1,2,14400,1.6
134993,135008,136969,15,1961,2,36000,1.00764915859
135004,135994,242043,990,106049,1,172800,1.00933530726
135008,135014,135015,6,1,2,14400,1.0
135009,135020,135021,11,1,2,14400,1.2
135019,135026,135027,7,1,2,14400,1.0
135020,135031,135032,11,1,2,14400,1.2
135024,135053,135059,29,6,1,900,3.5
135030,135042,135043,12,1,2,14400,1.3
135030,135047,135048,17,1,2,14400,1.8
135031,135037,135308,6,271,14,7980,1.0221402214
135041,135059,135060,18,1,2,14400,1.9
135051,135064,135065,13,1,2,14400,1.4
135060,135075,136743,15,1668,2,36000,1.00899280576
135062,135070,135071,8,1,2,14400,1.0
135073,135081,135082,8,1,2,14400,1.0
135073,135086,135087,13,1,2,14400,1.4
135083,135092,135093,9,1,2,14400,1.0
135084,135097,135098,13,1,2,14400,1.4
135094,135103,135104,9,1,2,14400,1.0
135095,135108,135109,13,1,2,14400,1.4
135105,135114,135115,9,1,2,14400,1.0
135106,135119,135120,13,1,2,14400,1.4
135115,135130,136910,15,1780,2,36000,1.00842696629
135116,135125,135126,9,1,2,14400,1.0
135127,135136,135137,9,1,2,14400,1.0
135127,135141,135142,14,1,2,14400,1.5
135135,135152,137050,17,1898,2,36000,1.00895679663
135137,135147,135148,10,1,2,14400,1.1
135148,135158,135159,10,1,2,14400,1.1
135148,135163,135164,15,1,2,14400,1.6
135150,135168,136953,18,1785,2,36000,1.01008403361
135159,135175,135176,16,1,2,14400,1.7
135175,135186,136814,11,1628,2,36000,1.00675675676
135180,135192,135193,12,1,2,14400,1.3
135190,135198,135199,8,1,2,14400,1.0
135191,135203,135204,12,1,2,14400,1.3
135201,135209,135210,8,1,2,14400,1.0
135202,135214,135215,12,1,2,14400,1.3
135206,135225,136809,19,1584,2,36000,1.01199494949
135212,135220,135221,8,1,2,14400,1.0
135221,137773,243572,2552,105799,1,172800,1.02412121098
135223,135232,135233,9,1,2,14400,1.0
135223,135237,135238,14,1,2,14400,1.5
135234,135248,135249,14,1,2,14400,1.5
135234,135243,135244,9,1,2,14400,1.0
135245,135259,135260,14,1,2,14400,1.5
135245,135254,135255,9,1,2,14400,1.0
135255,135265,135266,10,1,2,14400,1.1
135256,135270,135271,14,1,2,14400,1.5
135266,135276,135277,10,1,2,14400,1.1
135267,135281,135282,14,1,2,14400,1.5
135276,135292,137077,16,1785,2,36000,1.00896358543
135277,135287,135288,10,1,2,14400,1.1
135288,135304,135305,16,1,2,14400,1.7
135288,135299,135300,11,1,2,14400,1.2
135299,135310,135311,11,1,2,14400,1.2
135303,135315,135324,12,9,1,900,2.1
135309,135326,135327,17,1,2,14400,1.8
135310,135321,135606,11,285,14,7980,1.03859649123
135330,135338,135339,8,1,2,14400,1.0
135331,135343,135344,12,1,2,14400,1.3
135341,135349,135350,8,1,2,14400,1.0
135341,135354,135355,13,1,2,14400,1.4
135352,135360,135361,8,1,2,14400,1.0
135352,135365,135366,13,1,2,14400,1.4
135363,135376,135377,13,1,2,14400,1.4
135363,135371,135372,8,1,2,14400,1.0
135374,135387,135388,13,1,2,14400,1.4
135374,135382,135383,8,1,2,14400,1.0
135385,135393,135394,8,1,2,14400,1.0
135385,135398,135399,13,1,2,14400,1.4
135395,135405,135406,10,1,2,14400,1.1
135396,135410,135411,14,1,2,14400,1.5
135406,135416,135417,10,1,2,14400,1.1
135407,135421,135422,14,1,2,14400,1.5
135417,135427,135428,10,1,2,14400,1.1
135418,135432,135433,14,1,2,14400,1.5
135428,135438,135439,10,1,2,14400,1.1
135428,135443,135444,15,1,2,14400,1.6
135439,135449,135450,10,1,2,14400,1.1
135439,135454,135455,15,1,2,14400,1.6
135450,135460,135461,10,1,2,14400,1.1
135450,135465,135466,15,1,2,14400,1.6
135461,135471,135472,10,1,2,14400,1.1
135461,135476,135477,15,1,2,14400,1.6
135464,253931,361936,118467,108005,2,108000,2.09686588584
135472,135482,135483,10,1,2,14400,1.1
135472,135487,135488,15,1,2,14400,1.6
135483,135498,135499,15,1,2,14400,1.6
135483,135493,135494,10,1,2,14400,1.1
135493,135504,135505,11,1,2,14400,1.2
135494,135509,135510,15,1,2,14400,1.6
135504,135515,135516,11,1,2,14400,1.2
135505,135520,135521,15,1,2,14400,1.6
135515,135526,135527,11,1,2,14400,1.2
135516,135531,135532,15,1,2,14400,1.6
135536,135549,137052,13,1503,2,36000,1.00864936793
135537,135544,135545,7,1,2,14400,1.0
135547,135555,135556,8,1,2,14400,1.0
135548,135560,135561,12,1,2,14400,1.3
135558,135566,135567,8,1,2,14400,1.0
135559,135571,135572,12,1,2,14400,1.3
135569,135582,135583,13,1,2,14400,1.4
135569,135577,135578,8,1,2,14400,1.0
135580,135588,135589,8,1,2,14400,1.0
135580,135593,135594,13,1,2,14400,1.4
135591,135604,135605,13,1,2,14400,1.4
135591,135599,135600,8,1,2,14400,1.0
135601,135621,135628,20,7,1,900,2.7
135602,135610,135611,8,1,2,14400,1.0
135602,135615,135616,13,1,2,14400,1.4
135609,135627,135885,18,258,14,7980,1.06976744186
135634,135644,135645,10,1,2,14400,1.1
135634,135649,135650,15,1,2,14400,1.6
135645,135660,135661,15,1,2,14400,1.6
135645,135655,135656,10,1,2,14400,1.1
135655,135666,135667,11,1,2,14400,1.2
135656,135671,135672,15,1,2,14400,1.6
135662,135677,138315,15,2638,2,36000,1.00568612585
135677,135683,135684,6,1,2,14400,1.0
135677,135688,135689,11,1,2,14400,1.2
135687,135694,135695,7,1,2,14400,1.0
135688,135699,135700,11,1,2,14400,1.2
135698,135705,135706,7,1,2,14400,1.0
135699,135710,135711,11,1,2,14400,1.2
135709,135717,135718,8,1,2,14400,1.0
135709,135722,135723,13,1,2,14400,1.4
135720,135728,135729,8,1,2,14400,1.0
135720,135733,135734,13,1,2,14400,1.4
135731,135739,135740,8,1,2,14400,1.0
135731,135744,135745,13,1,2,14400,1.4
135742,135750,135751,8,1,2,14400,1.0
135742,135755,135756,13,1,2,14400,1.4
135753,135761,135762,8,1,2,14400,1.0
135753,135766,135767,13,1,2,14400,1.4
135764,135773,135774,9,1,2,14400,1.0
135764,135778,135780,14,2,2,14400,1.6
135774,135784,135785,10,1,2,14400,1.1
135775,135789,135790,14,1,2,14400,1.5
135778,135794,137699,16,1905,2,36000,1.00839895013
135785,135800,135801,15,1,2,14400,1.6
135796,135806,135807,10,1,2,14400,1.1
135796,135811,135812,15,1,2,14400,1.6
135807,135817,135818,10,1,2,14400,1.1
135807,135822,135823,15,1,2,14400,1.6
135818,135833,135834,15,1,2,14400,1.6
135818,135828,135829,10,1,2,14400,1.1
135834,135850,137405,16,1555,2,36000,1.01028938907
135850,135861,135862,11,1,2,14400,1.2
135850,135856,135857,6,1,2,14400,1.0
135861,135867,135868,6,1,2,14400,1.0
135861,135872,135873,11,1,2,14400,1.2
135872,135878,135879,6,1,2,14400,1.0
135872,135883,135884,11,1,2,14400,1.2
135883,135889,137492,6,1603,2,36000,1.00374298191
135884,135895,135903,11,8,1,900,1.9
135894,135901,136157,7,256,14,7980,1.02734375
135929,135936,135937,7,1,2,14400,1.0
135930,135941,135942,11,1,2,14400,1.2
135935,135952,137531,17,1579,2,36000,1.01076630779
135941,135947,135948,6,1,2,14400,1.0
135951,135963,137981,12,2018,2,36000,1.00594648167
135952,135958,135959,6,1,2,14400,1.0
135963,135974,135975,11,1,2,14400,1.2
135963,135969,135970,6,1,2,14400,1.0
135982,135988,137649,6,1661,2,36000,1.00361228176
136013,136019,137808,6,1789,2,36000,1.00335382895
136034,136040,136633,6,593,2,14400,1.01011804384
136034,136045,136574,11,529,2,14400,1.02079395085
136045,136056,136643,11,587,2,14400,1.01873935264
136045,136051,136650,6,599,2,14400,1.01001669449
136056,136067,136723,11,656,2,14400,1.01676829268
136056,136062,136637,6,575,2,14400,1.01043478261
136067,136073,137237,6,1164,2,14400,1.00515463918
136067,136078,136663,11,585,2,14400,1.0188034188
136078,136089,136742,11,653,2,14400,1.01684532925
136078,136084,136650,6,566,2,14400,1.01060070671
136089,136095,136740,6,645,2,14400,1.00930232558
136089,136100,136690,11,590,2,14400,1.0186440678
136100,136106,136793,6,687,2,14400,1.00873362445
136101,221032,301725,84931,80693,1,439200,2.05252004511
136110,136116,136728,6,612,2,14400,1.00980392157
136111,136122,137904,11,1782,2,36000,1.00617283951
136121,136128,136546,7,418,2,14400,1.01674641148
136131,136169,136598,38,429,2,14400,1.08857808858
136156,136175,136181,19,6,1,900,2.5
136170,146483,146769,10313,286,14,7980,37.0594405594
136173,136181,136628,8,447,2,14400,1.01789709172
136183,136190,136676,7,486,2,14400,1.01440329218
136194,136200,136702,6,502,2,14400,1.01195219124
136205,136211,136696,6,485,2,14400,1.01237113402
136213,136223,138176,10,1953,2,36000,1.0051203277
136225,136231,136764,6,533,2,14400,1.01125703565
136236,136242,136811,6,569,2,14400,1.01054481547
136246,136380,137059,134,679,2,14400,1.19734904271
136332,227073,486300,90741,259227,4,259200,1.35004455554
136335,227078,486297,90743,259219,4,259200,1.35006307408
136369,136439,138087,70,1648,2,36000,1.04247572816
136430,136461,138203,31,1742,2,36000,1.0177956372
136452,136467,138209,15,1742,2,36000,1.00861079219
136453,136557,137903,104,1346,2,36000,1.07726597325
136471,262613,335509,126142,72896,2,172800,2.73043788411
136545,136562,138549,17,1987,2,36000,1.00855561147
136563,136580,137143,17,563,2,14400,1.03019538188
136569,136616,138669,47,2053,2,36000,1.02289332684
136604,136622,138398,18,1776,2,36000,1.01013513514
136619,136628,138246,9,1618,2,36000,1.00556242274
136621,136650,138452,29,1802,2,36000,1.01609322974
136655,136661,137240,6,579,2,14400,1.0103626943
136666,136672,137270,6,598,2,14400,1.01003344482
136676,136682,137296,6,614,2,14400,1.00977198697
136687,136693,137280,6,587,2,14400,1.01022146508
136692,136699,138487,7,1788,2,36000,1.00391498881
136697,136705,137289,8,584,2,14400,1.01369863014
136708,136714,137310,6,596,2,14400,1.01006711409
136718,136725,137342,7,617,2,14400,1.0113452188
136729,136735,137427,6,692,2,14400,1.00867052023
136740,136746,137340,6,594,2,14400,1.0101010101
136744,136752,138440,8,1688,2,36000,1.00473933649
136750,136758,137329,8,571,2,14400,1.01401050788
136761,136767,137344,6,577,2,14400,1.01039861352
136771,136777,137157,6,380,2,14400,1.01578947368
136782,136788,137207,6,419,2,14400,1.01431980907
136792,136799,137313,7,514,2,14400,1.01361867704
136803,136809,137284,6,475,2,14400,1.01263157895
136808,136815,138133,7,1318,2,36000,1.00531107739
136814,136821,137395,7,574,2,14400,1.01219512195
136824,136830,138449,6,1619,2,36000,1.00370599135
136834,136840,137862,6,1022,2,14400,1.00587084149
136845,136851,137396,6,545,2,14400,1.01100917431
136855,136862,137434,7,572,2,14400,1.01223776224
136866,136921,137554,55,633,2,14400,1.0868878357
136911,136964,138616,53,1652,2,36000,1.03208232446
136954,136980,138965,26,1985,2,36000,1.01309823678
136969,137062,138983,93,1921,2,36000,1.04841228527
136975,254220,328836,117245,74616,2,108000,2.571311783
137051,137068,138857,17,1789,2,36000,1.00950251537
137052,137074,138867,22,1793,2,36000,1.01226993865
137071,137088,137676,17,588,2,14400,1.02891156463
137077,137155,138671,78,1516,2,36000,1.05145118734
137153,137168,137886,15,718,2,14400,1.0208913649
137173,137219,137818,46,599,2,14400,1.07679465776
137215,137248,137863,33,615,2,14400,1.05365853659
137246,137254,137992,8,738,2,14400,1.0108401084
137256,137281,137900,25,619,2,14400,1.04038772213
137277,137291,137928,14,637,2,14400,1.02197802198
137287,137297,137990,10,693,2,14400,1.01443001443
137298,137304,137900,6,596,2,14400,1.01006711409
137309,137315,137943,6,628,2,14400,1.00955414013
137319,137325,137921,6,596,2,14400,1.01006711409
137330,137336,137888,6,552,2,14400,1.01086956522
137340,137346,137819,6,473,2,14400,1.01268498943
137351,137357,137841,6,484,2,14400,1.01239669421
137361,137368,137821,7,453,2,14400,1.01545253863
137372,137378,137879,6,501,2,14400,1.0119760479
137383,137406,137997,23,591,2,14400,1.03891708968
137403,137412,137918,9,506,2,14400,1.01778656126
137404,137418,139232,14,1814,2,36000,1.00771775083
137414,137439,137962,25,523,2,14400,1.04780114723
137435,137445,138029,10,584,2,14400,1.01712328767
137445,137503,138110,58,607,2,14400,1.09555189456
137493,137542,139254,49,1712,2,36000,1.02862149533
137529,137566,139506,37,1940,2,36000,1.01907216495
137566,137830,139174,264,1344,6,3000,1.19642857143
137649,137660,139364,11,1704,2,36000,1.00645539906
137656,221628,301725,83972,80097,1,439200,2.04837884066
137702,137708,139361,6,1653,2,36000,1.00362976407
137792,261349,337996,123557,76647,2,108000,2.61202656334
137809,137815,139610,6,1795,2,36000,1.00334261838
137825,137852,139510,27,1658,6,3000,1.01628468034
137854,137873,138560,19,687,2,14400,1.02765647744
137874,137880,138518,6,638,2,14400,1.00940438871
137877,137899,139072,22,1173,6,3000,1.01875532822
137895,137911,138567,16,656,2,14400,1.0243902439
137902,137917,139751,15,1834,2,36000,1.00817884406
137916,137923,138638,7,715,2,14400,1.00979020979
137918,137928,139606,10,1678,2,36000,1.00595947557
137927,137934,138649,7,715,2,14400,1.00979020979
137937,137943,138573,6,630,2,14400,1.00952380952
137939,137973,139226,34,1253,6,3000,1.0271348763
137970,138008,139447,38,1439,6,3000,1.02640722724
137983,137992,139859,9,1867,2,36000,1.00482056776
138009,138041,138661,32,620,2,14400,1.05161290323
138040,138098,138754,58,656,2,14400,1.08841463415
138087,138122,139841,35,1719,2,36000,1.02036067481
138122,138128,138798,6,670,2,14400,1.00895522388
138125,138579,140461,454,1882,6,3000,1.24123273114
138134,138144,140019,10,1875,2,36000,1.00533333333
138177,138187,139931,10,1744,2,36000,1.00573394495
138205,138215,139926,10,1711,2,36000,1.00584453536
138220,138226,139845,6,1619,2,36000,1.00370599135
138248,138257,140138,9,1881,2,36000,1.004784689
138318,138327,140254,9,1927,2,36000,1.00467047224
138401,138409,140121,8,1712,2,36000,1.0046728972
138440,138451,140153,11,1702,2,36000,1.00646298472
138456,138462,140251,6,1789,2,36000,1.00335382895
138457,138468,140110,11,1642,2,36000,1.00669914738
138487,138498,140502,11,2004,2,36000,1.00548902196
138552,138558,140443,6,1885,2,36000,1.00318302387
138574,138661,141132,87,2471,6,3000,1.03520841764
138616,138627,140243,11,1616,2,36000,1.00680693069
138658,138809,140037,151,1228,6,3000,1.12296416938
138669,138675,140489,6,1814,2,36000,1.0033076075
138685,138691,140497,6,1806,2,36000,1.00332225914
138807,138868,139432,61,564,2,14400,1.10815602837
138856,138878,140638,22,1760,2,36000,1.0125
138871,138976,140568,105,1592,2,36000,1.06595477387
138965,138995,140894,30,1899,2,36000,1.01579778831
138984,139084,141001,100,1917,2,36000,1.0521648409
139066,262592,433301,123526,170709,4,259200,1.72360566813
139082,139090,139652,8,562,2,14400,1.01423487544
139087,139186,140337,99,1151,6,3000,1.08601216334
139185,139192,139777,7,585,2,14400,1.01196581197
139189,139238,140732,49,1494,6,3000,1.0327978581
139234,139244,140300,10,1056,2,36000,1.00946969697
139240,139458,142174,218,2716,6,3000,1.08026509573
139255,139265,141102,10,1837,2,36000,1.00544365814
139363,139372,140954,9,1582,2,36000,1.00568900126
139378,139384,141091,6,1707,2,36000,1.00351493849
139457,139521,140704,64,1183,6,3000,1.05409974641
139506,139512,141144,6,1632,2,36000,1.00367647059
139520,139789,142080,269,2291,6,3000,1.11741597556
139607,139613,141445,6,1832,2,36000,1.00327510917
139608,139619,141236,11,1617,2,36000,1.00680272109
139753,139759,141456,6,1697,2,36000,1.00353565115
139787,139852,140285,65,433,2,14400,1.15011547344
139841,139858,141349,17,1491,2,36000,1.0114017438
139856,139870,141631,14,1761,2,36000,1.00795002839
139869,139937,140378,68,441,2,14400,1.15419501134
139871,139943,141855,72,1912,2,36000,1.03765690377
139926,140030,141644,104,1614,2,36000,1.0644361834
139942,140049,141725,107,1676,2,36000,1.0638424821
140021,140054,141857,33,1803,2,36000,1.01830282862
140052,140060,140574,8,514,2,14400,1.01556420233
140063,140121,140651,58,530,2,14400,1.10943396226
140112,140133,142138,21,2005,2,36000,1.01047381546
140127,140148,142037,21,1889,2,36000,1.01111699312
140143,140164,142039,21,1875,2,36000,1.0112
140158,140255,141863,97,1608,2,36000,1.06032338308
140243,140262,141866,19,1604,2,36000,1.01184538653
140259,140268,142670,9,2402,2,36000,1.0037468776
140260,140296,142090,36,1794,2,36000,1.02006688963
140298,140348,141720,50,1372,6,3000,1.03644314869
140298,140311,140809,13,498,2,14400,1.02610441767
140300,140389,141973,89,1584,2,36000,1.05618686869
140390,140454,141038,64,584,2,14400,1.1095890411
140447,140472,142255,25,1783,2,36000,1.01402131239
140472,140478,141106,6,628,2,14400,1.00955414013
140482,140488,141072,6,584,2,14400,1.0102739726
140483,140715,143163,232,2448,6,3000,1.09477124183
140487,140500,142384,13,1884,2,36000,1.00690021231
140503,140508,142093,5,1585,2,36000,1.00315457413
140504,140514,142295,10,1781,2,36000,1.00561482313
140568,140579,142334,11,1755,2,36000,1.00626780627
140639,140649,142340,10,1691,2,36000,1.00591366056
140717,140723,141378,6,655,2,14400,1.00916030534
140728,140734,141347,6,613,2,14400,1.00978792822
140728,140743,141936,15,1193,6,3000,1.01257334451
140738,140821,141475,83,654,2,14400,1.12691131498
140820,140905,141520,85,615,2,14400,1.13821138211
140821,141143,142574,322,1431,6,3000,1.2250174703
140895,140966,142536,71,1570,2,36000,1.04522292994
140956,141012,142933,56,1921,2,36000,1.0291514836
140958,262598,349016,121640,86418,4,86400,2.40757712514
141003,141049,142891,46,1842,2,36000,1.02497285559
141007,262603,349028,121596,86425,4,86400,2.40695400636
141093,141102,143216,9,2114,2,36000,1.00425733207
141108,141114,143157,6,2043,2,36000,1.00293685756
141139,141155,142284,16,1129,6,3000,1.01417183348
141144,141247,143040,103,1793,2,36000,1.05744562186
141238,141358,143119,120,1761,2,36000,1.06814310051
141352,141364,142982,12,1618,2,36000,1.00741656366
141361,141390,141992,29,602,2,14400,1.04817275748
141392,141456,142078,64,622,2,14400,1.10289389068
141447,141468,142991,21,1523,2,36000,1.01378857518
141463,141486,143129,23,1643,2,36000,1.01399878271
141484,141531,142169,47,638,2,14400,1.0736677116
141498,262623,305852,121125,43229,2,43200,3.8019385135
141527,141732,142908,205,1176,6,3000,1.17431972789
141634,141642,143402,8,1760,2,36000,1.00454545455
141649,141655,143255,6,1600,2,36000,1.00375
141727,141738,143073,11,1335,2,36000,1.00823970037
141739,141866,142508,127,642,2,14400,1.19781931464
141857,141872,143688,15,1816,2,36000,1.00825991189
141858,141878,143593,20,1715,2,36000,1.01166180758
141860,253926,296432,112066,42506,10,57600,3.63647485061
141874,141884,143633,10,1749,2,36000,1.00571755289
141875,141947,143611,72,1664,2,36000,1.04326923077
141944,141953,142649,9,696,2,14400,1.01293103448
141954,141960,142563,6,603,2,14400,1.00995024876
141957,142092,144461,135,2369,6,3000,1.05698607007
141973,141984,143543,11,1559,2,36000,1.007055805
142037,142044,143987,7,1943,2,36000,1.00360267627
142053,142059,143677,6,1618,2,36000,1.00370828183
142090,142105,143260,15,1155,6,3000,1.01298701299
142093,142099,143925,6,1826,2,36000,1.00328587076
142094,142149,143900,55,1751,2,36000,1.0314106225
142137,142180,143956,43,1776,2,36000,1.02421171171
142179,142186,142857,7,671,2,14400,1.01043219076
142182,142296,143527,114,1231,6,3000,1.09260763607
142257,142263,143913,6,1650,2,36000,1.00363636364
142292,142302,142863,10,561,2,14400,1.01782531194
142297,142308,144309,11,2001,2,36000,1.00549725137
142305,142574,143715,269,1141,6,3000,1.23575810692
142337,142343,144235,6,1892,2,36000,1.00317124736
142352,142358,144285,6,1927,2,36000,1.00311364816
142385,142391,144223,6,1832,2,36000,1.00327510917
142538,142544,144360,6,1816,2,36000,1.00330396476
142571,142585,144659,14,2074,6,3000,1.00675024108
142582,142874,144101,292,1227,6,3000,1.23797881011
142601,261327,261338,118726,11,32,86400,10794.2727273
142672,142681,144489,9,1808,2,36000,1.00497787611
142876,142902,143597,26,695,2,14400,1.03741007194
142892,142919,144729,27,1810,2,36000,1.01491712707
142917,142925,143447,8,522,2,14400,1.0153256705
142928,142945,143481,17,536,2,14400,1.03171641791
142934,142993,144735,59,1742,2,36000,1.03386911596
142949,261354,369395,118405,108041,2,108000,2.0959265464
142983,143002,144660,19,1658,2,36000,1.01145958987
142998,143051,144786,53,1735,2,36000,1.03054755043
143028,262629,296865,119601,34236,2,43200,4.49342797056
143041,143084,144613,43,1529,2,36000,1.02812295618
143075,143130,144839,55,1709,2,36000,1.0321825629
143118,143141,144710,23,1569,2,36000,1.01465901848
143134,143168,144739,34,1571,2,36000,1.02164226607
143158,143227,144700,69,1473,2,36000,1.04684317719
143217,143266,144926,49,1660,2,36000,1.02951807229
143256,143272,144410,16,1138,2,36000,1.01405975395
143275,143281,143790,6,509,2,14400,1.01178781925
143286,143292,144750,6,1458,6,3000,1.00411522634
143286,143297,143825,11,528,2,14400,1.02083333333
143297,143413,143957,116,544,2,14400,1.21323529412
143400,143458,145417,58,1959,2,36000,1.02960694232
143460,143493,144018,33,525,2,14400,1.06285714286
143491,143538,144012,47,474,2,14400,1.09915611814
143534,143544,145386,10,1842,6,3000,1.00542888165
143542,143555,144145,13,590,2,14400,1.02203389831
143544,143604,145325,60,1721,2,36000,1.03486345148
143593,143610,145326,17,1716,2,36000,1.00990675991
143606,143726,145123,120,1397,6,3000,1.08589835361
143615,143622,145389,7,1767,2,36000,1.00396151669
143636,143644,145274,8,1630,2,36000,1.00490797546
143679,143688,145650,9,1962,2,36000,1.00458715596
143694,143700,145308,6,1608,2,36000,1.00373134328
143726,143801,144419,75,618,2,14400,1.1213592233
143798,143837,144470,39,633,2,14400,1.06161137441
143839,143911,144528,72,617,2,14400,1.11669367909
143901,143924,145578,23,1654,2,36000,1.01390568319
143918,143937,145903,19,1966,2,36000,1.00966429298
143934,143967,145769,33,1802,2,36000,1.01831298557
143934,144112,145765,178,1653,6,3000,1.1076830006
143956,143973,145847,17,1874,2,36000,1.0090715048
143990,143999,145733,9,1734,2,36000,1.00519031142
144108,144156,145336,48,1180,6,3000,1.0406779661
144156,144235,144962,79,727,2,14400,1.10866574966
144222,144246,146086,24,1840,2,36000,1.01304347826
144238,144296,145944,58,1648,2,36000,1.03519417476
144286,144321,146083,35,1762,2,36000,1.01986379115
144311,144371,146197,60,1826,2,36000,1.03285870756
144360,144422,146250,62,1828,2,36000,1.03391684902
144412,144430,146169,18,1739,2,36000,1.01035077631
144433,144472,145129,39,657,2,14400,1.05936073059
144474,144480,145101,6,621,2,14400,1.00966183575
144485,144491,145131,6,640,2,14400,1.009375
144491,144500,146245,9,1745,2,36000,1.00515759312
144495,144539,145145,44,606,2,14400,1.07260726073
144495,144670,146122,175,1452,6,3000,1.12052341598
144590,262634,293432,118044,30798,2,43200,4.83284628872
144614,144624,146057,10,1433,2,36000,1.00697836706
144662,261365,352691,116703,91326,2,108000,2.27787267591
144663,144676,146377,13,1701,2,36000,1.0076425632
144675,144712,145381,37,669,2,14400,1.0553064275
144699,144721,146698,22,1977,2,36000,1.01112797167
144715,144740,146455,25,1715,2,36000,1.01457725948
144731,144746,146425,15,1679,2,36000,1.00893388922
144747,144752,146452,5,1700,2,36000,1.00294117647
144748,144797,146577,49,1780,2,36000,1.02752808989
144788,144850,146662,62,1812,2,36000,1.03421633554
144840,144937,146597,97,1660,2,36000,1.05843373494
144928,144973,146639,45,1666,2,36000,1.02701080432
144975,144982,146471,7,1489,6,3000,1.00470114171
144986,145134,146364,148,1230,6,3000,1.12032520325
145133,145141,145794,8,653,2,14400,1.01225114855
145139,145147,146505,8,1358,6,3000,1.0058910162
145144,145156,145765,12,609,2,14400,1.0197044335
145154,145285,145969,131,684,2,14400,1.19152046784
145276,145319,147042,43,1723,2,36000,1.02495647127
145310,145336,147129,26,1793,2,36000,1.01450083659
145326,145342,147076,16,1734,2,36000,1.0092272203
145327,145348,147098,21,1750,2,36000,1.012
145344,145393,146819,49,1426,6,3000,1.03436185133
145389,145401,147100,12,1699,2,36000,1.00706297822
145399,145429,146047,30,618,2,14400,1.04854368932
145417,145590,147270,173,1680,2,36000,1.10297619048
145579,145661,147510,82,1849,2,36000,1.04434829638
145652,145744,146778,92,1034,2,36000,1.08897485493
145735,145776,147916,41,2140,2,36000,1.0191588785
145768,145781,147481,13,1700,2,36000,1.00764705882
145783,145790,147838,7,2048,6,3000,1.00341796875
145787,145796,146251,9,455,2,14400,1.01978021978
145794,145805,148271,11,2466,6,3000,1.00446066504
145804,146098,147810,294,1712,6,3000,1.17172897196
145848,262618,435436,116770,172818,4,172800,1.67568193128
145848,145858,147875,10,2017,2,36000,1.00495785821
145904,145914,147863,10,1949,2,36000,1.00513083633
145947,145955,147804,8,1849,2,36000,1.00432666306
146059,146065,147958,6,1893,2,36000,1.00316957211
146084,146090,148034,6,1944,2,36000,1.00308641975
146094,262847,345556,116753,82709,2,172800,2.41161179557
146095,146180,146654,85,474,2,14400,1.17932489451
146099,146208,148018,109,1810,2,36000,1.06022099448
146169,146256,147956,87,1700,2,36000,1.05117647059
146197,146262,148102,65,1840,2,36000,1.03532608696
146237,146243,146265,6,22,2,120,1.27272727273
146246,146267,148077,21,1810,2,36000,1.01160220994
146261,146375,148022,114,1647,2,36000,1.06921675774
146278,146284,146333,6,49,2,120,1.12244897959
146301,263014,348345,116713,85331,2,172800,2.36776786865
146371,146389,146892,18,503,2,14400,1.03578528827
146379,146436,148212,57,1776,2,36000,1.03209459459
146428,146463,148232,35,1769,2,36000,1.01978518937
146453,146469,147784,16,1315,2,36000,1.01216730038
146466,146516,147022,50,506,2,14400,1.09881422925
146468,146521,148300,53,1779,2,36000,1.02979201799
146476,263713,337655,117237,73942,2,172800,2.58552649374
146519,146665,148038,146,1373,6,3000,1.10633648944
146577,146584,148350,7,1766,2,36000,1.00396375991
146599,146605,148163,6,1558,2,36000,1.00385109114
146638,146644,148528,6,1884,2,36000,1.00318471338
146663,146781,148197,118,1416,6,3000,1.08333333333
146663,146673,148273,10,1600,2,36000,1.00625
146700,146709,148529,9,1820,2,36000,1.00494505495
146768,146787,146793,19,6,1,900,2.5
146778,175318,175587,28540,269,14,7980,107.096654275
146779,146793,148701,14,1908,2,36000,1.00733752621
146793,146831,147336,38,505,2,14400,1.07524752475
146836,146842,148307,6,1465,6,3000,1.00409556314
146836,146847,147319,11,472,2,14400,1.02330508475
146847,147034,148523,187,1489,6,3000,1.12558764271
146847,146853,147379,6,526,2,14400,1.01140684411
147031,147390,148589,359,1199,6,3000,1.29941618015
147046,147053,148587,7,1534,2,36000,1.00456323338
147077,147087,148872,10,1785,2,36000,1.0056022409
147099,147109,148712,10,1603,2,36000,1.00623830318
147100,147115,148960,15,1845,2,36000,1.0081300813
147127,147140,148845,13,1705,2,36000,1.00762463343
147267,185578,227053,38311,41475,24,259200,1.92371308017
147273,147281,149095,8,1814,2,36000,1.00441014333
147295,185594,221021,38299,35427,1,86400,2.08106811189
147388,147492,148114,104,622,2,14400,1.16720257235
147484,147522,149193,38,1671,2,36000,1.02274087373
147511,147795,149672,284,1877,2,36000,1.15130527437
147597,149519,156734,1922,7215,12,7200,1.26638946639
147787,147815,149250,28,1435,2,36000,1.01951219512
147806,147821,149413,15,1592,2,36000,1.00942211055
147818,147850,149359,32,1509,6,3000,1.02120609675
147849,147970,149550,121,1580,6,3000,1.07658227848
147864,147870,149891,6,2021,2,36000,1.00296882731
147879,147885,149851,6,1966,2,36000,1.00305188199
147915,147921,149742,6,1821,2,36000,1.00329489292
147958,147964,149821,6,1857,2,36000,1.00323101777
147959,148029,149809,70,1780,2,36000,1.0393258427
148021,148035,149953,14,1918,2,36000,1.00729927007
148022,148045,150036,23,1991,2,36000,1.01155198393
148038,148051,149715,13,1664,2,36000,1.0078125
148048,148057,148684,9,627,2,14400,1.01435406699
148054,148208,149508,154,1300,6,3000,1.11846153846
148078,148088,149833,10,1745,2,36000,1.00573065903
148102,148113,149852,11,1739,2,36000,1.00632547441
148166,148172,149752,6,1580,2,36000,1.00379746835
148207,148286,149507,79,1221,6,3000,1.0647010647
148215,148221,149765,6,1544,2,36000,1.00388601036
148234,148240,150247,6,2007,2,36000,1.00298953662
148273,148280,149723,7,1443,2,36000,1.00485100485
148284,148293,148929,9,636,2,14400,1.0141509434
148289,148319,150002,30,1683,6,3000,1.01782531194
148301,148307,149949,6,1642,2,36000,1.00365408039
148316,148325,148991,9,666,2,14400,1.01351351351
148328,148361,148970,33,609,2,14400,1.05418719212
148349,148534,150333,185,1799,2,36000,1.10283490828
148531,148540,150364,9,1824,2,36000,1.00493421053
148532,148545,150277,13,1732,2,36000,1.00750577367
148543,148551,149292,8,741,2,14400,1.01079622132
148543,148604,150378,61,1774,6,3000,1.03438556933
148584,266074,309292,117490,43218,2,43200,3.71854319959
148587,148598,150139,11,1541,2,36000,1.00713822193
148605,148610,149392,5,782,2,14400,1.00639386189
148605,148981,150643,376,1662,6,3000,1.22623345367
148643,262572,334595,113929,72023,2,72000,2.58184191161
148702,148708,150167,6,1459,2,36000,1.00411240576
148718,148723,150462,5,1739,2,36000,1.00287521564
148845,148852,150899,7,2047,2,36000,1.0034196385
148873,148879,150695,6,1816,2,36000,1.00330396476
148961,148967,150719,6,1752,2,36000,1.00342465753
148983,149371,150684,388,1313,6,3000,1.29550647372
148993,262577,262836,113584,259,2,36000,439.548262548
149096,149103,150765,7,1662,2,36000,1.00421179302
149194,149200,150931,6,1731,2,36000,1.00346620451
149225,262582,263702,113357,1120,2,36000,102.211607143
149249,149255,151027,6,1772,2,36000,1.00338600451
149371,149403,150621,32,1218,6,3000,1.026272578
149402,149561,151615,159,2054,6,3000,1.07740993184
149417,149424,151123,7,1699,2,36000,1.00412007063
149558,262587,262998,113029,411,2,36000,276.00973236
149564,149683,150307,119,624,2,14400,1.19070512821
149672,149727,151501,55,1774,2,36000,1.03100338219
149715,149734,151363,19,1629,2,36000,1.0116635973
149730,149753,151267,23,1514,2,36000,1.01519154557
149745,149763,151561,18,1798,2,36000,1.01001112347
149759,149777,150435,18,658,2,14400,1.0273556231
149761,149821,151401,60,1580,2,36000,1.03797468354
149776,149833,151684,57,1851,2,36000,1.03079416532
149809,149844,151713,35,1869,2,36000,1.01872659176
149824,149863,151547,39,1684,2,36000,1.02315914489
149840,149868,151690,28,1822,2,36000,1.01536772777
149855,149902,151937,47,2035,2,36000,1.0230958231
149856,149961,151613,105,1652,2,36000,1.06355932203
149890,149967,151625,77,1658,2,36000,1.04644149578
149951,150047,151758,96,1711,2,36000,1.05610753945
149966,150150,151811,184,1661,2,36000,1.11077664058
150037,150178,152094,141,1916,2,36000,1.0735908142
150140,150258,152013,118,1755,2,36000,1.06723646724
150167,150288,151931,121,1643,2,36000,1.07364576993
150211,150219,150241,8,22,1,600,1.36363636364
150246,150321,152044,75,1723,2,36000,1.04352872896
150277,150344,151911,67,1567,2,36000,1.04275686024
150335,150375,152216,40,1841,2,36000,1.02172732211
150365,150389,152267,24,1878,2,36000,1.01277955272
150389,150395,151056,6,661,2,14400,1.00907715582
150392,150401,151649,9,1248,6,3000,1.00721153846
150402,150446,151065,44,619,2,14400,1.07108239095
150418,150425,150426,7,1,1,600,1.0
150443,150474,151095,31,621,2,14400,1.0499194847
150466,150632,152274,166,1642,2,36000,1.10109622412
150581,150588,150596,7,8,1,600,1.5
150630,150638,151219,8,581,2,14400,1.01376936317
150637,150654,151800,17,1146,6,3000,1.01483420593
150651,150660,151265,9,605,2,14400,1.01487603306
150658,150695,151922,37,1227,6,3000,1.03015484923
150693,150701,151169,8,468,2,14400,1.01709401709
150698,150707,152618,9,1911,2,36000,1.00470957614
150704,150730,151275,26,545,2,14400,1.04770642202
150720,150777,152721,57,1944,2,36000,1.02932098765
150742,151660,151661,918,1,1,600,91.9
150766,150910,152572,144,1662,2,36000,1.08664259928
150899,150942,152173,43,1231,2,36000,1.03493095045
150933,151038,152790,105,1752,2,36000,1.05993150685
151027,151067,152799,40,1732,2,36000,1.02309468822
151067,151181,152523,114,1342,6,3000,1.08494783905
151125,151131,152976,6,1845,2,36000,1.00325203252
151179,151286,153579,107,2293,6,3000,1.04666375927
151269,151275,152851,6,1576,2,36000,1.0038071066
151282,151630,152890,348,1260,6,3000,1.27619047619
151363,151374,153134,11,1760,2,36000,1.00625
151403,151412,154022,9,2610,2,36000,1.00344827586
151503,151513,153135,10,1622,2,36000,1.00616522811
151549,151558,153389,9,1831,2,36000,1.00491534681
151564,151572,153225,8,1653,2,36000,1.00483968542
151612,151624,153284,12,1660,2,36000,1.00722891566
151626,151637,152236,11,599,2,14400,1.0183639399
151628,151695,153609,67,1914,2,36000,1.03500522466
151685,151702,153647,17,1945,2,36000,1.0087403599
151698,151724,152264,26,540,2,14400,1.04814814815
151700,151770,153372,70,1602,2,36000,1.04369538077
151715,151811,153580,96,1769,2,36000,1.05426794799
151761,151816,153611,55,1795,2,36000,1.03064066852
151813,151823,153934,10,2111,2,36000,1.00473709143
151821,151922,152462,101,540,2,14400,1.18703703704
151913,151942,153547,29,1605,2,36000,1.01806853583
151931,151949,153726,18,1777,2,36000,1.01012943163
151944,152024,152515,80,491,2,14400,1.16293279022
151946,152055,153980,109,1925,2,36000,1.05662337662
151964,261322,261323,109358,1,32,600,10935.9
152013,152105,153750,92,1645,2,36000,1.05592705167
152047,152184,153854,137,1670,2,36000,1.08203592814
152095,152227,153748,132,1521,2,36000,1.08678500986
152174,152247,154379,73,2132,2,36000,1.03424015009
152217,152275,153717,58,1442,2,36000,1.04022191401
152265,152281,152810,16,529,2,14400,1.03024574669
152269,152287,153492,18,1205,2,36000,1.01493775934
152282,152293,153612,11,1319,6,3000,1.00833965125
152284,152473,154003,189,1530,2,36000,1.12352941176
152370,152376,152377,6,1,8,1,1.0
152426,153771,153849,1345,78,12,7200,18.2435897436
152473,152526,153101,53,575,2,14400,1.09217391304
152526,152534,153127,8,593,2,14400,1.01349072513
152537,152543,153148,6,605,2,14400,1.00991735537
152548,152554,153756,6,1202,6,3000,1.00499168053
152548,152559,153192,11,633,2,14400,1.01737756714
152559,152901,155241,342,2340,6,3000,1.14615384615
152559,152583,153219,24,636,2,14400,1.03773584906
152573,152629,154323,56,1694,2,36000,1.03305785124
152618,152732,154586,114,1854,2,36000,1.06148867314
152722,152802,154465,80,1663,2,36000,1.04810583283
152792,152811,154336,19,1525,2,36000,1.01245901639
152808,152822,154637,14,1815,2,36000,1.00771349862
152853,152863,154537,10,1674,2,36000,1.00597371565
152902,152908,153566,6,658,2,14400,1.00911854103
152906,153146,154459,240,1313,6,3000,1.18278750952
152978,152987,154837,9,1850,2,36000,1.00486486486
153134,153140,154530,6,1390,2,36000,1.00431654676
153136,153160,154900,24,1740,2,36000,1.01379310345
153161,153577,155144,416,1567,6,3000,1.26547543076
153227,153233,154965,6,1732,2,36000,1.00346420323
153284,153291,155082,7,1791,2,36000,1.00390843104
153373,153379,154966,6,1587,2,36000,1.00378071834
153391,153397,155367,6,1970,2,36000,1.00304568528
153494,153500,155039,6,1539,2,36000,1.00389863548
153549,153555,155178,6,1623,2,36000,1.00369685767
153577,153590,154223,13,633,2,14400,1.0205371248
153582,153595,155377,13,1782,2,36000,1.00729517396
153591,153622,155358,31,1736,6,3000,1.01785714286
153610,153616,155462,6,1846,2,36000,1.00325027086
153611,153659,155537,48,1878,2,36000,1.02555910543
153648,153728,155396,80,1668,2,36000,1.0479616307
153718,153737,155584,19,1847,2,36000,1.01028695181
153733,153759,155354,26,1595,2,36000,1.01630094044
153748,153765,155454,17,1689,2,36000,1.01006512729
153761,153860,154523,99,663,2,14400,1.14932126697
153764,153866,155895,102,2029,2,36000,1.05027106949
153855,153945,155338,90,1393,2,36000,1.06460875808
153934,153991,155801,57,1810,2,36000,1.03149171271
153980,154014,155630,34,1616,2,36000,1.02103960396
154005,154033,155637,28,1604,2,36000,1.0174563591
154026,154234,156039,208,1805,2,36000,1.11523545706
154231,154240,154891,9,651,2,14400,1.01382488479
154241,154247,154905,6,658,2,14400,1.00911854103
154244,154253,155614,9,1361,6,3000,1.00661278472
154252,154334,154948,82,614,2,14400,1.1335504886
154324,154348,156414,24,2066,2,36000,1.01161665053
154339,154391,156124,52,1733,2,36000,1.03000577034
154382,154470,156170,88,1700,2,36000,1.05176470588
154467,154481,156172,14,1691,2,36000,1.00827912478
154467,154476,155232,9,756,2,14400,1.0119047619
154477,154487,155123,10,636,2,14400,1.01572327044
154488,154534,155166,46,632,2,14400,1.07278481013
154530,154959,156345,429,1386,6,3000,1.30952380952
154531,154541,156242,10,1701,2,36000,1.00587889477
154546,154552,156295,6,1743,2,36000,1.00344234079
154586,154597,156443,11,1846,2,36000,1.0059588299
154638,154649,156260,11,1611,2,36000,1.00682805711
154839,154849,156666,10,1817,2,36000,1.00550357733
154900,154911,156777,11,1866,2,36000,1.00589496249
154958,154976,155457,18,481,2,14400,1.03742203742
154968,154982,156573,14,1591,2,36000,1.00879949717
154969,155051,156787,82,1736,2,36000,1.04723502304
155042,155093,156815,51,1722,2,36000,1.02961672474
155082,155134,156979,52,1845,2,36000,1.02818428184
155131,155155,155638,24,483,2,14400,1.04968944099
155152,155161,155662,9,501,2,14400,1.01796407186
155163,155169,155701,6,532,2,14400,1.01127819549
155173,155179,155747,6,568,2,14400,1.01056338028
155179,155189,156698,10,1509,2,36000,1.00662690524
155194,155243,155797,49,554,2,14400,1.08844765343
155194,155252,158269,58,3017,6,3000,1.01922439509
155256,155371,156476,115,1105,6,3000,1.10407239819
155256,155349,155888,93,539,2,14400,1.17254174397
155340,155365,156994,25,1629,2,36000,1.01534683855
155355,155388,156830,33,1442,2,36000,1.02288488211
155371,155393,157208,22,1815,2,36000,1.01212121212
155372,155407,157100,35,1693,2,36000,1.0206733609
155398,155465,156984,67,1519,2,36000,1.04410796577
155456,155471,157126,15,1655,2,36000,1.00906344411
155471,155548,157280,77,1732,2,36000,1.04445727483
155471,155477,156165,6,688,2,14400,1.00872093023
155471,155625,156772,154,1147,6,3000,1.13426329555
155538,155595,157508,57,1913,2,36000,1.02979613173
155584,155641,157352,57,1711,2,36000,1.03331385155
155630,155648,157402,18,1754,2,36000,1.0102622577
155645,155809,157395,164,1586,6,3000,1.10340479193
155645,155673,157374,28,1701,2,36000,1.01646090535
155645,155654,156307,9,653,2,14400,1.01378254211
155803,155815,157633,12,1818,2,36000,1.00660066007
155818,156283,158049,465,1766,6,3000,1.26330690827
155818,155899,156525,81,626,2,14400,1.12939297125
155895,155906,157837,11,1931,2,36000,1.0056965303
155964,156745,163979,781,7234,12,7200,1.10796239978
156041,156050,158090,9,2040,2,36000,1.00441176471
156126,156135,158086,9,1951,2,36000,1.00461301896
156172,156178,158089,6,1911,2,36000,1.00313971743
156174,156184,157756,10,1572,2,36000,1.00636132316
156243,156250,157839,7,1589,2,36000,1.00440528634
156262,156269,158023,7,1754,2,36000,1.00399087799
156278,156289,156908,11,619,2,14400,1.01777059774
156288,156306,156847,18,541,2,14400,1.03327171904
156297,156318,157921,21,1603,2,36000,1.01310043668
156319,156357,156946,38,589,2,14400,1.06451612903
156361,156487,158176,126,1689,6,3000,1.07460035524
156361,156367,156896,6,529,2,14400,1.01134215501
156413,156420,158167,7,1747,2,36000,1.00400686892
156444,156450,158127,6,1677,2,36000,1.00357781753
156484,156783,157928,299,1145,6,3000,1.26113537118
156484,156493,157300,9,807,2,14400,1.01115241636
156576,156582,158250,6,1668,2,36000,1.0035971223
156667,156673,158407,6,1734,2,36000,1.00346020761
156700,156707,158802,7,2095,2,36000,1.00334128878
156776,156788,158095,12,1307,2,36000,1.00918133129
156790,156796,157277,6,481,2,14400,1.01247401247
156790,156919,159275,129,2356,6,3000,1.05475382003
156792,156802,158416,10,1614,2,36000,1.00619578686
156816,156827,158470,11,1643,2,36000,1.00669506999
156831,156841,158482,10,1641,2,36000,1.00609384522
156923,157407,158626,484,1219,6,3000,1.39704675964
156923,156958,157395,35,437,2,14400,1.08009153318
156980,156990,158928,10,1938,2,36000,1.00515995872
156996,157002,158616,6,1614,2,36000,1.00371747212
156997,157008,158962,11,1954,2,36000,1.00562947799
157103,157111,159056,8,1945,2,36000,1.00411311054
157128,157137,158642,9,1505,2,36000,1.00598006645
157210,157219,159447,9,2228,2,36000,1.00403949731
157281,157288,158966,7,1678,2,36000,1.0041716329
157354,157360,159191,6,1831,2,36000,1.00327689787
157375,157382,159114,7,1732,2,36000,1.00404157044
157403,157413,159184,10,1771,2,36000,1.00564652739
157414,157419,158608,5,1189,6,3000,1.00420521447
157414,157519,157978,105,459,2,14400,1.22875816993
157509,157644,159384,135,1740,2,36000,1.0775862069
157636,157767,159446,131,1679,2,36000,1.07802263252
157681,242073,290704,84392,48631,1,172800,2.73535399231
157755,157848,159624,93,1776,2,36000,1.05236486486
157838,157854,159563,16,1709,2,36000,1.00936220012
157853,157990,159883,137,1893,2,36000,1.07237189646
157853,157932,158360,79,428,2,14400,1.18457943925
157853,157939,159307,86,1368,6,3000,1.06286549708
157923,158034,159544,111,1510,2,36000,1.07350993377
158024,158100,159965,76,1865,2,36000,1.04075067024
158088,158105,159787,17,1682,2,36000,1.01010701546
158103,158116,159714,13,1598,2,36000,1.00813516896
158105,158122,159245,17,1123,2,36000,1.01513802315
158106,158138,160329,32,2191,2,36000,1.0146052031
158127,158179,159776,52,1597,2,36000,1.03256105197
158167,158188,160230,21,2042,2,36000,1.01028403526
158190,158280,159668,90,1388,6,3000,1.06484149856
158190,158196,158872,6,676,2,14400,1.00887573964
158250,158256,160107,6,1851,2,36000,1.00324149109
158282,158620,159848,338,1228,6,3000,1.27524429967
158282,158288,158995,6,707,2,14400,1.00848656294
158409,158416,160131,7,1715,2,36000,1.00408163265
158425,158431,160035,6,1604,2,36000,1.00374064838
158473,158480,160229,7,1749,2,36000,1.00400228702
158489,158495,160216,6,1721,2,36000,1.00348634515
158617,158626,160354,9,1728,2,36000,1.00520833333
158629,158635,159291,6,656,2,14400,1.00914634146
158640,158646,160208,6,1562,6,3000,1.00384122919
158640,158654,159272,14,618,2,14400,1.02265372168
158645,158813,160813,168,2000,2,36000,1.084
158803,158883,160681,80,1798,2,36000,1.04449388209
158885,159286,161485,401,2199,6,3000,1.18235561619
158885,158940,159651,55,711,2,14400,1.07735583685
158930,158973,160024,43,1051,2,36000,1.04091341579
158964,158979,160783,15,1804,2,36000,1.00831485588
158979,159006,160736,27,1730,2,36000,1.01560693642
159059,159067,160884,8,1817,2,36000,1.00440286186
159113,159125,160898,12,1773,2,36000,1.00676818951
159184,159195,160901,11,1706,2,36000,1.00644783118
159199,159205,161001,6,1796,2,36000,1.00334075724
159247,159256,161159,9,1903,2,36000,1.00472937467
159283,159292,159902,9,610,2,14400,1.01475409836
159294,159302,159835,8,533,2,14400,1.01500938086
159294,159318,160875,24,1557,6,3000,1.01541425819
159315,159679,160850,364,1171,6,3000,1.31084543126
159315,159395,160032,80,637,2,14400,1.12558869702
159388,159457,161068,69,1611,2,36000,1.04283054004
159446,159463,161455,17,1992,2,36000,1.00853413655
159448,159555,160670,107,1115,2,36000,1.09596412556
159547,159574,161281,27,1707,2,36000,1.0158172232
159565,159635,161485,70,1850,2,36000,1.03783783784
159626,159662,161088,36,1426,2,36000,1.0252454418
159682,159860,161599,178,1739,6,3000,1.10235767683
159682,159725,160269,43,544,2,14400,1.07904411765
159717,159788,161289,71,1501,2,36000,1.0473017988
159778,159798,161440,20,1642,2,36000,1.01218026797
159793,159846,161648,53,1802,2,36000,1.02941176471
159856,159895,160321,39,426,2,14400,1.09154929577
159856,160219,161621,363,1402,6,3000,1.25891583452
159884,159913,161555,29,1642,2,36000,1.01766138855
159966,159976,161810,10,1834,2,36000,1.0054525627
160024,160035,161720,11,1685,2,36000,1.00652818991
160039,160045,162022,6,1977,2,36000,1.00303490137
160106,160112,161679,6,1567,2,36000,1.00382897256
160131,160137,161636,6,1499,2,36000,1.00400266845
160217,160225,161993,8,1768,2,36000,1.00452488688
160224,160692,162056,468,1364,6,3000,1.3431085044
160224,160231,160686,7,455,2,14400,1.01538461538
160233,160241,162149,8,1908,2,36000,1.00419287212
160234,160246,161889,12,1643,2,36000,1.00730371272
160331,160337,162002,6,1665,2,36000,1.0036036036
160353,160359,161991,6,1632,2,36000,1.00367647059
160672,160678,162492,6,1814,2,36000,1.0033076075
160687,160698,161897,11,1199,2,36000,1.00917431193
160694,160747,161259,53,512,2,14400,1.103515625
160736,160795,162364,59,1569,2,36000,1.03760356915
160784,160824,162395,40,1571,2,36000,1.0254614895
160815,160861,162580,46,1719,2,36000,1.02675974404
160857,160867,161524,10,657,2,14400,1.01522070015
160868,160874,161623,6,749,2,14400,1.00801068091
160871,160886,162041,15,1155,6,3000,1.01298701299
160882,161499,163022,617,1523,6,3000,1.40512147078
160885,160895,162713,10,1818,2,36000,1.00550055006
160901,160909,162653,8,1744,2,36000,1.00458715596
160902,160915,162854,13,1939,2,36000,1.00670448685
161003,161012,162780,9,1768,2,36000,1.00509049774
161070,161079,162624,9,1545,2,36000,1.00582524272
161088,161099,162886,11,1787,2,36000,1.00615556799
161162,161170,162761,8,1591,2,36000,1.0050282841
161283,161290,162876,7,1586,2,36000,1.00441361917
161299,161305,162895,6,1590,2,36000,1.00377358491
161441,161447,163130,6,1683,2,36000,1.00356506239
161456,161463,163229,7,1766,2,36000,1.00396375991
161487,161493,163438,6,1945,2,36000,1.0030848329
161499,161610,162958,111,1348,6,3000,1.08234421365
161557,161563,163292,6,1729,2,36000,1.003470214
161613,161619,162299,6,680,2,14400,1.00882352941
161623,161629,162273,6,644,2,14400,1.00931677019
161624,161635,163218,11,1583,6,3000,1.00694883133
161634,161641,162332,7,691,2,14400,1.01013024602
161636,161647,163259,11,1612,2,36000,1.00682382134
161644,161659,162277,15,618,2,14400,1.02427184466
161645,162052,163234,407,1182,6,3000,1.34433164129
161651,161690,163058,39,1368,2,36000,1.02850877193
161682,161731,163431,49,1700,2,36000,1.02882352941
161722,161821,163560,99,1739,2,36000,1.0569292697
161810,161900,163333,90,1433,2,36000,1.06280530356
161890,161908,163842,18,1934,2,36000,1.00930713547
161905,162003,163694,98,1691,2,36000,1.05795387345
161994,162009,163611,15,1602,2,36000,1.00936329588
161995,162015,163649,20,1634,2,36000,1.01223990208
162010,162033,163740,23,1707,2,36000,1.01347393087
162026,162067,163665,41,1598,2,36000,1.02565707134
162063,162073,162640,10,567,2,14400,1.0176366843
162074,162080,162552,6,472,2,14400,1.01271186441
162077,162311,163758,234,1447,6,3000,1.16171389081
162153,162160,163931,7,1771,2,36000,1.00395256917
162309,162344,162882,35,538,2,14400,1.06505576208
162340,162375,162963,35,588,2,14400,1.05952380952
162366,162406,164278,40,1872,2,36000,1.02136752137
162397,162503,164469,106,1966,2,36000,1.05391658189
162494,162564,164484,70,1920,2,36000,1.03645833333
162560,162897,164065,337,1168,6,3000,1.28852739726
162583,162592,164077,9,1485,2,36000,1.00606060606
162626,162635,164362,9,1727,2,36000,1.00521134916
162654,162660,164644,6,1984,2,36000,1.00302419355
162715,162721,164437,6,1716,2,36000,1.0034965035
162764,162770,164516,6,1746,2,36000,1.00343642612
162783,162789,164887,6,2098,2,36000,1.00285986654
162857,162863,164018,6,1155,2,36000,1.00519480519
162876,162882,164826,6,1944,2,36000,1.00308641975
162891,162907,164357,16,1450,2,36000,1.01103448276
162906,162969,164914,63,1945,2,36000,1.0323907455
162969,162975,164115,6,1140,6,3000,1.00526315789
162972,163033,163578,61,545,2,14400,1.1119266055
163030,163230,165744,200,2514,6,3000,1.07955449483
163059,163065,164569,6,1504,2,36000,1.0039893617
163129,163135,164875,6,1740,2,36000,1.00344827586
163228,163236,163704,8,468,2,14400,1.01709401709
163230,163241,164997,11,1756,2,36000,1.0062642369
163238,163247,163889,9,642,2,14400,1.01401869159
163245,163253,164614,8,1361,6,3000,1.00587803086
163249,163270,163931,21,661,2,14400,1.03177004539
163260,163303,165158,43,1855,2,36000,1.02318059299
163294,163345,164904,51,1559,2,36000,1.03271327774
163333,163443,165324,110,1881,2,36000,1.05847953216
163433,163449,165161,16,1712,2,36000,1.00934579439
163449,163571,165347,122,1776,2,36000,1.06869369369
163563,163622,165348,59,1726,2,36000,1.03418308227
163605,266079,266086,102474,7,2,36000,10248.1
163612,163660,165205,48,1545,2,36000,1.03106796117
163626,261370,273964,97744,12594,17,36000,8.76115610608
163632,262561,274794,98929,12233,17,36000,9.0870595929
163639,262566,274913,98927,12347,17,36000,9.01222969142
163649,163676,165253,27,1577,2,36000,1.01712111604
163667,163705,165403,38,1698,2,36000,1.02237926973
163695,163715,165825,20,2110,2,36000,1.00947867299
163715,163769,165181,54,1412,6,3000,1.03824362606
163741,163751,165590,10,1839,2,36000,1.0054377379
163766,163945,165283,179,1338,6,3000,1.13378176383
163842,163848,165616,6,1768,2,36000,1.00339366516
163933,163939,165577,6,1638,2,36000,1.00366300366
163943,163990,164662,47,672,2,14400,1.06994047619
163991,163997,165354,6,1357,6,3000,1.00442151805
163995,164003,164626,8,623,2,14400,1.01284109149
164002,164076,165199,74,1123,6,3000,1.06589492431
164018,164029,165769,11,1740,2,36000,1.00632183908
164074,164126,166366,52,2240,6,3000,1.02321428571
164080,164086,165822,6,1736,2,36000,1.0034562212
164125,164626,165970,501,1344,6,3000,1.37276785714
164280,164287,165979,7,1692,2,36000,1.00413711584
164360,164366,165967,6,1601,2,36000,1.00374765771
164375,164381,166144,6,1763,2,36000,1.00340328985
164439,164446,166184,7,1738,2,36000,1.00402761795
164470,164476,166116,6,1640,2,36000,1.00365853659
164485,164491,166319,6,1828,2,36000,1.00328227571
164516,164522,166218,6,1696,2,36000,1.00353773585
164571,164577,166464,6,1887,2,36000,1.00317965024
164626,164674,166096,48,1422,6,3000,1.03375527426
164644,164650,165991,6,1341,2,36000,1.00447427293
164677,165192,166572,515,1380,6,3000,1.3731884058
164827,164837,166579,10,1742,2,36000,1.00574052813
164876,164886,166507,10,1621,2,36000,1.00616903146
164879,262608,297354,97729,34746,4,432000,3.81266908421
164891,164898,166615,7,1717,2,36000,1.00407687828
164906,164915,166716,9,1801,2,36000,1.00499722376
164922,164928,166683,6,1755,2,36000,1.00341880342
164998,165008,166708,10,1700,2,36000,1.00588235294
165159,165169,167042,10,1873,2,36000,1.0053390283
165174,165181,167041,7,1860,2,36000,1.00376344086
165188,165211,166438,23,1227,6,3000,1.01874490628
165205,165217,166805,12,1588,2,36000,1.00755667506
165219,165295,166447,76,1152,6,3000,1.06597222222
165220,165264,165838,44,574,2,14400,1.07665505226
165254,165336,167109,82,1773,2,36000,1.04624929498
165327,165358,167116,31,1758,2,36000,1.01763367463
165349,165364,167052,15,1688,2,36000,1.00888625592
165351,165414,167042,63,1628,2,36000,1.0386977887
165403,165588,167323,185,1735,2,36000,1.10662824207
165578,165601,167005,23,1404,2,36000,1.01638176638
165594,165627,167352,33,1725,2,36000,1.01913043478
165618,165755,167461,137,1706,2,36000,1.08030480657
165751,165766,166332,15,566,2,14400,1.02650176678
165751,165761,166906,10,1145,6,3000,1.00873362445
165770,165780,167717,10,1937,2,36000,1.00516262261
165782,165788,166401,6,613,2,14400,1.00978792822
165782,165981,167397,199,1416,6,3000,1.14053672316
165822,165834,167589,12,1755,2,36000,1.00683760684
165837,165843,167898,6,2055,2,36000,1.00291970803
165968,165974,167729,6,1755,2,36000,1.00341880342
165983,165989,167747,6,1758,2,36000,1.00341296928
165986,165995,166567,9,572,2,14400,1.01573426573
165986,166108,167251,122,1143,6,3000,1.10673665792
165998,166004,167774,6,1770,2,36000,1.00338983051
166109,166377,167555,268,1178,6,3000,1.22750424448
166109,166128,166578,19,450,2,14400,1.04222222222
166117,166155,167937,38,1782,2,36000,1.02132435466
166145,166195,167310,50,1115,2,36000,1.04484304933
166185,166229,167976,44,1747,2,36000,1.0251860332
166218,166330,168286,112,1956,2,36000,1.0572597137
166319,166382,168567,63,2185,2,36000,1.02883295195
166385,166449,168389,64,1940,6,3000,1.03298969072
166386,166413,166990,27,577,2,14400,1.04679376083
166447,166476,166947,29,471,2,14400,1.06157112527
166447,166458,168401,11,1943,6,3000,1.00566134843
166466,166518,168355,52,1837,2,36000,1.02830702232
166508,166579,168264,71,1685,2,36000,1.04213649852
166580,166592,167096,12,504,2,14400,1.02380952381
166580,166586,167707,6,1121,6,3000,1.00535236396
166581,166597,168340,16,1743,2,36000,1.00917957544
166601,166917,168180,316,1263,6,3000,1.25019794141
166601,166626,167298,25,672,2,14400,1.03720238095
166618,166694,168401,76,1707,2,36000,1.04452255419
166685,166720,168364,35,1644,2,36000,1.02128953771
166709,166727,168465,18,1738,2,36000,1.01035673188
166725,166817,168497,92,1680,2,36000,1.05476190476
166806,166958,168897,152,1939,2,36000,1.07839092316
166958,167002,167694,44,692,2,14400,1.06358381503
167000,167262,168630,262,1368,6,3000,1.19152046784
167000,167016,167766,16,750,2,14400,1.02133333333
167006,167052,168702,46,1650,2,36000,1.02787878788
167041,167058,168993,17,1935,2,36000,1.00878552972
167042,167063,168912,21,1849,2,36000,1.01135749054
167043,167070,168426,27,1356,2,36000,1.01991150442
167058,167108,169096,50,1988,2,36000,1.02515090543
167108,167120,168740,12,1620,2,36000,1.00740740741
167123,167129,168774,6,1645,2,36000,1.00364741641
167265,167310,167945,45,635,2,14400,1.07086614173
167265,167408,169261,143,1853,6,3000,1.07717215326
167313,167321,168828,8,1507,2,36000,1.00530856005
167328,167334,169124,6,1790,2,36000,1.00335195531
167353,167363,169407,10,2044,2,36000,1.00489236791
167409,167473,168050,64,577,2,14400,1.11091854419
167462,167566,169331,104,1765,2,36000,1.05892351275
167562,167572,168223,10,651,2,14400,1.0153609831
167573,167579,168216,6,637,2,14400,1.00941915228
167583,167600,168167,17,567,2,14400,1.02998236332
167589,167718,169464,129,1746,2,36000,1.07388316151
167716,167724,168248,8,524,2,14400,1.01526717557
167718,167729,169095,11,1366,2,36000,1.00805270864
167727,167735,168228,8,493,2,14400,1.01622718053
167733,167741,169484,8,1743,2,36000,1.00458978772
167737,167747,168251,10,504,2,14400,1.01984126984
167748,167758,168252,10,494,2,14400,1.02024291498
167748,167777,169714,29,1937,2,36000,1.01497160558
167769,167785,168888,16,1103,2,36000,1.01450589302
167789,167909,168455,120,546,2,14400,1.21978021978
167900,167949,169352,49,1403,2,36000,1.03492516037
167940,167956,169722,16,1766,2,36000,1.00906002265
167953,167987,168563,34,576,2,14400,1.05902777778
167976,168061,169735,85,1674,2,36000,1.05077658303
168066,168179,168663,113,484,2,14400,1.23347107438
168178,168192,168937,14,745,2,14400,1.01879194631
168189,168198,168816,9,618,2,14400,1.0145631068
168199,168206,168874,7,668,2,14400,1.01047904192
168210,168228,169032,18,804,2,14400,1.0223880597
168231,168237,168934,6,697,2,14400,1.00860832138
168241,168248,168910,7,662,2,14400,1.01057401813
168252,168259,168953,7,694,2,14400,1.01008645533
168263,168269,168921,6,652,2,14400,1.00920245399
168265,168275,170321,10,2046,2,36000,1.00488758553
168273,168281,168909,8,628,2,14400,1.0127388535
168284,168298,168963,14,665,2,14400,1.02105263158
168287,168352,170068,65,1716,2,36000,1.03787878788
168342,168367,169855,25,1488,2,36000,1.01680107527
168357,168376,170423,19,2047,2,36000,1.00928187592
168372,168400,170289,28,1889,2,36000,1.01482265749
168396,168406,169019,10,613,2,14400,1.0163132137
168403,168412,170159,9,1747,2,36000,1.00515168861
168417,168423,168996,6,573,2,14400,1.01047120419
168427,168433,170352,6,1919,2,36000,1.00312662845
168428,168439,168938,11,499,2,14400,1.02204408818
168438,168445,168948,7,503,2,14400,1.01391650099
168449,168455,169060,6,605,2,14400,1.00991735537
168459,168466,168951,7,485,2,14400,1.01443298969
168467,168477,169917,10,1440,2,36000,1.00694444444
168480,168509,169113,29,604,2,14400,1.04801324503
168501,168574,170368,73,1794,2,36000,1.04069119287
168568,168580,170441,12,1861,2,36000,1.00644814616
168583,168641,169137,58,496,2,14400,1.11693548387
168644,168651,169138,7,487,2,14400,1.01437371663
168655,168661,169119,6,458,2,14400,1.01310043668
168666,168674,169267,8,593,2,14400,1.01349072513
168676,168713,169307,37,594,2,14400,1.06228956229
168702,168751,170453,49,1702,2,36000,1.02878965922
168742,168785,170519,43,1734,2,36000,1.02479815456
168776,168839,170500,63,1661,2,36000,1.03792895846
168830,168899,170144,69,1245,2,36000,1.05542168675
168888,168908,170840,20,1932,2,36000,1.01035196687
168904,168920,170731,16,1811,2,36000,1.00883489785
168919,168926,170737,7,1811,2,36000,1.00386526781
168922,168932,169653,10,721,2,14400,1.01386962552
168932,168938,169509,6,571,2,14400,1.01050788091
168943,168949,169644,6,695,2,14400,1.00863309353
168953,168959,169663,6,704,2,14400,1.00852272727
168964,168970,169784,6,814,2,14400,1.00737100737
168975,168981,169661,6,680,2,14400,1.00882352941
168985,168991,169581,6,590,2,14400,1.01016949153
168995,169001,171208,6,2207,2,36000,1.00271862256
169006,169012,169670,6,658,2,14400,1.00911854103
169016,169023,169695,7,672,2,14400,1.01041666667
169027,169033,169644,6,611,2,14400,1.00981996727
169038,169044,169595,6,551,2,14400,1.0108892922
169048,169054,169736,6,682,2,14400,1.00879765396
169059,169065,169560,6,495,2,14400,1.01212121212
169069,169076,169602,7,526,2,14400,1.01330798479
169080,169086,169632,6,546,2,14400,1.01098901099
169091,169106,169636,15,530,2,14400,1.02830188679
169096,169112,171041,16,1929,2,36000,1.00829445308
169097,169124,170186,27,1062,2,36000,1.02542372881
169122,169130,169628,8,498,2,14400,1.01606425703
169125,169136,170832,11,1696,2,36000,1.00648584906
169132,169148,169651,16,503,2,14400,1.03180914513
169153,169159,169666,6,507,2,14400,1.01183431953
169164,169272,169845,108,573,2,14400,1.18848167539
169277,169283,169848,6,565,2,14400,1.01061946903
169287,169293,169829,6,536,2,14400,1.01119402985
169298,169304,169965,6,661,2,14400,1.00907715582
169308,169318,169955,10,637,2,14400,1.01569858713
169319,169342,170126,23,784,2,14400,1.02933673469
169334,169363,170928,29,1565,2,36000,1.01853035144
169353,169418,171059,65,1641,2,36000,1.03960999391
169408,169475,171292,67,1817,2,36000,1.03687396808
169463,169496,171108,33,1612,2,36000,1.02047146402
169485,169571,171067,86,1496,2,36000,1.05748663102
169575,169581,170202,6,621,2,14400,1.00966183575
169585,169593,170228,8,635,2,14400,1.0125984252
169596,169606,170361,10,755,2,14400,1.01324503311
169606,169613,170299,7,686,2,14400,1.01020408163
169617,169639,170240,22,601,2,14400,1.03660565724
169638,169645,170259,7,614,2,14400,1.01140065147
169648,169654,170204,6,550,2,14400,1.01090909091
169659,169665,170292,6,627,2,14400,1.00956937799
169669,169676,170253,7,577,2,14400,1.01213171577
169680,169686,170198,6,512,2,14400,1.01171875
169691,169697,170274,6,577,2,14400,1.01039861352
169701,169707,170188,6,481,2,14400,1.01247401247
169712,169718,170731,6,1013,2,14400,1.00592300099
169716,169724,170971,8,1247,2,36000,1.00641539695
169722,169730,170313,8,583,2,14400,1.01372212693
169731,169738,171559,7,1821,2,36000,1.00384404174
169743,169749,170260,6,511,2,14400,1.01174168297
169747,169755,171362,8,1607,2,36000,1.00497822029
169754,169761,170308,7,547,2,14400,1.01279707495
169764,169770,170370,6,600,2,14400,1.01
169775,169795,170348,20,553,2,14400,1.03616636528
169796,169840,170511,44,671,2,14400,1.06557377049
169837,169856,170458,19,602,2,14400,1.03156146179
169856,169866,171513,10,1647,2,36000,1.00607164542
169868,169874,170576,6,702,2,14400,1.00854700855
169878,169928,170597,50,669,2,14400,1.07473841555
169917,169967,171676,50,1709,2,36000,1.02925687537
169971,169977,170632,6,655,2,14400,1.00916030534
169981,170079,170710,98,631,2,14400,1.15530903328
170070,170137,171761,67,1624,2,36000,1.04125615764
170135,170155,170796,20,641,2,14400,1.03120124805
170146,170170,171809,24,1639,2,36000,1.01464307505
170161,170197,171845,36,1648,2,36000,1.02184466019
170189,170216,172182,27,1966,2,36000,1.01373346897
170217,170223,170846,6,623,2,14400,1.00963081862
170228,170234,170913,6,679,2,14400,1.0088365243
170238,170245,170785,7,540,2,14400,1.01296296296
170249,170255,170811,6,556,2,14400,1.01079136691
170259,170266,170926,7,660,2,14400,1.01060606061
170270,170276,170875,6,599,2,14400,1.01001669449
170281,170287,171268,6,981,2,14400,1.00611620795
170291,170297,170789,6,492,2,14400,1.01219512195
170292,170303,172394,11,2091,2,36000,1.00526064084
170302,170309,170893,7,584,2,14400,1.01198630137
170312,170319,170912,7,593,2,14400,1.01180438449
170323,170329,170854,6,525,2,14400,1.01142857143
170323,170334,172210,11,1876,2,36000,1.00586353945
170333,170340,170919,7,579,2,14400,1.01208981002
170344,170350,170921,6,571,2,14400,1.01050788091
170353,170363,172040,10,1677,2,36000,1.00596302922
170365,170371,170862,6,491,2,14400,1.01221995927
170369,170379,173078,10,2699,2,36000,1.00370507595
170375,170385,170933,10,548,2,14400,1.01824817518
170386,170392,171077,6,685,2,14400,1.00875912409
170397,170435,171094,38,659,2,14400,1.05766312595
170424,170452,172428,28,1976,2,36000,1.01417004049
170442,170464,172212,22,1748,2,36000,1.01258581236
170457,170511,171692,54,1181,2,36000,1.04572396274
170500,170522,172214,22,1692,2,36000,1.01300236407
170520,170528,171208,8,680,2,14400,1.01176470588
170521,170534,172240,13,1706,2,36000,1.00762016413
170530,170587,171234,57,647,2,14400,1.08809891808
170592,170609,171254,17,645,2,14400,1.02635658915
170613,170643,171241,30,598,2,14400,1.05016722408
170644,170721,171401,77,680,2,14400,1.11323529412
170726,170742,171346,16,604,2,14400,1.02649006623
170733,170747,172520,14,1773,2,36000,1.00789622109
170746,170753,171269,7,516,2,14400,1.01356589147
170749,170800,172561,51,1761,2,36000,1.02896081772
170798,170806,171320,8,514,2,14400,1.01556420233
170809,170815,171435,6,620,2,14400,1.00967741935
170819,170825,171346,6,521,2,14400,1.01151631478
170830,170844,171379,14,535,2,14400,1.0261682243
170834,170851,172747,17,1896,2,36000,1.00896624473
170849,170923,172802,74,1879,2,36000,1.03938265035
170922,170929,171469,7,540,2,14400,1.01296296296
170928,170935,172808,7,1873,2,36000,1.00373731981
170933,170941,171416,8,475,2,14400,1.01684210526
170943,170949,171535,6,586,2,14400,1.01023890785
170954,170960,171512,6,552,2,14400,1.01086956522
170964,170970,171496,6,526,2,14400,1.01140684411
170971,170977,172526,6,1549,2,36000,1.00387346675
170975,170983,171497,8,514,2,14400,1.01556420233
170985,170992,171488,7,496,2,14400,1.01411290323
170996,171002,171520,6,518,2,14400,1.01158301158
171007,171013,171530,6,517,2,14400,1.01160541586
171017,171024,171694,7,670,2,14400,1.01044776119
171028,171052,171737,24,685,2,14400,1.03503649635
171041,171070,173061,29,1991,2,36000,1.01456554495
171059,171078,172844,19,1766,2,36000,1.0107587769
171075,171088,172859,13,1771,2,36000,1.0073404856
171090,171106,171754,16,648,2,14400,1.02469135802
171109,171119,172755,10,1636,2,36000,1.00611246944
171121,171219,171887,98,668,2,14400,1.14670658683
171210,171224,172416,14,1192,2,36000,1.01174496644
171223,171246,171918,23,672,2,14400,1.03422619048
171244,171252,171883,8,631,2,14400,1.01267828843
171254,171265,171913,11,648,2,14400,1.01697530864
171265,171280,171817,15,537,2,14400,1.02793296089
171276,171286,171848,10,562,2,14400,1.01779359431
171286,171303,171834,17,531,2,14400,1.03201506591
171292,171357,172746,65,1389,2,36000,1.0467962563
171358,171364,171928,6,564,2,14400,1.01063829787
171362,171373,173076,11,1703,2,36000,1.00645918967
171369,171379,171912,10,533,2,14400,1.01876172608
171379,171390,171929,11,539,2,14400,1.02040816327
171390,171412,171945,22,533,2,14400,1.04127579737
171411,171427,172064,16,637,2,14400,1.0251177394
171431,171447,172077,16,630,2,14400,1.0253968254
171452,171480,171984,28,504,2,14400,1.05555555556
171483,171500,171987,17,487,2,14400,1.03490759754
171504,171510,172021,6,511,2,14400,1.01174168297
171512,171524,173355,12,1831,2,36000,1.00655379574
171525,171531,172010,6,479,2,14400,1.01252609603
171535,171541,172083,6,542,2,14400,1.0110701107
171546,171552,172244,6,692,2,14400,1.00867052023
171557,171563,172258,6,695,2,14400,1.00863309353
171561,171569,172714,8,1145,2,36000,1.00698689956
171567,171575,172234,8,659,2,14400,1.01213960546
171578,171687,172304,109,617,2,14400,1.17666126418
171676,171703,173480,27,1777,2,36000,1.01519414744
171692,171709,173556,17,1847,2,36000,1.00920411478
171711,171749,172405,38,656,2,14400,1.05792682927
171752,171765,172321,13,556,2,14400,1.02338129496
171762,171773,173470,11,1697,2,36000,1.00648202711
171773,171821,172497,48,676,2,14400,1.07100591716
171811,171846,173543,35,1697,2,36000,1.0206246317
171845,171852,172430,7,578,2,14400,1.01211072664
171848,171858,173615,10,1757,2,36000,1.00569151964
171855,171864,172402,9,538,2,14400,1.01672862454
171866,171894,172425,28,531,2,14400,1.0527306968
171897,171903,172456,6,553,2,14400,1.01084990958
171908,171923,172441,15,518,2,14400,1.02895752896
171928,171935,172528,7,593,2,14400,1.01180438449
171939,171945,172442,6,497,2,14400,1.01207243461
171950,171956,172575,6,619,2,14400,1.00969305331
171960,171966,172569,6,603,2,14400,1.00995024876
171971,171977,172553,6,576,2,14400,1.01041666667
171981,171996,172526,15,530,2,14400,1.02830188679
171992,172002,172527,10,525,2,14400,1.01904761905
172002,172021,172547,19,526,2,14400,1.036121673
172023,172032,172523,9,491,2,14400,1.0183299389
172034,172051,172774,17,723,2,14400,1.0235131397
172040,172089,173904,49,1815,2,36000,1.02699724518
172085,172095,172757,10,662,2,14400,1.01510574018
172096,172102,172774,6,672,2,14400,1.00892857143
172107,172193,172899,86,706,2,14400,1.12181303116
172183,172222,173611,39,1389,2,36000,1.02807775378
172211,172228,173873,17,1645,2,36000,1.0103343465
172213,172233,173962,20,1729,2,36000,1.01156737999
172214,172246,173933,32,1687,2,36000,1.01896858328
172241,172252,173984,11,1732,2,36000,1.00635103926
172250,172258,172991,8,733,2,14400,1.01091405184
172261,172270,172874,9,604,2,14400,1.01490066225
172271,172315,172931,44,616,2,14400,1.07142857143
172312,172332,173112,20,780,2,14400,1.02564102564
172333,172406,172936,73,530,2,14400,1.13773584906
172393,172413,174388,20,1975,2,36000,1.01012658228
172414,172420,173973,6,1553,2,36000,1.00386349002
172415,172427,173116,12,689,2,14400,1.01741654572
172426,172435,172969,9,534,2,14400,1.01685393258
172429,172442,174247,13,1805,2,36000,1.00720221607
172447,172452,172968,5,516,2,14400,1.00968992248
172457,172463,173012,6,549,2,14400,1.01092896175
172468,172474,172996,6,522,2,14400,1.01149425287
172478,172484,173019,6,535,2,14400,1.01121495327
172489,172508,173023,19,515,2,14400,1.03689320388
172510,172531,173106,21,575,2,14400,1.03652173913
172521,172537,174132,16,1595,2,36000,1.01003134796
172536,172564,174296,28,1732,2,36000,1.01616628176
172561,172570,173198,9,628,2,14400,1.01433121019
172563,172576,174430,13,1854,2,36000,1.00701186624
172572,172582,173138,10,556,2,14400,1.01798561151
172582,172588,173069,6,481,2,14400,1.01247401247
172593,172599,173090,6,491,2,14400,1.01221995927
172604,172610,173130,6,520,2,14400,1.01153846154
172614,172620,173075,6,455,2,14400,1.01318681319
172625,172631,173087,6,456,2,14400,1.01315789474
172635,172725,173183,90,458,2,14400,1.19650655022
172716,172757,174509,41,1752,2,36000,1.02340182648
172747,172763,174164,16,1401,2,36000,1.01142041399
172749,172769,174386,20,1617,2,36000,1.0123685838
172764,172785,174784,21,1999,2,36000,1.01050525263
172789,172795,173220,6,425,2,14400,1.01411764706
172799,172806,173282,7,476,2,14400,1.01470588235
172804,172813,174527,9,1714,2,36000,1.00525087515
172810,172819,173406,9,587,2,14400,1.01533219761
172819,172855,174419,36,1564,2,36000,1.02301790281
172847,172870,174567,23,1697,2,36000,1.0135533294
172862,172910,174839,48,1929,2,36000,1.02488335925
172912,172919,173435,7,516,2,14400,1.01356589147
172923,172942,173478,19,536,2,14400,1.03544776119
172944,172950,173456,6,506,2,14400,1.01185770751
172954,172980,173605,26,625,2,14400,1.0416
172985,172992,173480,7,488,2,14400,1.0143442623
172996,173002,173468,6,466,2,14400,1.01287553648
173007,173013,173551,6,538,2,14400,1.01115241636
173017,173023,173494,6,471,2,14400,1.0127388535
173028,173034,173454,6,420,2,14400,1.01428571429
173038,173044,173487,6,443,2,14400,1.01354401806
173049,173072,173683,23,611,2,14400,1.03764320786
173063,173086,174962,23,1876,2,36000,1.01226012793
173078,173092,174698,14,1606,2,36000,1.00871731009
173080,173097,174976,17,1879,2,36000,1.00904736562
173100,173107,173655,7,548,2,14400,1.01277372263
173111,173117,173658,6,541,2,14400,1.01109057301
173122,173128,173713,6,585,2,14400,1.01025641026
173132,173138,173758,6,620,2,14400,1.00967741935
173143,173149,173592,6,443,2,14400,1.01354401806
173153,173159,173618,6,459,2,14400,1.01307189542
173164,173170,173632,6,462,2,14400,1.01298701299
173174,173181,173636,7,455,2,14400,1.01538461538
173185,173194,173662,9,468,2,14400,1.01923076923
173196,173209,173628,13,419,2,14400,1.03102625298
173206,173231,173711,25,480,2,14400,1.05208333333
173227,173293,173855,66,562,2,14400,1.11743772242
173289,173366,173995,77,629,2,14400,1.12241653418
173351,173417,175103,66,1686,2,36000,1.03914590747
173422,173446,173902,24,456,2,14400,1.05263157895
173443,173465,173953,22,488,2,14400,1.04508196721
173464,173471,174100,7,629,2,14400,1.01112877583
173471,173482,175061,11,1579,2,36000,1.00696643445
173485,173490,174104,5,614,2,14400,1.00814332248
173486,173497,175124,11,1627,2,36000,1.00676090965
173495,173503,173988,8,485,2,14400,1.01649484536
173506,173512,173999,6,487,2,14400,1.01232032854
173516,173523,174089,7,566,2,14400,1.01236749117
173527,173533,173982,6,449,2,14400,1.01336302895
173537,173554,173997,17,443,2,14400,1.03837471783
173543,173568,175104,25,1536,2,36000,1.01627604167
173559,173622,175635,63,2013,2,36000,1.03129657228
173614,173628,175264,14,1636,2,36000,1.00855745721
173615,173643,175222,28,1579,2,36000,1.01773274224
173640,173649,174082,9,433,2,14400,1.0207852194
173651,173657,174283,6,626,2,14400,1.00958466454
173661,173667,174196,6,529,2,14400,1.01134215501
173672,173678,174305,6,627,2,14400,1.00956937799
173682,173688,174272,6,584,2,14400,1.0102739726
173693,173699,174245,6,546,2,14400,1.01098901099
173703,173710,174162,7,452,2,14400,1.01548672566
173714,173720,174201,6,481,2,14400,1.01247401247
173725,173731,174174,6,443,2,14400,1.01354401806
173735,173741,174171,6,430,2,14400,1.01395348837
173746,173752,174215,6,463,2,14400,1.01295896328
173756,173763,174268,7,505,2,14400,1.01386138614
173767,173773,174357,6,584,2,14400,1.0102739726
173778,173867,174582,89,715,2,14400,1.12447552448
173870,173884,174574,14,690,2,14400,1.02028985507
173874,173915,175800,41,1885,2,36000,1.02175066313
173905,173945,175855,40,1910,2,36000,1.02094240838
173932,173973,175304,41,1331,2,36000,1.03080390684
173963,173985,175745,22,1760,2,36000,1.0125
173979,173993,175829,14,1836,2,36000,1.00762527233
173993,173999,174692,6,693,2,14400,1.00865800866
173994,174005,175575,11,1570,2,36000,1.00700636943
174003,174011,174694,8,683,2,14400,1.01171303075
174014,174020,174715,6,695,2,14400,1.00863309353
174025,174031,174723,6,692,2,14400,1.00867052023
174035,174041,175214,6,1173,2,14400,1.00511508951
174046,174052,174526,6,474,2,14400,1.01265822785
174056,174093,174603,37,510,2,14400,1.07254901961
174098,174104,174596,6,492,2,14400,1.01219512195
174108,174114,174642,6,528,2,14400,1.01136363636
174119,174125,174701,6,576,2,14400,1.01041666667
174129,174143,174574,14,431,2,14400,1.03248259861
174132,174175,176161,43,1986,2,36000,1.02165156093
174165,174182,175890,17,1708,2,36000,1.00995316159
174181,174188,174811,7,623,2,14400,1.01123595506
174191,174197,174702,6,505,2,14400,1.01188118812
174202,174208,174742,6,534,2,14400,1.01123595506
174212,174219,174728,7,509,2,14400,1.0137524558
174223,174229,174732,6,503,2,14400,1.01192842942
174234,174257,174838,23,581,2,14400,1.0395869191
174248,174262,175903,14,1641,2,36000,1.0085313833
174265,174279,174777,14,498,2,14400,1.0281124498
174275,174285,175004,10,719,2,14400,1.01390820584
174286,174294,175036,8,742,2,14400,1.01078167116
174296,174307,175008,11,701,2,14400,1.01569186876
174297,174368,176349,71,1981,2,36000,1.0358404846
174368,174374,175048,6,674,2,14400,1.00890207715
174379,174398,175085,19,687,2,14400,1.02765647744
174388,174404,176325,16,1921,2,36000,1.00832899531
174390,174430,175946,40,1516,2,36000,1.02638522427
174420,174441,176221,21,1780,2,36000,1.01179775281
174436,174520,176269,84,1749,2,36000,1.04802744425
174509,174537,176164,28,1627,2,36000,1.0172095882
174527,174543,176645,16,2102,2,36000,1.00761179829
174543,174578,175292,35,714,2,14400,1.04901960784
174568,174585,176346,17,1761,2,36000,1.00965360591
174584,174591,175297,7,706,2,14400,1.00991501416
174594,174601,175306,7,705,2,14400,1.00992907801
174605,174611,175149,6,538,2,14400,1.01115241636
174616,174622,175209,6,587,2,14400,1.01022146508
174626,174653,175318,27,665,2,14400,1.04060150376
174657,174703,175225,46,522,2,14400,1.08812260536
174699,174709,175291,10,582,2,14400,1.01718213058
174702,174714,176252,12,1538,2,36000,1.0078023407
174719,174725,175275,6,550,2,14400,1.01090909091
174730,174736,175294,6,558,2,14400,1.01075268817
174740,174747,175339,7,592,2,14400,1.01182432432
174751,174757,175302,6,545,2,14400,1.01100917431
174762,174768,175276,6,508,2,14400,1.01181102362
174772,174778,175358,6,580,2,14400,1.01034482759
174783,174789,175481,6,692,2,14400,1.00867052023
174784,174795,176585,11,1790,2,36000,1.0061452514
174793,174801,175427,8,626,2,14400,1.01277955272
174804,174822,175331,18,509,2,14400,1.03536345776
174825,174850,175576,25,726,2,14400,1.03443526171
174839,174855,176690,16,1835,2,36000,1.00871934605
174856,174973,175673,117,700,2,14400,1.16714285714
174964,174987,176895,23,1908,2,36000,1.01205450734
174979,175019,176621,40,1602,2,36000,1.02496878901
175019,175026,175692,7,666,2,14400,1.01051051051
175030,175047,175730,17,683,2,14400,1.02489019034
175051,175073,175772,22,699,2,14400,1.03147353362
175062,175096,176859,34,1763,2,36000,1.01928530913
175092,175114,175771,22,657,2,14400,1.03348554033
175105,175119,176904,14,1785,2,36000,1.00784313725
175106,175136,176860,30,1724,2,36000,1.01740139211
175125,175160,176867,35,1707,2,36000,1.02050380785
175164,175225,175896,61,671,2,14400,1.09090909091
175222,175233,176501,11,1268,2,36000,1.00867507886
175236,175275,175806,39,531,2,14400,1.07344632768
175265,175287,176907,22,1620,2,36000,1.01358024691
175287,175303,175719,16,416,2,14400,1.03846153846
175305,175312,177011,7,1699,2,36000,1.00412007063
175308,175323,175801,15,478,2,14400,1.03138075314
175329,175335,175825,6,490,2,14400,1.01224489796
175339,175369,175824,30,455,2,14400,1.06593406593
175370,175439,175920,69,481,2,14400,1.14345114345
175442,175492,176545,50,1053,2,14400,1.04748338082
175493,175587,176128,94,541,2,14400,1.17375231054
175577,175646,176919,69,1273,2,36000,1.05420267086
175586,175593,175600,7,7,1,900,1.4
175596,175602,175845,6,243,14,7980,1.02469135802
175635,175685,177547,50,1862,2,36000,1.0268528464
175688,175730,176273,42,543,2,14400,1.0773480663
175729,175756,176265,27,509,2,14400,1.05304518664
175745,175782,177460,37,1678,2,36000,1.02205005959
175780,175788,176298,8,510,2,14400,1.01568627451
175781,175811,176325,30,514,2,14400,1.05836575875
175800,175817,177673,17,1856,2,36000,1.00915948276
175812,175822,176327,10,505,2,14400,1.0198019802
175822,175835,176353,13,518,2,14400,1.0250965251
175831,175841,177551,10,1710,2,36000,1.00584795322
175833,175846,176574,13,728,2,14400,1.01785714286
175843,175866,176563,23,697,2,14400,1.03299856528
175844,175852,175858,8,6,1,900,1.4
175851,175858,176145,7,287,14,7980,1.0243902439
175855,175901,177614,46,1713,2,36000,1.02685347344
175892,175907,177676,15,1769,2,36000,1.00847936687
175905,175931,176574,26,643,2,14400,1.04043545879
175905,175914,176573,9,659,2,14400,1.01365705615
175907,175957,177597,50,1640,2,36000,1.03048780488
175947,176140,176819,193,679,2,14400,1.28424153166
175947,176172,177783,225,1611,2,36000,1.13966480447
176144,176150,176156,6,6,1,900,1.2
176151,176158,176431,7,273,14,7980,1.02564102564
176161,176178,176869,17,691,2,14400,1.02460202605
176162,176232,177672,70,1440,2,36000,1.04861111111
176177,176263,177845,86,1582,2,36000,1.05436156764
176217,176276,178036,59,1760,2,36000,1.03352272727
176253,176282,177903,29,1621,2,36000,1.01789019124
176272,176288,178058,16,1770,2,36000,1.00903954802
176284,176309,177037,25,728,2,14400,1.03434065934
176305,176336,176869,31,533,2,14400,1.05816135084
176324,176341,177994,17,1653,2,36000,1.01028433152
176336,176347,176847,11,500,2,14400,1.022
176337,176357,176793,20,436,2,14400,1.04587155963
176346,176363,178684,17,2321,2,36000,1.00732442913
176357,176369,176851,12,482,2,14400,1.02489626556
176361,176513,177642,152,1129,2,36000,1.13463241807
176430,176437,176444,7,7,1,900,1.4
176438,176444,176687,6,243,14,7980,1.02469135802
176502,176557,177879,55,1322,2,36000,1.04160363086
176552,176574,177088,22,514,2,14400,1.04280155642
176573,176584,177350,11,766,2,14400,1.01436031332
176574,176590,177147,16,557,2,14400,1.02872531418
176584,176595,177161,11,566,2,14400,1.01943462898
176587,176601,177671,14,1070,2,36000,1.01308411215
176595,176632,177166,37,534,2,14400,1.06928838951
176621,176656,178505,35,1849,2,36000,1.01892915089
176645,176704,178434,59,1730,2,36000,1.03410404624
176684,176690,176697,6,7,1,900,1.3
176688,176804,178329,116,1525,2,36000,1.07606557377
176692,176698,176942,6,244,14,7980,1.02459016393
176795,176830,177372,35,542,2,14400,1.06457564576
176827,176858,177390,31,532,2,14400,1.05827067669
176848,176864,177388,16,524,2,14400,1.03053435115
176859,176870,178641,11,1771,2,36000,1.00621118012
176859,176876,177405,17,529,2,14400,1.03213610586
176870,176882,177453,12,571,2,14400,1.02101576182
176874,176887,178826,13,1939,2,36000,1.00670448685
176876,176892,178331,16,1439,2,36000,1.01111883252
176892,176906,177639,14,733,2,14400,1.01909959072
176897,176915,178583,18,1668,2,36000,1.01079136691
176913,176921,177598,8,677,2,14400,1.011816839
176913,177022,177822,109,800,2,14400,1.13625
176913,176930,178678,17,1748,2,36000,1.00972540046
176914,177049,178501,135,1452,2,36000,1.09297520661
176929,177099,178932,170,1833,2,36000,1.0927441353
176941,176948,176955,7,7,1,900,1.4
176948,176954,177237,6,283,14,7980,1.02120141343
177013,177158,179061,145,1903,2,36000,1.07619548082
177150,177173,177883,23,710,2,14400,1.0323943662
177171,177362,178045,191,683,2,14400,1.27964860908
177171,177179,177883,8,704,2,14400,1.01136363636
177235,177242,177248,7,6,1,900,1.3
177242,177248,177498,6,250,14,7980,1.024
177361,177383,178096,22,713,2,14400,1.03085553997
177383,177399,177879,16,480,2,14400,1.03333333333
177394,177405,177917,11,512,2,14400,1.021484375
177395,177416,178061,21,645,2,14400,1.03255813953
177407,177464,177929,57,465,2,14400,1.12258064516
177459,177471,178819,12,1348,2,36000,1.00890207715
177461,177558,178036,97,478,2,14400,1.20292887029
177494,177500,177507,6,7,1,900,1.3
177501,177509,177766,8,257,14,7980,1.03112840467
177549,177564,179244,15,1680,2,36000,1.00892857143
177550,177608,179168,58,1560,2,36000,1.03717948718
177598,177614,178108,16,494,2,14400,1.03238866397
177599,177625,179000,26,1375,2,36000,1.01890909091
177615,177651,178897,36,1246,2,36000,1.02889245586
177642,177657,179189,15,1532,2,36000,1.00979112272
177649,177682,178191,33,509,2,14400,1.06483300589
177674,177693,179425,19,1732,2,36000,1.01096997691
177675,177698,179415,23,1717,2,36000,1.01339545719
177677,177688,179417,11,1729,2,36000,1.00636205899
177690,177795,178382,105,587,2,14400,1.17887563884
177692,177833,179392,141,1559,2,36000,1.0904425914
177764,177770,177780,6,10,1,900,1.6
177773,177779,178050,6,271,14,7980,1.0221402214
177783,177857,179507,74,1650,2,36000,1.04484848485
177848,177890,179445,42,1555,2,36000,1.0270096463
177881,177895,179612,14,1717,2,36000,1.00815375655
177893,177906,178430,13,524,2,14400,1.02480916031
177893,177901,178529,8,628,2,14400,1.0127388535
177903,177914,179389,11,1475,2,36000,1.00745762712
177904,177928,178443,24,515,2,14400,1.04660194175
177926,177941,178456,15,515,2,14400,1.02912621359
177936,178005,178533,69,528,2,14400,1.13068181818
177994,178047,179970,53,1923,2,36000,1.02756110244
178034,178052,180242,18,2190,2,36000,1.00821917808
178049,178058,178065,9,7,1,900,1.6
178050,178063,178676,13,613,2,14400,1.02120717781
178050,178074,178787,24,713,2,14400,1.03366058906
178057,178069,178315,12,246,14,7980,1.0487804878
178059,178081,179493,22,1412,2,36000,1.01558073654
178071,178108,178842,37,734,2,14400,1.05040871935
178102,178119,178829,17,710,2,14400,1.02394366197
178113,178202,178947,89,745,2,14400,1.11946308725
178195,178340,179002,145,662,2,14400,1.21903323263
178313,178319,178326,6,7,1,900,1.3
178320,178326,178576,6,250,14,7980,1.024
178329,178346,179894,17,1548,2,36000,1.01098191214
178331,178393,180250,62,1857,2,36000,1.03338718363
178389,178441,179151,52,710,2,14400,1.07323943662
178435,178447,180321,12,1874,2,36000,1.00640341515
178440,178454,179143,14,689,2,14400,1.02031930334
178451,178467,178999,16,532,2,14400,1.03007518797
178462,178512,179093,50,581,2,14400,1.08605851979
178503,178540,180193,37,1653,2,36000,1.02238354507
178503,178518,178981,15,463,2,14400,1.03239740821
178518,178546,180076,28,1530,2,36000,1.01830065359
178545,178594,179036,49,442,2,14400,1.11085972851
178574,178580,178587,6,7,1,900,1.3
178580,178588,178691,8,103,14,7980,1.07766990291
178585,178653,180361,68,1708,2,36000,1.03981264637
178643,178687,180354,44,1667,2,36000,1.02639472106
178680,178699,180574,19,1875,2,36000,1.01013333333
178687,178693,178695,6,2,1,900,1.0
178692,178705,179196,13,491,2,14400,1.02647657841
178696,178799,180417,103,1618,2,36000,1.06365883807
178796,178830,179358,34,528,2,14400,1.06439393939
178822,178838,180328,16,1490,2,36000,1.01073825503
178827,178844,179517,17,673,2,14400,1.02526002972
178837,178853,180592,16,1739,2,36000,1.00920069005
178848,178908,179471,60,563,2,14400,1.10657193606
178898,178943,180598,45,1655,2,36000,1.02719033233
178932,178959,179926,27,967,2,36000,1.02792140641
178955,178992,179555,37,563,2,14400,1.06571936057
178986,179010,179573,24,563,2,14400,1.04262877442
179002,179016,180631,14,1615,2,36000,1.00866873065
179009,179021,179548,12,527,2,14400,1.02277039848
179020,179047,179600,27,553,2,14400,1.04882459313
179042,179072,179644,30,572,2,14400,1.05244755245
179063,179155,179659,92,504,2,14400,1.18253968254
179063,179104,180782,41,1678,2,36000,1.02443384982
179146,179162,179822,16,660,2,14400,1.02424242424
179157,179180,179852,23,672,2,14400,1.03422619048
179170,179201,180848,31,1647,2,36000,1.01882210079
179192,179207,181337,15,2130,2,36000,1.00704225352
179198,179255,179982,57,727,2,14400,1.07840440165
179247,179369,180649,122,1280,2,36000,1.0953125
179364,179401,180065,37,664,2,14400,1.05572289157
179391,179407,180987,16,1580,2,36000,1.01012658228
179392,179426,180972,34,1546,2,36000,1.02199223803
179417,179432,181355,15,1923,2,36000,1.00780031201
179418,179438,180121,20,683,2,14400,1.02928257687
179419,179456,181233,37,1777,2,36000,1.02082160945
179434,179482,181067,48,1585,2,36000,1.03028391167
179449,179504,180965,55,1461,2,36000,1.03764544832
179495,179518,181121,23,1603,2,36000,1.01434809732
179510,179529,181262,19,1733,2,36000,1.01096364686
179511,179559,180232,48,673,2,14400,1.07132243685
179552,179567,180387,15,820,2,14400,1.01829268293
179562,179584,180115,22,531,2,14400,1.04143126177
179583,179611,180137,28,526,2,14400,1.05323193916
179605,179624,180158,19,534,2,14400,1.03558052434
179614,179655,181555,41,1900,2,36000,1.02157894737
179646,179670,180204,24,534,2,14400,1.04494382022
179667,179833,180377,166,544,2,14400,1.30514705882
179825,179862,180432,37,570,2,14400,1.0649122807
179856,179905,180399,49,494,2,14400,1.0991902834
179896,179937,181565,41,1628,2,36000,1.02518427518
179927,179982,181817,55,1835,2,36000,1.02997275204
179972,179993,181731,21,1738,2,36000,1.01208285386
179990,180076,180660,86,584,2,14400,1.14726027397
180072,180087,180600,15,513,2,14400,1.02923976608
180076,180126,181876,50,1750,2,36000,1.02857142857
180124,180148,180688,24,540,2,14400,1.04444444444
180124,180132,180780,8,648,2,14400,1.01234567901
180145,180169,180703,24,534,2,14400,1.04494382022
180166,180204,180727,38,523,2,14400,1.07265774379
180195,180216,182147,21,1931,2,36000,1.0108751942
180207,180243,180775,36,532,2,14400,1.06766917293
180238,180254,180969,16,715,2,14400,1.02237762238
180244,180262,182116,18,1854,2,36000,1.00970873786
180259,180333,181160,74,827,2,14400,1.08948004837
180260,180339,182380,79,2041,2,36000,1.03870651641
180322,180365,182048,43,1683,2,36000,1.02554961378
180338,180373,182148,35,1775,2,36000,1.01971830986
180355,180388,182085,33,1697,2,36000,1.01944608132
180370,180399,182327,29,1928,2,36000,1.01504149378
180392,180410,181109,18,699,2,14400,1.02575107296
180404,180428,181095,24,667,2,14400,1.035982009
180419,180443,182171,24,1728,2,36000,1.01388888889
180438,180586,181228,148,642,2,14400,1.23052959502
180559,180566,180644,7,78,14,7980,1.08974358974
180576,180604,182445,28,1841,2,36000,1.01520912548
180596,180610,182466,14,1856,2,36000,1.00754310345
180600,180616,181289,16,673,2,14400,1.02377414562
180611,180643,181274,32,631,2,14400,1.05071315372
180612,180661,182514,49,1853,2,36000,1.02644360496
180631,180671,182406,40,1735,2,36000,1.02305475504
180641,180649,180660,8,11,1,900,1.72727272727
180648,180655,180743,7,88,14,7980,1.07954545455
180650,180699,182644,49,1945,2,36000,1.02519280206
180693,180714,181294,21,580,2,14400,1.03620689655
180704,180739,181192,35,453,2,14400,1.07726269316
180735,180786,181300,51,514,2,14400,1.09922178988
180742,180749,180760,7,11,1,900,1.63636363636
180751,180757,180838,6,81,14,7980,1.07407407407
180776,180792,181319,16,527,2,14400,1.03036053131
180785,180798,182596,13,1798,2,36000,1.00723025584
180798,180865,181363,67,498,2,14400,1.13453815261
180836,180842,180857,6,15,1,900,1.4
180844,180859,181002,15,143,14,7980,1.1048951049
180849,180976,182502,127,1526,2,36000,1.08322411533
180966,180982,182798,16,1816,2,36000,1.00881057269
180975,180988,181482,13,494,2,14400,1.02631578947
180982,180998,182643,16,1645,2,36000,1.00972644377
180997,181078,181575,81,497,2,14400,1.1629778672
180997,181106,182752,109,1646,2,36000,1.06622114216
181000,181006,181013,6,7,1,900,1.3
181014,181021,181182,7,161,14,7980,1.04347826087
181067,181120,182730,53,1610,2,36000,1.03291925466
181118,181132,181742,14,610,2,14400,1.02295081967
181122,181172,182708,50,1536,2,36000,1.03255208333
181174,181204,181854,30,650,2,14400,1.04615384615
181180,181186,181191,6,5,1,900,1.1
181189,181195,181362,6,167,14,7980,1.03592814371
181195,181240,181823,45,583,2,14400,1.07718696398
181235,181246,182966,11,1720,2,36000,1.00639534884
181238,181273,181845,35,572,2,14400,1.06118881119
181263,181285,182615,22,1330,2,36000,1.01654135338
181281,181300,181837,19,537,2,14400,1.03538175047
181292,181306,181886,14,580,2,14400,1.02413793103
181303,181312,181892,9,580,2,14400,1.01551724138
181304,181330,182039,26,709,2,14400,1.03667136812
181325,181348,181984,23,636,2,14400,1.03616352201
181337,181371,181998,34,627,2,14400,1.05422647528
181338,181382,183012,44,1630,2,36000,1.02699386503
181357,181493,183374,136,1881,2,36000,1.07230196704
181360,181366,181387,6,21,1,900,1.28571428571
181368,181377,181529,9,152,14,7980,1.05921052632
181494,181566,182242,72,676,2,14400,1.10650887574
181527,181533,181537,6,4,1,900,1.0
181556,181576,183392,20,1816,2,36000,1.01101321586
181567,181586,182144,19,558,2,14400,1.03405017921
181571,181742,183594,171,1852,2,36000,1.09233261339
181734,181753,183127,19,1374,2,36000,1.01382823872
181747,181829,182211,82,382,2,14400,1.21465968586
181819,181848,182208,29,360,2,14400,1.08055555556
181819,181835,183754,16,1919,2,36000,1.00833767587
181840,181856,182252,16,396,2,14400,1.0404040404
181850,181865,182335,15,470,2,14400,1.03191489362
181861,181888,182360,27,472,2,14400,1.05720338983
181877,181898,183834,21,1936,2,36000,1.01084710744
181892,181904,182444,12,540,2,14400,1.02222222222
181902,181996,182455,94,459,2,14400,1.20479302832
181985,182009,182750,24,741,2,14400,1.03238866397
182005,182050,182720,45,670,2,14400,1.0671641791
182047,182059,182710,12,651,2,14400,1.01843317972
182048,182097,183699,49,1602,2,36000,1.03058676654
182088,182127,182794,39,667,2,14400,1.05847076462
182088,182155,183905,67,1750,2,36000,1.03828571429
182116,182161,183451,45,1290,2,36000,1.03488372093
182151,182166,183961,15,1795,2,36000,1.00835654596
182153,182183,183908,30,1725,2,36000,1.01739130435
182171,182220,183910,49,1690,2,36000,1.02899408284
182211,182226,182774,15,548,2,14400,1.02737226277
182222,182253,182569,31,316,2,14400,1.09810126582
182243,182264,182615,21,351,2,14400,1.05982905983
182255,182338,182759,83,421,2,14400,1.19714964371
182328,182346,183953,18,1607,2,36000,1.01120099564
182331,241570,241665,59239,95,14,7980,624.568421053
182339,182372,182814,33,442,2,14400,1.07466063348
182374,182391,182893,17,502,2,14400,1.03386454183
182380,182418,184107,38,1689,2,36000,1.02249851983
182407,182455,184224,48,1769,2,36000,1.027133974
182447,182461,184453,14,1992,2,36000,1.00702811245
182459,182467,183343,8,876,2,14400,1.00913242009
182459,182478,182902,19,424,2,14400,1.04481132075
182465,182513,184209,48,1696,2,36000,1.02830188679
182502,182526,184403,24,1877,2,36000,1.01278636121
182517,182580,184245,63,1665,2,36000,1.03783783784
182548,182554,182839,6,285,1,3600,1.02105263158
182573,182608,183329,35,721,2,14400,1.04854368932
182597,182626,184222,29,1596,2,36000,1.01817042607
182615,182631,184309,16,1678,2,36000,1.00953516091
182624,182654,183234,30,580,2,14400,1.05172413793
182645,182719,183337,74,618,2,14400,1.11974110032
182645,182660,185207,15,2547,2,36000,1.00588928151
182646,182725,184315,79,1590,2,36000,1.04968553459
182710,182731,184512,21,1781,2,36000,1.01179112858
182728,182741,183394,13,653,2,14400,1.01990811639
182732,182761,184341,29,1580,2,36000,1.01835443038
182751,182767,183217,16,450,2,14400,1.03555555556
182753,182773,184763,20,1990,2,36000,1.01005025126
182772,182786,183215,14,429,2,14400,1.03263403263
182782,182805,183199,23,394,2,14400,1.05837563452
182799,182812,184658,13,1846,2,36000,1.00704225352
182804,182825,183274,21,449,2,14400,1.04677060134
182816,182904,183370,88,466,2,14400,1.18884120172
182899,182913,183447,14,534,2,14400,1.02621722846
182909,182977,183424,68,447,2,14400,1.15212527964
182967,183023,184613,56,1590,2,36000,1.03522012579
183013,183138,184645,125,1507,2,36000,1.08294625083
183123,183131,183850,8,719,1,3600,1.01112656467
183128,183211,183708,83,497,2,14400,1.16700201207
183129,183226,185030,97,1804,2,36000,1.05376940133
183222,183232,183856,10,624,2,14400,1.01602564103
183223,183246,184500,23,1254,2,14400,1.01834130781
183244,183285,183910,41,625,2,14400,1.0656
183275,183340,183995,65,655,2,14400,1.09923664122
183337,183348,183787,11,439,2,14400,1.02505694761
183348,183354,183784,6,430,2,14400,1.01395348837
183349,183381,183740,32,359,2,14400,1.08913649025
183371,183387,183814,16,427,2,14400,1.037470726
183375,183404,185162,29,1758,2,36000,1.0164960182
183394,183410,184995,16,1585,2,36000,1.01009463722
183403,183435,183906,32,471,2,14400,1.06794055202
183424,183458,183939,34,481,2,14400,1.07068607069
183452,183464,185251,12,1787,2,36000,1.00671516508
183457,183606,184371,149,765,2,14400,1.19477124183
183595,183711,185230,116,1519,2,36000,1.07636603028
183702,183719,185744,17,2025,2,36000,1.00839506173
183718,183751,184238,33,487,2,14400,1.06776180698
183749,183765,184339,16,574,2,14400,1.02787456446
183755,183796,185712,41,1916,2,36000,1.02139874739
183790,183802,184477,12,675,2,14400,1.01777777778
183801,183826,184495,25,669,2,14400,1.03736920777
183822,183846,184425,24,579,2,14400,1.0414507772
183837,183867,185614,30,1747,2,36000,1.01717229536
183863,183917,184418,54,501,2,14400,1.10778443114
183908,183922,185812,14,1890,2,36000,1.00740740741
183910,183928,185663,18,1735,2,36000,1.01037463977
183911,183933,185517,22,1584,2,36000,1.01388888889
183925,183940,184409,15,469,2,14400,1.03198294243
183935,183951,184329,16,378,2,14400,1.04232804233
183946,183964,184390,18,426,2,14400,1.04225352113
183954,183972,185623,18,1651,2,36000,1.01090248334
183967,184006,184581,39,575,2,14400,1.06782608696
183969,184119,185832,150,1713,2,36000,1.08756567426
184109,184220,185934,111,1714,2,36000,1.06476079347
184212,184233,185864,21,1631,2,36000,1.01287553648
184226,184239,184693,13,454,2,14400,1.02863436123
184228,184249,186231,21,1982,2,36000,1.01059535822
184229,184257,185908,28,1651,2,36000,1.01695941853
184246,184320,184754,74,434,2,14400,1.17050691244
184247,184327,186087,80,1760,2,36000,1.04545454545
184309,184343,186086,34,1743,2,36000,1.01950659782
184324,184350,186124,26,1774,2,36000,1.01465614431
184329,184337,185699,8,1362,1,3600,1.00587371512
184342,184356,184799,14,443,2,14400,1.0316027088
184342,184382,186072,40,1690,2,36000,1.02366863905
184375,184402,185319,27,917,2,14400,1.0294438386
184396,184415,185073,19,658,2,14400,1.02887537994
184403,184421,186039,18,1618,2,36000,1.01112484549
184417,184430,185076,13,646,2,14400,1.02012383901
184428,184464,185115,36,651,2,14400,1.05529953917
184428,184436,185030,8,594,2,14400,1.01346801347
184452,184488,186346,36,1858,2,36000,1.01937567277
184479,184506,185218,27,712,2,14400,1.03792134831
184500,184512,185029,12,517,2,14400,1.02321083172
184513,184523,186122,10,1599,2,36000,1.00625390869
184520,184592,185163,72,571,2,14400,1.12609457093
184586,184624,185219,38,595,2,14400,1.06386554622
184617,184656,186653,39,1997,2,36000,1.01952929394
184647,184669,185946,22,1277,2,36000,1.01722787784
184661,184705,185284,44,579,2,14400,1.07599309154
184662,184765,186376,103,1611,2,36000,1.06393544382
184756,184774,185395,18,621,2,14400,1.02898550725
184764,184811,186497,47,1686,2,36000,1.02787663108
184807,185007,185560,200,553,2,14400,1.3616636528
184996,185040,186806,44,1766,2,36000,1.02491506229
185033,185046,186893,13,1847,2,36000,1.00703844071
185043,185052,185663,9,611,2,14400,1.0147299509
185044,185084,185653,40,569,2,14400,1.07029876977
185076,185090,185546,14,456,2,14400,1.03070175439
185087,185126,185556,39,430,2,14400,1.09069767442
185118,185174,185557,56,383,2,14400,1.14621409922
185165,185180,186987,15,1807,2,36000,1.00830105147
185169,185219,185618,50,399,2,14400,1.12531328321
185207,185229,186669,22,1440,2,36000,1.01527777778
185223,185234,185655,11,421,2,14400,1.02612826603
185229,185240,186551,11,1311,2,36000,1.00839054157
185234,185262,185689,28,427,2,14400,1.06557377049
185251,185295,187058,44,1763,2,36000,1.02495745888
185289,185331,185782,42,451,2,14400,1.09312638581
185322,185406,185876,84,470,2,14400,1.17872340426
185397,185529,186148,132,619,2,14400,1.21324717286
185520,185557,187392,37,1835,2,36000,1.02016348774
185554,185567,186238,13,671,2,14400,1.01937406855
185565,185584,186203,19,619,2,14400,1.03069466882
185565,185589,186188,24,599,2,14400,1.04006677796
185586,185625,186164,39,539,2,14400,1.07235621521
185614,185631,187516,17,1885,2,36000,1.00901856764
185627,185637,186351,10,714,2,14400,1.01400560224
185628,185664,186303,36,639,2,14400,1.05633802817
185629,185670,187382,41,1712,2,36000,1.02394859813
185663,185676,187275,13,1599,2,36000,1.0081300813
185669,185681,186359,12,678,2,14400,1.01769911504
185679,185700,186251,21,551,2,14400,1.03811252269
185690,185723,186276,33,553,2,14400,1.05967450271
185714,185755,187150,41,1395,2,36000,1.029390681
185745,185793,187591,48,1798,2,36000,1.02669632925
185783,185823,186379,40,556,2,14400,1.07194244604
185812,185843,187408,31,1565,2,36000,1.01980830671
185833,185876,187569,43,1693,2,36000,1.02539870053
185864,185888,187641,24,1753,2,36000,1.01369081574
185885,185919,186501,34,582,2,14400,1.05841924399
185910,185945,187499,35,1554,2,36000,1.02252252252
185935,185957,187945,22,1988,2,36000,1.01106639839
185947,186050,186515,103,465,2,14400,1.22150537634
185950,186084,187807,134,1723,2,36000,1.07777132908
186030,187315,187487,1285,172,1,3600,8.47093023256
186040,186097,187841,57,1744,2,36000,1.03268348624
186073,186103,188428,30,2325,2,36000,1.01290322581
186088,186134,187395,46,1261,2,36000,1.03647898493
186090,186140,187503,50,1363,2,36000,1.03668378577
186125,186159,188006,34,1847,2,36000,1.01840822956
186126,186176,187125,50,949,2,36000,1.05268703899
186172,186199,186769,27,570,2,14400,1.04736842105
186192,186214,186685,22,471,2,14400,1.04670912951
186213,186242,186620,29,378,2,14400,1.07671957672
186233,186249,187980,16,1731,2,36000,1.00924321202
186244,186262,186697,18,435,2,14400,1.04137931034
186255,186287,186731,32,444,2,14400,1.07207207207
186286,186314,186707,28,393,2,14400,1.07124681934
186307,186357,186759,50,402,2,14400,1.12437810945
186348,186363,186752,15,389,2,14400,1.03856041131
186349,186370,188454,21,2084,2,36000,1.01007677543
186368,186388,186818,20,430,2,14400,1.04651162791
186377,186394,188015,17,1621,2,36000,1.01048735349
186389,186508,187229,119,721,2,14400,1.16504854369
186499,186514,188090,15,1576,2,36000,1.0095177665
186512,186526,187185,14,659,2,14400,1.02124430956
186523,186562,187182,39,620,2,14400,1.06290322581
186551,186631,189319,80,2688,2,36000,1.02976190476
186625,186665,187312,40,647,2,14400,1.06182380216
186656,186680,188242,24,1562,2,36000,1.01536491677
186656,186696,187378,40,682,2,14400,1.05865102639
186671,186709,188452,38,1743,2,36000,1.02180149168
186708,186742,187304,34,562,2,14400,1.06049822064
186708,186718,187365,10,647,2,14400,1.01545595054
186739,186763,187386,24,623,2,14400,1.03852327448
186760,186780,187359,20,579,2,14400,1.03454231434
186760,186771,187458,11,687,2,14400,1.01601164483
186771,186817,187370,46,553,2,14400,1.08318264014
186803,186830,188386,27,1556,2,36000,1.01735218509
186822,186904,187898,82,994,2,14400,1.08249496982
186894,187069,188830,175,1761,2,36000,1.09937535491
186894,186999,188121,105,1122,2,14400,1.0935828877
186978,187497,187608,519,111,1,3600,5.67567567568
186989,187136,188727,147,1591,2,36000,1.0923947203
187059,187161,189179,102,2018,2,36000,1.05054509415
187126,187194,189010,68,1816,2,36000,1.03744493392
187150,187200,188929,50,1729,2,36000,1.02891844997
187190,187240,187771,50,531,2,14400,1.09416195857
187231,187287,187734,56,447,2,14400,1.12527964206
187278,187320,189008,42,1688,2,36000,1.02488151659
187313,187326,187732,13,406,2,14400,1.03201970443
187324,187370,187777,46,407,2,14400,1.11302211302
187365,187376,187759,11,383,2,14400,1.02872062663
187376,187382,187815,6,433,2,14400,1.01385681293
187376,187389,187802,13,413,2,14400,1.03147699758
187382,187395,189009,13,1614,2,36000,1.00805452292
187387,187401,187812,14,411,2,14400,1.03406326034
187397,187407,187820,10,413,2,14400,1.02421307506
187398,187419,189223,21,1804,2,36000,1.01164079823
187398,187412,187991,14,579,2,14400,1.02417962003
187399,187469,188982,70,1513,2,36000,1.04626569729
187414,187510,189170,96,1660,2,36000,1.0578313253
187500,187516,188139,16,623,2,14400,1.02568218299
187500,187527,189444,27,1917,2,36000,1.01408450704
187516,187580,189412,64,1832,2,36000,1.03493449782
187518,187602,189386,84,1784,2,36000,1.04708520179
187569,187652,189270,83,1618,2,36000,1.05129789864
187591,187743,189511,152,1768,2,36000,1.08597285068
187643,187749,189308,106,1559,2,36000,1.06799230276
187657,187663,188000,6,337,1,3600,1.0178041543
187746,187770,188374,24,604,2,14400,1.03973509934
187767,187782,188311,15,529,2,14400,1.02835538752
187777,187788,188333,11,545,2,14400,1.02018348624
187779,188011,188323,232,312,1,3600,1.74358974359
187788,187813,188451,25,638,2,14400,1.03918495298
187809,187825,189758,16,1933,2,36000,1.00827728919
187809,187819,188566,10,747,2,14400,1.01338688086
187809,187831,188459,22,628,2,14400,1.03503184713
187830,187837,188371,7,534,2,14400,1.01310861423
187830,187853,188497,23,644,2,14400,1.03571428571
187843,187909,189491,66,1582,2,36000,1.0417193426
187902,187956,188510,54,554,2,14400,1.09747292419
187947,187991,189782,44,1791,2,36000,1.02456728085
187980,188002,189834,22,1832,2,36000,1.01200873362
187994,188018,188609,24,591,2,14400,1.04060913706
188008,188026,189769,18,1743,2,36000,1.01032702238
188023,188101,189688,78,1587,2,36000,1.04914933837
188090,188132,189972,42,1840,2,36000,1.02282608696
188127,188150,188734,23,584,2,14400,1.03938356164
188148,188253,188784,105,531,2,14400,1.19774011299
188245,188323,190263,78,1940,2,36000,1.04020618557
188322,188347,188826,25,479,2,14400,1.05219206681
188335,188341,189164,6,823,1,3600,1.00729040097
188343,188382,188794,39,412,2,14400,1.09466019417
188374,188388,188795,14,407,2,14400,1.0343980344
188385,188397,188845,12,448,2,14400,1.02678571429
188386,188439,189786,53,1347,2,36000,1.03934669636
188429,188462,190239,33,1777,2,36000,1.01857062465
188453,188468,189680,15,1212,2,36000,1.01237623762
188455,188473,189453,18,980,2,36000,1.01836734694
188467,188479,188897,12,418,2,14400,1.02870813397
188477,188508,188898,31,390,2,14400,1.07948717949
188498,188521,189032,23,511,2,14400,1.04500978474
188519,188577,189223,58,646,2,14400,1.08978328173
188570,188620,189217,50,597,2,14400,1.0837520938
188611,188738,189420,127,682,2,14400,1.1862170088
188727,188745,190474,18,1729,2,36000,1.01041064199
188744,188796,189394,52,598,2,14400,1.08695652174
188745,189174,189775,429,601,1,3600,1.71381031614
188786,188806,189426,20,620,2,14400,1.03225806452
188796,188811,189532,15,721,2,14400,1.02080443828
188807,188837,189488,30,651,2,14400,1.04608294931
188828,188843,189467,15,624,2,14400,1.02403846154
188831,188856,190739,25,1883,2,36000,1.01327668614
188848,188908,189489,60,581,2,14400,1.10327022375
188900,188914,189486,14,572,2,14400,1.02447552448
188910,188940,189457,30,517,2,14400,1.0580270793
188929,188993,191019,64,2026,2,36000,1.0315893386
188982,189019,189656,37,637,2,14400,1.05808477237
188984,189025,190671,41,1646,2,36000,1.02490886999
189010,189030,190821,20,1791,2,36000,1.01116694584
189011,189044,190745,33,1701,2,36000,1.01940035273
189012,189181,190851,169,1670,2,36000,1.10119760479
189172,189190,191032,18,1842,2,36000,1.00977198697
189187,189228,191058,41,1830,2,36000,1.02240437158
189219,189234,189756,15,522,2,14400,1.02873563218
189224,189239,191083,15,1844,2,36000,1.00813449024
189239,189281,189824,42,543,2,14400,1.0773480663
189273,189319,190871,46,1552,2,36000,1.02963917526
189305,189786,189906,481,120,1,1800,5.00833333333
189309,189330,191352,21,2022,2,36000,1.01038575668
189321,189398,189873,77,475,2,14400,1.16210526316
189324,189405,190997,81,1592,2,36000,1.05087939698
189389,189424,191054,35,1630,2,36000,1.02147239264
189413,189431,191299,18,1868,2,36000,1.0096359743
189424,189437,189846,13,409,2,14400,1.03178484108
189434,189455,189836,21,381,2,14400,1.05511811024
189444,189464,191218,20,1754,2,36000,1.01140250855
189455,189470,189888,15,418,2,14400,1.03588516746
189459,189478,191104,19,1626,2,36000,1.01168511685
189476,189497,189952,21,455,2,14400,1.04615384615
189487,189503,189940,16,437,2,14400,1.03661327231
189493,189508,191407,15,1899,2,36000,1.00789889415
189507,189514,189914,7,400,2,14400,1.0175
189508,189522,190003,14,481,2,14400,1.02910602911
189512,189543,191352,31,1809,2,36000,1.01713653952
189539,189667,190313,128,646,2,14400,1.19814241486
189661,189691,190274,30,583,2,14400,1.05145797599
189682,189767,191731,85,1964,2,36000,1.0432790224
189682,189700,190346,18,646,2,14400,1.02786377709
189698,189773,191417,75,1644,2,36000,1.04562043796
189759,189780,191535,21,1755,2,36000,1.01196581197
189774,189793,190421,19,628,2,14400,1.03025477707
189775,189799,191674,24,1875,2,36000,1.0128
189790,189836,191797,46,1961,2,36000,1.02345741968
189792,189845,191691,53,1846,2,36000,1.02871072589
189835,189851,191853,16,2002,2,36000,1.00799200799
189847,189857,190530,10,673,2,14400,1.01485884101
189848,189884,190600,36,716,2,14400,1.05027932961
189879,189899,190602,20,703,2,14400,1.02844950213
189889,189925,190487,36,562,2,14400,1.0640569395
189920,189951,190535,31,584,2,14400,1.05308219178
189941,189963,190493,22,530,2,14400,1.04150943396
189962,189984,190518,22,534,2,14400,1.04119850187
189973,190014,191681,41,1667,2,36000,1.02459508098
189973,190250,190782,277,532,2,14400,1.52067669173
190196,190498,190591,302,93,1,1800,4.24731182796
190239,190274,192092,35,1818,2,36000,1.01925192519
190263,190285,192115,22,1830,2,36000,1.01202185792
190279,190324,190892,45,568,2,14400,1.07922535211
190320,190357,190891,37,534,2,14400,1.06928838951
190351,190432,190885,81,453,2,14400,1.17880794702
190423,190485,190861,62,376,2,14400,1.16489361702
190451,190601,190714,150,113,1,3600,2.32743362832
190474,190503,192279,29,1776,2,36000,1.01632882883
190495,190509,190948,14,439,2,14400,1.03189066059
190506,190530,190986,24,456,2,14400,1.05263157895
190526,190542,190992,16,450,2,14400,1.03555555556
190537,190548,190952,11,404,2,14400,1.02722772277
190537,190611,191209,74,598,2,14400,1.1237458194
190609,190617,191308,8,691,2,14400,1.01157742402
190610,190682,191236,72,554,2,14400,1.12996389892
190673,190751,192625,78,1874,2,36000,1.04162219851
190740,190757,192617,17,1860,2,36000,1.00913978495
190753,190793,191451,40,658,2,14400,1.06079027356
190756,190832,192466,76,1634,2,36000,1.04651162791
190823,190863,192565,40,1702,2,36000,1.02350176263
190853,190873,192217,20,1344,2,36000,1.01488095238
190866,190882,191572,16,690,2,14400,1.0231884058
190872,190896,192671,24,1775,2,36000,1.01352112676
190885,191907,192217,1022,310,1,3600,4.29677419355
190886,190902,191541,16,639,2,14400,1.02503912363
190897,190908,191559,11,651,2,14400,1.01689708141
190898,190959,191560,61,601,2,14400,1.10149750416
190949,190965,191530,16,565,2,14400,1.02831858407
190960,190997,191560,37,563,2,14400,1.06571936057
190991,191004,191631,13,627,2,14400,1.02073365231
190997,191010,192699,13,1689,2,36000,1.00769686205
191001,191030,191527,29,497,2,14400,1.0583501006
191019,191044,192921,25,1877,2,36000,1.01331912627
191034,191065,192647,31,1582,2,36000,1.0195954488
191056,191071,192982,15,1911,2,36000,1.00784929356
191063,191094,191676,31,582,2,14400,1.05326460481
191071,191115,192967,44,1852,2,36000,1.02375809935
191087,191220,193176,133,1956,2,36000,1.06799591002
191105,191229,192920,124,1691,2,36000,1.07332939089
191218,191247,192897,29,1650,2,36000,1.01757575758
191237,191310,191853,73,543,2,14400,1.13443830571
191249,192227,192745,978,518,1,1800,2.88803088803
191300,191319,193199,19,1880,2,36000,1.01010638298
191309,191363,191937,54,574,2,14400,1.09407665505
191354,191368,192512,14,1144,2,36000,1.01223776224
191356,191418,193179,62,1761,2,36000,1.0352072686
191408,191428,193333,20,1905,2,36000,1.01049868766
191421,191463,191896,42,433,2,14400,1.09699769053
191423,191538,193302,115,1764,2,36000,1.06519274376
191534,191550,192007,16,457,2,14400,1.03501094092
191534,191544,191946,10,402,2,14400,1.02487562189
191536,191556,193138,20,1582,2,36000,1.01264222503
191555,191570,191994,15,424,2,14400,1.03537735849
191566,191577,192013,11,436,2,14400,1.0252293578
191566,191582,192008,16,426,2,14400,1.03755868545
191576,191588,192175,12,587,2,14400,1.02044293015
191587,191642,192379,55,737,2,14400,1.07462686567
191638,191685,192222,47,537,2,14400,1.08752327747
191676,191691,193456,15,1765,2,36000,1.00849858357
191690,191703,192325,13,622,2,14400,1.02090032154
191690,191697,192367,7,670,2,14400,1.01044776119
191692,191742,193496,50,1754,2,36000,1.02850627138
191693,191808,193439,115,1631,2,36000,1.07050889025
191730,191864,193283,134,1419,2,36000,1.09443269908
191797,191869,193703,72,1834,2,36000,1.03925845147
191853,191912,193530,59,1618,2,36000,1.03646477132
191905,191948,192511,43,563,2,14400,1.07637655417
191946,191958,192603,12,645,2,14400,1.01860465116
191956,192006,192535,50,529,2,14400,1.09451795841
191998,192018,192618,20,600,2,14400,1.03333333333
192008,192024,192897,16,873,2,14400,1.01832760596
192019,192029,192522,10,493,2,14400,1.02028397566
192029,192103,192584,74,481,2,14400,1.15384615385
192092,192127,193835,35,1708,2,36000,1.02049180328
192116,192186,193884,70,1698,2,36000,1.04122497055
192183,192232,192711,49,479,2,14400,1.10229645094
192218,192238,193345,20,1107,2,36000,1.01806684734
192234,192290,192929,56,639,2,14400,1.08763693271
192281,192336,194099,55,1763,2,36000,1.0311968236
192326,192378,192880,52,502,2,14400,1.10358565737
192368,192390,192839,22,449,2,14400,1.04899777283
192388,192477,192881,89,404,2,14400,1.2202970297
192468,192522,194386,54,1864,2,36000,1.02896995708
192514,192528,194200,14,1672,2,36000,1.00837320574
192521,192534,192985,13,451,2,14400,1.0288248337
192532,192546,192993,14,447,2,14400,1.03131991051
192543,192576,192988,33,412,2,14400,1.08009708738
192566,192595,194618,29,2023,2,36000,1.01433514582
192594,192614,193077,20,463,2,14400,1.04319654428
192605,192628,193250,23,622,2,14400,1.03697749196
192619,192634,194428,15,1794,2,36000,1.00836120401
192626,192640,193247,14,607,2,14400,1.02306425041
192634,192658,194251,24,1593,2,36000,1.01506591337
192649,192682,194253,33,1571,2,36000,1.02100572884
192651,192755,193345,104,590,1,3600,1.17627118644
192671,192710,194552,39,1842,2,36000,1.02117263844
192702,192723,194368,21,1645,2,36000,1.01276595745
192718,192850,193465,132,615,2,14400,1.21463414634
192842,192891,193534,49,643,2,14400,1.07620528771
192883,192897,193458,14,561,2,14400,1.02495543672
192893,192908,193488,15,580,2,14400,1.02586206897
192897,192913,194484,16,1571,2,36000,1.0101845958
192904,192931,193453,27,522,2,14400,1.05172413793
192922,192937,194696,15,1759,2,36000,1.00852757248
192923,192943,194733,20,1790,2,36000,1.01117318436
192935,192978,193480,43,502,2,14400,1.08565737052
192969,192994,194635,25,1641,2,36000,1.01523461304
192982,193355,193465,373,110,1,1800,4.39090909091
192985,193000,194591,15,1591,2,36000,1.00942803268
192996,193006,193343,10,337,2,14400,1.0296735905
192997,193011,193379,14,368,2,14400,1.03804347826
193007,193088,193446,81,358,2,14400,1.22625698324
193079,193150,193487,71,337,2,14400,1.21068249258
193140,193187,194889,47,1702,2,36000,1.02761457109
193177,193193,194976,16,1783,2,36000,1.00897363993
193192,193258,194839,66,1581,2,36000,1.04174573055
193192,193210,193741,18,531,2,14400,1.03389830508
193207,193264,195264,57,2000,2,36000,1.0285
193264,193294,194072,30,778,2,14400,1.03856041131
193284,193344,193915,60,571,2,14400,1.10507880911
193284,193313,195321,29,2008,2,36000,1.01444223108
193303,193361,195439,58,2078,2,36000,1.02791145332
193333,193366,194876,33,1510,2,36000,1.02185430464
193348,193391,195053,43,1662,2,36000,1.02587244284
193387,193450,193993,63,543,2,14400,1.11602209945
193440,193458,195315,18,1857,2,36000,1.00969305331
193449,193464,194115,15,651,2,14400,1.02304147465
193459,193470,195102,11,1632,2,36000,1.00674019608
193459,193475,194007,16,532,2,14400,1.03007518797
193470,193481,194008,11,527,2,14400,1.02087286528
193481,193491,194041,10,550,2,14400,1.01818181818
193481,193498,193864,17,366,2,14400,1.04644808743
193492,193504,193882,12,378,2,14400,1.03174603175
193496,193510,195281,14,1771,2,36000,1.00790513834
193502,193542,193974,40,432,2,14400,1.09259259259
193533,193548,195236,15,1688,2,36000,1.00888625592
193533,193714,194129,181,415,2,14400,1.43614457831
193705,193752,195532,47,1780,2,36000,1.02640449438
193748,193847,194437,99,590,2,14400,1.16779661017
193771,195654,195755,1883,101,1,1800,19.6435643564
193837,193876,195482,39,1606,2,36000,1.02428393524
193871,193893,194425,22,532,2,14400,1.04135338346
193886,193899,195483,13,1584,2,36000,1.00820707071
193892,193927,194520,35,593,2,14400,1.05902192243
193923,193985,194524,62,539,2,14400,1.11502782931
193974,194004,194650,30,646,2,14400,1.04643962848
193995,194018,194551,23,533,2,14400,1.04315196998
194015,194024,194536,9,512,2,14400,1.017578125
194016,194052,194543,36,491,2,14400,1.0733197556
194047,194083,194569,36,486,2,14400,1.07407407407
194078,194110,194507,32,397,2,14400,1.08060453401
194100,194126,195579,26,1453,2,36000,1.01789401239
194119,194140,194480,21,340,2,14400,1.06176470588
194130,194212,194558,82,346,2,14400,1.23699421965
194201,194262,195499,61,1237,2,36000,1.04931285368
194252,194268,194956,16,688,2,14400,1.02325581395
194253,194379,196142,126,1763,2,36000,1.07146908678
194255,194397,196170,142,1773,2,36000,1.08009024253
194371,194436,196322,65,1886,2,36000,1.03446447508
194386,194442,196231,56,1789,2,36000,1.03130240358
194389,195765,195816,1376,51,1,1800,27.9803921569
194426,194448,196409,22,1961,2,36000,1.01121876594
194447,194491,195134,44,643,2,14400,1.06842923795
194485,194497,196098,12,1601,2,36000,1.00749531543
194488,194518,195163,30,645,2,14400,1.04651162791
194509,194531,195165,22,634,2,14400,1.03470031546
194529,194537,195101,8,564,2,14400,1.01418439716
194530,194547,195073,17,526,2,14400,1.03231939163
194541,194554,195082,13,528,2,14400,1.02462121212
194552,194563,195161,11,598,2,14400,1.01839464883
194552,194574,196211,22,1637,2,36000,1.01343921808
194552,194568,194965,16,397,2,14400,1.040302267
194573,194603,194957,30,354,2,14400,1.08474576271
194573,194580,194946,7,366,2,14400,1.01912568306
194592,194629,196551,37,1922,2,36000,1.01925078044
194620,194646,196355,26,1709,2,36000,1.01521357519
194635,194661,196508,26,1847,2,36000,1.01407688143
194655,194708,195076,53,368,2,14400,1.14402173913
194697,194744,196566,47,1822,2,36000,1.02579582876
194734,194850,196598,116,1748,2,36000,1.06636155606
194839,194887,195518,48,631,2,14400,1.07606973059
194841,194900,196192,59,1292,2,36000,1.04566563467
194877,194958,196593,81,1635,2,36000,1.0495412844
194893,194967,196843,74,1876,2,36000,1.039445629
194962,194973,195602,11,629,2,14400,1.01748807631
194963,194979,195565,16,586,2,14400,1.02730375427
194973,194988,195486,15,498,2,14400,1.03012048193
194978,195064,196800,86,1736,2,36000,1.04953917051
195055,195090,197058,35,1968,2,36000,1.01778455285
195055,195084,195643,29,559,2,14400,1.0518783542
195086,195096,195609,10,513,2,14400,1.01949317739
195087,195113,195616,26,503,2,14400,1.05168986083
195104,195118,196909,14,1791,2,36000,1.00781686209
195118,195145,195636,27,491,2,14400,1.0549898167
195138,195173,195552,35,379,2,14400,1.09234828496
195169,195179,195636,10,457,2,14400,1.02188183807
195170,195184,195564,14,380,2,14400,1.03684210526
195180,195247,195556,67,309,2,14400,1.21682847896
195236,195275,197081,39,1806,2,36000,1.02159468439
195264,195292,196731,28,1439,2,36000,1.01945795691
195280,195327,197154,47,1827,2,36000,1.02572523262
195317,195333,196900,16,1567,2,36000,1.01021059349
195332,195451,197279,119,1828,2,36000,1.06509846827
195442,195494,197229,52,1735,2,36000,1.02997118156
195483,195499,196521,16,1022,2,36000,1.0156555773
195484,195505,197265,21,1760,2,36000,1.01193181818
195499,195511,197093,12,1582,2,36000,1.00758533502
195533,195539,197153,6,1614,2,36000,1.00371747212
195579,195585,197400,6,1815,2,36000,1.00330578512
196098,196104,197857,6,1753,2,36000,1.00342270394
196114,196120,196190,6,70,1,1800,1.08571428571
196144,196150,198038,6,1888,2,36000,1.0031779661
196172,196178,197759,6,1581,2,36000,1.00379506641
196193,196200,197826,7,1626,2,36000,1.00430504305
196212,196218,198234,6,2016,2,36000,1.00297619048
196234,196240,197861,6,1621,2,36000,1.00370141888
196322,196328,198103,6,1775,2,36000,1.00338028169
196356,196362,198027,6,1665,2,36000,1.0036036036
196412,196418,197965,6,1547,2,36000,1.00387847447
196437,196443,197013,6,570,1,1800,1.01052631579
196509,196515,198166,6,1651,2,36000,1.00363416111
196524,196531,198211,7,1680,2,36000,1.00416666667
196553,196559,198285,6,1726,2,36000,1.00347624565
196568,196574,198252,6,1678,2,36000,1.00357568534
196596,196602,197835,6,1233,2,36000,1.00486618005
196611,196617,198527,6,1910,2,36000,1.00314136126
196733,196739,198565,6,1826,2,36000,1.00328587076
196800,196805,198526,5,1721,2,36000,1.00290528762
196846,196852,198536,6,1684,2,36000,1.00356294537
196901,196907,198626,6,1719,2,36000,1.0034904014
196916,196922,198751,6,1829,2,36000,1.00328048114
197059,197065,198474,6,1409,2,36000,1.00425833925
197081,197087,199045,6,1958,2,36000,1.00306435138
197096,197102,198843,6,1741,2,36000,1.00344629523
197153,197159,198594,6,1435,2,36000,1.00418118467
197155,197170,198950,15,1780,2,36000,1.00842696629
197156,197165,197453,9,288,1,1800,1.03125
197232,197238,198981,6,1743,2,36000,1.00344234079
197266,197272,199016,6,1744,2,36000,1.00344036697
197281,197287,199319,6,2032,2,36000,1.00295275591
197402,197409,199114,7,1705,2,36000,1.00410557185
197612,197618,198938,6,1320,2,36000,1.00454545455
197614,197624,198777,10,1153,2,36000,1.00867302689
197615,197629,198964,14,1335,2,36000,1.01048689139
197616,197634,199293,18,1659,2,36000,1.01084990958
197617,197640,199543,23,1903,2,36000,1.01208617972
197619,197646,199471,27,1825,2,36000,1.01479452055
197620,197651,199489,31,1838,2,36000,1.01686615887
197621,197656,199518,35,1862,2,36000,1.01879699248
197623,197661,199380,38,1719,2,36000,1.02210587551
197624,197667,199377,43,1710,2,36000,1.02514619883
197625,197672,199480,47,1808,2,36000,1.02599557522
197626,197770,199351,144,1581,2,36000,1.09108159393
197628,197837,199718,209,1881,2,36000,1.11111111111
197629,197846,199749,217,1903,2,36000,1.11403047819
197630,197868,199486,238,1618,2,36000,1.14709517923
197632,197874,199799,242,1925,2,36000,1.12571428571
197633,197976,199667,343,1691,2,36000,1.20283855707
197634,198038,199673,404,1635,2,36000,1.24709480122
197636,198049,199900,413,1851,2,36000,1.22312263641
197637,198114,199774,477,1660,2,36000,1.28734939759
197759,198177,199908,418,1731,2,36000,1.24147891392
197828,198222,200042,394,1820,2,36000,1.21648351648
197843,198246,200030,403,1784,2,36000,1.22589686099
197859,198263,200000,404,1737,2,36000,1.23258491652
197860,198296,199884,436,1588,2,36000,1.27455919395
197966,198485,200155,519,1670,2,36000,1.31077844311
198027,198537,200232,510,1695,2,36000,1.30088495575
198043,198543,200254,500,1711,2,36000,1.29222676797
198104,198549,200271,445,1722,2,36000,1.25842044135
198167,198576,200159,409,1583,2,36000,1.2583701832
198213,198605,200315,392,1710,2,36000,1.22923976608
198234,198637,200525,403,1888,2,36000,1.21345338983
198253,198762,200078,509,1316,2,36000,1.3867781155
198287,198789,200553,502,1764,2,36000,1.28458049887
198474,198854,200732,380,1878,2,36000,1.202342918
198527,198950,200663,423,1713,2,36000,1.2469352014
198529,198961,200779,432,1818,2,36000,1.23762376238
198544,198975,200705,431,1730,2,36000,1.24913294798
198566,198992,200875,426,1883,2,36000,1.22623473181
198597,199028,200773,431,1745,2,36000,1.24699140401
198628,199056,200450,428,1394,2,36000,1.30703012912
198752,199125,200877,373,1752,2,36000,1.21289954338
198776,199304,201123,528,1819,2,36000,1.29026937878
198844,199330,201086,486,1756,2,36000,1.27676537585
198896,198902,198953,6,51,1,1800,1.11764705882
198940,199362,200993,422,1631,2,36000,1.25873697118
198955,199388,201255,433,1867,2,36000,1.23192287092
198971,199394,201295,423,1901,2,36000,1.22251446607
198987,199482,201242,495,1760,2,36000,1.28125
199018,199491,201476,473,1985,2,36000,1.23828715365
199045,199497,201064,452,1567,2,36000,1.28844926611
199116,199503,201200,387,1697,2,36000,1.22804949912
199292,199529,201305,237,1776,2,36000,1.13344594595
199292,199298,199369,6,71,1,1800,1.08450704225
199320,199554,201275,234,1721,2,36000,1.13596746078
199351,199678,201670,327,1992,2,36000,1.16415662651
199376,199685,201589,309,1904,2,36000,1.16228991597
199378,199730,201597,352,1867,2,36000,1.18853776111
199473,199760,201467,287,1707,2,36000,1.16813122437
199489,199785,201407,296,1622,2,36000,1.18249075216
199491,199810,201734,319,1924,2,36000,1.1658004158
199492,199895,201674,403,1779,2,36000,1.22653175942
199517,199911,201669,394,1758,2,36000,1.22411831627
199542,199919,201433,377,1514,2,36000,1.24900924703
199667,200011,201716,344,1705,2,36000,1.20175953079
199683,200041,201835,358,1794,2,36000,1.19955406912
199720,200053,201877,333,1824,2,36000,1.18256578947
199751,200089,201827,338,1738,2,36000,1.19447640967
199775,200166,201633,391,1467,2,36000,1.26653033401
199800,200172,202032,372,1860,2,36000,1.2
199886,200244,202032,358,1788,2,36000,1.20022371365
199901,200265,202032,364,1767,2,36000,1.20599886814
199918,200282,202005,364,1723,2,36000,1.21125943122
200004,200326,202032,322,1706,2,36000,1.18874560375
200031,200461,202032,430,1571,2,36000,1.27371101209
200047,200536,202032,489,1496,2,36000,1.32687165775
200078,200565,201462,487,897,2,36000,1.54292084727
200159,200675,202032,516,1357,2,36000,1.38025055269
200160,200716,202032,556,1316,2,36000,1.42249240122
200234,200743,202032,509,1289,2,36000,1.39487975175
200256,200784,201909,528,1125,2,36000,1.46933333333
200272,200790,202032,518,1242,2,36000,1.41706924316
200318,200887,202032,569,1145,2,36000,1.49694323144
200352,200358,200633,6,275,1,1800,1.02181818182
200450,200893,202032,443,1139,2,36000,1.38893766462
200527,201004,202032,477,1028,2,36000,1.4640077821
200555,201075,202032,520,957,2,36000,1.5433646813
200666,201097,202032,431,935,2,36000,1.46096256684
200703,201134,202034,431,900,2,36000,1.47888888889
200734,201211,202034,477,823,2,36000,1.57958687728
200775,201253,202034,478,781,2,36000,1.61203585147
200790,201266,202034,476,768,2,36000,1.61979166667
200877,201286,202034,409,748,2,36000,1.54679144385
200892,201307,202034,415,727,2,36000,1.57083906465
200994,201317,202034,323,717,2,36000,1.45048814505
201065,201418,202034,353,616,2,36000,1.57305194805
201087,201445,202034,358,589,2,36000,1.6078098472
201124,201474,202034,350,560,2,36000,1.625
201204,201480,202034,276,554,2,36000,1.49819494585
201244,201487,202034,243,547,2,36000,1.44424131627
201259,201600,202034,341,434,2,36000,1.78571428571
201275,201608,202034,333,426,2,36000,1.78169014085
201297,201645,202034,348,389,2,36000,1.89460154242
201312,201680,202035,368,355,2,36000,2.03661971831
201407,201686,202035,279,349,2,36000,1.7994269341
201435,201691,202035,256,344,2,36000,1.74418604651
201463,201727,202035,264,308,2,36000,1.85714285714
201479,201745,202035,266,290,2,36000,1.91724137931
201481,201838,202035,357,197,2,36000,2.81218274112
201591,201846,202035,255,189,2,36000,2.34920634921
201607,201889,202035,282,146,2,36000,2.93150684932
201637,201920,202035,283,115,2,36000,3.46086956522
201673,202016,202035,343,19,2,36000,19.0526315789
202099,202105,203640,6,1535,2,36000,1.00390879479
202101,202111,203778,10,1667,2,36000,1.00599880024
202103,202116,203683,13,1567,2,36000,1.00829610721
202104,202121,203883,17,1762,2,36000,1.00964812713
202106,202127,203658,21,1531,2,36000,1.01371652515
202108,202132,203721,24,1589,2,36000,1.01510383889
202110,202138,203753,28,1615,2,36000,1.0173374613
202112,202143,203900,31,1757,2,36000,1.01764371087
202114,202148,203714,34,1566,2,36000,1.02171136654
202116,202153,203800,37,1647,2,36000,1.02246508804
202119,202158,203799,39,1641,2,36000,1.02376599634
202121,202164,203793,43,1629,2,36000,1.02639656231
202123,202170,203830,47,1660,2,36000,1.02831325301
202125,202175,204191,50,2016,2,36000,1.0248015873
202127,202180,203743,53,1563,2,36000,1.03390914907
202129,202186,203767,57,1581,2,36000,1.03605313093
202131,202191,203834,60,1643,2,36000,1.0365185636
202132,202196,203838,64,1642,2,36000,1.03897685749
202134,202201,204084,67,1883,2,36000,1.03558151885
202136,202206,203882,70,1676,2,36000,1.04176610979
202138,202212,203883,74,1671,2,36000,1.04428485937
202140,202217,203742,77,1525,2,36000,1.05049180328
202143,202222,203924,79,1702,2,36000,1.0464159812
202144,202227,204227,83,2000,2,36000,1.0415
202147,202233,203815,86,1582,2,36000,1.05436156764
202148,202238,204201,90,1963,2,36000,1.04584819154
202151,202243,203960,92,1717,2,36000,1.05358182877
202153,202248,203881,95,1633,2,36000,1.05817513778
202154,202253,203749,99,1496,2,36000,1.06617647059
202156,202259,204250,103,1991,2,36000,1.05173279759
202158,202264,203751,106,1487,2,36000,1.07128446537
202160,202269,204210,109,1941,2,36000,1.0561566203
202161,202274,204109,113,1835,2,36000,1.06158038147
202163,202279,204048,116,1769,2,36000,1.06557377049
202165,202286,203900,121,1614,2,36000,1.07496902107
202167,202291,203960,124,1669,2,36000,1.07429598562
202168,202297,203922,129,1625,2,36000,1.07938461538
202170,202302,204104,132,1802,2,36000,1.07325194229
202173,202307,203883,134,1576,2,36000,1.08502538071
202177,202312,203937,135,1625,2,36000,1.08307692308
203641,203652,205402,11,1750,2,36000,1.00628571429
203659,203669,205337,10,1668,2,36000,1.00599520384
203683,203694,205399,11,1705,2,36000,1.0064516129
203713,203725,205584,12,1859,2,36000,1.00645508338
203727,203733,205363,6,1630,2,36000,1.0036809816
203743,203753,205581,10,1828,2,36000,1.00547045952
203744,203759,205416,15,1657,2,36000,1.00905250453
203761,203767,205455,6,1688,2,36000,1.00355450237
203762,203773,205435,11,1662,2,36000,1.00661853189
203764,203778,205716,14,1938,2,36000,1.00722394221
203779,203785,205582,6,1797,2,36000,1.00333889816
203780,203791,205453,11,1662,2,36000,1.00661853189
203795,203804,205506,9,1702,2,36000,1.00528789659
203810,203816,205717,6,1901,2,36000,1.00315623356
203812,203822,205381,10,1559,2,36000,1.00641436818
203827,203833,205546,6,1713,2,36000,1.00350262697
203842,203848,205683,6,1835,2,36000,1.00326975477
203844,203854,205734,10,1880,2,36000,1.00531914894
203845,203859,205664,14,1805,2,36000,1.00775623269
203882,203892,205544,10,1652,2,36000,1.00605326877
203883,203898,205502,15,1604,2,36000,1.00935162095
203885,203903,205654,18,1751,2,36000,1.01027984009
203900,203910,205729,10,1819,2,36000,1.00549752611
203902,203915,205943,13,2028,2,36000,1.00641025641
203903,203926,205537,23,1611,2,36000,1.01427684668
203904,203921,205677,17,1756,2,36000,1.00968109339
203923,203932,205697,9,1765,2,36000,1.00509915014
203938,203944,205748,6,1804,2,36000,1.00332594235
203939,203950,205940,11,1990,2,36000,1.00552763819
203961,203971,205927,10,1956,2,36000,1.00511247444
203962,203976,205778,14,1802,2,36000,1.00776914539
204044,204059,205687,15,1628,2,36000,1.00921375921
204086,204096,205749,10,1653,2,36000,1.00604960678
204104,204115,205797,11,1682,2,36000,1.00653983353
204119,204125,205835,6,1710,2,36000,1.00350877193
204191,204202,206010,11,1808,2,36000,1.0060840708
204206,204212,205921,6,1709,2,36000,1.00351082504
204221,204227,206092,6,1865,2,36000,1.00321715818
204236,204242,206042,6,1800,2,36000,1.00333333333
204251,204261,205939,10,1678,2,36000,1.00595947557
205338,205348,207172,10,1824,2,36000,1.00548245614
205366,205374,207052,8,1678,2,36000,1.00476758045
205384,205392,207191,8,1799,2,36000,1.00444691495
205402,205410,207290,8,1880,2,36000,1.00425531915
205403,205416,207144,13,1728,2,36000,1.00752314815
205418,205427,207146,9,1719,2,36000,1.00523560209
205436,205446,207133,10,1687,2,36000,1.00592768228
205454,205464,207173,10,1709,2,36000,1.00585137507
205469,205475,207227,6,1752,2,36000,1.00342465753
205502,205514,207309,12,1795,2,36000,1.00668523677
205517,205523,207210,6,1687,2,36000,1.00355660937
205538,205548,207262,10,1714,2,36000,1.00583430572
205553,205559,207320,6,1761,2,36000,1.00340715503
205555,205565,207431,10,1866,2,36000,1.00535905681
205583,205592,207426,9,1834,2,36000,1.00490730643
205584,205598,207334,14,1736,2,36000,1.00806451613
205585,205603,207141,18,1538,2,36000,1.01170351105
205655,205666,207552,11,1886,2,36000,1.00583244963
205670,205675,207469,5,1794,2,36000,1.002787068
205685,205692,207508,7,1816,2,36000,1.00385462555
205687,205698,207525,11,1827,2,36000,1.00602079912
205702,205708,207358,6,1650,2,36000,1.00363636364
205704,205714,207440,10,1726,2,36000,1.00579374276
205719,205727,207465,8,1738,2,36000,1.00460299194
205720,205733,207583,13,1850,2,36000,1.00702702703
205736,205742,207369,6,1627,2,36000,1.0036877689
205737,205748,207522,11,1774,2,36000,1.00620067644
205752,205759,207459,7,1700,2,36000,1.00411764706
205754,205765,207522,11,1757,2,36000,1.0062606716
205778,205790,207618,12,1828,2,36000,1.00656455142
205799,205808,207443,9,1635,2,36000,1.00550458716
205835,205846,207717,11,1871,2,36000,1.00587920898
205923,205932,207683,9,1751,2,36000,1.00513992005
205939,205945,207789,6,1844,2,36000,1.0032537961
205940,205951,207596,11,1645,2,36000,1.00668693009
205941,205956,207794,15,1838,2,36000,1.00816104461
205956,205963,207696,7,1733,2,36000,1.00403923832
206011,206021,207924,10,1903,2,36000,1.00525486075
206041,206053,207735,12,1682,2,36000,1.00713436385
206093,206103,208434,10,2331,2,36000,1.00429000429
207054,207063,208817,9,1754,2,36000,1.00513112885
207136,207145,208910,9,1765,2,36000,1.00509915014
207151,207157,208854,6,1697,2,36000,1.00353565115
207153,207163,208782,10,1619,2,36000,1.00617665225
207154,207168,208853,14,1685,2,36000,1.00830860534
207175,207183,208984,8,1801,2,36000,1.00444197668
207177,207189,208998,12,1809,2,36000,1.00663349917
207192,207203,209095,11,1892,2,36000,1.00581395349
207209,207221,208932,12,1711,2,36000,1.00701344243
207227,207238,208902,11,1664,2,36000,1.00661057692
207263,207273,209022,10,1749,2,36000,1.00571755289
207290,207301,209200,11,1899,2,36000,1.00579252238
207308,207321,209143,13,1822,2,36000,1.00713501647
207323,207332,209182,9,1850,2,36000,1.00486486486
207338,207345,209086,7,1741,2,36000,1.00402067777
207359,207369,209169,10,1800,2,36000,1.00555555556
207373,207380,209130,7,1750,2,36000,1.004
207422,207437,209578,15,2141,2,36000,1.00700607193
207438,207444,209041,6,1597,2,36000,1.00375704446
207453,207459,209250,6,1791,2,36000,1.00335008375
207454,207465,209315,11,1850,2,36000,1.00594594595
207470,207476,209315,6,1839,2,36000,1.00326264274
207471,207482,209302,11,1820,2,36000,1.00604395604
207472,207487,209079,15,1592,2,36000,1.00942211055
207507,207519,209270,12,1751,2,36000,1.00685322673
207522,207533,209281,11,1748,2,36000,1.00629290618
207523,207538,209338,15,1800,2,36000,1.00833333333
207538,207544,209131,6,1587,2,36000,1.00378071834
207553,207563,209224,10,1661,2,36000,1.0060204696
207583,207594,209420,11,1826,2,36000,1.00602409639
207598,207607,209476,9,1869,2,36000,1.00481540931
207619,207629,209372,10,1743,2,36000,1.00573723465
207683,207694,209340,11,1646,2,36000,1.00668286756
207698,207707,209381,9,1674,2,36000,1.00537634409
207718,207728,209268,10,1540,2,36000,1.00649350649
207737,207746,209548,9,1802,2,36000,1.00499445061
207789,207800,209492,11,1692,2,36000,1.00650118203
207803,207810,209611,7,1801,2,36000,1.00388672959
207924,207936,209726,12,1790,2,36000,1.00670391061
208435,208445,210458,10,2013,2,36000,1.00496770989
208654,241677,253911,33023,12234,12,43200,3.69928069315
208783,208793,210454,10,1661,2,36000,1.0060204696
208817,208828,210554,11,1726,2,36000,1.00637311703
208834,266089,279292,57255,13203,4,360000,5.33651442854
208855,208864,210619,9,1755,2,36000,1.00512820513
208856,208870,210465,14,1595,2,36000,1.00877742947
208904,208913,210593,9,1680,2,36000,1.00535714286
208920,208926,210585,6,1659,2,36000,1.00361663653
208938,208944,210676,6,1732,2,36000,1.00346420323
208986,208995,210677,9,1682,2,36000,1.00535077289
209001,209009,211023,8,2014,2,36000,1.00397219464
209022,209033,210811,11,1778,2,36000,1.00618672666
209041,209052,210870,11,1818,2,36000,1.00605060506
209077,209090,210822,13,1732,2,36000,1.00750577367
209092,209098,210899,6,1801,2,36000,1.00333148251
209107,209113,210892,6,1779,2,36000,1.00337268128
209130,209141,211033,11,1892,2,36000,1.00581395349
209131,209147,210832,16,1685,2,36000,1.00949554896
209146,209153,210839,7,1686,2,36000,1.00415183867
209170,209180,211048,10,1868,2,36000,1.00535331906
209185,209193,210877,8,1684,2,36000,1.00475059382
209200,209211,210928,11,1717,2,36000,1.00640652301
209225,209235,210942,10,1707,2,36000,1.00585823081
209249,209262,211054,13,1792,2,36000,1.00725446429
209271,209279,211114,8,1835,2,36000,1.00435967302
209272,209285,211217,13,1932,2,36000,1.00672877847
209287,209293,211027,6,1734,2,36000,1.00346020761
209302,209313,211026,11,1713,2,36000,1.00642148278
209317,209326,211317,9,1991,2,36000,1.00452034154
209319,209331,210989,12,1658,2,36000,1.00723763571
209340,209350,210991,10,1641,2,36000,1.00609384522
209355,209362,210936,7,1574,2,36000,1.00444726811
209374,209383,211197,9,1814,2,36000,1.00496141125
209389,209395,211187,6,1792,2,36000,1.00334821429
209422,209431,211162,9,1731,2,36000,1.00519930676
209477,209487,211277,10,1790,2,36000,1.00558659218
209492,209504,211166,12,1662,2,36000,1.00722021661
209550,209559,211404,9,1845,2,36000,1.00487804878
209578,209589,211451,11,1862,2,36000,1.00590762621
209612,209622,211230,10,1608,2,36000,1.00621890547
209724,209737,211511,13,1774,2,36000,1.00732807215
210455,210465,212169,10,1704,2,36000,1.0058685446
210471,210476,212114,5,1638,2,36000,1.00305250305
210472,210482,212261,10,1779,2,36000,1.00562113547
210554,210565,212267,11,1702,2,36000,1.00646298472
210585,210596,212210,11,1614,2,36000,1.00681536555
210600,210605,212286,5,1681,2,36000,1.00297441999
210621,210631,212291,10,1660,2,36000,1.00602409639
210677,210688,212470,11,1782,2,36000,1.00617283951
210678,210693,212453,15,1760,2,36000,1.00852272727
210812,210823,212575,11,1752,2,36000,1.00627853881
210827,210833,212493,6,1660,2,36000,1.00361445783
210842,210848,212553,6,1705,2,36000,1.00351906158
210844,210854,212661,10,1807,2,36000,1.00553403431
210871,210881,212901,10,2020,2,36000,1.00495049505
210886,210892,212686,6,1794,2,36000,1.00334448161
210902,210908,212596,6,1688,2,36000,1.00355450237
210903,210914,212675,11,1761,2,36000,1.00624645088
210928,210939,212828,11,1889,2,36000,1.00582318687
210944,210950,212653,6,1703,2,36000,1.00352319436
210945,210956,212776,11,1820,2,36000,1.00604395604
210988,211000,212843,12,1843,2,36000,1.00651112317
211003,211009,212798,6,1789,2,36000,1.00335382895
211025,211034,212761,9,1727,2,36000,1.00521134916
211026,211040,212797,14,1757,2,36000,1.00796812749
211028,211045,212899,17,1854,2,36000,1.00916936354
211043,211051,212898,8,1847,2,36000,1.00433134813
211058,211064,212886,6,1822,2,36000,1.00329308452
211059,211070,212873,11,1803,2,36000,1.00610094287
211117,211125,213035,8,1910,2,36000,1.00418848168
211162,211173,213045,11,1872,2,36000,1.00587606838
211177,211184,212978,7,1794,2,36000,1.00390189521
211193,211199,212885,6,1686,2,36000,1.00355871886
211208,211214,212995,6,1781,2,36000,1.00336889388
211223,211229,213064,6,1835,2,36000,1.00326975477
211238,211244,213016,6,1772,2,36000,1.00338600451
211277,211288,213134,11,1846,2,36000,1.0059588299
211316,211328,213027,12,1699,2,36000,1.00706297822
211405,211415,213373,10,1958,2,36000,1.0051072523
211453,211463,213199,10,1736,2,36000,1.00576036866
211511,211522,213349,11,1827,2,36000,1.00602079912
212116,212125,213833,9,1708,2,36000,1.00526932084
212168,212181,214147,13,1966,2,36000,1.00661241099
212211,212226,214043,15,1817,2,36000,1.00825536599
212213,212220,212227,7,7,1,180,1.4
212261,212272,214069,11,1797,2,36000,1.0061213133
212276,212282,213968,6,1686,2,36000,1.00355871886
212289,212295,212524,6,229,1,180,1.02620087336
212291,212301,214227,10,1926,2,36000,1.005192108
212292,212307,214055,15,1748,2,36000,1.0085812357
212454,212464,214109,10,1645,2,36000,1.00607902736
212470,212481,214348,11,1867,2,36000,1.00589180503
212495,212504,214276,9,1772,2,36000,1.00507900677
212555,212564,214718,9,2154,2,36000,1.00417827298
212577,212586,214122,9,1536,2,36000,1.005859375
212599,212607,214431,8,1824,2,36000,1.00438596491
212654,212664,214432,10,1768,2,36000,1.0056561086
212669,212675,214484,6,1809,2,36000,1.00331674959
212684,212690,214415,6,1725,2,36000,1.00347826087
212699,212705,214391,6,1686,2,36000,1.00355871886
212760,212772,214753,12,1981,2,36000,1.00605754669
212778,212788,214583,10,1795,2,36000,1.00557103064
212799,212809,214762,10,1953,2,36000,1.0051203277
212801,212814,214617,13,1803,2,36000,1.00721020521
212825,212839,214550,14,1711,2,36000,1.0081823495
212843,212855,214631,12,1776,2,36000,1.00675675676
212874,212885,214718,11,1833,2,36000,1.00600109111
212888,212896,214564,8,1668,2,36000,1.00479616307
212890,212902,215102,12,2200,2,36000,1.00545454545
212906,212912,214725,6,1813,2,36000,1.00330943188
212907,212918,214433,11,1515,2,36000,1.00726072607
212909,212923,214886,14,1963,2,36000,1.00713194091
212982,212990,215021,8,2031,2,36000,1.00393894633
212997,213006,214643,9,1637,2,36000,1.00549786194
213018,213027,214931,9,1904,2,36000,1.00472689076
213033,213038,214767,5,1729,2,36000,1.002891845
213048,213054,214799,6,1745,2,36000,1.00343839542
213049,213060,214848,11,1788,2,36000,1.00615212528
213065,213075,214928,10,1853,2,36000,1.00539665407
213134,213145,214792,11,1647,2,36000,1.00667880996
213202,213211,215003,9,1792,2,36000,1.00502232143
213351,213360,215077,9,1717,2,36000,1.00524170064
213375,213385,215225,10,1840,2,36000,1.00543478261
213399,213405,213407,6,2,1,600,1.0
213833,213844,215522,11,1678,2,36000,1.00655542312
213968,213979,215674,11,1695,2,36000,1.00648967552
214044,214054,215660,10,1606,2,36000,1.00622665006
214060,214066,215811,6,1745,2,36000,1.00343839542
214075,214081,215863,6,1782,2,36000,1.00336700337
214111,214120,215807,9,1687,2,36000,1.00533491405
214127,214133,215801,6,1668,2,36000,1.0035971223
214148,214158,215861,10,1703,2,36000,1.0058719906
214230,214238,215896,8,1658,2,36000,1.00482509047
214276,214287,215988,11,1701,2,36000,1.00646678424
214349,214360,216212,11,1852,2,36000,1.00593952484
214391,214403,216069,12,1666,2,36000,1.00720288115
214416,214426,216113,10,1687,2,36000,1.00592768228
214431,214442,216875,11,2433,2,36000,1.00452116728
214446,214452,216140,6,1688,2,36000,1.00355450237
214447,214458,216243,11,1785,2,36000,1.00616246499
214484,214495,216309,11,1814,2,36000,1.00606394708
214551,214561,216338,10,1777,2,36000,1.00562746201
214566,214575,216410,9,1835,2,36000,1.00490463215
214584,214594,216442,10,1848,2,36000,1.00541125541
214618,214628,216275,10,1647,2,36000,1.00607164542
214632,214642,216337,10,1695,2,36000,1.00589970501
214647,214653,216354,6,1701,2,36000,1.00352733686
214720,214729,216507,9,1778,2,36000,1.00506186727
214722,214734,216628,12,1894,2,36000,1.00633579725
214736,214743,216635,7,1892,2,36000,1.00369978858
214755,214764,216599,9,1835,2,36000,1.00490463215
214770,214776,216480,6,1704,2,36000,1.00352112676
214771,214782,216697,11,1915,2,36000,1.00574412533
214793,214803,216563,10,1760,2,36000,1.00568181818
214807,214814,216554,7,1740,2,36000,1.00402298851
214850,214859,216693,9,1834,2,36000,1.00490730643
214887,214897,216918,10,2021,2,36000,1.00494804552
214929,214939,216787,10,1848,2,36000,1.00541125541
214944,214950,216714,6,1764,2,36000,1.00340136054
215005,215014,216758,9,1744,2,36000,1.00516055046
215023,215032,216759,9,1727,2,36000,1.00521134916
215078,215088,217132,10,2044,2,36000,1.00489236791
215102,215113,216922,11,1809,2,36000,1.00608070757
215227,215236,217082,9,1846,2,36000,1.00487540628
215524,215533,217304,9,1771,2,36000,1.00508187465
215662,215671,217336,9,1665,2,36000,1.00540540541
215677,215686,217489,9,1803,2,36000,1.00499168053
215802,215812,217502,10,1690,2,36000,1.00591715976
215817,215823,217546,6,1723,2,36000,1.00348229832
215818,215829,217463,11,1634,2,36000,1.00673194614
215861,215872,217744,11,1872,2,36000,1.00587606838
215877,215883,217796,6,1913,2,36000,1.00313643492
215898,215907,217584,9,1677,2,36000,1.0053667263
215989,215999,217742,10,1743,2,36000,1.00573723465
216071,216080,217826,9,1746,2,36000,1.00515463918
216113,216124,217821,11,1697,2,36000,1.00648202711
216141,216151,217937,10,1786,2,36000,1.00559910414
216214,216223,218010,9,1787,2,36000,1.00503637381
216241,216254,218076,13,1822,2,36000,1.00713501647
216275,216286,218172,11,1886,2,36000,1.00583244963
216308,216320,218101,12,1781,2,36000,1.00673778776
216335,216349,218310,14,1961,2,36000,1.00713921469
216350,216356,218004,6,1648,2,36000,1.0036407767
216369,216375,218235,6,1860,2,36000,1.00322580645
216411,216421,218290,10,1869,2,36000,1.00535045479
216445,216453,218353,8,1900,2,36000,1.00421052632
216482,216492,218434,10,1942,2,36000,1.00514933059
216509,216518,218246,9,1728,2,36000,1.00520833333
216555,216565,218207,10,1642,2,36000,1.00609013398
216569,216576,218435,7,1859,2,36000,1.0037654653
216600,216611,218296,11,1685,2,36000,1.00652818991
216627,216639,218443,12,1804,2,36000,1.0066518847
216642,216647,218307,5,1660,2,36000,1.00301204819
216693,216704,218477,11,1773,2,36000,1.00620417372
216708,216714,218394,6,1680,2,36000,1.00357142857
216723,216729,218467,6,1738,2,36000,1.00345224396
216760,216770,218530,10,1760,2,36000,1.00568181818
216761,216775,218704,14,1929,2,36000,1.00725764645
216788,216798,218701,10,1903,2,36000,1.00525486075
216876,216886,218741,10,1855,2,36000,1.00539083558
216919,216929,218563,10,1634,2,36000,1.00611995104
216934,216940,218815,6,1875,2,36000,1.0032
217084,217093,218804,9,1711,2,36000,1.00526008182
217133,217143,219072,10,1929,2,36000,1.00518403318
217306,217315,219039,9,1724,2,36000,1.00522041763
217336,217348,219006,12,1658,2,36000,1.00723763571
217464,217474,219215,10,1741,2,36000,1.00574382539
217492,217500,219163,8,1663,2,36000,1.00481058328
217507,217513,219320,6,1807,2,36000,1.00332042059
217549,217558,219256,9,1698,2,36000,1.00530035336
217585,217595,219381,10,1786,2,36000,1.00559910414
217744,217753,219387,9,1634,2,36000,1.00550795594
217746,217759,219423,13,1664,2,36000,1.0078125
217798,217808,219701,10,1893,2,36000,1.00528262018
217822,217832,219564,10,1732,2,36000,1.00577367206
217837,217843,219476,6,1633,2,36000,1.00367421923
217940,217948,219738,8,1790,2,36000,1.00446927374
217985,266084,266089,48099,5,8,86400,4810.4
218008,218015,219833,7,1818,2,36000,1.00385038504
218023,218029,220048,6,2019,2,36000,1.0029717682
218078,218087,219916,9,1829,2,36000,1.00492072171
218102,218112,219879,10,1767,2,36000,1.00565930956
218172,218183,220071,11,1888,2,36000,1.00582627119
218208,218218,219899,10,1681,2,36000,1.00594883998
218236,218246,219954,10,1708,2,36000,1.00585480094
218251,218257,220436,6,2179,2,36000,1.00275355668
218290,218301,219927,11,1626,2,36000,1.00676506765
218306,218312,220185,6,1873,2,36000,1.00320341698
218321,218327,220329,6,2002,2,36000,1.002997003
218322,218333,220286,11,1953,2,36000,1.00563236047
218355,218365,220088,10,1723,2,36000,1.00580383053
218395,218405,220205,10,1800,2,36000,1.00555555556
218435,218445,220268,10,1823,2,36000,1.00548546352
218436,218451,220119,15,1668,2,36000,1.00899280576
218451,218457,220454,6,1997,2,36000,1.00300450676
218469,218478,220307,9,1829,2,36000,1.00492072171
218485,218491,220249,6,1758,2,36000,1.00341296928
218528,218542,220288,14,1746,2,36000,1.00801832761
218564,218575,220416,11,1841,2,36000,1.00597501358
218685,227068,234318,8383,7250,16,7200,2.15627586207
218701,218712,220598,11,1886,2,36000,1.00583244963
218717,218723,220521,6,1798,2,36000,1.00333704116
218741,218752,220405,11,1653,2,36000,1.00665456745
218808,218816,220474,8,1658,2,36000,1.00482509047
218823,218829,220706,6,1877,2,36000,1.0031965903
218964,234330,241559,15366,7229,16,7200,3.12560520127
219008,219018,220585,10,1567,2,36000,1.00638162093
219039,219050,220815,11,1765,2,36000,1.00623229462
219073,219083,221062,10,1979,2,36000,1.0050530571
219165,219174,220852,9,1678,2,36000,1.00536352801
219217,219226,221000,9,1774,2,36000,1.00507328072
219229,261334,267804,42105,6470,32,7200,7.50772797527
219257,219267,220918,10,1651,2,36000,1.00605693519
219322,219331,221139,9,1808,2,36000,1.00497787611
219383,219392,221254,9,1862,2,36000,1.00483351235
219398,219404,221080,6,1676,2,36000,1.00357995227
219423,219434,221053,11,1619,2,36000,1.00679431748
219478,219488,221142,10,1654,2,36000,1.00604594921
219566,219576,221277,10,1701,2,36000,1.00587889477
219702,219713,221499,11,1786,2,36000,1.00615901456
219739,219749,221441,10,1692,2,36000,1.00591016548
219834,219844,221514,10,1670,2,36000,1.00598802395
219879,219890,221897,11,2007,2,36000,1.00548081714
219901,219910,221631,9,1721,2,36000,1.00522951772
219916,219927,221805,11,1878,2,36000,1.00585729499
219931,219938,221758,7,1820,2,36000,1.00384615385
219955,219966,221671,11,1705,2,36000,1.0064516129
220049,220059,221674,10,1615,2,36000,1.00619195046
220071,220082,221972,11,1890,2,36000,1.00582010582
220089,220099,222138,10,2039,2,36000,1.00490436488
220119,220130,222016,11,1886,2,36000,1.00583244963
220123,236209,239843,16086,3634,64,3600,5.42652724271
220187,220197,222189,10,1992,2,36000,1.00502008032
220205,220216,222032,11,1816,2,36000,1.00605726872
220251,220260,222029,9,1769,2,36000,1.00508762012
220270,220279,222081,9,1802,2,36000,1.00499445061
220273,236214,239826,15941,3612,64,3600,5.41334440753
220290,220300,222008,10,1708,2,36000,1.00585480094
220291,220305,222099,14,1794,2,36000,1.00780379041
220310,220319,222121,9,1802,2,36000,1.00499445061
220331,220341,222103,10,1762,2,36000,1.0056753689
220408,220416,222149,8,1733,2,36000,1.00461627236
220425,220431,222208,6,1777,2,36000,1.00337647721
220440,220447,222085,7,1638,2,36000,1.00427350427
220455,220465,222348,10,1883,2,36000,1.00531067446
220474,220486,222225,12,1739,2,36000,1.00690051754
220523,220532,222432,9,1900,2,36000,1.00473684211
220584,220596,222157,12,1561,2,36000,1.00768737988
220599,220609,222465,10,1856,2,36000,1.00538793103
220709,220717,222606,8,1889,2,36000,1.004235045
220753,239837,242996,19084,3159,64,3600,7.04115226337
220817,220826,222504,9,1678,2,36000,1.00536352801
220853,220863,222508,10,1645,2,36000,1.00607902736
220916,239854,243487,18938,3633,64,3600,6.21277181393
220918,220929,222639,11,1710,2,36000,1.00643274854
220953,266094,298825,45141,32731,2,345600,2.37915126333
220958,266106,295900,45148,29794,2,345600,2.51533865879
220966,266111,298140,45145,32029,2,345600,2.4095038871
220972,266117,296811,45145,30694,2,345600,2.47080862709
221002,221011,222693,9,1682,2,36000,1.00535077289
221049,257672,261311,36623,3639,64,3600,11.0640285793
221055,221064,222663,9,1599,2,36000,1.00562851782
221070,221077,222781,7,1704,2,36000,1.00410798122
221085,221091,222835,6,1744,2,36000,1.00344036697
221119,262639,262642,41520,3,1,86400,4152.3
221143,221151,222885,8,1734,2,36000,1.00461361015
221144,221157,222918,13,1761,2,36000,1.00738216922
221257,221265,222905,8,1640,2,36000,1.00487804878
221280,221288,222832,8,1544,2,36000,1.00518134715
221444,221452,223207,8,1755,2,36000,1.00455840456
221502,221510,223381,8,1871,2,36000,1.00427578835
221517,221525,223363,8,1838,2,36000,1.00435255713
221633,221642,223640,9,1998,2,36000,1.0045045045
221675,221685,223362,10,1677,2,36000,1.00596302922
221676,221690,223520,14,1830,2,36000,1.00765027322
221758,221769,223437,11,1668,2,36000,1.00659472422
221808,221816,223616,8,1800,2,36000,1.00444444444
221899,221908,223609,9,1701,2,36000,1.00529100529
221973,221984,223881,11,1897,2,36000,1.00579862941
222009,222019,223684,10,1665,2,36000,1.00600600601
222024,222030,223880,6,1850,2,36000,1.00324324324
222040,222046,223903,6,1857,2,36000,1.00323101777
222041,222052,223784,11,1732,2,36000,1.00635103926
222057,261298,262548,39241,1250,64,7200,32.3928
222083,222092,223903,9,1811,2,36000,1.00496963004
222099,222105,223827,6,1722,2,36000,1.00348432056
222100,222111,223903,11,1792,2,36000,1.00613839286
222116,222123,223903,7,1780,2,36000,1.00393258427
222132,222138,223757,6,1619,2,36000,1.00370599135
222147,222153,223903,6,1750,2,36000,1.00342857143
222162,222168,223903,6,1735,2,36000,1.00345821326
222164,222174,223903,10,1729,2,36000,1.00578368999
222192,222200,223903,8,1703,2,36000,1.00469759248
222210,222219,223903,9,1684,2,36000,1.00534441805
222226,222237,223903,11,1666,2,36000,1.00660264106
222349,222359,223903,10,1544,2,36000,1.00647668394
222434,222443,223903,9,1460,2,36000,1.00616438356
222466,222476,223903,10,1427,2,36000,1.00700770848
222507,222515,223903,8,1388,2,36000,1.00576368876
222522,222528,223903,6,1375,2,36000,1.00436363636
222608,222617,223903,9,1286,2,36000,1.00699844479
222639,222651,223903,12,1252,2,36000,1.00958466454
222663,222674,223903,11,1229,2,36000,1.00895036615
222693,222704,223903,11,1199,2,36000,1.00917431193
222782,222792,223903,10,1111,2,36000,1.00900090009
222834,222843,223903,9,1060,2,36000,1.00849056604
222836,222849,223903,13,1054,2,36000,1.01233396584
222885,222896,223903,11,1007,2,36000,1.01092353525
222907,222916,223903,9,987,2,36000,1.00911854103
222922,222930,223903,8,973,2,36000,1.00822199383
223206,223218,223903,12,685,2,36000,1.01751824818
223365,223373,223903,8,530,2,36000,1.01509433962
223366,223379,223903,13,524,2,36000,1.02480916031
223382,223391,223903,9,512,2,36000,1.017578125
223386,257677,261287,34291,3610,64,3600,10.4988919668
223439,223449,223903,10,454,2,36000,1.02202643172
223524,223531,223903,7,372,2,36000,1.0188172043
223613,223620,223903,7,283,2,36000,1.02473498233
223629,223635,223903,6,268,2,36000,1.0223880597
223645,223651,223903,6,252,2,36000,1.02380952381
223686,223695,223903,9,208,2,36000,1.04326923077
223761,223769,223903,8,134,2,36000,1.05970149254
223788,223796,223903,8,107,2,36000,1.07476635514
223839,223845,223903,6,58,2,36000,1.10344827586
223883,223891,223903,8,12,2,36000,1.66666666667
223885,223897,223903,12,6,2,36000,1.8
224038,224045,224857,7,812,2,36000,1.00862068966
224040,224050,225104,10,1054,2,36000,1.00948766603
224041,224056,224815,15,759,2,36000,1.01976284585
224042,224061,224859,19,798,2,36000,1.02380952381
224044,224066,224940,22,874,2,36000,1.02517162471
224045,224071,224821,26,750,2,36000,1.03466666667
224047,224077,224801,30,724,2,36000,1.04143646409
224048,224082,224996,34,914,2,36000,1.03719912473
224050,224087,224890,37,803,2,36000,1.04607721046
224052,224092,225021,40,929,2,36000,1.04305705059
224053,224098,225071,45,973,2,36000,1.04624871531
224055,224103,224936,48,833,2,36000,1.05762304922
224056,224108,224918,52,810,2,36000,1.06419753086
224058,224113,224911,55,798,2,36000,1.06892230576
224060,224118,224961,58,843,2,36000,1.06880189798
224061,224124,224891,63,767,2,36000,1.08213820078
224063,224129,225026,66,897,2,36000,1.07357859532
224065,224135,224972,70,837,2,36000,1.08363201912
224066,224140,224925,74,785,2,36000,1.09426751592
224067,224145,225052,78,907,2,36000,1.08599779493
224069,224150,224976,81,826,2,36000,1.098062954
224071,224155,225085,84,930,2,36000,1.09032258065
224072,224162,224974,90,812,2,36000,1.11083743842
224074,224167,224950,93,783,2,36000,1.11877394636
224075,224173,224976,98,803,2,36000,1.12204234122
224077,224178,225143,101,965,2,36000,1.10466321244
224078,224183,224975,105,792,2,36000,1.13257575758
224080,224188,225457,108,1269,2,36000,1.08510638298
224081,224193,225023,112,830,2,36000,1.13493975904
224083,224198,224965,115,767,2,36000,1.14993481095
224085,224204,224949,119,745,2,36000,1.15973154362
224087,224209,225086,122,877,2,36000,1.13911060433
224088,224214,224970,126,756,2,36000,1.16666666667
224090,224219,224946,129,727,2,36000,1.17744154058
224092,224224,224982,132,758,2,36000,1.17414248021
224094,224230,225091,136,861,2,36000,1.15795586527
224096,224235,224997,139,762,2,36000,1.18241469816
224098,224240,224956,142,716,2,36000,1.19832402235
224100,224245,225034,145,789,2,36000,1.18377693283
224101,224250,224991,149,741,2,36000,1.20107962213
224801,224812,225630,11,818,2,36000,1.01344743276
224816,224826,225703,10,877,2,36000,1.01140250855
224832,224838,225637,6,799,2,36000,1.00750938673
224870,224876,225727,6,851,2,36000,1.00705052879
224872,224882,225667,10,785,2,36000,1.0127388535
224903,224909,225683,6,774,2,36000,1.00775193798
224904,224915,225728,11,813,2,36000,1.0135301353
224922,224928,225726,6,798,2,36000,1.00751879699
224923,224934,225639,11,705,2,36000,1.01560283688
224939,224945,225758,6,813,2,36000,1.0073800738
224940,224951,225851,11,900,2,36000,1.01222222222
224957,224964,225677,7,713,2,36000,1.00981767181
224959,224970,225735,11,765,2,36000,1.01437908497
224961,224975,225798,14,823,2,36000,1.0170109356
224962,224980,225861,18,881,2,36000,1.02043132804
224963,224986,225899,23,913,2,36000,1.02519167579
224986,224992,225804,6,812,2,36000,1.00738916256
224987,225004,225788,17,784,2,36000,1.02168367347
224988,225009,225839,21,830,2,36000,1.02530120482
224990,225015,225926,25,911,2,36000,1.02744237102
224991,225020,225784,29,764,2,36000,1.03795811518
224992,225025,225806,33,781,2,36000,1.04225352113
224993,225030,225764,37,734,2,36000,1.05040871935
224995,225037,225859,42,822,2,36000,1.05109489051
224996,225043,225928,47,885,2,36000,1.05310734463
225014,225048,225834,34,786,2,36000,1.04325699746
225015,225053,225772,38,719,2,36000,1.0528511822
225017,225058,225847,41,789,2,36000,1.05196451204
225037,225064,225801,27,737,2,36000,1.03663500678
225038,225069,225945,31,876,2,36000,1.03538812785
225040,225075,226001,35,926,2,36000,1.03779697624
225041,225080,225856,39,776,2,36000,1.05025773196
225057,225085,225893,28,808,2,36000,1.03465346535
225080,225091,225927,11,836,2,36000,1.01315789474
225102,225108,225868,6,760,2,36000,1.00789473684
225103,225114,225942,11,828,2,36000,1.01328502415
225105,225119,225880,14,761,2,36000,1.01839684625
225127,225133,225993,6,860,2,36000,1.00697674419
225159,225166,226035,7,869,2,36000,1.0080552359
225460,225469,226274,9,805,2,36000,1.01118012422
225654,225660,226465,6,805,2,36000,1.00745341615
225655,225666,226399,11,733,2,36000,1.01500682128
225656,225671,226544,15,873,2,36000,1.01718213058
225685,225691,226438,6,747,2,36000,1.00803212851
225686,225697,226402,11,705,2,36000,1.01560283688
225688,225702,226485,14,783,2,36000,1.01787994891
225706,225714,226611,8,897,2,36000,1.00891861761
225729,225736,226607,7,871,2,36000,1.00803673938
225731,225742,226513,11,771,2,36000,1.01426718547
225732,225747,226505,15,758,2,36000,1.01978891821
225752,225758,226544,6,786,2,36000,1.00763358779
225767,225773,226516,6,743,2,36000,1.00807537012
225768,225779,226493,11,714,2,36000,1.01540616246
225785,225791,226575,6,784,2,36000,1.00765306122
225786,225797,226685,11,888,2,36000,1.01238738739
225803,225809,226630,6,821,2,36000,1.00730816078
225804,225815,226549,11,734,2,36000,1.01498637602
225806,225820,226745,14,925,2,36000,1.01513513514
225822,225828,226631,6,803,2,36000,1.00747198007
225823,225834,226670,11,836,2,36000,1.01315789474
225838,225845,226719,7,874,2,36000,1.00800915332
225857,225862,226654,5,792,2,36000,1.00631313131
225858,225868,226774,10,906,2,36000,1.01103752759
225859,225873,226720,14,847,2,36000,1.01652892562
225861,225878,226647,17,769,2,36000,1.02210663199
225877,225885,226643,8,758,2,36000,1.01055408971
225878,225890,226641,12,751,2,36000,1.01597869507
225880,225896,226761,16,865,2,36000,1.01849710983
225911,225917,226698,6,781,2,36000,1.00768245839
225912,225923,226829,11,906,2,36000,1.01214128035
225913,225928,226795,15,867,2,36000,1.01730103806
225942,225948,226791,6,843,2,36000,1.00711743772
225943,225954,226718,11,764,2,36000,1.01439790576
225944,225959,226724,15,765,2,36000,1.01960784314
225946,225964,226771,18,807,2,36000,1.02230483271
225962,225971,226796,9,825,2,36000,1.01090909091
225995,226004,226750,9,746,2,36000,1.01206434316
226010,226016,226808,6,792,2,36000,1.00757575758
226040,226046,226929,6,883,2,36000,1.00679501699
226275,226285,227069,10,784,2,36000,1.01275510204
226400,226411,227230,11,819,2,36000,1.01343101343
226420,226426,227226,6,800,2,36000,1.0075
226453,226459,227233,6,774,2,36000,1.00775193798
226469,226476,227246,7,770,2,36000,1.00909090909
226484,226496,227312,12,816,2,36000,1.01470588235
226500,226506,227304,6,798,2,36000,1.00751879699
226516,226522,227375,6,853,2,36000,1.00703399766
226518,226528,227245,10,717,2,36000,1.01394700139
226519,226533,227360,14,827,2,36000,1.0169286578
226546,226556,227394,10,838,2,36000,1.01193317422
226547,226561,227384,14,823,2,36000,1.0170109356
226564,226570,227358,6,788,2,36000,1.0076142132
226583,226590,227482,7,892,2,36000,1.00784753363
226610,226619,227386,9,767,2,36000,1.01173402868
226626,226632,227449,6,817,2,36000,1.00734394125
226642,226648,227485,6,837,2,36000,1.00716845878
226643,226654,227497,11,843,2,36000,1.01304863582
226644,226659,227508,15,849,2,36000,1.01766784452
226664,226670,227427,6,757,2,36000,1.00792602378
226665,226676,227558,11,882,2,36000,1.01247165533
226667,226681,227444,14,763,2,36000,1.01834862385
226685,226692,227458,7,766,2,36000,1.0091383812
226687,226698,227545,11,847,2,36000,1.01298701299
226714,226720,227514,6,794,2,36000,1.00755667506
226731,226737,227608,6,871,2,36000,1.00688863375
226732,226743,227569,11,826,2,36000,1.01331719128
226733,226748,227562,15,814,2,36000,1.01842751843
226735,226753,227499,18,746,2,36000,1.02412868633
226752,226759,227572,7,813,2,36000,1.0086100861
226753,226765,227534,12,769,2,36000,1.0156046814
226768,226774,227706,6,932,2,36000,1.00643776824
226786,226792,227603,6,811,2,36000,1.00739827374
226787,226798,227623,11,825,2,36000,1.01333333333
226806,226812,227638,6,826,2,36000,1.00726392252
226808,226818,227703,10,885,2,36000,1.01129943503
226809,226823,227620,14,797,2,36000,1.01756587202
226826,226832,227607,6,775,2,36000,1.00774193548
226827,226840,227631,13,791,2,36000,1.01643489254
226939,226945,227694,6,749,2,36000,1.00801068091
227071,227084,227993,13,909,2,36000,1.01430143014
227226,227237,228122,11,885,2,36000,1.01242937853
227242,227248,227977,6,729,2,36000,1.00823045267
227243,227254,228148,11,894,2,36000,1.01230425056
227258,227264,228052,6,788,2,36000,1.0076142132
227260,227270,228011,10,741,2,36000,1.01349527665
227306,227315,228131,9,816,2,36000,1.01102941176
227321,227327,228095,6,768,2,36000,1.0078125
227358,227369,228270,11,901,2,36000,1.01220865705
227373,227379,228044,6,665,2,36000,1.00902255639
227388,227394,228120,6,726,2,36000,1.00826446281
227389,227400,228133,11,733,2,36000,1.01500682128
227391,227405,228246,14,841,2,36000,1.01664684899
227406,227412,228192,6,780,2,36000,1.00769230769
227428,227439,228434,11,995,2,36000,1.01105527638
227446,227455,228180,9,725,2,36000,1.0124137931
227462,227468,228258,6,790,2,36000,1.00759493671
227463,227474,228245,11,771,2,36000,1.01426718547
227482,227493,228253,11,760,2,36000,1.01447368421
227497,227503,228251,6,748,2,36000,1.00802139037
227498,227509,228259,11,750,2,36000,1.01466666667
227514,227520,228274,6,754,2,36000,1.00795755968
227515,227526,228499,11,973,2,36000,1.01130524152
227516,227531,228313,15,782,2,36000,1.01918158568
227535,227545,228429,10,884,2,36000,1.01131221719
227550,227556,228282,6,726,2,36000,1.00826446281
227565,227571,228502,6,931,2,36000,1.00644468314
227566,227577,228335,11,758,2,36000,1.01451187335
227582,227588,228414,6,826,2,36000,1.00726392252
227583,227594,228356,11,762,2,36000,1.01443569554
227605,227615,228446,10,831,2,36000,1.01203369434
227620,227626,228505,6,879,2,36000,1.00682593857
227621,227632,228415,11,783,2,36000,1.01404853129
227623,227637,228347,14,710,2,36000,1.01971830986
227639,227645,228505,6,860,2,36000,1.00697674419
227640,227651,228473,11,822,2,36000,1.01338199513
227641,227656,228394,15,738,2,36000,1.02032520325
227694,227705,228372,11,667,2,36000,1.01649175412
227709,227715,228405,6,690,2,36000,1.00869565217
227710,227721,228477,11,756,2,36000,1.01455026455
227977,227988,228809,11,821,2,36000,1.01339829476
227995,228004,228786,9,782,2,36000,1.01150895141
228006,228962,236198,956,7236,128,7200,1.13211719182
228013,228022,228804,9,782,2,36000,1.01150895141
228046,228056,228944,10,888,2,36000,1.01126126126
228061,228067,228939,6,872,2,36000,1.00688073394
228097,228106,228816,9,710,2,36000,1.01267605634
228121,228132,228890,11,758,2,36000,1.01451187335
228137,228142,228885,5,743,2,36000,1.0067294751
228138,228148,228953,10,805,2,36000,1.01242236025
228139,228153,228960,14,807,2,36000,1.01734820322
228154,228160,228890,6,730,2,36000,1.00821917808
228181,228192,228955,11,763,2,36000,1.01441677588
228196,228204,229045,8,841,2,36000,1.00951248514
228245,228256,229048,11,792,2,36000,1.01388888889
228247,228262,229000,15,738,2,36000,1.02032520325
228264,228270,229091,6,821,2,36000,1.00730816078
228266,228276,229064,10,788,2,36000,1.01269035533
228267,228281,229361,14,1080,2,36000,1.01296296296
228268,228286,229149,18,863,2,36000,1.02085747393
228269,261375,262230,33106,855,6,1800,39.7204678363
228285,228292,229009,7,717,2,36000,1.00976290098
228286,228297,229071,11,774,2,36000,1.0142118863
228287,228303,229127,16,824,2,36000,1.01941747573
228315,228324,229151,9,827,2,36000,1.01088270859
228336,228346,229186,10,840,2,36000,1.0119047619
228351,228359,229203,8,844,2,36000,1.00947867299
228366,228372,229068,6,696,2,36000,1.00862068966
228381,228387,229114,6,727,2,36000,1.00825309491
228396,228405,229183,9,778,2,36000,1.01156812339
228413,228420,229208,7,788,2,36000,1.00888324873
228415,228426,229351,11,925,2,36000,1.01189189189
228416,228431,229214,15,783,2,36000,1.01915708812
228431,228440,229179,9,739,2,36000,1.01217861976
228446,228452,229270,6,818,2,36000,1.00733496333
228447,228458,229208,11,750,2,36000,1.01466666667
228476,228484,229404,8,920,2,36000,1.00869565217
228477,228490,229259,13,769,2,36000,1.01690507152
228499,228510,229239,11,729,2,36000,1.01508916324
228500,228516,229456,16,940,2,36000,1.0170212766
228515,228522,229302,7,780,2,36000,1.00897435897
228517,228527,229396,10,869,2,36000,1.01150747986
228788,228797,229618,9,821,2,36000,1.01096224117
228806,228815,229773,9,958,2,36000,1.00939457203
228821,228827,229481,6,654,2,36000,1.00917431193
228822,228833,229692,11,859,2,36000,1.01280558789
228879,267820,298327,38941,30507,4,126000,2.27646114007
228886,228896,229769,10,873,2,36000,1.01145475372
228900,228907,229681,7,774,2,36000,1.00904392765
228902,267826,298331,38924,30505,4,126000,2.27598754303
228902,228913,229751,11,838,2,36000,1.01312649165
228934,267831,298332,38897,30501,4,126000,2.27526966329
228941,228950,229772,9,822,2,36000,1.01094890511
228956,228968,229810,12,842,2,36000,1.01425178147
228958,228974,229730,16,756,2,36000,1.02116402116
228959,228979,229723,20,744,2,36000,1.02688172043
228974,228986,229762,12,776,2,36000,1.01546391753
229002,229011,229838,9,827,2,36000,1.01088270859
229016,229023,229823,7,800,2,36000,1.00875
229047,229056,229789,9,733,2,36000,1.01227830832
229048,229062,229852,14,790,2,36000,1.01772151899
229064,229075,229930,11,855,2,36000,1.01286549708
229079,229085,229910,6,825,2,36000,1.00727272727
229081,229091,229903,10,812,2,36000,1.01231527094
229096,229102,229905,6,803,2,36000,1.00747198007
229116,229125,229871,9,746,2,36000,1.01206434316
229131,229138,229975,7,837,2,36000,1.00836320191
229153,229160,229988,7,828,2,36000,1.00845410628
229154,229166,229958,12,792,2,36000,1.01515151515
229182,229190,230107,8,917,2,36000,1.00872410033
229197,229203,230129,6,926,2,36000,1.00647948164
229198,229209,229957,11,748,2,36000,1.01470588235
229214,229220,229995,6,775,2,36000,1.00774193548
229216,229226,230008,10,782,2,36000,1.01278772379
229217,229231,230076,14,845,2,36000,1.01656804734
229218,229236,230102,18,866,2,36000,1.0207852194
229240,229250,230081,10,831,2,36000,1.01203369434
229261,229270,230245,9,975,2,36000,1.00923076923
229276,229282,230036,6,754,2,36000,1.00795755968
229301,229313,230157,12,844,2,36000,1.01421800948
229354,229363,230161,9,798,2,36000,1.01127819549
229369,229375,230185,6,810,2,36000,1.00740740741
229398,229407,230227,9,820,2,36000,1.01097560976
229413,229419,230268,6,849,2,36000,1.00706713781
229457,229467,230238,10,771,2,36000,1.01297016861
229481,229492,230266,11,774,2,36000,1.0142118863
229621,229629,230484,8,855,2,36000,1.00935672515
229682,229692,230510,10,818,2,36000,1.01222493888
229697,229704,230631,7,927,2,36000,1.00755124056
229724,229734,230608,10,874,2,36000,1.0114416476
229739,229745,230662,6,917,2,36000,1.00654307525
229754,229762,230528,8,766,2,36000,1.01044386423
229769,229775,230571,6,796,2,36000,1.00753768844
229770,229781,230553,11,772,2,36000,1.01424870466
229785,229791,230629,6,838,2,36000,1.00715990453
229787,229797,230596,10,799,2,36000,1.01251564456
229802,229808,230677,6,869,2,36000,1.00690448792
229817,229824,230622,7,798,2,36000,1.00877192982
229832,229838,230684,6,846,2,36000,1.00709219858
229848,229854,230625,6,771,2,36000,1.00778210117
229862,229869,230599,7,730,2,36000,1.0095890411
229877,229884,230755,7,871,2,36000,1.00803673938
229905,229914,230722,9,808,2,36000,1.01113861386
229907,229920,230743,13,823,2,36000,1.01579586877
229922,229928,230766,6,838,2,36000,1.00715990453
229937,229943,230719,6,776,2,36000,1.00773195876
229955,229968,230775,13,807,2,36000,1.01610904585
229970,229976,230815,6,839,2,36000,1.00715137068
229985,229991,230901,6,910,2,36000,1.00659340659
230001,230007,230764,6,757,2,36000,1.00792602378
230003,230013,230813,10,800,2,36000,1.0125
230018,230024,230799,6,775,2,36000,1.00774193548
230037,230047,230832,10,785,2,36000,1.0127388535
230079,230087,230932,8,845,2,36000,1.00946745562
230094,230100,230849,6,749,2,36000,1.00801068091
230109,230115,230835,6,720,2,36000,1.00833333333
230110,230121,230932,11,811,2,36000,1.01356350185
230131,230140,230884,9,744,2,36000,1.01209677419
230159,230168,230955,9,787,2,36000,1.01143583227
230174,230180,230981,6,801,2,36000,1.0074906367
230189,230197,230938,8,741,2,36000,1.01079622132
230229,230238,230961,9,723,2,36000,1.01244813278
230244,230250,231169,6,919,2,36000,1.00652883569
230259,230265,231041,6,776,2,36000,1.00773195876
230275,230281,231041,6,760,2,36000,1.00789473684
230276,230287,231127,11,840,2,36000,1.0130952381
230486,230495,231307,9,812,2,36000,1.01108374384
230510,230522,231362,12,840,2,36000,1.01428571429
230528,230539,231382,11,843,2,36000,1.01304863582
230555,230564,231537,9,973,2,36000,1.00924974306
230573,230582,231502,9,920,2,36000,1.0097826087
230595,230607,231411,12,804,2,36000,1.01492537313
230610,230616,231397,6,781,2,36000,1.00768245839
230612,230622,231387,10,765,2,36000,1.01307189542
230627,230633,231389,6,756,2,36000,1.00793650794
230628,230639,231443,11,804,2,36000,1.01368159204
230643,230649,231404,6,755,2,36000,1.00794701987
230645,230655,231504,10,849,2,36000,1.01177856302
230663,230673,231428,10,755,2,36000,1.01324503311
230678,230688,231619,10,931,2,36000,1.01074113856
230693,230699,231460,6,761,2,36000,1.00788436268
230721,230730,231534,9,804,2,36000,1.01119402985
230723,230736,231579,13,843,2,36000,1.01542111507
230744,230754,231504,10,750,2,36000,1.01333333333
230759,230765,231724,6,959,2,36000,1.00625651721
230775,230781,231473,6,692,2,36000,1.00867052023
230776,230787,231582,11,795,2,36000,1.01383647799
230777,230792,231748,15,956,2,36000,1.01569037657
230799,230810,231647,11,837,2,36000,1.01314217443
230815,230824,231536,9,712,2,36000,1.01264044944
230816,230830,231608,14,778,2,36000,1.01799485861
230835,230843,231657,8,814,2,36000,1.00982800983
230836,230849,231649,13,800,2,36000,1.01625
230852,230860,231698,8,838,2,36000,1.00954653938
230885,230895,231703,10,808,2,36000,1.01237623762
230903,230912,231677,9,765,2,36000,1.01176470588
230934,230943,231739,9,796,2,36000,1.01130653266
230935,230948,231912,13,964,2,36000,1.01348547718
230951,230957,231689,6,732,2,36000,1.00819672131
230966,230972,231773,6,801,2,36000,1.0074906367
230967,230978,231732,11,754,2,36000,1.01458885942
230982,230993,231742,11,749,2,36000,1.01468624833
231041,231052,231899,11,847,2,36000,1.01298701299
231042,231057,231918,15,861,2,36000,1.01742160279
231128,231138,231950,10,812,2,36000,1.01231527094
231170,231180,231930,10,750,2,36000,1.01333333333
231306,231318,232089,12,771,2,36000,1.01556420233
231363,231373,232159,10,786,2,36000,1.01272264631
231382,231393,232176,11,783,2,36000,1.01404853129
231397,231403,232221,6,818,2,36000,1.00733496333
231398,231409,232250,11,841,2,36000,1.01307966706
231400,231414,232233,14,819,2,36000,1.01709401709
231415,231421,232385,6,964,2,36000,1.00622406639
231417,231427,232235,10,808,2,36000,1.01237623762
231432,231440,232224,8,784,2,36000,1.01020408163
231446,231455,232241,9,786,2,36000,1.01145038168
231461,231471,232279,10,808,2,36000,1.01237623762
231476,231484,232246,8,762,2,36000,1.01049868766
231504,231513,232289,9,776,2,36000,1.01159793814
231506,231519,232345,13,826,2,36000,1.01573849879
231507,231524,232305,17,781,2,36000,1.02176696543
231535,231545,232319,10,774,2,36000,1.01291989664
231536,231551,232376,15,825,2,36000,1.01818181818
231552,231558,232278,6,720,2,36000,1.00833333333
231576,231590,232356,14,766,2,36000,1.0182767624
231591,231597,232370,6,773,2,36000,1.00776196636
231609,231619,232438,10,819,2,36000,1.01221001221
231624,231630,232368,6,738,2,36000,1.0081300813
231649,231658,232654,9,996,2,36000,1.00903614458
231650,231664,232519,14,855,2,36000,1.01637426901
231665,231671,232513,6,842,2,36000,1.00712589074
231680,231688,232550,8,862,2,36000,1.00928074246
231695,231701,232439,6,738,2,36000,1.0081300813
231711,231717,232668,6,951,2,36000,1.00630914826
231712,231723,232472,11,749,2,36000,1.01468624833
231727,231735,232523,8,788,2,36000,1.01015228426
231744,231750,232550,6,800,2,36000,1.0075
231745,231756,232627,11,871,2,36000,1.01262916188
231746,231761,232511,15,750,2,36000,1.02
231761,231767,232571,6,804,2,36000,1.00746268657
231776,231784,232602,8,818,2,36000,1.0097799511
231900,231910,232578,10,668,2,36000,1.01497005988
231915,231923,232653,8,730,2,36000,1.01095890411
231930,231936,233093,6,1157,2,36000,1.00518582541
231945,231951,232813,6,862,2,36000,1.00696055684
231960,231967,232876,7,909,2,36000,1.00770077008
232091,232100,232905,9,805,2,36000,1.01118012422
232160,232171,232856,11,685,2,36000,1.01605839416
232175,232187,232991,12,804,2,36000,1.01492537313
232221,232232,233080,11,848,2,36000,1.01297169811
232236,232242,233045,6,803,2,36000,1.00747198007
232238,232248,233001,10,753,2,36000,1.01328021248
232239,232253,233052,14,799,2,36000,1.01752190238
232255,232261,232976,6,715,2,36000,1.00839160839
232256,232267,233097,11,830,2,36000,1.01325301205
232257,232272,233000,15,728,2,36000,1.0206043956
232279,232289,233056,10,767,2,36000,1.01303780965
232280,232295,233110,15,815,2,36000,1.01840490798
232295,232301,233051,6,750,2,36000,1.008
232311,232317,233110,6,793,2,36000,1.00756620429
232326,232333,233159,7,826,2,36000,1.00847457627
232345,232356,233065,11,709,2,36000,1.01551480959
232360,232367,233059,7,692,2,36000,1.01011560694
232376,232382,233242,6,860,2,36000,1.00697674419
232377,232388,233236,11,848,2,36000,1.01297169811
232379,232393,233157,14,764,2,36000,1.01832460733
232394,232399,233209,5,810,2,36000,1.00617283951
232440,232450,233194,10,744,2,36000,1.01344086022
232441,232455,233326,14,871,2,36000,1.01607347876
232472,232483,233285,11,802,2,36000,1.01371571072
232512,232523,233376,11,853,2,36000,1.01289566237
232513,232529,233429,16,900,2,36000,1.01777777778
232529,232535,233286,6,751,2,36000,1.00798934754
232530,232541,233330,11,789,2,36000,1.01394169835
232549,232560,233464,11,904,2,36000,1.01216814159
232550,232566,233289,16,723,2,36000,1.02213001383
232573,232582,233390,9,808,2,36000,1.01113861386
232587,232594,233381,7,787,2,36000,1.00889453621
232602,232613,233427,11,814,2,36000,1.01351351351
232627,232638,233387,11,749,2,36000,1.01468624833
232655,232664,233431,9,767,2,36000,1.01173402868
232656,232670,233472,14,802,2,36000,1.0174563591
232671,232679,233500,8,821,2,36000,1.00974421437
232814,232824,233676,10,852,2,36000,1.0117370892
232857,232867,233613,10,746,2,36000,1.01340482574
232878,232887,233616,9,729,2,36000,1.01234567901
232906,232916,233769,10,853,2,36000,1.01172332943
232975,232987,233755,12,768,2,36000,1.015625
232993,233002,233839,9,837,2,36000,1.01075268817
233009,233015,233884,6,869,2,36000,1.00690448792
233010,233021,233744,11,723,2,36000,1.01521438451
233044,233056,233825,12,769,2,36000,1.0156046814
233060,233066,233800,6,734,2,36000,1.00817438692
233062,233072,233917,10,845,2,36000,1.01183431953
233063,233077,233927,14,850,2,36000,1.01647058824
233064,233083,233873,19,790,2,36000,1.02405063291
233079,233089,233950,10,861,2,36000,1.01161440186
233081,233095,233900,14,805,2,36000,1.01739130435
233096,233105,234217,9,1112,2,36000,1.00809352518
233097,233111,233944,14,833,2,36000,1.01680672269
233114,233162,233971,48,809,2,36000,1.05933250927
233115,233167,233969,52,802,2,36000,1.06483790524
233156,233173,233970,17,797,2,36000,1.02132998745
233171,233179,234082,8,903,2,36000,1.0088593577
233197,233205,233956,8,751,2,36000,1.01065246338
233211,233220,234054,9,834,2,36000,1.01079136691
233239,233247,233906,8,659,2,36000,1.01213960546
233241,233253,234173,12,920,2,36000,1.01304347826
233287,233297,234115,10,818,2,36000,1.01222493888
233288,233302,234031,14,729,2,36000,1.01920438957
233303,233310,234161,7,851,2,36000,1.00822561692
233328,233337,234145,9,808,2,36000,1.01113861386
233343,233349,234282,6,933,2,36000,1.00643086817
233377,233387,234180,10,793,2,36000,1.01261034048
233393,233398,234202,5,804,2,36000,1.00621890547
233394,233404,234194,10,790,2,36000,1.01265822785
233395,233409,234169,14,760,2,36000,1.01842105263
233431,233439,234244,8,805,2,36000,1.0099378882
233432,233445,234272,13,827,2,36000,1.01571946796
233433,233450,234305,17,855,2,36000,1.01988304094
233468,233475,234217,7,742,2,36000,1.00943396226
233483,233489,234351,6,862,2,36000,1.00696055684
233501,233511,234208,10,697,2,36000,1.0143472023
233614,233624,234403,10,779,2,36000,1.01283697047
233629,233635,234462,6,827,2,36000,1.00725513906
233677,233688,234566,11,878,2,36000,1.0125284738
233747,233755,234582,8,827,2,36000,1.00967351874
233762,233768,234641,6,873,2,36000,1.00687285223
233777,233783,234575,6,792,2,36000,1.00757575758
233801,233812,234627,11,815,2,36000,1.01349693252
233825,233836,234695,11,859,2,36000,1.01280558789
233840,233850,234651,10,801,2,36000,1.01248439451
233873,233884,234672,11,788,2,36000,1.01395939086
233888,233895,234674,7,779,2,36000,1.00898587933
233903,233911,234725,8,814,2,36000,1.00982800983
233918,233924,234695,6,771,2,36000,1.00778210117
233919,233930,234724,11,794,2,36000,1.01385390428
233934,233941,234682,7,741,2,36000,1.00944669366
233950,233956,234784,6,828,2,36000,1.00724637681
233952,233962,234652,10,690,2,36000,1.01449275362
233967,233973,234714,6,741,2,36000,1.00809716599
233982,233988,234863,6,875,2,36000,1.00685714286
233983,233994,234855,11,861,2,36000,1.01277584204
233985,233999,234735,14,736,2,36000,1.01902173913
234032,234042,234832,10,790,2,36000,1.01265822785
234057,234066,234908,9,842,2,36000,1.0106888361
234081,234093,234802,12,709,2,36000,1.01692524683
234118,234126,235001,8,875,2,36000,1.00914285714
234148,234156,234945,8,789,2,36000,1.01013941698
234163,234172,235047,9,875,2,36000,1.01028571429
234178,234184,234883,6,699,2,36000,1.00858369099
234179,234190,235019,11,829,2,36000,1.01326899879
234195,234201,234997,6,796,2,36000,1.00753768844
234196,234207,235036,11,829,2,36000,1.01326899879
234212,234218,235212,6,994,2,36000,1.0060362173
234213,234224,235184,11,960,2,36000,1.01145833333
234228,234234,235006,6,772,2,36000,1.00777202073
234230,234240,235222,10,982,2,36000,1.01018329939
234245,234255,235101,10,846,2,36000,1.01182033097
234272,234283,235096,11,813,2,36000,1.0135301353
234287,234294,235121,7,827,2,36000,1.0084643289
234305,234317,235124,12,807,2,36000,1.01486988848
234351,234362,235185,11,823,2,36000,1.01336573512
234405,234415,235290,10,875,2,36000,1.01142857143
234463,234474,235299,11,825,2,36000,1.01333333333
234563,234577,235328,14,751,2,36000,1.01864181092
234578,234586,235321,8,735,2,36000,1.01088435374
234593,234599,235422,6,823,2,36000,1.00729040097
234629,234638,235454,9,816,2,36000,1.01102941176
234644,234653,235431,9,778,2,36000,1.01156812339
234660,234666,235476,6,810,2,36000,1.00740740741
234661,234672,235489,11,817,2,36000,1.01346389229
234676,234683,235498,7,815,2,36000,1.00858895706
234678,234689,235475,11,786,2,36000,1.01399491094
234693,234699,235482,6,783,2,36000,1.00766283525
234694,234706,235523,12,817,2,36000,1.0146878825
234710,234716,235436,6,720,2,36000,1.00833333333
234726,234732,235679,6,947,2,36000,1.00633579725
234727,234738,235483,11,745,2,36000,1.01476510067
234729,234743,235548,14,805,2,36000,1.01739130435
234743,234749,235564,6,815,2,36000,1.00736196319
234786,234795,235606,9,811,2,36000,1.0110974106
234801,234813,235606,12,793,2,36000,1.01513240858
234834,234843,235686,9,843,2,36000,1.01067615658
234856,234867,235751,11,884,2,36000,1.01244343891
234871,234877,235612,6,735,2,36000,1.00816326531
234888,234894,235691,6,797,2,36000,1.00752823087
234910,234919,235650,9,731,2,36000,1.0123119015
234946,234956,235777,10,821,2,36000,1.01218026797
234998,235008,235882,10,874,2,36000,1.0114416476
235013,235019,235737,6,718,2,36000,1.00835654596
235015,235025,235849,10,824,2,36000,1.01213592233
235030,235036,236118,6,1082,2,36000,1.00554528651
235045,235051,235839,6,788,2,36000,1.0076142132
235060,235066,235798,6,732,2,36000,1.00819672131
235096,235107,235876,11,769,2,36000,1.01430429129
235111,235117,235900,6,783,2,36000,1.00766283525
235126,235132,235937,6,805,2,36000,1.00745341615
235128,235138,235997,10,859,2,36000,1.01164144354
235186,235195,235953,9,758,2,36000,1.01187335092
235187,235201,236146,14,945,2,36000,1.01481481481
235211,235223,236013,12,790,2,36000,1.01518987342
235227,235233,236010,6,777,2,36000,1.00772200772
235291,235301,236008,10,707,2,36000,1.01414427157
235306,235312,236078,6,766,2,36000,1.00783289817
235322,235332,236209,10,877,2,36000,1.01140250855
235338,235344,236204,6,860,2,36000,1.00697674419
235423,235433,236208,10,775,2,36000,1.01290322581
235438,235444,236333,6,889,2,36000,1.00674915636
235439,235450,236305,11,855,2,36000,1.01286549708
235454,235465,236219,11,754,2,36000,1.01458885942
235477,235486,236267,9,781,2,36000,1.01152368758
235478,235492,236222,14,730,2,36000,1.01917808219
235494,235499,236272,5,773,2,36000,1.0064683053
235495,235506,236408,11,902,2,36000,1.01219512195
235496,235511,236390,15,879,2,36000,1.01706484642
235512,235518,236325,6,807,2,36000,1.00743494424
235527,235534,236312,7,778,2,36000,1.00899742931
235548,235559,236269,11,710,2,36000,1.01549295775
235566,235575,236344,9,769,2,36000,1.01170351105
235606,235617,236425,11,808,2,36000,1.01361386139
235607,235622,236562,15,940,2,36000,1.01595744681
235622,235628,236433,6,805,2,36000,1.00745341615
235652,235662,236355,10,693,2,36000,1.01443001443
235680,235690,236510,10,820,2,36000,1.01219512195
235696,235702,236498,6,796,2,36000,1.00753768844
235697,235708,236480,11,772,2,36000,1.01424870466
235737,235749,236606,12,857,2,36000,1.01400233372
235752,235763,236507,11,744,2,36000,1.01478494624
235779,235789,236566,10,777,2,36000,1.01287001287
235800,235810,236557,10,747,2,36000,1.01338688086
235841,235850,236649,9,799,2,36000,1.0112640801
235856,235863,236683,7,820,2,36000,1.00853658537
235877,235887,236622,10,735,2,36000,1.01360544218
235892,235899,236694,7,795,2,36000,1.00880503145
235907,235913,236662,6,749,2,36000,1.00801068091
235938,235948,236744,10,796,2,36000,1.01256281407
235953,235965,236701,12,736,2,36000,1.01630434783
235999,236009,236831,10,822,2,36000,1.01216545012
236015,236021,236965,6,944,2,36000,1.0063559322
236016,236027,236851,11,824,2,36000,1.01334951456
236017,236032,236815,15,783,2,36000,1.01915708812
236076,236090,236866,14,776,2,36000,1.01804123711
236119,236129,236952,10,823,2,36000,1.01215066829
236146,236157,236858,11,701,2,36000,1.01569186876
236205,236220,237141,15,921,2,36000,1.01628664495
236225,236231,237053,6,822,2,36000,1.00729927007
236226,236237,236990,11,753,2,36000,1.01460823373
236228,236243,237062,15,819,2,36000,1.01831501832
236229,236248,237009,19,761,2,36000,1.02496714849
236272,236279,237055,7,776,2,36000,1.00902061856
236273,236285,237126,12,841,2,36000,1.01426872771
236274,236290,237222,16,932,2,36000,1.01716738197
236305,236316,237099,11,783,2,36000,1.01404853129
236320,236326,237137,6,811,2,36000,1.00739827374
236336,236342,237153,6,811,2,36000,1.00739827374
236338,236348,237123,10,775,2,36000,1.01290322581
236353,236359,237170,6,811,2,36000,1.00739827374
236367,236374,237191,7,817,2,36000,1.00856793146
236392,236401,237304,9,903,2,36000,1.00996677741
236410,236420,237228,10,808,2,36000,1.01237623762
236425,236436,237194,11,758,2,36000,1.01451187335
236441,236447,237211,6,764,2,36000,1.00785340314
236481,236492,237401,11,909,2,36000,1.01210121012
236499,236510,237251,11,741,2,36000,1.01484480432
236515,236520,237484,5,964,2,36000,1.00518672199
236516,236527,237266,11,739,2,36000,1.0148849797
236559,236569,237387,10,818,2,36000,1.01222493888
236574,236580,237462,6,882,2,36000,1.00680272109
236575,236586,237525,11,939,2,36000,1.01171458999
236606,236618,237500,12,882,2,36000,1.01360544218
236621,236633,237552,12,919,2,36000,1.01305767138
236649,236660,237687,11,1027,2,36000,1.01071080818
236664,236673,237532,9,859,2,36000,1.01047729919
236683,236694,237496,11,802,2,36000,1.01371571072
236698,236705,237515,7,810,2,36000,1.00864197531
236713,236719,237505,6,786,2,36000,1.00763358779
236743,236755,237677,12,922,2,36000,1.01301518438
236816,236826,237741,10,915,2,36000,1.01092896175
236834,236843,237669,9,826,2,36000,1.01089588378
236852,236862,237617,10,755,2,36000,1.01324503311
236868,236874,237580,6,706,2,36000,1.00849858357
236869,236880,237664,11,784,2,36000,1.01403061224
236954,236964,237902,10,938,2,36000,1.01066098081
236969,236976,237764,7,788,2,36000,1.00888324873
236994,237002,237910,8,908,2,36000,1.00881057269
237008,237020,237888,12,868,2,36000,1.01382488479
237056,237064,237841,8,777,2,36000,1.0102960103
237057,237070,237872,13,802,2,36000,1.01620947631
237072,237078,237811,6,733,2,36000,1.00818553888
237100,237110,237876,10,766,2,36000,1.01305483029
237124,237134,237951,10,817,2,36000,1.01223990208
237139,237145,237901,6,756,2,36000,1.00793650794
237140,237151,238001,11,850,2,36000,1.01294117647
237156,237162,237930,6,768,2,36000,1.0078125
237157,237168,237975,11,807,2,36000,1.0136307311
237172,237181,238005,9,824,2,36000,1.0109223301
237194,237202,237970,8,768,2,36000,1.01041666667
237195,237208,237973,13,765,2,36000,1.01699346405
237213,237222,237961,9,739,2,36000,1.01217861976
237229,237235,238052,6,817,2,36000,1.00734394125
237230,237241,238100,11,859,2,36000,1.01280558789
237251,237263,238734,12,1471,2,36000,1.00815771584
237266,237277,238103,11,826,2,36000,1.01331719128
237306,237315,238073,9,758,2,36000,1.01187335092
237388,237398,238133,10,735,2,36000,1.01360544218
237403,237412,238171,9,759,2,36000,1.01185770751
237463,237474,238267,11,793,2,36000,1.01387137453
237484,237496,238350,12,854,2,36000,1.01405152225
237499,237507,238299,8,792,2,36000,1.0101010101
237501,237513,238348,12,835,2,36000,1.01437125749
237516,237523,238353,7,830,2,36000,1.00843373494
237518,237529,238370,11,841,2,36000,1.01307966706
237534,237540,238330,6,790,2,36000,1.00759493671
237535,237546,238323,11,777,2,36000,1.01415701416
237553,237563,238295,10,732,2,36000,1.01366120219
237581,237591,238385,10,794,2,36000,1.01259445844
237618,237628,238391,10,763,2,36000,1.0131061599
237664,237675,238454,11,779,2,36000,1.01412066752
237679,237686,238514,7,828,2,36000,1.00845410628
237681,237692,238499,11,807,2,36000,1.0136307311
237696,237703,238569,7,866,2,36000,1.00808314088
237742,237752,238593,10,841,2,36000,1.01189060642
237766,237775,238493,9,718,2,36000,1.01253481894
237814,237822,238671,8,849,2,36000,1.00942285041
237841,237853,238601,12,748,2,36000,1.01604278075
237872,237883,238768,11,885,2,36000,1.01242937853
237887,237893,238759,6,866,2,36000,1.00692840647
237902,237908,238820,6,912,2,36000,1.00657894737
237903,237914,238710,11,796,2,36000,1.01381909548
237905,237919,238851,14,932,2,36000,1.01502145923
237920,237926,238768,6,842,2,36000,1.00712589074
237935,237941,238707,6,766,2,36000,1.00783289817
237953,237963,238752,10,789,2,36000,1.01267427123
237968,237974,238905,6,931,2,36000,1.00644468314
237983,237990,238763,7,773,2,36000,1.00905562743
237985,237996,238757,11,761,2,36000,1.01445466491
237986,238001,238783,15,782,2,36000,1.01918158568
238001,238012,238695,11,683,2,36000,1.01610541728
238016,238022,238818,6,796,2,36000,1.00753768844
238053,238063,238966,10,903,2,36000,1.01107419712
238074,238084,238808,10,724,2,36000,1.0138121547
238101,238112,238910,11,798,2,36000,1.01378446115
238117,238123,238899,6,776,2,36000,1.00773195876
238135,238145,238940,10,795,2,36000,1.01257861635
238174,238182,238952,8,770,2,36000,1.01038961039
238267,238278,239133,11,855,2,36000,1.01286549708
238298,238306,239151,8,845,2,36000,1.00946745562
238313,238319,239004,6,685,2,36000,1.00875912409
238328,238334,239276,6,942,2,36000,1.00636942675
238343,238350,239170,7,820,2,36000,1.00853658537
238359,238365,239165,6,800,2,36000,1.0075
238360,238371,239080,11,709,2,36000,1.01551480959
238362,238376,239125,14,749,2,36000,1.01869158879
238377,238382,239262,5,880,2,36000,1.00568181818
238392,238398,239181,6,783,2,36000,1.00766283525
238393,238404,239264,11,860,2,36000,1.01279069767
238454,238465,239203,11,738,2,36000,1.01490514905
238493,238505,239285,12,780,2,36000,1.01538461538
238508,238514,239308,6,794,2,36000,1.00755667506
238523,238529,239374,6,845,2,36000,1.00710059172
238569,238580,239397,11,817,2,36000,1.01346389229
238596,238605,239416,9,811,2,36000,1.0110974106
238611,238617,239380,6,763,2,36000,1.00786369594
238674,238682,239457,8,775,2,36000,1.01032258065
238695,238706,239664,11,958,2,36000,1.0114822547
238710,238718,239465,8,747,2,36000,1.01070950469
238711,238724,239477,13,753,2,36000,1.01726427623
238736,238745,239527,9,782,2,36000,1.01150895141
238754,238764,239497,10,733,2,36000,1.0136425648
238771,238777,239559,6,782,2,36000,1.00767263427
238773,238783,239602,10,819,2,36000,1.01221001221
238774,238788,239679,14,891,2,36000,1.01571268238
238775,238793,239673,18,880,2,36000,1.02045454545
238776,238799,239622,23,823,2,36000,1.02794653706
238792,238805,239606,13,801,2,36000,1.01622971286
238810,238819,239618,9,799,2,36000,1.0112640801
238826,238831,239581,5,750,2,36000,1.00666666667
238827,238837,239623,10,786,2,36000,1.01272264631
238851,238862,240184,11,1322,2,36000,1.00832072617
238899,238910,239689,11,779,2,36000,1.01412066752
238914,238921,239669,7,748,2,36000,1.00935828877
238916,238927,239681,11,754,2,36000,1.01458885942
238940,238951,239774,11,823,2,36000,1.01336573512
238955,238963,239710,8,747,2,36000,1.01070950469
238970,238978,239892,8,914,2,36000,1.00875273523
239006,239016,239804,10,788,2,36000,1.01269035533
239081,239091,239917,10,826,2,36000,1.01210653753
239127,239136,240194,9,1058,2,36000,1.00850661626
239141,239148,239939,7,791,2,36000,1.00884955752
239156,239162,240013,6,851,2,36000,1.00705052879
239172,239178,240038,6,860,2,36000,1.00697674419
239173,239184,239990,11,806,2,36000,1.01364764268
239188,239194,239922,6,728,2,36000,1.00824175824
239207,239215,240008,8,793,2,36000,1.01008827238
239265,239273,240017,8,744,2,36000,1.01075268817
239266,239279,240181,13,902,2,36000,1.01441241685
239281,239287,240083,6,796,2,36000,1.00753768844
239296,239302,240192,6,890,2,36000,1.00674157303
239311,239319,240157,8,838,2,36000,1.00954653938
239375,239385,240087,10,702,2,36000,1.01424501425
239392,239398,240213,6,815,2,36000,1.00736196319
239407,239413,240198,6,785,2,36000,1.0076433121
239422,239428,240311,6,883,2,36000,1.00679501699
239459,239468,240260,9,792,2,36000,1.01136363636
239474,239480,240238,6,758,2,36000,1.00791556728
239488,239494,240335,6,841,2,36000,1.00713436385
239503,239509,240258,6,749,2,36000,1.00801068091
239527,239538,240420,11,882,2,36000,1.01247165533
239560,239571,240272,11,701,2,36000,1.01569186876
239581,239592,240424,11,832,2,36000,1.01322115385
239603,239613,240517,10,904,2,36000,1.0110619469
239619,239625,240481,6,856,2,36000,1.00700934579
239620,239631,240581,11,950,2,36000,1.01157894737
239635,239641,240480,6,839,2,36000,1.00715137068
239637,239647,240429,10,782,2,36000,1.01278772379
239664,239675,240459,11,784,2,36000,1.01403061224
239680,239687,240475,7,788,2,36000,1.00888324873
239682,239693,240456,11,763,2,36000,1.01441677588
239683,239698,240477,15,779,2,36000,1.01925545571
239684,239703,240413,19,710,2,36000,1.02676056338
239700,239710,240443,10,733,2,36000,1.0136425648
239715,239721,240527,6,806,2,36000,1.00744416873
239775,239785,240587,10,802,2,36000,1.01246882793
239803,239815,240643,12,828,2,36000,1.01449275362
239894,239903,240711,9,808,2,36000,1.01113861386
239918,239928,240686,10,758,2,36000,1.01319261214
239933,239939,240815,6,876,2,36000,1.00684931507
239948,239954,240769,6,815,2,36000,1.00736196319
239990,240001,240871,11,870,2,36000,1.01264367816
240009,240020,240784,11,764,2,36000,1.01439790576
240024,240030,241111,6,1081,2,36000,1.00555041628
240025,240036,240801,11,765,2,36000,1.01437908497
240040,240050,240819,10,769,2,36000,1.01300390117
240083,240094,240918,11,824,2,36000,1.01334951456
240098,240104,241149,6,1045,2,36000,1.00574162679
240158,240168,240951,10,783,2,36000,1.01277139208
240183,240192,240922,9,730,2,36000,1.01232876712
240198,240204,241042,6,838,2,36000,1.00715990453
240200,240210,240984,10,774,2,36000,1.01291989664
240201,240215,240985,14,770,2,36000,1.01818181818
240202,240220,241019,18,799,2,36000,1.0225281602
240217,240227,241137,10,910,2,36000,1.01098901099
240239,240250,241013,11,763,2,36000,1.01441677588
240260,240270,240986,10,716,2,36000,1.01396648045
240261,240276,241125,15,849,2,36000,1.01766784452
240276,240283,241084,7,801,2,36000,1.00873907615
240313,240322,241262,9,940,2,36000,1.00957446809
240337,240346,241199,9,853,2,36000,1.01055099648
240415,240424,241205,9,781,2,36000,1.01152368758
240431,240437,241228,6,791,2,36000,1.00758533502
240432,240443,241224,11,781,2,36000,1.01408450704
240433,240448,241235,15,787,2,36000,1.01905972046
240448,240455,241209,7,754,2,36000,1.00928381963
240464,240470,241273,6,803,2,36000,1.00747198007
240465,240476,241275,11,799,2,36000,1.01376720901
240481,240488,241269,7,781,2,36000,1.00896286812
240483,240493,241177,10,684,2,36000,1.01461988304
240484,240499,241416,15,917,2,36000,1.01635768811
240485,240504,241320,19,816,2,36000,1.02328431373
240520,240528,241321,8,793,2,36000,1.01008827238
240534,240541,241298,7,757,2,36000,1.00924702774
240583,240592,241344,9,752,2,36000,1.01196808511
240598,240604,241397,6,793,2,36000,1.00756620429
240643,240654,241421,11,767,2,36000,1.01434159061
240686,240697,241475,11,778,2,36000,1.01413881748
240713,240723,241468,10,745,2,36000,1.01342281879
240771,240781,241605,10,824,2,36000,1.01213592233
240786,240796,241565,10,769,2,36000,1.01300390117
240804,240813,241616,9,803,2,36000,1.01120797011
240820,240826,241754,6,928,2,36000,1.00646551724
240821,240832,241645,11,813,2,36000,1.0135301353
240873,240882,241735,9,853,2,36000,1.01055099648
240921,240929,241743,8,814,2,36000,1.00982800983
240936,240942,241741,6,799,2,36000,1.00750938673
240951,240962,241779,11,817,2,36000,1.01346389229
240982,240995,241710,13,715,2,36000,1.01818181818
240997,241003,241829,6,826,2,36000,1.00726392252
240998,241009,241892,11,883,2,36000,1.01245753114
241014,241024,241834,10,810,2,36000,1.01234567901
241029,241035,241871,6,836,2,36000,1.00717703349
241044,241053,241847,9,794,2,36000,1.01133501259
241086,241096,241900,10,804,2,36000,1.01243781095
241114,241122,241844,8,722,2,36000,1.01108033241
241128,241136,242004,8,868,2,36000,1.00921658986
241143,241150,241999,7,849,2,36000,1.00824499411
241158,241165,241997,7,832,2,36000,1.00841346154
241177,241188,241901,11,713,2,36000,1.01542776999
241201,241211,241916,10,705,2,36000,1.01418439716
241217,241223,242036,6,813,2,36000,1.0073800738
241218,241229,242064,11,835,2,36000,1.01317365269
241233,241239,242075,6,836,2,36000,1.00717703349
241235,241245,242047,10,802,2,36000,1.01246882793
241249,241256,242109,7,853,2,36000,1.0082063306
241264,241273,242124,9,851,2,36000,1.01057579318
241280,241286,242033,6,747,2,36000,1.00803212851
241282,241292,242152,10,860,2,36000,1.01162790698
241283,241297,242018,14,721,2,36000,1.01941747573
241298,241309,242041,11,732,2,36000,1.0150273224
241316,243499,251225,2183,7726,128,36000,1.2825524204
241320,241331,242112,11,781,2,36000,1.01408450704
241321,241337,242140,16,803,2,36000,1.0199252802
241323,251236,254449,9913,3213,128,36000,4.08527855587
241331,254461,257661,13130,3200,128,36000,5.103125
241346,241355,242151,9,796,2,36000,1.01130653266
241397,241409,242340,12,931,2,36000,1.01288936627
241418,241427,242207,9,780,2,36000,1.01153846154
241434,241440,242181,6,741,2,36000,1.00809716599
241468,241479,242424,11,945,2,36000,1.01164021164
241482,241489,242284,7,795,2,36000,1.00880503145
241565,241581,242301,16,720,2,36000,1.02222222222
241608,241617,242414,9,797,2,36000,1.0112923463
241623,241629,242378,6,749,2,36000,1.00801068091
241647,241657,242382,10,725,2,36000,1.01379310345
241663,243583,243594,1920,11,1,900,175.545454545
241674,267815,267925,26141,110,14,7980,238.645454545
241711,241721,242443,10,722,2,36000,1.01385041551
241738,241746,242587,8,841,2,36000,1.00951248514
241753,241759,242671,6,912,2,36000,1.00657894737
241755,241765,242511,10,746,2,36000,1.01340482574
241770,241776,242421,6,645,2,36000,1.00930232558
241785,241791,242647,6,856,2,36000,1.00700934579
241831,241841,242841,10,1000,2,36000,1.01
241847,241853,242644,6,791,2,36000,1.00758533502
241848,241859,242680,11,821,2,36000,1.01339829476
241849,241864,242639,15,775,2,36000,1.01935483871
241871,241882,242615,11,733,2,36000,1.01500682128
241892,241903,242685,11,782,2,36000,1.01406649616
241909,241915,242679,6,764,2,36000,1.00785340314
241910,241921,242736,11,815,2,36000,1.01349693252
241925,241931,242602,6,671,2,36000,1.00894187779
241999,242008,242780,9,772,2,36000,1.01165803109
242000,242014,242903,14,889,2,36000,1.0157480315
242015,242021,242825,6,804,2,36000,1.00746268657
242031,242037,242751,6,714,2,36000,1.00840336134
242046,242052,242838,6,786,2,36000,1.00763358779
242048,242058,242975,10,917,2,36000,1.01090512541
242049,242063,242802,14,739,2,36000,1.01894451962
242050,242068,242859,18,791,2,36000,1.02275600506
242066,242080,242857,14,777,2,36000,1.01801801802
242082,242088,242911,6,823,2,36000,1.00729040097
242087,243605,276142,1518,32537,1,511200,1.04665457787
242109,242121,243045,12,924,2,36000,1.01298701299
242124,242131,242902,7,771,2,36000,1.00907911803
242126,242137,242976,11,839,2,36000,1.01311084625
242141,242152,242834,11,682,2,36000,1.01612903226
242157,242163,243012,6,849,2,36000,1.00706713781
242158,242169,242894,11,725,2,36000,1.01517241379
242183,242192,242996,9,804,2,36000,1.01119402985
242207,242218,243133,11,915,2,36000,1.01202185792
242284,242295,243195,11,900,2,36000,1.01222222222
242302,242312,243113,10,801,2,36000,1.01248439451
242341,242351,243094,10,743,2,36000,1.0134589502
242378,242389,243229,11,840,2,36000,1.0130952381
242393,242399,243206,6,807,2,36000,1.00743494424
242414,242425,243173,11,748,2,36000,1.01470588235
242429,242435,243214,6,779,2,36000,1.00770218228
242431,242441,243176,10,735,2,36000,1.01360544218
242446,242455,243247,9,792,2,36000,1.01136363636
242509,242522,243290,13,768,2,36000,1.01692708333
242588,242598,243407,10,809,2,36000,1.01236093943
242603,242613,243429,10,816,2,36000,1.01225490196
242617,242626,243372,9,746,2,36000,1.01206434316
242639,242650,243508,11,858,2,36000,1.01282051282
242654,242660,243432,6,772,2,36000,1.00777202073
242655,242666,243404,11,738,2,36000,1.01490514905
242671,242682,243470,11,788,2,36000,1.01395939086
242686,242692,243482,6,790,2,36000,1.00759493671
242688,242698,243493,10,795,2,36000,1.01257861635
242689,242703,243550,14,847,2,36000,1.01652892562
242737,242747,243504,10,757,2,36000,1.01321003963
242752,242762,243644,10,882,2,36000,1.01133786848
242780,242791,243625,11,834,2,36000,1.01318944844
242804,242813,243603,9,790,2,36000,1.01139240506
242826,242836,243647,10,811,2,36000,1.01233045623
242841,242847,243603,6,756,2,36000,1.00793650794
242842,242853,243669,11,816,2,36000,1.01348039216
242844,242858,243657,14,799,2,36000,1.01752190238
242859,242868,243787,9,919,2,36000,1.00979325354
242860,242874,243620,14,746,2,36000,1.01876675603
242894,242905,243708,11,803,2,36000,1.01369863014
242910,242916,243635,6,719,2,36000,1.0083449235
242911,242922,243659,11,737,2,36000,1.01492537313
242926,242932,243697,6,765,2,36000,1.00784313725
242975,242986,243738,11,752,2,36000,1.01462765957
242977,242992,243770,15,778,2,36000,1.01928020566
242998,243007,243860,9,853,2,36000,1.01055099648
243013,243023,243829,10,806,2,36000,1.01240694789
243047,243056,243795,9,739,2,36000,1.01217861976
243095,243105,243877,10,772,2,36000,1.01295336788
243113,243124,243981,11,857,2,36000,1.01283547258
243134,243144,243796,10,652,2,36000,1.01533742331
243174,243185,244014,11,829,2,36000,1.01326899879
243189,243195,244065,6,870,2,36000,1.00689655172
243204,243210,244280,6,1070,2,36000,1.00560747664
243219,243225,244072,6,847,2,36000,1.00708382527
243221,243231,244057,10,826,2,36000,1.01210653753
243236,243241,244031,5,790,2,36000,1.00632911392
243251,243258,244079,7,821,2,36000,1.00852618758
243290,243301,244129,11,828,2,36000,1.01328502415
243372,243383,244131,11,748,2,36000,1.01470588235
243406,243415,244229,9,814,2,36000,1.01105651106
243421,243427,244157,6,730,2,36000,1.00821917808
243436,243442,244143,6,701,2,36000,1.00855920114
243437,243448,244509,11,1061,2,36000,1.01036757776
243472,243481,244194,9,713,2,36000,1.0126227209
243486,243493,244216,7,723,2,36000,1.00968188105
243502,243508,244346,6,838,2,36000,1.00715990453
243517,243523,244302,6,779,2,36000,1.00770218228
243518,243529,244340,11,811,2,36000,1.01356350185
243552,243561,244396,9,835,2,36000,1.01077844311
243605,243614,244288,9,674,2,36000,1.01335311573
243606,243619,244339,13,720,2,36000,1.01805555556
243621,243631,244440,10,809,2,36000,1.01236093943
243638,243644,244447,6,803,2,36000,1.00747198007
243639,243650,244352,11,702,2,36000,1.01566951567
243654,243661,244411,7,750,2,36000,1.00933333333
243656,243667,244432,11,765,2,36000,1.01437908497
243673,243679,244554,6,875,2,36000,1.00685714286
243674,243685,244485,11,800,2,36000,1.01375
243675,243690,244501,15,811,2,36000,1.01849568434
243697,243708,244507,11,799,2,36000,1.01376720901
243712,243719,244552,7,833,2,36000,1.00840336134
243737,243749,244588,12,839,2,36000,1.01430274136
243770,243781,244567,11,786,2,36000,1.01399491094
243789,243799,244654,10,855,2,36000,1.01169590643
243804,243810,244690,6,880,2,36000,1.00681818182
243806,243816,244629,10,813,2,36000,1.012300123
243830,243840,244671,10,831,2,36000,1.01203369434
243861,243871,244702,10,831,2,36000,1.01203369434
243879,243888,244803,9,915,2,36000,1.00983606557
243982,243993,244751,11,758,2,36000,1.01451187335
244015,244025,244782,10,757,2,36000,1.01321003963
244034,244042,244889,8,847,2,36000,1.00944510035
244058,244068,244762,10,694,2,36000,1.0144092219
244074,244080,244870,6,790,2,36000,1.00759493671
244076,244086,244933,10,847,2,36000,1.01180637544
244091,244097,244864,6,767,2,36000,1.00782268579
244131,244140,244879,9,739,2,36000,1.01217861976
244132,244146,245043,14,897,2,36000,1.01560758082
244147,244153,245014,6,861,2,36000,1.00696864111
244162,244168,245028,6,860,2,36000,1.00697674419
244196,244206,245108,10,902,2,36000,1.0110864745
244217,244227,245057,10,830,2,36000,1.01204819277
244232,244240,245134,8,894,2,36000,1.00894854586
244281,244291,245089,10,798,2,36000,1.01253132832
244295,244302,245177,7,875,2,36000,1.008
244310,244317,245029,7,712,2,36000,1.00983146067
244341,244350,245161,9,811,2,36000,1.0110974106
244342,244356,245253,14,897,2,36000,1.01560758082
244358,244365,245187,7,822,2,36000,1.00851581509
244360,244371,245265,11,894,2,36000,1.01230425056
244396,244408,245155,12,747,2,36000,1.01606425703
244411,244422,245254,11,832,2,36000,1.01322115385
244433,244443,245238,10,795,2,36000,1.01257861635
244448,244455,245257,7,802,2,36000,1.00872817955
244450,244461,245240,11,779,2,36000,1.01412066752
244487,244496,245346,9,850,2,36000,1.01058823529
244502,244512,245243,10,731,2,36000,1.01367989056
244517,244523,245248,6,725,2,36000,1.00827586207
244519,244529,245397,10,868,2,36000,1.01152073733
244556,244563,245762,7,1199,2,36000,1.0058381985
244557,244569,245453,12,884,2,36000,1.01357466063
244572,244577,245450,5,873,2,36000,1.00572737686
244590,244600,245429,10,829,2,36000,1.01206272618
244629,244641,245426,12,785,2,36000,1.0152866242
244654,244665,245475,11,810,2,36000,1.01358024691
244673,244682,245529,9,847,2,36000,1.0106257379
244691,244701,245565,10,864,2,36000,1.01157407407
244706,244713,245608,7,895,2,36000,1.00782122905
244753,244763,245495,10,732,2,36000,1.01366120219
244768,244774,245566,6,792,2,36000,1.00757575758
244783,244793,245625,10,832,2,36000,1.01201923077
244805,244815,245666,10,851,2,36000,1.01175088132
244866,244875,245681,9,806,2,36000,1.0111662531
244881,244888,245646,7,758,2,36000,1.0092348285
244883,244894,245737,11,843,2,36000,1.01304863582
244898,244904,245798,6,894,2,36000,1.0067114094
244935,244944,245727,9,783,2,36000,1.01149425287
245014,245025,245823,11,798,2,36000,1.01378446115
245029,245039,245811,10,772,2,36000,1.01295336788
245030,245045,245926,15,881,2,36000,1.0170261067
245045,245054,245838,9,784,2,36000,1.01147959184
245061,245068,245978,7,910,2,36000,1.00769230769
245091,245101,245986,10,885,2,36000,1.01129943503
245109,245120,246009,11,889,2,36000,1.01237345332
245131,245145,245988,14,843,2,36000,1.01660735469
245159,245166,245896,7,730,2,36000,1.0095890411
245175,245181,245956,6,775,2,36000,1.00774193548
245190,245196,246036,6,840,2,36000,1.00714285714
245191,245202,245987,11,785,2,36000,1.01401273885
245238,245249,246070,11,821,2,36000,1.01339829476
245254,245261,246119,7,858,2,36000,1.00815850816
245256,245267,246204,11,937,2,36000,1.01173959445
245257,245272,246152,15,880,2,36000,1.01704545455
245258,245278,246057,20,779,2,36000,1.02567394095
245260,245283,246168,23,885,2,36000,1.02598870056
245276,245289,246061,13,772,2,36000,1.01683937824
245277,245294,246067,17,773,2,36000,1.02199223803
245348,245358,246124,10,766,2,36000,1.01305483029
245395,245408,246286,13,878,2,36000,1.01480637813
245427,245437,246213,10,776,2,36000,1.01288659794
245442,245448,246290,6,842,2,36000,1.00712589074
245457,245463,246242,6,779,2,36000,1.00770218228
245459,245469,246235,10,766,2,36000,1.01305483029
245477,245486,246295,9,809,2,36000,1.01112484549
245498,245507,246293,9,786,2,36000,1.01145038168
245529,245540,246373,11,833,2,36000,1.01320528211
245565,245576,246557,11,981,2,36000,1.01121304791
245566,245582,246376,16,794,2,36000,1.0201511335
245610,245619,246479,9,860,2,36000,1.01046511628
245625,245637,246504,12,867,2,36000,1.01384083045
245647,245658,246481,11,823,2,36000,1.01336573512
245668,245677,246430,9,753,2,36000,1.01195219124
245683,245692,246503,9,811,2,36000,1.0110974106
245727,245738,246493,11,755,2,36000,1.01456953642
245742,245748,246587,6,839,2,36000,1.00715137068
245764,245773,246613,9,840,2,36000,1.01071428571
245800,245809,246628,9,819,2,36000,1.01098901099
245815,245822,246529,7,707,2,36000,1.0099009901
245831,245837,246646,6,809,2,36000,1.00741656366
245846,245852,246710,6,858,2,36000,1.00699300699
245897,245908,246844,11,936,2,36000,1.01175213675
245927,245937,246672,10,735,2,36000,1.01360544218
245958,245967,246723,9,756,2,36000,1.0119047619
245980,245990,246763,10,773,2,36000,1.01293661061
245995,246001,246840,6,839,2,36000,1.00715137068
245996,246007,246879,11,872,2,36000,1.0126146789
245998,246012,246797,14,785,2,36000,1.0178343949
246013,246020,246987,7,967,2,36000,1.00723888314
246038,246047,246885,9,838,2,36000,1.0107398568
246059,246068,246895,9,827,2,36000,1.01088270859
246075,246081,246896,6,815,2,36000,1.00736196319
246076,246087,246871,11,784,2,36000,1.01403061224
246077,246092,247096,15,1004,2,36000,1.01494023904
246120,246131,246889,11,758,2,36000,1.01451187335
246135,246141,246996,6,855,2,36000,1.00701754386
246156,246164,246980,8,816,2,36000,1.00980392157
246171,246179,247040,8,861,2,36000,1.00929152149
246205,246215,247011,10,796,2,36000,1.01256281407
246220,246226,246968,6,742,2,36000,1.00808625337
246235,246246,247182,11,936,2,36000,1.01175213675
246249,246256,247183,7,927,2,36000,1.00755124056
246288,246298,247008,10,710,2,36000,1.01408450704
246304,246310,247143,6,833,2,36000,1.00720288115
246305,246316,247113,11,797,2,36000,1.01380175659
246306,246321,247115,15,794,2,36000,1.01889168766
246373,246384,247252,11,868,2,36000,1.01267281106
246388,246394,247310,6,916,2,36000,1.00655021834
246430,246441,247273,11,832,2,36000,1.01322115385
246481,246490,247247,9,757,2,36000,1.01188903567
246482,246496,247301,14,805,2,36000,1.01739130435
246498,246504,247348,6,844,2,36000,1.00710900474
246513,246519,247312,6,793,2,36000,1.00756620429
246514,246525,247278,11,753,2,36000,1.01460823373
246531,246541,247337,10,796,2,36000,1.01256281407
246558,246569,247293,11,724,2,36000,1.01519337017
246589,246599,247474,10,875,2,36000,1.01142857143
246614,246624,247347,10,723,2,36000,1.01383125864
246629,246639,247413,10,774,2,36000,1.01291989664
246647,246657,247375,10,718,2,36000,1.0139275766
246673,246683,247419,10,736,2,36000,1.01358695652
246713,246722,247431,9,709,2,36000,1.01269393512
246728,246734,247620,6,886,2,36000,1.00677200903
246764,246775,247633,11,858,2,36000,1.01282051282
246798,246808,247589,10,781,2,36000,1.01280409731
246843,246851,247584,8,733,2,36000,1.01091405184
246845,246857,247729,12,872,2,36000,1.01376146789
246872,246883,247692,11,809,2,36000,1.01359703337
246887,246893,247664,6,771,2,36000,1.00778210117
246889,246899,247796,10,897,2,36000,1.01114827202
246907,246913,247688,6,775,2,36000,1.00774193548
246908,246919,247686,11,767,2,36000,1.01434159061
246910,246924,247971,14,1047,2,36000,1.01337153773
246970,246980,247811,10,831,2,36000,1.01203369434
246986,246991,247794,5,803,2,36000,1.00622665006
246987,246998,247744,11,746,2,36000,1.01474530831
247004,247010,247713,6,703,2,36000,1.00853485064
247019,247025,247817,6,792,2,36000,1.00757575758
247021,247031,247891,10,860,2,36000,1.01162790698
247044,247050,247793,6,743,2,36000,1.00807537012
247096,247107,247910,11,803,2,36000,1.01369863014
247114,247124,248037,10,913,2,36000,1.01095290252
247130,247136,247957,6,821,2,36000,1.00730816078
247145,247154,247913,9,759,2,36000,1.01185770751
247185,247193,248110,8,917,2,36000,1.00872410033
247186,247199,248146,13,947,2,36000,1.01372756072
247248,247258,248095,10,837,2,36000,1.0119474313
247263,247269,248158,6,889,2,36000,1.00674915636
247278,247283,248124,5,841,2,36000,1.00594530321
247279,247290,248129,11,839,2,36000,1.01311084625
247294,247304,248090,10,786,2,36000,1.01272264631
247310,247316,248091,6,775,2,36000,1.00774193548
247312,247322,248097,10,775,2,36000,1.01290322581
247327,247333,248095,6,762,2,36000,1.00787401575
247343,247350,248139,7,789,2,36000,1.00887198986
247358,247365,248112,7,747,2,36000,1.0093708166
247360,247371,248181,11,810,2,36000,1.01358024691
247375,247386,248215,11,829,2,36000,1.01326899879
247411,247424,248256,13,832,2,36000,1.015625
247427,247433,248309,6,876,2,36000,1.00684931507
247441,247447,248357,6,910,2,36000,1.00659340659
247475,247485,248264,10,779,2,36000,1.01283697047
247585,247595,248286,10,691,2,36000,1.01447178003
247599,247606,248392,7,786,2,36000,1.00890585242
247621,247631,248422,10,791,2,36000,1.01264222503
247636,247644,248562,8,918,2,36000,1.00871459695
247666,247675,248535,9,860,2,36000,1.01046511628
247687,247697,248468,10,771,2,36000,1.01297016861
247702,247709,248531,7,822,2,36000,1.00851581509
247704,247715,248450,11,735,2,36000,1.01496598639
247719,247725,248592,6,867,2,36000,1.00692041522
247734,247740,248708,6,968,2,36000,1.00619834711
247749,247755,248449,6,694,2,36000,1.00864553314
247794,247804,248624,10,820,2,36000,1.01219512195
247796,247810,248581,14,771,2,36000,1.01815823606
247811,247817,248565,6,748,2,36000,1.00802139037
247813,247823,248624,10,801,2,36000,1.01248439451
247828,247834,248539,6,705,2,36000,1.0085106383
247892,247903,248654,11,751,2,36000,1.01464713715
247910,247921,248623,11,702,2,36000,1.01566951567
247925,247931,248748,6,817,2,36000,1.00734394125
247956,247968,248696,12,728,2,36000,1.01648351648
247971,247982,248758,11,776,2,36000,1.01417525773
248038,248048,248908,10,860,2,36000,1.01162790698
248094,248101,248877,7,776,2,36000,1.00902061856
248095,248107,248924,12,817,2,36000,1.0146878825
248112,248118,248936,6,818,2,36000,1.00733496333
248113,248124,249056,11,932,2,36000,1.01180257511
248114,248129,248951,15,822,2,36000,1.01824817518
248116,248134,249041,18,907,2,36000,1.01984564498
248117,248140,248973,23,833,2,36000,1.02761104442
248132,248146,248935,14,789,2,36000,1.01774397972
248133,248151,248965,18,814,2,36000,1.02211302211
248149,248157,248848,8,691,2,36000,1.01157742402
248150,248162,248901,12,739,2,36000,1.01623815968
248166,248172,248950,6,778,2,36000,1.00771208226
248181,248192,248981,11,789,2,36000,1.01394169835
248214,248226,249027,12,801,2,36000,1.01498127341
248257,248268,249167,11,899,2,36000,1.01223581758
248272,248278,249434,6,1156,2,36000,1.00519031142
248287,248297,249050,10,753,2,36000,1.01328021248
248308,248320,249091,12,771,2,36000,1.01556420233
248359,248369,249296,10,927,2,36000,1.01078748652
248393,248403,249300,10,897,2,36000,1.01114827202
248423,248433,249153,10,720,2,36000,1.01388888889
248451,248460,249320,9,860,2,36000,1.01046511628
248452,248466,249213,14,747,2,36000,1.0187416332
248470,248479,249333,9,854,2,36000,1.01053864169
248531,248542,249358,11,816,2,36000,1.01348039216
248532,248548,249349,16,801,2,36000,1.01997503121
248547,248554,249332,7,778,2,36000,1.00899742931
248562,248573,249366,11,793,2,36000,1.01387137453
248577,248583,249339,6,756,2,36000,1.00793650794
248592,248598,249377,6,779,2,36000,1.00770218228
248607,248613,249627,6,1014,2,36000,1.00591715976
248622,248634,249395,12,761,2,36000,1.01576872536
248638,248644,249403,6,759,2,36000,1.00790513834
248639,248650,249433,11,783,2,36000,1.01404853129
248654,248665,249379,11,714,2,36000,1.01540616246
248697,248708,249462,11,754,2,36000,1.01458885942
248712,248719,249516,7,797,2,36000,1.00878293601
248748,248760,249668,12,908,2,36000,1.01321585903
248763,248769,249583,6,814,2,36000,1.00737100737
248848,248859,249626,11,767,2,36000,1.01434159061
248878,248888,249852,10,964,2,36000,1.01037344398
248903,248912,249689,9,777,2,36000,1.01158301158
248918,248924,249849,6,925,2,36000,1.00648648649
248933,248939,249680,6,741,2,36000,1.00809716599
248934,248946,249740,12,794,2,36000,1.01511335013
248950,248956,249683,6,727,2,36000,1.00825309491
248951,248962,249750,11,788,2,36000,1.01395939086
248967,248973,249714,6,741,2,36000,1.00809716599
248968,248979,250492,11,1513,2,36000,1.00727032386
248984,248990,249790,6,800,2,36000,1.0075
248985,248996,249754,11,758,2,36000,1.01451187335
249028,249038,249751,10,713,2,36000,1.01402524544
249043,249052,249882,9,830,2,36000,1.01084337349
249058,249065,249863,7,798,2,36000,1.00877192982
249060,249071,249848,11,777,2,36000,1.01415701416
249090,249103,249868,13,765,2,36000,1.01699346405
249154,249165,249974,11,809,2,36000,1.01359703337
249169,249178,249949,9,771,2,36000,1.01167315175
249215,249225,250022,10,797,2,36000,1.01254705144
249297,249307,250176,10,869,2,36000,1.01150747986
249312,249318,250151,6,833,2,36000,1.00720288115
249327,249334,250057,7,723,2,36000,1.00968188105
249343,249349,250256,6,907,2,36000,1.00661521499
249344,249355,250069,11,714,2,36000,1.01540616246
249346,249360,250113,14,753,2,36000,1.01859229748
249362,249368,250188,6,820,2,36000,1.00731707317
249363,249374,250207,11,833,2,36000,1.01320528211
249379,249385,250144,6,759,2,36000,1.00790513834
249380,249391,250173,11,782,2,36000,1.01406649616
249382,249396,250210,14,814,2,36000,1.0171990172
249397,249406,250133,9,727,2,36000,1.01237964237
249413,249419,250328,6,909,2,36000,1.00660066007
249434,249444,250225,10,781,2,36000,1.01280409731
249435,249450,250398,15,948,2,36000,1.01582278481
249463,249474,250316,11,842,2,36000,1.01306413302
249515,249527,250247,12,720,2,36000,1.01666666667
249585,249594,250444,9,850,2,36000,1.01058823529
249628,249637,250386,9,749,2,36000,1.01201602136
249629,249643,250625,14,982,2,36000,1.01425661914
249666,249679,250466,13,787,2,36000,1.0165184244
249681,249691,250459,10,768,2,36000,1.01302083333
249696,249702,250507,6,805,2,36000,1.00745341615
249697,249708,250493,11,785,2,36000,1.01401273885
249716,249725,250537,9,812,2,36000,1.01108374384
249740,249751,250587,11,836,2,36000,1.01315789474
249755,249761,250433,6,672,2,36000,1.00892857143
249757,249767,250532,10,765,2,36000,1.01307189542
249758,249772,250589,14,817,2,36000,1.01713586291
249791,249801,250617,10,816,2,36000,1.01225490196
249849,249859,250705,10,846,2,36000,1.01182033097
249851,249865,250667,14,802,2,36000,1.0174563591
249866,249872,250709,6,837,2,36000,1.00716845878
249867,249878,250688,11,810,2,36000,1.01358024691
249883,249889,250745,6,856,2,36000,1.00700934579
249884,249895,250744,11,849,2,36000,1.01295641932
249951,249960,250708,9,748,2,36000,1.01203208556
249975,249986,250756,11,770,2,36000,1.01428571429
250023,250033,250843,10,810,2,36000,1.01234567901
250057,250068,250914,11,846,2,36000,1.01300236407
250072,250080,250942,8,862,2,36000,1.00928074246
250114,250124,250890,10,766,2,36000,1.01305483029
250135,250145,250971,10,826,2,36000,1.01210653753
250151,250156,250991,5,835,2,36000,1.00598802395
250152,250162,250904,10,742,2,36000,1.01347708895
250171,250184,250927,13,743,2,36000,1.01749663526
250172,250190,251052,18,862,2,36000,1.02088167053
250187,250199,250915,12,716,2,36000,1.01675977654
250209,250218,250977,9,759,2,36000,1.01185770751
250211,250224,250980,13,756,2,36000,1.0171957672
250226,250237,251019,11,782,2,36000,1.01406649616
250247,250258,251043,11,785,2,36000,1.01401273885
250262,250269,251080,7,811,2,36000,1.00863131936
250317,250327,251110,10,783,2,36000,1.01277139208
250332,250339,251184,7,845,2,36000,1.00828402367
250386,250397,251168,11,771,2,36000,1.01426718547
250401,250409,251351,8,942,2,36000,1.008492569
250435,250445,251304,10,859,2,36000,1.01164144354
250450,250456,251289,6,833,2,36000,1.00720288115
250465,250471,251205,6,734,2,36000,1.00817438692
250481,250487,251312,6,825,2,36000,1.00727272727
250496,250503,251329,7,826,2,36000,1.00847457627
250498,250509,251287,11,778,2,36000,1.01413881748
250513,250519,251350,6,831,2,36000,1.00722021661
250534,250544,251390,10,846,2,36000,1.01182033097
250549,250555,251358,6,803,2,36000,1.00747198007
250589,250598,251427,9,829,2,36000,1.01085645356
250590,250604,251420,14,816,2,36000,1.01715686275
250618,250628,251363,10,735,2,36000,1.01360544218
250633,250639,251449,6,810,2,36000,1.00740740741
250669,250679,251525,10,846,2,36000,1.01182033097
250687,250699,251487,12,788,2,36000,1.0152284264
250706,250716,251505,10,789,2,36000,1.01267427123
250721,250727,251554,6,827,2,36000,1.00725513906
250722,250733,251608,11,875,2,36000,1.01257142857
250747,250755,251946,8,1191,2,36000,1.0067170445
250748,250761,251513,13,752,2,36000,1.01728723404
250763,250770,251517,7,747,2,36000,1.0093708166
250845,250854,251686,9,832,2,36000,1.01081730769
250891,250901,251709,10,808,2,36000,1.01237623762
250908,250916,251713,8,797,2,36000,1.01003764115
250923,250929,251768,6,839,2,36000,1.00715137068
250924,250935,251765,11,830,2,36000,1.01325301205
250939,250945,251904,6,959,2,36000,1.00625651721
250954,250960,251738,6,778,2,36000,1.00771208226
250973,250982,251799,9,817,2,36000,1.01101591187
250988,250994,251772,6,778,2,36000,1.00771208226
250989,251000,252406,11,1406,2,36000,1.00782361309
251004,251010,251940,6,930,2,36000,1.0064516129
251019,251030,251784,11,754,2,36000,1.01458885942
251044,251054,251870,10,816,2,36000,1.01225490196
251058,251065,251899,7,834,2,36000,1.00839328537
251083,251091,251948,8,857,2,36000,1.00933488915
251110,251121,251926,11,805,2,36000,1.01366459627
251168,251179,251999,11,820,2,36000,1.01341463415
251186,251195,251984,9,789,2,36000,1.01140684411
251207,251216,252039,9,823,2,36000,1.01093560146
251289,251298,252101,9,803,2,36000,1.01120797011
251290,251304,252052,14,748,2,36000,1.01871657754
251305,251315,252150,10,835,2,36000,1.0119760479
251320,251327,252092,7,765,2,36000,1.0091503268
251335,251341,252062,6,721,2,36000,1.00832177531
251351,251362,252127,11,765,2,36000,1.01437908497
251352,251367,252172,15,805,2,36000,1.01863354037
251368,251375,252225,7,850,2,36000,1.00823529412
251370,251381,252175,11,794,2,36000,1.01385390428
251391,251401,252250,10,849,2,36000,1.01177856302
251422,251431,252314,9,883,2,36000,1.01019252548
251437,251443,252247,6,804,2,36000,1.00746268657
251452,251460,252298,8,838,2,36000,1.00954653938
251488,251498,252288,10,790,2,36000,1.01265822785
251506,251517,252334,11,817,2,36000,1.01346389229
251521,251527,252490,6,963,2,36000,1.0062305296
251523,251533,252295,10,762,2,36000,1.01312335958
251537,251544,252291,7,747,2,36000,1.0093708166
251556,251565,252344,9,779,2,36000,1.01155327343
251611,251620,252462,9,842,2,36000,1.0106888361
251686,251698,252460,12,762,2,36000,1.0157480315
251710,251721,252696,11,975,2,36000,1.01128205128
251725,251731,252485,6,754,2,36000,1.00795755968
251740,251749,252510,9,761,2,36000,1.01182654402
251767,251776,252480,9,704,2,36000,1.01278409091
251782,251789,252623,7,834,2,36000,1.00839328537
251784,251795,252577,11,782,2,36000,1.01406649616
251800,251806,252640,6,834,2,36000,1.0071942446
251801,251812,252528,11,716,2,36000,1.01536312849
251871,251881,252683,10,802,2,36000,1.01246882793
251898,251910,252735,12,825,2,36000,1.01454545455
251913,251919,252719,6,800,2,36000,1.0075
251928,251937,252707,9,770,2,36000,1.01168831169
251944,251951,252830,7,879,2,36000,1.00796359499
251959,251965,252835,6,870,2,36000,1.00689655172
251961,251971,252768,10,797,2,36000,1.01254705144
251985,251995,252822,10,827,2,36000,1.01209189843
252000,252010,252889,10,879,2,36000,1.01137656428
252040,252051,252823,11,772,2,36000,1.01424870466
252055,252063,253022,8,959,2,36000,1.00834202294
252070,252076,253000,6,924,2,36000,1.00649350649
252095,252103,252991,8,888,2,36000,1.00900900901
252110,252116,252845,6,729,2,36000,1.00823045267
252128,252138,253004,10,866,2,36000,1.01154734411
252150,252162,252968,12,806,2,36000,1.01488833747
252174,252184,253407,10,1223,2,36000,1.00817661488
252189,252195,252917,6,722,2,36000,1.00831024931
252226,252236,253030,10,794,2,36000,1.01259445844
252249,252258,253027,9,769,2,36000,1.01170351105
252251,252264,253132,13,868,2,36000,1.01497695853
252291,252299,253076,8,777,2,36000,1.0102960103
252292,252305,253049,13,744,2,36000,1.01747311828
252307,252313,253112,6,799,2,36000,1.00750938673
252309,252319,253120,10,801,2,36000,1.01248439451
252324,252330,253090,6,760,2,36000,1.00789473684
252339,252345,253316,6,971,2,36000,1.0061791967
252354,252360,253156,6,796,2,36000,1.00753768844
252406,252417,253153,11,736,2,36000,1.01494565217
252460,252472,253237,12,765,2,36000,1.01568627451
252476,252482,253199,6,717,2,36000,1.00836820084
252491,252497,253251,6,754,2,36000,1.00795755968
252493,252503,253284,10,781,2,36000,1.01280409731
252494,252508,253619,14,1111,2,36000,1.01260126013
252512,252521,253429,9,908,2,36000,1.00991189427
252530,252539,253357,9,818,2,36000,1.01100244499
252579,252588,253422,9,834,2,36000,1.01079136691
252624,252634,253556,10,922,2,36000,1.01084598698
252642,252652,253493,10,841,2,36000,1.01189060642
252684,252694,253481,10,787,2,36000,1.0127064803
252699,252708,253737,9,1029,2,36000,1.00874635569
252714,252721,253447,7,726,2,36000,1.00964187328
252729,252735,253606,6,871,2,36000,1.00688863375
252744,252750,253504,6,754,2,36000,1.00795755968
252769,252779,253653,10,874,2,36000,1.0114416476
252824,252833,253573,9,740,2,36000,1.01216216216
252825,252839,253856,14,1017,2,36000,1.01376597837
252840,252846,253618,6,772,2,36000,1.00777202073
252842,252852,253668,10,816,2,36000,1.01225490196
252856,252863,253818,7,955,2,36000,1.00732984293
252890,252900,253658,10,758,2,36000,1.01319261214
252918,252929,253757,11,828,2,36000,1.01328502415
252969,252979,254111,10,1132,2,36000,1.00883392226
252993,253002,253777,9,775,2,36000,1.01161290323
253009,253015,253870,6,855,2,36000,1.00701754386
253010,253021,253906,11,885,2,36000,1.01242937853
253025,253034,253839,9,805,2,36000,1.01118012422
253040,253046,253917,6,871,2,36000,1.00688863375
253042,253052,253823,10,771,2,36000,1.01297016861
253057,253063,253921,6,858,2,36000,1.00699300699
253078,253087,253828,9,741,2,36000,1.01214574899
253093,253101,254411,8,1310,2,36000,1.00610687023
253114,253123,253881,9,758,2,36000,1.01187335092
253129,253135,253940,6,805,2,36000,1.00745341615
253144,253150,253931,6,781,2,36000,1.00768245839
253159,253165,253889,6,724,2,36000,1.00828729282
253160,253171,253947,11,776,2,36000,1.01417525773
253200,253210,253957,10,747,2,36000,1.01338688086
253240,253249,254067,9,818,2,36000,1.01100244499
253254,253263,254201,9,938,2,36000,1.00959488273
253285,253295,254164,10,869,2,36000,1.01150747986
253312,253327,254067,15,740,2,36000,1.02027027027
253357,253368,254185,11,817,2,36000,1.01346389229
253408,253418,254232,10,814,2,36000,1.01228501229
253423,253434,254263,11,829,2,36000,1.01326899879
253438,253444,254172,6,728,2,36000,1.00824175824
253453,253460,254491,7,1031,2,36000,1.00678952473
253484,253492,254346,8,854,2,36000,1.0093676815
253500,253506,254294,6,788,2,36000,1.0076142132
253515,253521,254317,6,796,2,36000,1.00753768844
253557,253567,254333,10,766,2,36000,1.01305483029
253576,253584,254356,8,772,2,36000,1.0103626943
253606,253617,254418,11,801,2,36000,1.01373283396
253622,253629,254677,7,1048,2,36000,1.00667938931
253623,253635,254452,12,817,2,36000,1.0146878825
253651,253664,254493,13,829,2,36000,1.01568154403
253666,253672,254420,6,748,2,36000,1.00802139037
253681,253687,254537,6,850,2,36000,1.00705882353
253739,253749,254721,10,972,2,36000,1.01028806584
253757,253768,254678,11,910,2,36000,1.01208791209
253779,253788,254612,9,824,2,36000,1.0109223301
253819,253829,254624,10,795,2,36000,1.01257861635
253834,253840,254613,6,773,2,36000,1.00776196636
253835,253846,254684,11,838,2,36000,1.01312649165
253850,253857,254630,7,773,2,36000,1.00905562743
253866,253872,254726,6,854,2,36000,1.00702576112
253882,253888,254741,6,853,2,36000,1.00703399766
253884,253894,254794,10,900,2,36000,1.01111111111
253899,253905,254713,6,808,2,36000,1.00742574257
253914,253920,254730,6,810,2,36000,1.00740740741
253929,253937,254724,8,787,2,36000,1.01016518424
253931,253942,254758,11,816,2,36000,1.01348039216
253946,253952,254806,6,854,2,36000,1.00702576112
253948,253958,254818,10,860,2,36000,1.01162790698
253949,253963,255493,14,1530,2,36000,1.0091503268
253965,253971,254818,6,847,2,36000,1.00708382527
254071,254078,254909,7,831,2,36000,1.00842358604
254072,254083,254984,11,901,2,36000,1.01220865705
254112,254122,254873,10,751,2,36000,1.01331557923
254163,254175,254973,12,798,2,36000,1.01503759398
254178,254184,255037,6,853,2,36000,1.00703399766
254193,254199,255007,6,808,2,36000,1.00742574257
254208,254214,254966,6,752,2,36000,1.0079787234
254232,254243,255171,11,928,2,36000,1.01185344828
254265,254274,254947,9,673,2,36000,1.01337295691
254296,254305,255030,9,725,2,36000,1.0124137931
254317,254328,255129,11,801,2,36000,1.01373283396
254335,254344,255133,9,789,2,36000,1.01140684411
254350,254358,255158,8,800,2,36000,1.01
254365,254371,255145,6,774,2,36000,1.00775193798
254411,254422,255178,11,756,2,36000,1.01455026455
254426,254432,255191,6,759,2,36000,1.00790513834
254428,254438,255215,10,777,2,36000,1.01287001287
254452,254467,255324,15,857,2,36000,1.01750291715
254479,267050,267191,12571,141,2,18000,90.1560283688
254491,254502,255312,11,810,2,36000,1.01358024691
254506,254512,255468,6,956,2,36000,1.00627615063
254539,254548,255242,9,694,2,36000,1.01296829971
254613,254623,255423,10,800,2,36000,1.0125
254614,254629,255365,15,736,2,36000,1.02038043478
254629,254635,255453,6,818,2,36000,1.00733496333
254631,254641,255450,10,809,2,36000,1.01236093943
254677,254688,255470,11,782,2,36000,1.01406649616
254692,254698,255492,6,794,2,36000,1.00755667506
254694,254704,255584,10,880,2,36000,1.01136363636
254715,254724,255449,9,725,2,36000,1.0124137931
254732,254738,255538,6,800,2,36000,1.0075
254733,254744,255456,11,712,2,36000,1.0154494382
254735,254749,255545,14,796,2,36000,1.0175879397
254736,254754,255507,18,753,2,36000,1.02390438247
254751,254761,255650,10,889,2,36000,1.01124859393
254766,254772,255526,6,754,2,36000,1.00795755968
254793,254805,255548,12,743,2,36000,1.01615074024
254808,254818,255667,10,849,2,36000,1.01177856302
254824,254829,255634,5,805,2,36000,1.00621118012
254825,254835,255796,10,961,2,36000,1.01040582726
254874,254884,255619,10,735,2,36000,1.01360544218
254910,254920,255766,10,846,2,36000,1.01182033097
254950,254958,255824,8,866,2,36000,1.00923787529
254968,254977,255840,9,863,2,36000,1.01042873696
254983,254989,255738,6,749,2,36000,1.00801068091
254984,254995,255777,11,782,2,36000,1.01406649616
255008,255019,256438,11,1419,2,36000,1.00775193798
255030,255041,255823,11,782,2,36000,1.01406649616
255045,255052,255915,7,863,2,36000,1.00811123986
255130,255140,256004,10,864,2,36000,1.01157407407
255145,255151,255937,6,786,2,36000,1.00763358779
255146,255157,256052,11,895,2,36000,1.01229050279
255161,255169,255893,8,724,2,36000,1.01104972376
255176,255182,256042,6,860,2,36000,1.00697674419
255192,255198,255986,6,788,2,36000,1.0076142132
255193,255204,255907,11,703,2,36000,1.01564722617
255217,255226,255947,9,721,2,36000,1.01248266297
255242,255253,256104,11,851,2,36000,1.01292596945
255314,255324,256132,10,808,2,36000,1.01237623762
255329,255335,256662,6,1327,2,36000,1.00452147702
255365,255376,256124,11,748,2,36000,1.01470588235
255426,255434,256297,8,863,2,36000,1.00926998841
255450,255460,256187,10,727,2,36000,1.01375515818
255452,255466,256180,14,714,2,36000,1.01960784314
255468,255474,256268,6,794,2,36000,1.00755667506
255469,255480,256274,11,794,2,36000,1.01385390428
255470,255485,256250,15,765,2,36000,1.01960784314
255486,255492,256316,6,824,2,36000,1.0072815534
255502,255508,256709,6,1201,2,36000,1.0049958368
255503,255514,256390,11,876,2,36000,1.01255707763
255518,255524,256341,6,817,2,36000,1.00734394125
255533,255539,256329,6,790,2,36000,1.00759493671
255548,255554,256399,6,845,2,36000,1.00710059172
255550,255560,256355,10,795,2,36000,1.01257861635
255551,255565,256471,14,906,2,36000,1.01545253863
255585,255595,256348,10,753,2,36000,1.01328021248
255622,255630,256436,8,806,2,36000,1.00992555831
255636,255646,256418,10,772,2,36000,1.01295336788
255652,255661,256576,9,915,2,36000,1.00983606557
255667,255679,256383,12,704,2,36000,1.01704545455
255740,255750,256611,10,861,2,36000,1.01161440186
255767,255777,256547,10,770,2,36000,1.01298701299
255782,255787,256696,5,909,2,36000,1.00550055006
255797,255807,256617,10,810,2,36000,1.01234567901
255825,255834,256704,9,870,2,36000,1.01034482759
255826,255840,256622,14,782,2,36000,1.0179028133
255841,255851,256611,10,760,2,36000,1.01315789474
255892,255904,256753,12,849,2,36000,1.01413427562
255908,255918,256680,10,762,2,36000,1.01312335958
255922,255929,256704,7,775,2,36000,1.00903225806
255938,255948,256688,10,740,2,36000,1.01351351351
255953,255959,256815,6,856,2,36000,1.00700934579
255986,255997,256720,11,723,2,36000,1.01521438451
256004,256015,256947,11,932,2,36000,1.01180257511
256041,256053,256805,12,752,2,36000,1.01595744681
256056,256064,256880,8,816,2,36000,1.00980392157
256104,256116,256819,12,703,2,36000,1.01706970128
256125,256135,256966,10,831,2,36000,1.01203369434
256140,256147,256928,7,781,2,36000,1.00896286812
256183,256191,256995,8,804,2,36000,1.00995024876
256198,256204,257043,6,839,2,36000,1.00715137068
256249,256261,257095,12,834,2,36000,1.01438848921
256270,256280,257031,10,751,2,36000,1.01331557923
256285,256291,257113,6,822,2,36000,1.00729927007
256300,256308,257200,8,892,2,36000,1.00896860987
256316,256328,257023,12,695,2,36000,1.01726618705
256331,256340,257039,9,699,2,36000,1.01287553648
256346,256352,257160,6,808,2,36000,1.00742574257
256362,256368,257192,6,824,2,36000,1.0072815534
256363,256374,257161,11,787,2,36000,1.01397712834
256384,256394,257186,10,792,2,36000,1.01262626263
256399,256405,257298,6,893,2,36000,1.00671892497
256400,256411,257134,11,723,2,36000,1.01521438451
256419,256429,257277,10,848,2,36000,1.01179245283
256437,256448,257227,11,779,2,36000,1.01412066752
256452,256458,257222,6,764,2,36000,1.00785340314
256473,256482,257324,9,842,2,36000,1.0106888361
256549,256558,257360,9,802,2,36000,1.01122194514
256576,256587,257456,11,869,2,36000,1.01265822785
256613,256622,257426,9,804,2,36000,1.01119402985
256614,256627,257430,13,803,2,36000,1.01618929016
256630,256636,257363,6,727,2,36000,1.00825309491
256631,256642,257390,11,748,2,36000,1.01470588235
256661,256673,257608,12,935,2,36000,1.0128342246
256680,256691,257463,11,772,2,36000,1.01424870466
256695,256701,257583,6,882,2,36000,1.00680272109
256710,256716,257500,6,784,2,36000,1.00765306122
256712,256722,258303,10,1581,2,36000,1.00632511069
256713,256727,257520,14,793,2,36000,1.01765447667
256714,256732,257464,18,732,2,36000,1.02459016393
256730,256738,257495,8,757,2,36000,1.0105680317
256754,256764,257514,10,750,2,36000,1.01333333333
256805,256816,257605,11,789,2,36000,1.01394169835
256820,256826,257656,6,830,2,36000,1.00722891566
256822,256832,257655,10,823,2,36000,1.01215066829
256882,256891,257668,9,777,2,36000,1.01158301158
256931,256940,257747,9,807,2,36000,1.01115241636
256949,256958,257794,9,836,2,36000,1.01076555024
256967,256977,257680,10,703,2,36000,1.01422475107
256998,257007,258148,9,1141,2,36000,1.0078878177
257025,257034,257990,9,956,2,36000,1.00941422594
257040,257046,257791,6,745,2,36000,1.00805369128
257041,257052,257840,11,788,2,36000,1.01395939086
257056,257062,257843,6,781,2,36000,1.00768245839
257096,257106,257837,10,731,2,36000,1.01367989056
257114,257124,257913,10,789,2,36000,1.01267427123
257135,257145,258093,10,948,2,36000,1.01054852321
257163,257171,258116,8,945,2,36000,1.00846560847
257164,257177,257904,13,727,2,36000,1.01788170564
257188,257197,258012,9,815,2,36000,1.01104294479
257204,257210,257936,6,726,2,36000,1.00826446281
257205,257216,258045,11,829,2,36000,1.01326899879
257223,257233,258092,10,859,2,36000,1.01164144354
257239,257245,258099,6,854,2,36000,1.00702576112
257278,257288,258110,10,822,2,36000,1.01216545012
257299,257309,258136,10,827,2,36000,1.01209189843
257326,257335,258140,9,805,2,36000,1.01118012422
257360,257371,258133,11,762,2,36000,1.01443569554
257375,257381,258197,6,816,2,36000,1.00735294118
257390,257401,258135,11,734,2,36000,1.01498637602
257427,257437,258183,10,746,2,36000,1.01340482574
257441,257448,258350,7,902,2,36000,1.00776053215
257456,257467,258243,11,776,2,36000,1.01417525773
257473,257479,258194,6,715,2,36000,1.00839160839
257474,257485,258323,11,838,2,36000,1.01312649165
257496,257507,258366,11,859,2,36000,1.01280558789
257511,257517,258187,6,670,2,36000,1.00895522388
257526,257532,258376,6,844,2,36000,1.00710900474
257527,257538,258269,11,731,2,36000,1.01504787962
257585,257594,258500,9,906,2,36000,1.00993377483
257606,257617,258501,11,884,2,36000,1.01244343891
257621,257627,258420,6,793,2,36000,1.00756620429
257657,257666,258352,9,686,2,36000,1.01311953353
257659,257683,258460,24,777,2,36000,1.03088803089
257674,257689,258434,15,745,2,36000,1.02013422819
257689,257695,258464,6,769,2,36000,1.0078023407
257747,257759,258549,12,790,2,36000,1.01518987342
257792,257802,258683,10,881,2,36000,1.0113507378
257807,257813,258599,6,786,2,36000,1.00763358779
257837,257848,258696,11,848,2,36000,1.01297169811
257853,257859,258692,6,833,2,36000,1.00720288115
257854,257865,258684,11,819,2,36000,1.01343101343
257906,257915,258766,9,851,2,36000,1.01057579318
257921,257927,258703,6,776,2,36000,1.00773195876
257939,257948,258707,9,759,2,36000,1.01185770751
257990,258001,258819,11,818,2,36000,1.01344743276
258011,258023,258823,12,800,2,36000,1.015
258045,258056,258904,11,848,2,36000,1.01297169811
258094,258103,258947,9,844,2,36000,1.01066350711
258095,258109,258966,14,857,2,36000,1.01633605601
258110,258117,259059,7,942,2,36000,1.00743099788
258112,258123,258921,11,798,2,36000,1.01378446115
258127,258133,259159,6,1026,2,36000,1.00584795322
258143,258149,258917,6,768,2,36000,1.0078125
258144,258155,258982,11,827,2,36000,1.01330108827
258145,258160,258981,15,821,2,36000,1.01827040195
258147,258165,259016,18,851,2,36000,1.02115158637
258162,258172,258895,10,723,2,36000,1.01383125864
258183,258194,258996,11,802,2,36000,1.01371571072
258199,258204,259013,5,809,2,36000,1.00618046972
258200,258211,258959,11,748,2,36000,1.01470588235
258201,258216,259314,15,1098,2,36000,1.01366120219
258244,258255,259071,11,816,2,36000,1.01348039216
258271,258281,259085,10,804,2,36000,1.01243781095
258304,258314,259167,10,853,2,36000,1.01172332943
258323,258334,259039,11,705,2,36000,1.01560283688
258353,258362,259205,9,843,2,36000,1.01067615658
258355,258368,259259,13,891,2,36000,1.01459034792
258370,258377,259174,7,797,2,36000,1.00878293601
258385,258391,259145,6,754,2,36000,1.00795755968
258421,258431,259290,10,859,2,36000,1.01164144354
258436,258445,259346,9,901,2,36000,1.00998890122
258464,258471,259240,7,769,2,36000,1.00910273082
258465,258477,259321,12,844,2,36000,1.01421800948
258502,258511,259468,9,957,2,36000,1.00940438871
258504,258517,259362,13,845,2,36000,1.01538461538
258549,258560,259387,11,827,2,36000,1.01330108827
258600,258610,259412,10,802,2,36000,1.01246882793
258686,258695,259595,9,900,2,36000,1.01
258687,258700,259606,13,906,2,36000,1.01434878587
258703,258709,259522,6,813,2,36000,1.0073800738
258705,258715,259445,10,730,2,36000,1.01369863014
258706,258720,259490,14,770,2,36000,1.01818181818
258721,258727,259547,6,820,2,36000,1.00731707317
258767,258777,259604,10,827,2,36000,1.01209189843
258822,258830,259788,8,958,2,36000,1.00835073069
258837,258843,259594,6,751,2,36000,1.00798934754
258897,258907,259615,10,708,2,36000,1.01412429379
258913,258919,259685,6,766,2,36000,1.00783289817
258928,258934,259664,6,730,2,36000,1.00821917808
258930,258940,259768,10,828,2,36000,1.01207729469
258948,258959,259767,11,808,2,36000,1.01361386139
258963,258970,259730,7,760,2,36000,1.00921052632
258979,258985,259768,6,783,2,36000,1.00766283525
258994,259000,259822,6,822,2,36000,1.00729927007
258996,259006,259778,10,772,2,36000,1.01295336788
259010,259017,259866,7,849,2,36000,1.00824499411
259026,259032,259772,6,740,2,36000,1.00810810811
259027,259038,259841,11,803,2,36000,1.01369863014
259042,259050,259950,8,900,2,36000,1.00888888889
259061,259071,259939,10,868,2,36000,1.01152073733
259076,259082,259919,6,837,2,36000,1.00716845878
259091,259097,259979,6,882,2,36000,1.00680272109
259145,259156,259973,11,817,2,36000,1.01346389229
259161,259170,259990,9,820,2,36000,1.01097560976
259176,259182,260066,6,884,2,36000,1.00678733032
259178,259188,260053,10,865,2,36000,1.01156069364
259205,259216,259965,11,749,2,36000,1.01468624833
259242,259251,260011,9,760,2,36000,1.01184210526
259260,259271,260075,11,804,2,36000,1.01368159204
259293,259301,260080,8,779,2,36000,1.01026957638
259314,259325,260117,11,792,2,36000,1.01388888889
259329,259335,260118,6,783,2,36000,1.00766283525
259348,259357,260203,9,846,2,36000,1.01063829787
259363,259374,260228,11,854,2,36000,1.01288056206
259390,259398,260135,8,737,2,36000,1.01085481682
259414,259424,260187,10,763,2,36000,1.0131061599
259447,259457,260344,10,887,2,36000,1.01127395716
259469,259479,260224,10,745,2,36000,1.01342281879
259490,259501,260213,11,712,2,36000,1.0154494382
259523,259533,260403,10,870,2,36000,1.01149425287
259547,259558,260310,11,752,2,36000,1.01462765957
259596,259605,260417,9,812,2,36000,1.01108374384
259598,259611,260508,13,897,2,36000,1.01449275362
259613,259619,260437,6,818,2,36000,1.00733496333
259614,259625,260368,11,743,2,36000,1.01480484522
259629,259635,260479,6,844,2,36000,1.00710900474
259666,259676,260563,10,887,2,36000,1.01127395716
259685,259696,260452,11,756,2,36000,1.01455026455
259730,259741,260569,11,828,2,36000,1.01328502415
259767,259778,260768,11,990,2,36000,1.01111111111
259768,259784,260658,16,874,2,36000,1.01830663616
259784,259790,260565,6,775,2,36000,1.00774193548
259786,259796,260549,10,753,2,36000,1.01328021248
259787,259801,260587,14,786,2,36000,1.01781170483
259802,259808,260799,6,991,2,36000,1.00605449041
259823,259833,260603,10,770,2,36000,1.01298701299
259844,259853,260642,9,789,2,36000,1.01140684411
259869,259877,260766,8,889,2,36000,1.00899887514
259920,259930,260713,10,783,2,36000,1.01277139208
259941,259951,260781,10,830,2,36000,1.01204819277
259956,259962,260700,6,738,2,36000,1.0081300813
259971,259977,260904,6,927,2,36000,1.00647249191
259986,259992,260938,6,946,2,36000,1.00634249471
259988,259998,260824,10,826,2,36000,1.01210653753
260003,260009,260743,6,734,2,36000,1.00817438692
260018,260024,261356,6,1332,2,36000,1.0045045045
260051,260064,260930,13,866,2,36000,1.01501154734
260066,260077,260915,11,838,2,36000,1.01312649165
260082,260088,260841,6,753,2,36000,1.00796812749
260083,260094,260855,11,761,2,36000,1.01445466491
260117,260128,260964,11,836,2,36000,1.01315789474
260132,260138,260882,6,744,2,36000,1.00806451613
260147,260153,260934,6,781,2,36000,1.00768245839
260189,260198,261364,9,1166,2,36000,1.0077186964
260204,260215,261013,11,798,2,36000,1.01378446115
260220,260225,261208,5,983,2,36000,1.00508646999
260235,260241,261078,6,837,2,36000,1.00716845878
260236,260247,261127,11,880,2,36000,1.0125
260312,260322,261096,10,774,2,36000,1.01291989664
260345,260355,261261,10,906,2,36000,1.01103752759
260370,260379,261242,9,863,2,36000,1.01042873696
260404,260415,261239,11,824,2,36000,1.01334951456
260419,260428,261266,9,838,2,36000,1.0107398568
260437,260448,261221,11,773,2,36000,1.01423027167
260452,260463,261204,11,741,2,36000,1.01484480432
260479,260490,261349,11,859,2,36000,1.01280558789
260509,260519,261324,10,805,2,36000,1.01242236025
260549,260560,261434,11,874,2,36000,1.01258581236
260565,260574,261416,9,842,2,36000,1.0106888361
260566,260580,261489,14,909,2,36000,1.01540154015
260581,260587,261713,6,1126,2,36000,1.0053285968
260596,260602,261303,6,701,2,36000,1.00855920114
260611,260617,261340,6,723,2,36000,1.00829875519
260642,260653,261523,11,870,2,36000,1.01264367816
260660,260670,261401,10,731,2,36000,1.01367989056
260702,260711,261560,9,849,2,36000,1.01060070671
260717,260724,261467,7,743,2,36000,1.00942126514
260744,260755,261455,11,700,2,36000,1.01571428571
260766,260777,261591,11,814,2,36000,1.01351351351
260781,260787,261628,6,841,2,36000,1.00713436385
260796,260802,262411,6,1609,2,36000,1.00372902424
260811,260817,261602,6,785,2,36000,1.0076433121
260826,260835,261746,9,911,2,36000,1.00987925357
260844,260852,261690,8,838,2,36000,1.00954653938
260859,260866,261688,7,822,2,36000,1.00851581509
260883,260893,261778,10,885,2,36000,1.01129943503
260905,260915,261644,10,729,2,36000,1.01371742112
260920,260926,261675,6,749,2,36000,1.00801068091
260935,260941,261768,6,827,2,36000,1.00725513906
260937,260947,261781,10,834,2,36000,1.01199040767
260952,260958,261758,6,800,2,36000,1.0075
260967,260975,261854,8,879,2,36000,1.00910125142
261015,261024,261845,9,821,2,36000,1.01096224117
261079,261089,261921,10,832,2,36000,1.01201923077
261097,261107,261862,10,755,2,36000,1.01324503311
261128,261139,261974,11,835,2,36000,1.01317365269
261206,261215,262002,9,787,2,36000,1.01143583227
261221,261228,262048,7,820,2,36000,1.00853658537
261223,261234,261995,11,761,2,36000,1.01445466491
261241,261250,262027,9,777,2,36000,1.01158301158
261256,261262,262055,6,793,2,36000,1.00756620429
261272,261278,262101,6,823,2,36000,1.00729040097
261274,261284,262242,10,958,2,36000,1.01043841336
261304,261314,262133,10,819,2,36000,1.01221001221
261327,261340,262129,13,789,2,36000,1.0164765526
261344,261381,262130,37,749,2,36000,1.04939919893
261360,261386,262410,26,1024,2,36000,1.025390625
261362,261391,262203,29,812,2,36000,1.03571428571
261377,261398,262160,21,762,2,36000,1.02755905512
261404,261412,262220,8,808,2,36000,1.0099009901
261422,261428,262189,6,761,2,36000,1.00788436268
261438,261445,262129,7,684,2,36000,1.01023391813
261460,261466,262462,6,996,2,36000,1.00602409639
261475,261482,262411,7,929,2,36000,1.00753498385
261493,261500,262267,7,767,2,36000,1.00912646675
261525,261535,262244,10,709,2,36000,1.01410437236
261564,261571,262411,7,840,2,36000,1.00833333333
261597,261602,262457,5,855,2,36000,1.00584795322
261612,261618,262427,6,809,2,36000,1.00741656366
261630,261639,262413,9,774,2,36000,1.01162790698
261646,261655,262438,9,783,2,36000,1.01149425287
261677,261686,262473,9,787,2,36000,1.01143583227
261692,261699,262478,7,779,2,36000,1.00898587933
261693,261705,262499,12,794,2,36000,1.01511335013
261715,261724,262517,9,793,2,36000,1.01134930643
261745,261757,262520,12,763,2,36000,1.01572739187
261760,261769,262883,9,1114,2,36000,1.00807899461
261775,261781,262639,6,858,2,36000,1.00699300699
261791,261797,262702,6,905,2,36000,1.00662983425
261792,261803,262684,11,881,2,36000,1.01248581158
261847,261856,262541,9,685,2,36000,1.01313868613
261862,261868,262679,6,811,2,36000,1.00739827374
261863,261874,262708,11,834,2,36000,1.01318944844
261921,261932,262633,11,701,2,36000,1.01569186876
261976,261986,262836,10,850,2,36000,1.01176470588
261997,262006,262878,9,872,2,36000,1.01032110092
262012,262018,262742,6,724,2,36000,1.00828729282
262027,262038,262852,11,814,2,36000,1.01351351351
262051,262059,262838,8,779,2,36000,1.01026957638
262066,262073,262914,7,841,2,36000,1.00832342449
262103,262112,263118,9,1006,2,36000,1.00894632207
262132,262140,263379,8,1239,2,36000,1.00645682002
262134,262145,262981,11,836,2,36000,1.01315789474
262135,262151,262967,16,816,2,36000,1.01960784314
262136,262156,262967,20,811,2,36000,1.02466091245
262161,262171,263088,10,917,2,36000,1.01090512541
262192,262200,263072,8,872,2,36000,1.00917431193
262207,262214,262997,7,783,2,36000,1.00893997446
262222,262231,263022,9,791,2,36000,1.01137800253
262244,262254,263177,10,923,2,36000,1.01083423619
262245,262259,263192,14,933,2,36000,1.01500535906
262266,262278,263307,12,1029,2,36000,1.01166180758
262410,262421,263280,11,859,2,36000,1.01280558789
262411,262427,263330,16,903,2,36000,1.01771871539
262427,262433,263171,6,738,2,36000,1.0081300813
262428,262439,263264,11,825,2,36000,1.01333333333
262430,262444,263234,14,790,2,36000,1.01772151899
262431,262449,263248,18,799,2,36000,1.0225281602
262449,262456,263194,7,738,2,36000,1.00948509485
262465,262471,263156,6,685,2,36000,1.00875912409
262466,262477,263242,11,765,2,36000,1.01437908497
262481,262488,263268,7,780,2,36000,1.00897435897
262483,262494,263292,11,798,2,36000,1.01378446115
262501,262510,263421,9,911,2,36000,1.00987925357
262519,262528,263406,9,878,2,36000,1.01025056948
262534,262540,263278,6,738,2,36000,1.0081300813
262549,262555,263391,6,836,2,36000,1.00717703349
262634,262645,263512,11,867,2,36000,1.01268742791
262649,262655,263395,6,740,2,36000,1.00810810811
262680,262690,263494,10,804,2,36000,1.01243781095
262695,262701,263513,6,812,2,36000,1.00738916256
262711,262717,263490,6,773,2,36000,1.00776196636
262712,262723,263434,11,711,2,36000,1.01547116737
262743,262753,263547,10,794,2,36000,1.01259445844
262837,262852,263585,15,733,2,36000,1.0204638472
262853,262858,263620,5,762,2,36000,1.00656167979
262854,262864,263675,10,811,2,36000,1.01233045623
262878,262889,263670,11,781,2,36000,1.01408450704
262893,262899,263871,6,972,2,36000,1.00617283951
262916,262926,263791,10,865,2,36000,1.01156069364
262970,262978,263820,8,842,2,36000,1.00950118765
262972,262983,263724,11,741,2,36000,1.01484480432
262987,262992,263887,5,895,2,36000,1.00558659218
263002,263008,263820,6,812,2,36000,1.00738916256
263023,263034,263877,11,843,2,36000,1.01304863582
263075,263083,263935,8,852,2,36000,1.00938967136
263091,263100,263946,9,846,2,36000,1.01063829787
263119,263130,263917,11,787,2,36000,1.01397712834
263156,263167,264021,11,854,2,36000,1.01288056206
263171,263182,263960,11,778,2,36000,1.01413881748
263186,263192,263963,6,771,2,36000,1.00778210117
263201,263208,263981,7,773,2,36000,1.00905562743
263203,263214,264103,11,889,2,36000,1.01237345332
263237,263245,264064,8,819,2,36000,1.00976800977
263252,263259,264052,7,793,2,36000,1.00882723834
263254,263265,264017,11,752,2,36000,1.01462765957
263269,263275,264197,6,922,2,36000,1.00650759219
263271,263281,264897,10,1616,2,36000,1.00618811881
263286,263292,264152,6,860,2,36000,1.00697674419
263287,263298,264108,11,810,2,36000,1.01358024691
263303,263309,264015,6,706,2,36000,1.00849858357
263318,263324,264101,6,777,2,36000,1.00772200772
263334,263341,264211,7,870,2,36000,1.00804597701
263383,263390,264237,7,847,2,36000,1.00826446281
263399,263405,264235,6,830,2,36000,1.00722891566
263400,263411,264164,11,753,2,36000,1.01460823373
263416,263422,264232,6,810,2,36000,1.00740740741
263431,263437,264120,6,683,2,36000,1.00878477306
263446,263452,264312,6,860,2,36000,1.00697674419
263493,263501,264380,8,879,2,36000,1.00910125142
263508,263515,264318,7,803,2,36000,1.00871731009
263528,263534,264263,6,729,2,36000,1.00823045267
263529,263540,264259,11,719,2,36000,1.01529902643
263551,263559,264311,8,752,2,36000,1.01063829787
263584,263596,264376,12,780,2,36000,1.01538461538
263621,263631,264428,10,797,2,36000,1.01254705144
263672,263682,264519,10,837,2,36000,1.0119474313
263687,263694,264493,7,799,2,36000,1.00876095119
263724,263735,264561,11,826,2,36000,1.01331719128
263791,263802,264565,11,763,2,36000,1.01441677588
263822,263831,264622,9,791,2,36000,1.01137800253
263824,263836,264722,12,886,2,36000,1.01354401806
263874,263882,264662,8,780,2,36000,1.01025641026
263889,263895,264623,6,728,2,36000,1.00824175824
263891,263901,264675,10,774,2,36000,1.01291989664
263918,263929,264676,11,747,2,36000,1.01472556894
263936,263946,264809,10,863,2,36000,1.01158748552
263951,263957,264725,6,768,2,36000,1.0078125
263967,263973,264750,6,777,2,36000,1.00772200772
263968,263979,264830,11,851,2,36000,1.01292596945
263983,263992,264777,9,785,2,36000,1.01146496815
264014,264026,264872,12,846,2,36000,1.01418439716
264016,264032,264937,16,905,2,36000,1.01767955801
264031,264038,264800,7,762,2,36000,1.00918635171
264049,264063,264839,14,776,2,36000,1.01804123711
264064,264075,264928,11,853,2,36000,1.01289566237
264101,264112,265114,11,1002,2,36000,1.01097804391
264117,264123,264988,6,865,2,36000,1.00693641618
264119,264129,264951,10,822,2,36000,1.01216545012
264136,264142,264955,6,813,2,36000,1.0073800738
264152,264163,264977,11,814,2,36000,1.01351351351
264167,264175,264942,8,767,2,36000,1.01043024772
264197,264208,264963,11,755,2,36000,1.01456953642
264212,264222,265072,10,850,2,36000,1.01176470588
264235,264243,265518,8,1275,2,36000,1.0062745098
264237,264249,265082,12,833,2,36000,1.0144057623
264238,264254,265097,16,843,2,36000,1.01897983393
264260,264270,265043,10,773,2,36000,1.01293661061
264276,264282,265122,6,840,2,36000,1.00714285714
264310,264322,265200,12,878,2,36000,1.01366742597
264325,264331,265128,6,797,2,36000,1.00752823087
264326,264337,265042,11,705,2,36000,1.01560283688
264379,264386,265251,7,865,2,36000,1.00809248555
264380,264392,265127,12,735,2,36000,1.01632653061
264429,264439,265189,10,750,2,36000,1.01333333333
264493,264504,265275,11,771,2,36000,1.01426718547
264520,264531,265446,11,915,2,36000,1.01202185792
264567,264573,265453,6,880,2,36000,1.00681818182
264568,264579,265338,11,759,2,36000,1.01449275362
264626,264633,265387,7,754,2,36000,1.00928381963
264627,264639,265383,12,744,2,36000,1.01612903226
264664,264673,265447,9,774,2,36000,1.01162790698
264681,264687,265476,6,789,2,36000,1.00760456274
264683,264693,265509,10,816,2,36000,1.01225490196
264724,264733,265495,9,762,2,36000,1.01181102362
264739,264745,265558,6,813,2,36000,1.0073800738
264756,264762,265543,6,781,2,36000,1.00768245839
264784,264790,265588,6,798,2,36000,1.00751879699
264817,264824,265628,7,804,2,36000,1.00870646766
264819,264830,265687,11,857,2,36000,1.01283547258
264834,264841,265666,7,825,2,36000,1.00848484848
264850,264856,265649,6,793,2,36000,1.00756620429
264871,264883,265592,12,709,2,36000,1.01692524683
264899,264908,265681,9,773,2,36000,1.01164294955
264929,264939,265781,10,842,2,36000,1.01187648456
264944,264950,265751,6,801,2,36000,1.0074906367
264945,264956,265727,11,771,2,36000,1.01426718547
264960,264966,265748,6,782,2,36000,1.00767263427
264962,264972,265764,10,792,2,36000,1.01262626263
264977,264984,265877,7,893,2,36000,1.0078387458
264979,264990,265751,11,761,2,36000,1.01445466491
264994,265000,265750,6,750,2,36000,1.008
265043,265053,265793,10,740,2,36000,1.01351351351
265044,265059,265817,15,758,2,36000,1.01978891821
265072,265083,266142,11,1059,2,36000,1.0103871577
265087,265093,265916,6,823,2,36000,1.00729040097
265102,265108,265974,6,866,2,36000,1.00692840647
265117,265125,265872,8,747,2,36000,1.01070950469
265133,265139,266012,6,873,2,36000,1.00687285223
265135,265145,265991,10,846,2,36000,1.01182033097
265136,265150,265986,14,836,2,36000,1.01674641148
265191,265200,265995,9,795,2,36000,1.01132075472
265206,265212,266290,6,1078,2,36000,1.00556586271
265252,265262,266063,10,801,2,36000,1.01248439451
265276,265286,266080,10,794,2,36000,1.01259445844
265340,265350,266239,10,889,2,36000,1.01124859393
265390,265397,266164,7,767,2,36000,1.00912646675
265392,265403,266260,11,857,2,36000,1.01283547258
265448,265457,266222,9,765,2,36000,1.01176470588
265449,265463,266356,14,893,2,36000,1.0156774916
265450,265469,266456,19,987,2,36000,1.01925025329
265479,265488,266281,9,793,2,36000,1.01134930643
265501,265507,266390,6,883,2,36000,1.00679501699
265518,265524,266498,6,974,2,36000,1.00616016427
265519,265530,266309,11,779,2,36000,1.01412066752
265545,265554,266506,9,952,2,36000,1.00945378151
265560,265569,266381,9,812,2,36000,1.01108374384
265591,265600,266350,9,750,2,36000,1.012
265606,265612,266363,6,751,2,36000,1.00798934754
265630,265639,266683,9,1044,2,36000,1.00862068966
265651,265661,266373,10,712,2,36000,1.01404494382
265667,265677,266455,10,778,2,36000,1.01285347044
265682,265692,266575,10,883,2,36000,1.01132502831
265697,265703,266516,6,813,2,36000,1.0073800738
265730,265738,266584,8,846,2,36000,1.00945626478
265752,265761,266455,9,694,2,36000,1.01296829971
265753,265766,266481,13,715,2,36000,1.01818181818
265754,265772,266615,18,843,2,36000,1.02135231317
265756,265777,266583,21,806,2,36000,1.02605459057
265771,265783,266569,12,786,2,36000,1.01526717557
265786,265792,266916,6,1124,2,36000,1.00533807829
265801,265807,266647,6,840,2,36000,1.00714285714
265819,265828,266635,9,807,2,36000,1.01115241636
265873,265883,266718,10,835,2,36000,1.0119760479
265889,265895,266773,6,878,2,36000,1.00683371298
265916,265928,266694,12,766,2,36000,1.01566579634
265975,265985,266840,10,855,2,36000,1.01169590643
265992,265998,266797,6,799,2,36000,1.00750938673
265993,266004,266798,11,794,2,36000,1.01385390428
266010,266016,266767,6,751,2,36000,1.00798934754
266027,266033,266825,6,792,2,36000,1.00757575758
266065,266100,266871,35,771,2,36000,1.04539559014
266080,266122,267034,42,912,2,36000,1.04605263158
266144,266150,266986,6,836,2,36000,1.00717703349
266165,266172,267086,7,914,2,36000,1.00765864333
266224,266230,267150,6,920,2,36000,1.00652173913
266242,266248,267056,6,808,2,36000,1.00742574257
266260,266266,267067,6,801,2,36000,1.0074906367
266281,266288,267106,7,818,2,36000,1.00855745721
266297,266303,267122,6,819,2,36000,1.00732600733
266312,266318,267090,6,772,2,36000,1.00777202073
266349,266355,267111,6,756,2,36000,1.00793650794
266365,266371,267169,6,798,2,36000,1.00751879699
266366,266377,267747,11,1370,2,36000,1.00802919708
266382,266388,267174,6,786,2,36000,1.00763358779
266383,266394,267202,11,808,2,36000,1.01361386139
266399,266405,267214,6,809,2,36000,1.00741656366
266455,266461,267356,6,895,2,36000,1.00670391061
266456,266467,267195,11,728,2,36000,1.01510989011
266472,266478,267588,6,1110,2,36000,1.00540540541
266491,266497,267223,6,726,2,36000,1.00826446281
266507,266514,267171,7,657,2,36000,1.01065449011
266508,266520,267397,12,877,2,36000,1.01368301026
266523,266530,267398,7,868,2,36000,1.00806451613
266569,266576,267404,7,828,2,36000,1.00845410628
266585,266591,267282,6,691,2,36000,1.00868306802
266586,266597,267400,11,803,2,36000,1.01369863014
266588,266602,267361,14,759,2,36000,1.01844532279
266616,266622,267442,6,820,2,36000,1.00731707317
266637,266643,267488,6,845,2,36000,1.00710059172
266653,266659,267507,6,848,2,36000,1.0070754717
266684,266690,267495,6,805,2,36000,1.00745341615
266702,266708,267565,6,857,2,36000,1.00700116686
266721,266727,267527,6,800,2,36000,1.0075
266769,266775,267601,6,826,2,36000,1.00726392252
266770,266781,267614,11,833,2,36000,1.01320528211
266800,266806,267626,6,820,2,36000,1.00731707317
266801,266812,267656,11,844,2,36000,1.01303317536
266825,266832,267618,7,786,2,36000,1.00890585242
266841,266847,267708,6,861,2,36000,1.00696864111
266874,266880,267675,6,795,2,36000,1.00754716981
266917,266923,267750,6,827,2,36000,1.00725513906
266997,267003,267755,6,752,2,36000,1.0079787234
267037,267044,267768,7,724,2,36000,1.00966850829
267056,267062,267884,6,822,2,36000,1.00729927007
267071,267077,267812,6,735,2,36000,1.00816326531
267087,267093,267896,6,803,2,36000,1.00747198007
267102,267109,267880,7,771,2,36000,1.00907911803
267119,267125,267996,6,871,2,36000,1.00688863375
267120,267131,267985,11,854,2,36000,1.01288056206
267136,267142,267974,6,832,2,36000,1.00721153846
267153,267159,267960,6,801,2,36000,1.0074906367
267172,267178,267965,6,787,2,36000,1.00762388818
267174,267184,268037,10,853,2,36000,1.01172332943
267193,267199,268101,6,902,2,36000,1.0066518847
267212,267218,268029,6,811,2,36000,1.00739827374
267213,267224,268621,11,1397,2,36000,1.00787401575
267229,267235,268037,6,802,2,36000,1.00748129676
267231,267241,268004,10,763,2,36000,1.0131061599
267284,267290,268116,6,826,2,36000,1.00726392252
267359,267365,268163,6,798,2,36000,1.00751879699
267374,267380,268201,6,821,2,36000,1.00730816078
267400,267406,268275,6,869,2,36000,1.00690448792
267401,267412,268359,11,947,2,36000,1.0116156283
267402,267417,268190,15,773,2,36000,1.01940491591
267418,267424,268184,6,760,2,36000,1.00789473684
267447,267453,268363,6,910,2,36000,1.00659340659
267492,267498,268233,6,735,2,36000,1.00816326531
267524,267530,268348,6,818,2,36000,1.00733496333
267525,267536,268314,11,778,2,36000,1.01413881748
267541,267548,268401,7,853,2,36000,1.0082063306
267568,267574,268347,6,773,2,36000,1.00776196636
267591,267597,268378,6,781,2,36000,1.00768245839
267606,267612,268442,6,830,2,36000,1.00722891566
267624,267629,268458,5,829,2,36000,1.00603136309
267625,267635,268470,10,835,2,36000,1.0119760479
267641,267647,268464,6,817,2,36000,1.00734394125
267659,267665,268516,6,851,2,36000,1.00705052879
267675,267681,268587,6,906,2,36000,1.00662251656
267711,267717,268448,6,731,2,36000,1.00820793434
267762,267768,268577,6,809,2,36000,1.00741656366
267763,267774,268626,11,852,2,36000,1.01291079812
267764,267779,268548,15,769,2,36000,1.01950585176
267790,267796,268679,6,883,2,36000,1.00679501699
267813,267837,268683,24,846,2,36000,1.02836879433
267821,267844,267846,23,2,2,3540,2.5
267882,267888,268926,6,1038,2,36000,1.00578034682
267901,267907,268768,6,861,2,36000,1.00696864111
267903,267913,268703,10,790,2,36000,1.01265822785
267921,267936,267956,15,20,1,900,1.75
267940,267967,268156,27,189,14,7980,1.14285714286
267963,267973,268764,10,791,2,36000,1.01264222503
267984,267990,268838,6,848,2,36000,1.0070754717
267985,267996,268881,11,885,2,36000,1.01242937853
268001,268007,268796,6,789,2,36000,1.00760456274
268002,268013,268843,11,830,2,36000,1.01325301205
268025,268031,268856,6,825,2,36000,1.00727272727
268053,268059,268776,6,717,2,36000,1.00836820084
268054,268065,268849,11,784,2,36000,1.01403061224
268056,268070,268860,14,790,2,36000,1.01772151899
268107,268113,268927,6,814,2,36000,1.00737100737
268126,268132,268911,6,779,2,36000,1.00770218228
268152,268168,268183,16,15,1,900,2.06666666667
268167,268198,268386,31,188,14,7980,1.16489361702
268168,268174,268951,6,777,2,36000,1.00772200772
268186,268192,269074,6,882,2,36000,1.00680272109
268202,268208,268952,6,744,2,36000,1.00806451613
268203,268214,269076,11,862,2,36000,1.01276102088
268238,268244,269072,6,828,2,36000,1.00724637681
268277,268283,269088,6,805,2,36000,1.00745341615
268344,268350,269121,6,771,2,36000,1.00778210117
268361,268367,269230,6,863,2,36000,1.00695249131
268362,268373,269223,11,850,2,36000,1.01294117647
268364,268378,269236,14,858,2,36000,1.01631701632
268380,268386,269227,6,841,2,36000,1.00713436385
268381,268398,268412,17,14,1,900,2.21428571429
268381,268392,269224,11,832,2,36000,1.01322115385
268398,268423,268645,25,222,14,7980,1.11261261261
268405,268411,269276,6,865,2,36000,1.00693641618
268450,268456,269334,6,878,2,36000,1.00683371298
268451,268462,269273,11,811,2,36000,1.01356350185
268468,268474,269286,6,812,2,36000,1.00738916256
268469,268480,269312,11,832,2,36000,1.01322115385
268485,268491,269269,6,778,2,36000,1.00771208226
268517,268523,269542,6,1019,2,36000,1.00588812561
268558,268565,269426,7,861,2,36000,1.0081300813
268589,268595,269355,6,760,2,36000,1.00789473684
268590,268601,269311,11,710,2,36000,1.01549295775
268632,268638,269420,6,782,2,36000,1.00767263427
268634,268644,269394,10,750,2,36000,1.01333333333
268643,268657,268667,14,10,1,900,2.4
268645,268662,268855,17,193,1,3600,1.08808290155
268652,268698,268878,46,180,14,7980,1.25555555556
268686,268692,269708,6,1016,2,36000,1.00590551181
268687,268703,269511,16,808,2,36000,1.0198019802
268710,268716,269558,6,842,2,36000,1.00712589074
268763,268769,269610,6,841,2,36000,1.00713436385
268779,268785,269639,6,854,2,36000,1.00702576112
268780,268791,269600,11,809,2,36000,1.01359703337
268798,268804,269569,6,765,2,36000,1.00784313725
268842,268849,269704,7,855,2,36000,1.0081871345
268870,268876,269695,6,819,2,36000,1.00732600733
268871,268882,269697,11,815,2,36000,1.01349693252
268872,268887,269679,15,792,2,36000,1.01893939394
268874,268892,269675,18,783,2,36000,1.02298850575
268876,268938,268973,62,35,1,900,2.77142857143
268887,268898,269049,11,151,14,7980,1.07284768212
268891,268903,269744,12,841,2,36000,1.01426872771
268912,268919,269785,7,866,2,36000,1.00808314088
268948,268954,269795,6,841,2,36000,1.00713436385
268949,268960,269921,11,961,2,36000,1.01144640999
268969,268975,269920,6,945,2,36000,1.00634920635
268970,268981,269883,11,902,2,36000,1.01219512195
269047,269053,269060,6,7,1,900,1.3
269054,269061,269254,7,193,14,7980,1.03626943005
269064,269072,269479,8,407,1,3600,1.01965601966
269074,269081,269927,7,846,2,36000,1.00827423168
269076,269087,269963,11,876,2,36000,1.01255707763
269077,269092,269986,15,894,2,36000,1.01677852349
269112,269118,269926,6,808,2,36000,1.00742574257
269242,269247,270059,5,812,2,36000,1.00615763547
269243,269253,270158,10,905,2,36000,1.01104972376
269244,269258,270038,14,780,2,36000,1.01794871795
269246,269263,270123,17,860,2,36000,1.01976744186
269247,269268,270023,21,755,2,36000,1.02781456954
269248,269280,270112,32,832,2,36000,1.03846153846
269249,269368,269406,119,38,1,900,4.13157894737
269260,269275,269432,15,157,14,7980,1.09554140127
269275,269286,270195,11,909,2,36000,1.01210121012
269276,269291,270077,15,786,2,36000,1.01908396947
269277,269296,270035,19,739,2,36000,1.02571041949
269300,269306,270153,6,847,2,36000,1.00708382527
269315,269321,270078,6,757,2,36000,1.00792602378
269317,269327,270134,10,807,2,36000,1.01239157373
269337,269344,270240,7,896,2,36000,1.0078125
269356,269362,270314,6,952,2,36000,1.00630252101
269415,269421,270142,6,721,2,36000,1.00832177531
269430,269443,269452,13,9,1,900,2.2
269431,269437,270213,6,776,2,36000,1.00773195876
269432,269448,270281,16,833,2,36000,1.01920768307
269438,269526,269686,88,160,14,7980,1.55
269514,269520,270313,6,793,2,36000,1.00756620429
269542,269548,270483,6,935,2,36000,1.0064171123
269564,269570,270355,6,785,2,36000,1.0076433121
269579,269586,270352,7,766,2,36000,1.0091383812
269601,269607,270381,6,774,2,36000,1.00775193798
269631,269637,270502,6,865,2,36000,1.00693641618
269653,269660,270399,7,739,2,36000,1.00947225981
269676,269682,270515,6,833,2,36000,1.00720288115
269684,269697,269705,13,8,1,900,2.1
269691,269702,270588,11,886,2,36000,1.01241534989
269695,269809,269987,114,178,14,7980,1.6404494382
269708,269714,270537,6,823,2,36000,1.00729040097
269709,269720,270522,11,802,2,36000,1.01371571072
269710,269725,270567,15,842,2,36000,1.01781472684
269712,269731,270533,19,802,2,36000,1.02369077307
269747,269754,270573,7,819,2,36000,1.00854700855
269782,269788,270562,6,774,2,36000,1.00775193798
269797,269803,270497,6,694,2,36000,1.00864553314
269856,270110,270939,254,829,1,3600,1.30639324487
269919,269926,270708,7,782,2,36000,1.00895140665
269921,269932,270685,11,753,2,36000,1.01460823373
269922,269937,270742,15,805,2,36000,1.01863354037
269944,269951,270806,7,855,2,36000,1.0081871345
269946,269957,270662,11,705,2,36000,1.01560283688
269965,269971,270831,6,860,2,36000,1.00697674419
269980,270070,270094,90,24,1,900,4.75
269989,269996,270808,7,812,2,36000,1.00862068966
269990,270002,270204,12,202,14,7980,1.05940594059
270034,270040,270827,6,787,2,36000,1.00762388818
270035,270046,270877,11,831,2,36000,1.01323706378
270055,270061,270953,6,892,2,36000,1.0067264574
270075,270081,270902,6,821,2,36000,1.00730816078
270092,270098,270959,6,861,2,36000,1.00696864111
270093,270104,270867,11,763,2,36000,1.01441677588
270113,270119,271020,6,901,2,36000,1.00665926748
270131,270138,271003,7,865,2,36000,1.00809248555
270152,270158,271043,6,885,2,36000,1.00677966102
270153,270164,270956,11,792,2,36000,1.01388888889
270179,270185,271091,6,906,2,36000,1.00662251656
270181,270191,271009,10,818,2,36000,1.01222493888
270188,270295,270304,107,9,1,900,11.6
270200,270217,270490,17,273,14,7980,1.06227106227
270205,270211,271050,6,839,2,36000,1.00715137068
270221,270227,271020,6,793,2,36000,1.00756620429
270242,270249,271095,7,846,2,36000,1.00827423168
270283,270289,271061,6,772,2,36000,1.00777202073
270312,270318,271070,6,752,2,36000,1.0079787234
270327,270333,271140,6,807,2,36000,1.00743494424
270353,270359,271207,6,848,2,36000,1.0070754717
270368,270375,271148,7,773,2,36000,1.00905562743
270384,270390,271175,6,785,2,36000,1.0076433121
270401,270407,271213,6,806,2,36000,1.00744416873
270484,270490,271279,6,789,2,36000,1.00760456274
270485,270501,270513,16,12,1,900,2.33333333333
270498,270514,270759,16,245,14,7980,1.06530612245
270502,270507,271325,5,818,2,36000,1.00611246944
270518,270524,271306,6,782,2,36000,1.00767263427
270519,270530,271275,11,745,2,36000,1.01476510067
270535,270541,271694,6,1153,2,36000,1.00520381613
270536,270547,271751,11,1204,2,36000,1.00913621262
270552,270558,271366,6,808,2,36000,1.00742574257
270571,270577,271387,6,810,2,36000,1.00740740741
270573,270583,271456,10,873,2,36000,1.01145475372
270589,270595,271388,6,793,2,36000,1.00756620429
270590,270601,271376,11,775,2,36000,1.01419354839
270663,270669,271578,6,909,2,36000,1.00660066007
270701,270707,271471,6,764,2,36000,1.00785340314
270725,270732,271597,7,865,2,36000,1.00809248555
270741,270747,271620,6,873,2,36000,1.00687285223
270757,270949,270982,192,33,1,900,6.81818181818
270764,270770,271011,6,241,14,7980,1.02489626556
270806,270813,271644,7,831,2,36000,1.00842358604
270824,270830,272066,6,1236,2,36000,1.00485436893
270840,270846,271686,6,840,2,36000,1.00714285714
270841,270852,271628,11,776,2,36000,1.01417525773
270870,270876,271595,6,719,2,36000,1.0083449235
270885,270892,271692,7,800,2,36000,1.00875
270906,270912,271698,6,786,2,36000,1.00763358779
270968,270974,271864,6,890,2,36000,1.00674157303
270969,270980,271887,11,907,2,36000,1.01212789416
270970,270985,271707,15,722,2,36000,1.02077562327
271009,271015,271025,6,10,1,900,1.6
271010,271020,271854,10,834,2,36000,1.01199040767
271011,271026,271935,15,909,2,36000,1.01650165017
271028,271034,271958,6,924,2,36000,1.00649350649
271029,271040,271913,11,873,2,36000,1.0126002291
271031,271923,272184,892,261,14,7980,4.41762452107
271046,271052,272094,6,1042,2,36000,1.00575815739
271067,271073,271841,6,768,2,36000,1.0078125
271068,271079,271903,11,824,2,36000,1.01334951456
271085,271091,271832,6,741,2,36000,1.00809716599
271105,271111,271907,6,796,2,36000,1.00753768844
271107,271117,271918,10,801,2,36000,1.01248439451
271145,271151,271935,6,784,2,36000,1.00765306122
271161,271167,271938,6,771,2,36000,1.00778210117
271176,271182,271991,6,809,2,36000,1.00741656366
271257,271263,272031,6,768,2,36000,1.0078125
271258,271269,272055,11,786,2,36000,1.01399491094
271284,271290,272198,6,908,2,36000,1.00660792952
271285,271296,272329,11,1033,2,36000,1.01064859632
271311,271317,272248,6,931,2,36000,1.00644468314
271330,271336,272325,6,989,2,36000,1.00606673407
271368,271374,272192,6,818,2,36000,1.00733496333
271385,271391,272250,6,859,2,36000,1.00698486612
271400,271406,272194,6,788,2,36000,1.0076142132
271402,271412,272263,10,851,2,36000,1.01175088132
271458,271465,272369,7,904,2,36000,1.00774336283
271491,271498,272287,7,789,2,36000,1.00887198986
271579,271585,272477,6,892,2,36000,1.0067264574
271598,271604,272382,6,778,2,36000,1.00771208226
271599,271610,272359,11,749,2,36000,1.01468624833
271614,271620,272506,6,886,2,36000,1.00677200903
271629,271636,272459,7,823,2,36000,1.0085054678
271646,271652,272425,6,773,2,36000,1.00776196636
271686,271692,272456,6,764,2,36000,1.00785340314
271702,271708,272565,6,857,2,36000,1.00700116686
271704,271714,272480,10,766,2,36000,1.01305483029
271705,271719,272559,14,840,2,36000,1.01666666667
271720,271726,272653,6,927,2,36000,1.00647249191
271778,271784,272701,6,917,2,36000,1.00654307525
271837,271843,272715,6,872,2,36000,1.00688073394
271855,271861,272665,6,804,2,36000,1.00746268657
271856,271867,272652,11,785,2,36000,1.01401273885
271878,271885,272745,7,860,2,36000,1.00813953488
271898,271904,272606,6,702,2,36000,1.00854700855
271920,271929,272778,9,849,2,36000,1.01060070671
271922,271934,272688,12,754,2,36000,1.01591511936
271923,271939,272769,16,830,2,36000,1.01927710843
271924,271946,272827,22,881,2,36000,1.02497162316
271942,271952,272764,10,812,2,36000,1.01231527094
271944,271957,272752,13,795,2,36000,1.01635220126
271945,271962,272794,17,832,2,36000,1.02043269231
271961,271968,272751,7,783,2,36000,1.00893997446
272009,272015,272865,6,850,2,36000,1.00705882353
272042,272048,272806,6,758,2,36000,1.00791556728
272058,272064,272895,6,831,2,36000,1.00722021661
272073,272079,272941,6,862,2,36000,1.00696055684
272095,272101,272893,6,792,2,36000,1.00757575758
272182,272195,272217,13,22,1,900,1.59090909091
272199,272205,273021,6,816,2,36000,1.00735294118
272201,272211,273069,10,858,2,36000,1.01165501166
272202,272216,273000,14,784,2,36000,1.01785714286
272211,272798,273053,587,255,14,7980,3.30196078431
272230,272237,272433,7,196,1,3600,1.03571428571
272267,272273,273063,6,790,2,36000,1.00759493671
272268,272279,273113,11,834,2,36000,1.01318944844
272270,272284,273111,14,827,2,36000,1.0169286578
272298,272304,273200,6,896,2,36000,1.00669642857
272329,272335,273072,6,737,2,36000,1.00814111262
272330,272341,273092,11,751,2,36000,1.01464713715
272379,272385,273190,6,805,2,36000,1.00745341615
272381,272391,273231,10,840,2,36000,1.0119047619
272396,272403,273275,7,872,2,36000,1.00802752294
272397,272408,272544,11,136,1,3600,1.08088235294
272428,272434,273242,6,808,2,36000,1.00742574257
272460,272466,273272,6,806,2,36000,1.00744416873
272461,272472,273306,11,834,2,36000,1.01318944844
272477,272483,273327,6,844,2,36000,1.00710900474
272492,272498,273411,6,913,2,36000,1.00657174151
272519,272525,273461,6,936,2,36000,1.00641025641
272563,272569,273392,6,823,2,36000,1.00729040097
272580,272587,273330,7,743,2,36000,1.00942126514
272610,272616,273601,6,985,2,36000,1.00609137056
272642,272648,273014,6,366,1,3600,1.01639344262
272651,272658,273420,7,762,2,36000,1.00918635171
272653,272663,273501,10,838,2,36000,1.01193317422
272669,272675,273496,6,821,2,36000,1.00730816078
272689,272695,273691,6,996,2,36000,1.00602409639
272704,272711,273602,7,891,2,36000,1.00785634119
272726,272732,273509,6,777,2,36000,1.00772200772
272747,272753,273114,6,361,1,3600,1.01662049861
272748,272759,273603,11,844,2,36000,1.01303317536
272769,272775,273568,6,793,2,36000,1.00756620429
272770,272781,273598,11,817,2,36000,1.01346389229
272772,272786,273642,14,856,2,36000,1.01635514019
272773,272791,273507,18,716,2,36000,1.0251396648
272798,272804,273617,6,813,2,36000,1.0073800738
272799,272810,273713,11,903,2,36000,1.01218161683
272822,272829,273686,7,857,2,36000,1.008168028
272839,272846,273682,7,836,2,36000,1.00837320574
272869,272875,273702,6,827,2,36000,1.00725513906
272894,272900,273746,6,846,2,36000,1.00709219858
272909,272916,273739,7,823,2,36000,1.0085054678
272944,272951,273709,7,758,2,36000,1.0092348285
272998,273004,273812,6,808,2,36000,1.00742574257
273020,273026,273825,6,799,2,36000,1.00750938673
273052,273058,273104,6,46,1,900,1.13043478261
273079,273085,273914,6,829,2,36000,1.00723763571
273080,273091,273905,11,814,2,36000,1.01351351351
273081,273096,273958,15,862,2,36000,1.01740139211
273090,273115,273364,25,249,14,7980,1.10040160643
273098,273104,273910,6,806,2,36000,1.00744416873
273118,273124,273979,6,855,2,36000,1.00701754386
273119,273130,274012,11,882,2,36000,1.01247165533
273192,273198,273993,6,795,2,36000,1.00754716981
273207,273213,273873,6,660,2,36000,1.00909090909
273236,273242,274096,6,854,2,36000,1.00702576112
273252,273258,274084,6,826,2,36000,1.00726392252
273275,273281,274151,6,870,2,36000,1.00689655172
273291,273297,274072,6,775,2,36000,1.00774193548
273321,273327,274156,6,829,2,36000,1.00723763571
273344,273350,274130,6,780,2,36000,1.00769230769
273345,273356,274103,11,747,2,36000,1.01472556894
273362,273376,273384,14,8,1,900,2.2
273374,273395,273637,21,242,14,7980,1.0867768595
273393,273401,274218,8,817,2,36000,1.00979192166
273408,273637,274541,229,904,1,3600,1.25331858407
273412,273418,274282,6,864,2,36000,1.00694444444
273428,273434,274170,6,736,2,36000,1.00815217391
273459,273466,274252,7,786,2,36000,1.00890585242
273497,273503,274332,6,829,2,36000,1.00723763571
273513,273519,274380,6,861,2,36000,1.00696864111
273515,273525,274316,10,791,2,36000,1.01264222503
273516,273530,274327,14,797,2,36000,1.01756587202
273576,273582,274562,6,980,2,36000,1.00612244898
273609,273615,274407,6,792,2,36000,1.00757575758
273610,273621,274348,11,727,2,36000,1.015130674
273612,273626,274464,14,838,2,36000,1.01670644391
273613,273631,274460,18,829,2,36000,1.02171290712
273623,273836,274520,213,684,1,3600,1.31140350877
273633,273702,273725,69,23,1,900,4.0
273635,273643,274453,8,810,2,36000,1.00987654321
273643,273649,273890,6,241,14,7980,1.02489626556
273654,273660,274466,6,806,2,36000,1.00744416873
273685,273691,274437,6,746,2,36000,1.00804289544
273707,273713,274503,6,790,2,36000,1.00759493671
273708,273719,274465,11,746,2,36000,1.01474530831
273710,273724,274562,14,838,2,36000,1.01670644391
273730,273736,274566,6,830,2,36000,1.00722891566
273731,273742,274483,11,741,2,36000,1.01484480432
273754,273760,274568,6,808,2,36000,1.00742574257
273755,273766,274638,11,872,2,36000,1.0126146789
273815,273822,274610,7,788,2,36000,1.00888324873
273839,273845,274869,6,1024,2,36000,1.005859375
273878,273884,274726,6,842,2,36000,1.00712589074
273887,273901,273911,14,10,1,900,2.4
273896,273919,274205,23,286,14,7980,1.08041958042
273907,273913,274643,6,730,2,36000,1.00821917808
273925,273931,274704,6,773,2,36000,1.00776196636
273927,273937,274790,10,853,2,36000,1.01172332943
273958,273965,274749,7,784,2,36000,1.00892857143
273977,273983,274802,6,819,2,36000,1.00732600733
273993,273999,274699,6,700,2,36000,1.00857142857
274014,274020,274846,6,826,2,36000,1.00726392252
274074,274080,274954,6,874,2,36000,1.00686498856
274100,274106,274979,6,873,2,36000,1.00687285223
274101,274112,274961,11,849,2,36000,1.01295641932
274122,274128,274843,6,715,2,36000,1.00839160839
274138,274144,274880,6,736,2,36000,1.00815217391
274155,274162,274942,7,780,2,36000,1.00897435897
274157,274168,274978,11,810,2,36000,1.01358024691
274173,274179,275043,6,864,2,36000,1.00694444444
274203,274531,274590,328,59,1,900,6.5593220339
274210,274216,274492,6,276,14,7980,1.02173913043
274223,274229,275045,6,816,2,36000,1.00735294118
274256,274262,275166,6,904,2,36000,1.00663716814
274285,274291,275077,6,786,2,36000,1.00763358779
274319,274325,275171,6,846,2,36000,1.00709219858
274334,274340,275185,6,845,2,36000,1.00710059172
274336,274346,275188,10,842,2,36000,1.01187648456
274363,274369,275124,6,755,2,36000,1.00794701987
274405,274411,275266,6,855,2,36000,1.00701754386
274422,274428,275257,6,829,2,36000,1.00723763571
274438,274445,275235,7,790,2,36000,1.00886075949
274457,274463,275196,6,733,2,36000,1.00818553888
274479,274485,275311,6,826,2,36000,1.00726392252
274480,274491,275394,11,903,2,36000,1.01218161683
274482,274496,275403,14,907,2,36000,1.01543550165
274483,274501,275294,18,793,2,36000,1.02269861286
274487,274551,274596,64,45,1,900,2.42222222222
274500,274507,274768,7,261,14,7980,1.02681992337
274501,274512,275328,11,816,2,36000,1.01348039216
274519,274525,275374,6,849,2,36000,1.00706713781
274571,274577,275318,6,741,2,36000,1.00809716599
274572,274583,275351,11,768,2,36000,1.01432291667
274573,274588,275419,15,831,2,36000,1.01805054152
274575,274593,275453,18,860,2,36000,1.02093023256
274613,274620,275457,7,837,2,36000,1.00836320191
274645,274650,275506,5,856,2,36000,1.0058411215
274646,274656,275525,10,869,2,36000,1.01150747986
274703,274709,275561,6,852,2,36000,1.00704225352
274718,274724,275623,6,899,2,36000,1.00667408231
274734,274740,275498,6,758,2,36000,1.00791556728
274750,274756,275611,6,855,2,36000,1.00701754386
274768,274780,274792,12,12,1,900,2.0
274784,274804,275051,20,247,14,7980,1.08097165992
274791,274798,275582,7,784,2,36000,1.00892857143
274808,274814,275591,6,777,2,36000,1.00772200772
274843,274849,275672,6,823,2,36000,1.00729040097
274858,274864,275660,6,796,2,36000,1.00753768844
274874,274880,276125,6,1245,2,36000,1.00481927711
274901,274907,275853,6,946,2,36000,1.00634249471
274940,274946,275727,6,781,2,36000,1.00768245839
274955,274961,275751,6,790,2,36000,1.00759493671
274971,274978,275846,7,868,2,36000,1.00806451613
274987,274993,275846,6,853,2,36000,1.00703399766
274988,274999,276388,11,1389,2,36000,1.00791936645
275045,275051,275856,6,805,2,36000,1.00745341615
275047,275062,275866,15,804,2,36000,1.01865671642
275048,275057,275070,9,13,1,900,1.69230769231
275058,275068,275320,10,252,14,7980,1.03968253968
275078,275084,275886,6,802,2,36000,1.00748129676
275125,275131,275972,6,841,2,36000,1.00713436385
275184,275190,275959,6,769,2,36000,1.0078023407
275185,275196,275990,11,794,2,36000,1.01385390428
275202,275208,276098,6,890,2,36000,1.00674157303
275203,275214,275941,11,727,2,36000,1.015130674
275204,275219,276010,15,791,2,36000,1.01896333755
275233,275239,275971,6,732,2,36000,1.00819672131
275257,275263,276059,6,796,2,36000,1.00753768844
275273,275279,276095,6,816,2,36000,1.00735294118
275294,275300,276180,6,880,2,36000,1.00681818182
275313,275319,276279,6,960,2,36000,1.00625
275317,275325,275340,8,15,1,900,1.53333333333
275329,275340,276099,11,759,2,36000,1.01449275362
275329,275334,275595,5,261,14,7980,1.01915708812
275330,275346,276222,16,876,2,36000,1.01826484018
275355,275361,276101,6,740,2,36000,1.00810810811
275375,275381,276186,6,805,2,36000,1.00745341615
275407,275414,276260,7,846,2,36000,1.00827423168
275409,275420,276216,11,796,2,36000,1.01381909548
275434,275440,276236,6,796,2,36000,1.00753768844
275468,275474,276244,6,770,2,36000,1.00779220779
275469,275480,276270,11,790,2,36000,1.01392405063
275502,275508,276455,6,947,2,36000,1.00633579725
275520,275527,276205,7,678,2,36000,1.01032448378
275536,275542,276337,6,795,2,36000,1.00754716981
275564,275570,276365,6,795,2,36000,1.00754716981
275583,275589,276406,6,817,2,36000,1.00734394125
275592,275602,275615,10,13,1,900,1.76923076923
275599,275608,276417,9,809,2,36000,1.01112484549
275612,275627,275873,15,246,14,7980,1.06097560976
275614,275621,276418,7,797,2,36000,1.00878293601
275631,275637,276408,6,771,2,36000,1.00778210117
275662,275668,276507,6,839,2,36000,1.00715137068
275689,275695,276458,6,763,2,36000,1.00786369594
275728,275734,276580,6,846,2,36000,1.00709219858
275755,275762,276497,7,735,2,36000,1.00952380952
275856,275862,276625,6,763,2,36000,1.00786369594
275857,275868,276760,11,892,2,36000,1.01233183857
275859,275873,276794,14,921,2,36000,1.01520086862
275860,275878,276704,18,826,2,36000,1.02179176755
275870,275885,275979,15,94,1,900,1.15957446809
275885,275892,276685,7,793,2,36000,1.00882723834
275887,275898,276790,11,892,2,36000,1.01233183857
275897,275904,276207,7,303,14,7980,1.02310231023
275947,275953,276794,6,841,2,36000,1.00713436385
275967,275973,276770,6,797,2,36000,1.00752823087
275983,275989,276807,6,818,2,36000,1.00733496333
275985,275995,276971,10,976,2,36000,1.01024590164
275991,276001,276191,10,190,1,3600,1.05263157895
276003,276009,276792,6,783,2,36000,1.00766283525
276027,276033,276939,6,906,2,36000,1.00662251656
276030,276039,276333,9,294,1,1800,1.0306122449
276095,276101,276910,6,809,2,36000,1.00741656366
276097,276107,277029,10,922,2,36000,1.01084598698
276128,276134,276879,6,745,2,36000,1.00805369128
276149,276155,276862,6,707,2,36000,1.00848656294
276151,276161,276877,10,716,2,36000,1.01396648045
276152,276166,277000,14,834,2,36000,1.01678657074
276185,276190,277376,5,1186,2,36000,1.0042158516
276204,276210,276953,6,743,2,36000,1.00807537012
276205,276221,277047,16,826,2,36000,1.01937046005
276206,276216,276295,10,79,1,900,1.12658227848
276225,276232,276508,7,276,14,7980,1.02536231884
276230,276237,277086,7,849,2,36000,1.00824499411
276232,276243,277075,11,832,2,36000,1.01322115385
276261,276268,276972,7,704,2,36000,1.00994318182
276263,276274,277071,11,797,2,36000,1.01380175659
276269,276280,277187,11,907,2,36000,1.01212789416
276289,276295,277115,6,820,2,36000,1.00731707317
276290,276301,277073,11,772,2,36000,1.01424870466
276337,276343,277160,6,817,2,36000,1.00734394125
276367,276373,277181,6,808,2,36000,1.00742574257
276397,276403,277213,6,810,2,36000,1.00740740741
276414,276420,277133,6,713,2,36000,1.00841514727
276415,276426,277304,11,878,2,36000,1.0125284738
276427,276433,276765,6,332,1,3600,1.01807228916
276431,276439,277295,8,856,2,36000,1.00934579439
276432,276444,277234,12,790,2,36000,1.01518987342
276458,276464,277443,6,979,2,36000,1.00612870276
276459,276470,277297,11,827,2,36000,1.01330108827
276498,276504,277301,6,797,2,36000,1.00752823087
276506,276512,276526,6,14,1,900,1.42857142857
276514,276519,277280,5,761,2,36000,1.00657030223
276520,276538,276815,18,277,14,7980,1.06498194946
276582,276589,277412,7,823,2,36000,1.0085054678
276631,276637,277525,6,888,2,36000,1.00675675676
276688,276694,277417,6,723,2,36000,1.00829875519
276703,276709,277458,6,749,2,36000,1.00801068091
276717,276723,276836,6,113,1,1800,1.05309734513
276763,276769,277551,6,782,2,36000,1.00767263427
276778,276785,277511,7,726,2,36000,1.00964187328
276795,276801,277521,6,720,2,36000,1.00833333333
276797,276807,277625,10,818,2,36000,1.01222493888
276798,276812,277785,14,973,2,36000,1.01438848921
276799,276817,277589,18,772,2,36000,1.02331606218
276813,276824,276832,11,8,1,900,1.9
276816,276829,277737,13,908,2,36000,1.01431718062
276827,276835,277077,8,242,14,7980,1.03305785124
276873,276880,277639,7,759,2,36000,1.0092226614
276898,276904,277647,6,743,2,36000,1.00807537012
276899,276910,277785,11,875,2,36000,1.01257142857
276916,276922,277809,6,887,2,36000,1.0067643743
276942,276948,277692,6,744,2,36000,1.00806451613
276962,276968,277762,6,794,2,36000,1.00755667506
276980,276986,277816,6,830,2,36000,1.00722891566
276981,276992,277781,11,789,2,36000,1.01394169835
277003,277009,277690,6,681,2,36000,1.00881057269
277031,277037,277784,6,747,2,36000,1.00803212851
277047,277053,277908,6,855,2,36000,1.00701754386
277073,277079,277866,6,787,2,36000,1.00762388818
277074,277090,277872,16,782,2,36000,1.02046035806
277074,277085,277094,11,9,1,900,2.0
277075,277095,277890,20,795,2,36000,1.0251572327
277087,277102,277405,15,303,14,7980,1.0495049505
277093,277107,277860,14,753,2,36000,1.01859229748
277132,277138,277972,6,834,2,36000,1.0071942446
277149,277156,277978,7,822,2,36000,1.00851581509
277166,277171,277934,5,763,2,36000,1.00655307995
277181,277187,278012,6,825,2,36000,1.00727272727
277196,277203,278010,7,807,2,36000,1.00867410161
277216,277223,278018,7,795,2,36000,1.00880503145
277235,277241,278268,6,1027,2,36000,1.00584225901
277250,277292,277979,42,687,1,3600,1.06113537118
277289,277298,278171,9,873,2,36000,1.01030927835
277313,277319,278147,6,828,2,36000,1.00724637681
277314,277325,278185,11,860,2,36000,1.01279069767
277315,277330,278069,15,739,2,36000,1.02029769959
277317,277335,278122,18,787,2,36000,1.02287166455
277390,277396,278325,6,929,2,36000,1.00645855759
277394,277416,277445,22,29,1,900,1.75862068966
277418,277428,277680,10,252,14,7980,1.03968253968
277422,277433,278222,11,789,2,36000,1.01394169835
277424,277439,278286,15,847,2,36000,1.01770956316
277446,277452,278298,6,846,2,36000,1.00709219858
277466,277472,278247,6,775,2,36000,1.00774193548
277521,277527,278307,6,780,2,36000,1.00769230769
277522,277533,278342,11,809,2,36000,1.01359703337
277544,277550,278411,6,861,2,36000,1.00696864111
277561,277567,278264,6,697,2,36000,1.00860832138
277572,277601,278224,29,623,1,1800,1.04654895666
277598,277607,278395,9,788,2,36000,1.0114213198
277632,277638,278554,6,916,2,36000,1.00655021834
277654,277660,279034,6,1374,2,36000,1.00436681223
277656,277666,278430,10,764,2,36000,1.01308900524
277676,277691,277703,15,12,1,900,2.25
277688,277707,277994,19,287,14,7980,1.06620209059
277695,277701,278298,6,597,2,36000,1.01005025126
277697,277712,278563,15,851,2,36000,1.01762632197
277752,277758,278618,6,860,2,36000,1.00697674419
277775,277782,278746,7,964,2,36000,1.00726141079
277800,277806,278685,6,879,2,36000,1.00682593857
277802,277812,278533,10,721,2,36000,1.01386962552
277803,277817,278580,14,763,2,36000,1.01834862385
277805,277822,278695,17,873,2,36000,1.01947308133
277826,277832,278702,6,870,2,36000,1.00689655172
277827,277838,278718,11,880,2,36000,1.0125
277869,277875,278614,6,739,2,36000,1.00811907984
277870,277881,278732,11,851,2,36000,1.01292596945
277893,277899,278684,6,785,2,36000,1.0076433121
277895,277905,278692,10,787,2,36000,1.0127064803
277914,277920,278701,6,781,2,36000,1.00768245839
277936,277942,278702,6,760,2,36000,1.00789473684
277974,277980,278709,6,729,2,36000,1.00823045267
277989,277996,278896,7,900,2,36000,1.00777777778
277993,278002,278011,9,9,1,900,1.8
278009,278015,278301,6,286,14,7980,1.02097902098
278012,278021,278830,9,809,2,36000,1.01112484549
278013,278026,278875,13,849,2,36000,1.01531213192
278034,278040,278883,6,843,2,36000,1.00711743772
278078,278084,278927,6,843,2,36000,1.00711743772
278122,278129,278854,7,725,2,36000,1.00965517241
278147,278153,279008,6,855,2,36000,1.00701754386
278169,278176,278901,7,725,2,36000,1.00965517241
278186,278192,279080,6,888,2,36000,1.00675675676
278221,278227,278992,6,765,2,36000,1.00784313725
278247,278253,279062,6,809,2,36000,1.00741656366
278266,278272,278977,6,705,2,36000,1.0085106383
278283,278289,279136,6,847,2,36000,1.00708382527
278299,278305,278336,6,31,1,900,1.1935483871
278312,278318,279164,6,846,2,36000,1.00709219858
278313,278324,279214,11,890,2,36000,1.01235955056
278315,278329,279157,14,828,2,36000,1.01690821256
278316,278334,279152,18,818,2,36000,1.02200488998
278333,278340,279137,7,797,2,36000,1.00878293601
278340,278716,279021,376,305,14,7980,2.23278688525
278349,278355,279228,6,873,2,36000,1.00687285223
278396,278402,279234,6,832,2,36000,1.00721153846
278411,278418,279182,7,764,2,36000,1.00916230366
278430,278436,279245,6,809,2,36000,1.00741656366
278558,278564,279441,6,877,2,36000,1.00684150513
278559,278570,279316,11,746,2,36000,1.01474530831
278581,278587,279610,6,1023,2,36000,1.00586510264
278582,278593,279392,11,799,2,36000,1.01376720901
278618,278624,279369,6,745,2,36000,1.00805369128
278619,278630,279429,11,799,2,36000,1.01376720901
278685,278691,279478,6,787,2,36000,1.00762388818
278686,278697,279445,11,748,2,36000,1.01470588235
278703,278710,279465,7,755,2,36000,1.00927152318
278705,278721,279611,16,890,2,36000,1.01797752809
278706,278726,279611,20,885,2,36000,1.02259887006
278708,278732,279572,24,840,2,36000,1.02857142857
278709,278737,279734,28,997,2,36000,1.02808425276
278728,278743,279420,15,677,2,36000,1.02215657312
278729,278748,279627,19,879,2,36000,1.02161547213
278746,278755,279587,9,832,2,36000,1.01081730769
278747,278760,279612,13,852,2,36000,1.01525821596
278842,278848,279705,6,857,2,36000,1.00700116686
278857,278863,279621,6,758,2,36000,1.00791556728
278879,278886,279691,7,805,2,36000,1.00869565217
278903,278909,279689,6,780,2,36000,1.00769230769
278904,278915,279770,11,855,2,36000,1.01286549708
278906,278920,279710,14,790,2,36000,1.01772151899
278932,278938,279774,6,836,2,36000,1.00717703349
278979,278986,279730,7,744,2,36000,1.00940860215
278995,279001,279789,6,788,2,36000,1.0076142132
279012,279018,279826,6,808,2,36000,1.00742574257
279020,279032,279042,12,10,1,900,2.2
279031,279049,279319,18,270,14,7980,1.06666666667
279037,279043,279859,6,816,2,36000,1.00735294118
279068,279073,279919,5,846,2,36000,1.00591016548
279132,279139,279883,7,744,2,36000,1.00940860215
279150,279157,280002,7,845,2,36000,1.00828402367
279152,279163,279906,11,743,2,36000,1.01480484522
279182,279189,279988,7,799,2,36000,1.00876095119
279184,279195,280100,11,905,2,36000,1.01215469613
279185,279200,280030,15,830,2,36000,1.01807228916
279186,279205,280061,19,856,2,36000,1.02219626168
279224,279230,280103,6,873,2,36000,1.00687285223
279246,279252,280019,6,767,2,36000,1.00782268579
279247,279258,280120,11,862,2,36000,1.01276102088
279248,279263,280055,15,792,2,36000,1.01893939394
279318,279324,279346,6,22,1,900,1.27272727273
279319,279330,280124,11,794,2,36000,1.01385390428
279348,279354,279630,6,276,14,7980,1.02173913043
279368,279374,280256,6,882,2,36000,1.00680272109
279401,279407,280257,6,850,2,36000,1.00705882353
279434,279440,280202,6,762,2,36000,1.00787401575
279435,279446,280135,11,689,2,36000,1.01596516691
279465,279471,280358,6,887,2,36000,1.0067643743
279467,279477,280400,10,923,2,36000,1.01083423619
279468,279482,280437,14,955,2,36000,1.01465968586
279606,279612,280349,6,737,2,36000,1.00814111262
279607,279618,280580,11,962,2,36000,1.01143451143
279609,279623,280318,14,695,2,36000,1.02014388489
279627,279633,279644,6,11,1,900,1.54545454545
279628,279638,280366,10,728,2,36000,1.01373626374
279629,279643,280522,14,879,2,36000,1.01592718999
279630,279649,280504,19,855,2,36000,1.02222222222
279631,279654,280423,23,769,2,36000,1.02990897269
279633,279659,280501,26,842,2,36000,1.03087885986
279634,279670,280592,36,922,2,36000,1.03904555315
279645,279665,279923,20,258,14,7980,1.07751937984
279699,279705,280501,6,796,2,36000,1.00753768844
279700,279711,280559,11,848,2,36000,1.01297169811
279726,279732,280497,6,765,2,36000,1.00784313725
279727,279738,280485,11,747,2,36000,1.01472556894
279744,279750,280540,6,790,2,36000,1.00759493671
279746,279756,280558,10,802,2,36000,1.01246882793
279771,279777,280528,6,751,2,36000,1.00798934754
279787,279793,280652,6,859,2,36000,1.00698486612
279802,279808,280642,6,834,2,36000,1.0071942446
279828,279834,280629,6,795,2,36000,1.00754716981
279860,279866,280616,6,750,2,36000,1.008
279882,279888,280621,6,733,2,36000,1.00818553888
279886,279894,280031,8,137,1,1800,1.05839416058
279907,279913,280817,6,904,2,36000,1.00663716814
279921,279927,279937,6,10,1,900,1.6
279922,279933,280750,11,817,2,36000,1.01346389229
279931,279939,280216,8,277,14,7980,1.02888086643
279988,279995,280056,7,61,1,1800,1.11475409836
279998,280004,280785,6,781,2,36000,1.00768245839
280014,280020,280896,6,876,2,36000,1.00684931507
280029,280036,280778,7,742,2,36000,1.00943396226
280031,280042,280892,11,850,2,36000,1.01294117647
280057,280066,280888,9,822,2,36000,1.01094890511
280072,280078,280707,6,629,2,36000,1.00953895072
280100,280106,280962,6,856,2,36000,1.00700934579
280117,280123,281462,6,1339,2,36000,1.00448095594
280132,280138,280982,6,844,2,36000,1.00710900474
280134,280144,280939,10,795,2,36000,1.01257861635
280150,280156,280937,6,781,2,36000,1.00768245839
280215,280221,280262,6,41,1,900,1.14634146341
280221,280227,281044,6,817,2,36000,1.00734394125
280240,280246,280507,6,261,14,7980,1.02298850575
280258,280264,281050,6,786,2,36000,1.00763358779
280260,280270,281014,10,744,2,36000,1.01344086022
280320,280327,281125,7,798,2,36000,1.00877192982
280351,280357,281134,6,777,2,36000,1.00772200772
280367,280373,281286,6,913,2,36000,1.00657174151
280368,280379,281176,11,797,2,36000,1.01380175659
280369,280384,280537,15,153,1,1800,1.09803921569
280398,280404,280539,6,135,1,1800,1.04444444444
280401,280410,281378,9,968,2,36000,1.00929752066
280423,280429,281294,6,865,2,36000,1.00693641618
280438,280444,281250,6,806,2,36000,1.00744416873
280500,280506,281231,6,725,2,36000,1.00827586207
280501,280517,281266,16,749,2,36000,1.02136181575
280504,280512,280545,8,33,1,900,1.24242424242
280516,280523,280769,7,246,14,7980,1.02845528455
280522,280529,281326,7,797,2,36000,1.00878293601
280523,280534,281316,11,782,2,36000,1.01406649616
280524,280540,281381,16,841,2,36000,1.01902497027
280526,280545,281376,19,831,2,36000,1.02286401925
280556,280563,281389,7,826,2,36000,1.00847457627
280558,280569,281416,11,847,2,36000,1.01298701299
280575,280581,281380,6,799,2,36000,1.00750938673
280576,280587,281420,11,833,2,36000,1.01320528211
280592,280598,281393,6,795,2,36000,1.00754716981
280593,280604,281414,11,810,2,36000,1.01358024691
280619,280625,281427,6,802,2,36000,1.00748129676
280639,280645,281511,6,866,2,36000,1.00692840647
280640,280651,281515,11,864,2,36000,1.01273148148
280655,280661,281513,6,852,2,36000,1.00704225352
280657,280667,281458,10,791,2,36000,1.01264222503
280708,280714,281535,6,821,2,36000,1.00730816078
280760,280766,281679,6,913,2,36000,1.00657174151
280766,280773,280801,7,28,1,900,1.25
280781,280788,281018,7,230,14,7980,1.03043478261
280783,280793,281665,10,872,2,36000,1.01146788991
280799,280805,281635,6,830,2,36000,1.00722891566
280822,280828,281678,6,850,2,36000,1.00705882353
280896,280902,281781,6,879,2,36000,1.00682593857
280898,280908,281713,10,805,2,36000,1.01242236025
280899,280913,281702,14,789,2,36000,1.01774397972
280971,280977,281815,6,838,2,36000,1.00715990453
280973,280983,281744,10,761,2,36000,1.01314060447
280974,280988,281781,14,793,2,36000,1.01765447667
280989,280995,281805,6,810,2,36000,1.00740740741
281015,281021,281860,6,839,2,36000,1.00715137068
281016,281027,281084,11,57,1,900,1.19298245614
281069,281075,281923,6,848,2,36000,1.0070754717
281070,281086,281839,16,753,2,36000,1.02124833997
281075,281081,281352,6,271,14,7980,1.0221402214
281128,281134,282182,6,1048,2,36000,1.00572519084
281143,281150,281926,7,776,2,36000,1.00902061856
281181,281186,281987,5,801,2,36000,1.00624219725
281233,281240,281985,7,745,2,36000,1.00939597315
281258,281265,282007,7,742,2,36000,1.00943396226
281277,281283,282188,6,905,2,36000,1.00662983425
281294,281301,282146,7,845,2,36000,1.00828402367
281296,281307,282117,11,810,2,36000,1.01358024691
281333,281344,281914,11,570,1,1800,1.01929824561
281333,281339,281387,6,48,1,900,1.125
281375,281381,281670,6,289,14,7980,1.02076124567
281377,281387,282230,10,843,2,36000,1.0118623962
281378,281392,282202,14,810,2,36000,1.01728395062
281379,281397,282196,18,799,2,36000,1.0225281602
281381,281402,282201,21,799,2,36000,1.02628285357
281402,281408,282190,6,782,2,36000,1.00767263427
281403,281415,282237,12,822,2,36000,1.01459854015
281405,281420,282189,15,769,2,36000,1.01950585176
281406,281425,282273,19,848,2,36000,1.02240566038
281432,281438,282317,6,879,2,36000,1.00682593857
281433,281444,282197,11,753,2,36000,1.01460823373
281435,281449,282208,14,759,2,36000,1.01844532279
281436,281454,282335,18,881,2,36000,1.02043132804
281475,281482,282483,7,1001,2,36000,1.00699300699
281477,281488,282292,11,804,2,36000,1.01368159204
281531,281537,282301,6,764,2,36000,1.00785340314
281532,281543,282304,11,761,2,36000,1.01445466491
281534,281548,282288,14,740,2,36000,1.01891891892
281550,281556,281909,6,353,1,1800,1.01699716714
281553,281562,282320,9,758,2,36000,1.01187335092
281640,281646,282394,6,748,2,36000,1.00802139037
281669,281675,281691,6,16,1,900,1.375
281671,281681,282486,10,805,2,36000,1.01242236025
281679,281687,281943,8,256,14,7980,1.03125
281690,281696,282487,6,791,2,36000,1.00758533502
281691,281702,282556,11,854,2,36000,1.01288056206
281706,281713,282450,7,737,2,36000,1.00949796472
281722,281728,282530,6,802,2,36000,1.00748129676
281744,281750,282686,6,936,2,36000,1.00641025641
281779,281785,282942,6,1157,2,36000,1.00518582541
281781,281791,282490,10,699,2,36000,1.01430615165
281805,281812,282505,7,693,2,36000,1.0101010101
281821,281827,282697,6,870,2,36000,1.00689655172
281840,281846,282693,6,847,2,36000,1.00708382527
281861,281867,282661,6,794,2,36000,1.00755667506
281928,281934,282784,6,850,2,36000,1.00705882353
281929,281940,282716,11,776,2,36000,1.01417525773
281941,281947,281960,6,13,1,900,1.46153846154
281956,281962,282201,6,239,14,7980,1.02510460251
281988,281994,282742,6,748,2,36000,1.00802139037
281989,282000,282936,11,936,2,36000,1.01175213675
282008,282014,282756,6,742,2,36000,1.00808625337
282119,282125,283068,6,943,2,36000,1.00636267232
282186,282192,282994,6,802,2,36000,1.00748129676
282188,282198,283099,10,901,2,36000,1.01109877913
282195,282204,282257,9,53,1,900,1.16981132075
282212,282218,282474,6,256,14,7980,1.0234375
282222,282229,283028,7,799,2,36000,1.00876095119
282224,282235,283029,11,794,2,36000,1.01385390428
282225,282240,283057,15,817,2,36000,1.01835985312
282228,282245,283052,17,807,2,36000,1.02106567534
282229,282250,283143,21,893,2,36000,1.0235162374
282234,282256,282961,22,705,2,36000,1.03120567376
282239,282261,283049,22,788,2,36000,1.02791878173
282240,282266,283152,26,886,2,36000,1.02934537246
282259,282272,283076,13,804,2,36000,1.01616915423
282260,282277,283151,17,874,2,36000,1.01945080092
282277,282283,283102,6,819,2,36000,1.00732600733
282295,282301,283100,6,799,2,36000,1.00750938673
282296,282307,283114,11,807,2,36000,1.0136307311
282312,282318,283094,6,776,2,36000,1.00773195876
282314,282324,283154,10,830,2,36000,1.01204819277
282330,282336,283142,6,806,2,36000,1.00744416873
282331,282342,283163,11,821,2,36000,1.01339829476
282347,282353,283160,6,807,2,36000,1.00743494424
282404,282410,283207,6,797,2,36000,1.00752823087
282450,282456,283311,6,855,2,36000,1.00701754386
282472,282478,282493,6,15,1,900,1.4
282484,282490,282740,6,250,14,7980,1.024
282488,282496,283340,8,844,2,36000,1.00947867299
282489,282501,283289,12,788,2,36000,1.0152284264
282490,282506,283301,16,795,2,36000,1.02012578616
282527,282533,283324,6,791,2,36000,1.00758533502
282529,282539,283267,10,728,2,36000,1.01373626374
282546,282552,283376,6,824,2,36000,1.0072815534
282564,282570,283305,6,735,2,36000,1.00816326531
282681,282687,283533,6,846,2,36000,1.00709219858
282710,282716,283456,6,740,2,36000,1.00810810811
282712,282722,283488,10,766,2,36000,1.01305483029
282713,282727,283510,14,783,2,36000,1.01787994891
282731,282737,283661,6,924,2,36000,1.00649350649
282736,282743,282829,7,86,1,900,1.08139534884
282750,282756,283681,6,925,2,36000,1.00648648649
282752,282762,283094,10,332,14,7980,1.03012048193
282768,282775,283586,7,811,2,36000,1.00863131936
282793,282799,283564,6,765,2,36000,1.00784313725
282939,282945,283742,6,797,2,36000,1.00752823087
282955,282961,283741,6,780,2,36000,1.00769230769
282974,282980,283822,6,842,2,36000,1.00712589074
283020,283026,283927,6,901,2,36000,1.00665926748
283039,283045,283813,6,768,2,36000,1.0078125
283040,283051,283870,11,819,2,36000,1.01343101343
283059,283066,283932,7,866,2,36000,1.00808314088
283061,283077,283864,16,787,2,36000,1.02033036849
283062,283083,283912,21,829,2,36000,1.02533172497
283062,283072,283103,10,31,1,900,1.32258064516
283080,283105,283367,25,262,14,7980,1.09541984733
283099,283110,284019,11,909,2,36000,1.01210121012
283101,283116,283832,15,716,2,36000,1.02094972067
283102,283121,283957,19,836,2,36000,1.02272727273
283103,283127,283971,24,844,2,36000,1.02843601896
283104,283132,283961,28,829,2,36000,1.03377563329
283106,283137,283938,31,801,2,36000,1.03870162297
283122,283143,284020,21,877,2,36000,1.02394526796
283144,283151,284019,7,868,2,36000,1.00806451613
283146,283157,283866,11,709,2,36000,1.01551480959
283165,283171,284149,6,978,2,36000,1.00613496933
283166,283177,283942,11,765,2,36000,1.01437908497
283167,283182,283959,15,777,2,36000,1.01930501931
283169,283187,283916,18,729,2,36000,1.02469135802
283170,283193,283947,23,754,2,36000,1.03050397878
283208,283214,284068,6,854,2,36000,1.00702576112
283286,283293,284174,7,881,2,36000,1.00794551646
283302,283308,284119,6,811,2,36000,1.00739827374
283304,283314,284076,10,762,2,36000,1.01312335958
283320,283327,284171,7,844,2,36000,1.00829383886
283322,283332,284175,10,843,2,36000,1.0118623962
283338,283344,284129,6,785,2,36000,1.0076433121
283353,283359,284180,6,821,2,36000,1.00730816078
283366,283373,283383,7,10,1,900,1.7
283374,283380,283491,6,111,14,7980,1.05405405405
283375,283386,284180,11,794,2,36000,1.01385390428
283458,283464,284253,6,789,2,36000,1.00760456274
283478,283484,283504,6,20,1,900,1.3
283498,283505,284417,7,912,2,36000,1.0076754386
283521,283527,284282,6,755,2,36000,1.00794701987
283537,283543,284362,6,819,2,36000,1.00732600733
283565,283571,284406,6,835,2,36000,1.00718562874
283587,283593,284383,6,790,2,36000,1.00759493671
283661,283667,284400,6,733,2,36000,1.00818553888
283683,283689,284526,6,837,2,36000,1.00716845878
283754,283760,284636,6,876,2,36000,1.00684931507
283755,283766,284524,11,758,2,36000,1.01451187335
283815,283821,284596,6,775,2,36000,1.00774193548
283831,283837,284739,6,902,2,36000,1.0066518847
283832,283843,284648,11,805,2,36000,1.01366459627
283864,283871,284665,7,794,2,36000,1.00881612091
283880,283886,284637,6,751,2,36000,1.00798934754
283881,283892,285162,11,1270,2,36000,1.00866141732
283891,283898,283961,7,63,1,1800,1.11111111111
283913,283919,284628,6,709,2,36000,1.00846262341
283930,283936,284765,6,829,2,36000,1.00723763571
283931,283942,284720,11,778,2,36000,1.01413881748
283957,283963,284828,6,865,2,36000,1.00693641618
283958,283971,284752,13,781,2,36000,1.0166453265
283960,283976,284784,16,808,2,36000,1.0198019802
283961,283981,284755,20,774,2,36000,1.02583979328
283962,283987,284778,25,791,2,36000,1.03160556258
284013,284019,284934,6,915,2,36000,1.00655737705
284014,284025,284780,11,755,2,36000,1.01456953642
284015,284030,284848,15,818,2,36000,1.01833740831
284053,284059,284893,6,834,2,36000,1.0071942446
284055,284065,284807,10,742,2,36000,1.01347708895
284056,284070,284823,14,753,2,36000,1.01859229748
284074,284080,284870,6,790,2,36000,1.00759493671
284091,284097,284908,6,811,2,36000,1.00739827374
284122,284128,284877,6,749,2,36000,1.00801068091
284137,284143,284932,6,789,2,36000,1.00760456274
284173,284179,284983,6,804,2,36000,1.00746268657
284174,284185,284967,11,782,2,36000,1.01406649616
284215,284221,285177,6,956,2,36000,1.00627615063
284216,284227,285028,11,801,2,36000,1.01373283396
284218,284232,285098,14,866,2,36000,1.01616628176
284219,284237,285112,18,875,2,36000,1.02057142857
284258,284264,285162,6,898,2,36000,1.00668151448
284289,284295,285095,6,800,2,36000,1.0075
284338,284344,284474,6,130,1,1800,1.04615384615
284375,284382,285156,7,774,2,36000,1.00904392765
284392,284398,285199,6,801,2,36000,1.0074906367
284425,284431,285175,6,744,2,36000,1.00806451613
284426,284437,285229,11,792,2,36000,1.01388888889
284428,284442,285327,14,885,2,36000,1.01581920904
284525,284532,285339,7,807,2,36000,1.00867410161
284527,284537,285268,10,731,2,36000,1.01367989056
284600,284606,285464,6,858,2,36000,1.00699300699
284639,284646,285596,7,950,2,36000,1.00736842105
284641,284652,285404,11,752,2,36000,1.01462765957
284642,284657,285416,15,759,2,36000,1.01976284585
284659,284666,285380,7,714,2,36000,1.00980392157
284675,284681,285572,6,891,2,36000,1.00673400673
284722,284728,285580,6,852,2,36000,1.00704225352
284740,284746,285576,6,830,2,36000,1.00722891566
284756,284762,285528,6,766,2,36000,1.00783289817
284758,284768,285746,10,978,2,36000,1.01022494888
284774,284780,285520,6,740,2,36000,1.00810810811
284791,284797,285595,6,798,2,36000,1.00751879699
284792,284803,285553,11,750,2,36000,1.01466666667
284793,284808,285706,15,898,2,36000,1.01670378619
284809,284815,285564,6,749,2,36000,1.00801068091
284824,284831,285718,7,887,2,36000,1.00789177001
284840,284846,285608,6,762,2,36000,1.00787401575
284855,284861,285777,6,916,2,36000,1.00655021834
284883,284890,285718,7,828,2,36000,1.00845410628
284885,284896,285755,11,859,2,36000,1.01280558789
284912,284919,285698,7,779,2,36000,1.00898587933
284914,284925,285802,11,877,2,36000,1.01254275941
284935,284941,285766,6,825,2,36000,1.00727272727
284936,284947,285776,11,829,2,36000,1.01326899879
284972,284978,285751,6,773,2,36000,1.00776196636
284997,285003,285887,6,884,2,36000,1.00678733032
285094,285100,285922,6,822,2,36000,1.00729927007
285112,285118,285880,6,762,2,36000,1.00787401575
285113,285124,285803,11,679,2,36000,1.01620029455
285115,285129,285926,14,797,2,36000,1.01756587202
285157,285163,285997,6,834,2,36000,1.0071942446
285188,285194,285967,6,773,2,36000,1.00776196636
285190,285200,285956,10,756,2,36000,1.01322751323
285191,285205,286019,14,814,2,36000,1.0171990172
285192,285210,286081,18,871,2,36000,1.02066590126
285214,285220,285957,6,737,2,36000,1.00814111262
285234,285240,286089,6,849,2,36000,1.00706713781
285272,285278,286075,6,797,2,36000,1.00752823087
285337,285343,286130,6,787,2,36000,1.00762388818
285356,285362,286116,6,754,2,36000,1.00795755968
285385,285391,286114,6,723,2,36000,1.00829875519
285406,285412,286112,6,700,2,36000,1.00857142857
285421,285427,286232,6,805,2,36000,1.00745341615
285473,285479,286328,6,849,2,36000,1.00706713781
285528,285534,286271,6,737,2,36000,1.00814111262
285529,285540,286673,11,1133,2,36000,1.00970873786
285554,285560,286331,6,771,2,36000,1.00778210117
285560,285566,285910,6,344,1,1800,1.01744186047
285581,285587,286364,6,777,2,36000,1.00772200772
285582,285593,286322,11,729,2,36000,1.01508916324
285584,285598,286362,14,764,2,36000,1.01832460733
285585,285603,286439,18,836,2,36000,1.02153110048
285608,285615,286327,7,712,2,36000,1.00983146067
285610,285621,286390,11,769,2,36000,1.01430429129
285611,285626,286346,15,720,2,36000,1.02083333333
285698,285704,286550,6,846,2,36000,1.00709219858
285714,285720,286471,6,751,2,36000,1.00798934754
285716,285726,286564,10,838,2,36000,1.01193317422
285747,285753,286542,6,789,2,36000,1.00760456274
285748,285759,286505,11,746,2,36000,1.01474530831
285779,285785,286592,6,807,2,36000,1.00743494424
285780,285791,286631,11,840,2,36000,1.0130952381
285782,285796,286615,14,819,2,36000,1.01709401709
285783,285801,286562,18,761,2,36000,1.02365308804
285784,285807,286516,23,709,2,36000,1.03244005642
285810,285816,286567,6,751,2,36000,1.00798934754
285811,285822,286696,11,874,2,36000,1.01258581236
285886,285893,286619,7,726,2,36000,1.00964187328
285902,285908,286753,6,845,2,36000,1.00710059172
285955,285961,286709,6,748,2,36000,1.00802139037
285957,285967,286798,10,831,2,36000,1.01203369434
285958,285972,286727,14,755,2,36000,1.01854304636
285978,285984,286817,6,833,2,36000,1.00720288115
285979,285990,286756,11,766,2,36000,1.01436031332
286009,286015,286932,6,917,2,36000,1.00654307525
286024,286030,286860,6,830,2,36000,1.00722891566
286075,286081,286775,6,694,2,36000,1.00864553314
286090,286096,286812,6,716,2,36000,1.00837988827
286091,286102,286835,11,733,2,36000,1.01500682128
286118,286125,286993,7,868,2,36000,1.00806451613
286120,286131,286986,11,855,2,36000,1.01286549708
286121,286136,286950,15,814,2,36000,1.01842751843
286145,286151,286968,6,817,2,36000,1.00734394125
286238,286243,287020,5,777,2,36000,1.00643500644
286275,286281,287187,6,906,2,36000,1.00662251656
286333,286338,287199,5,861,2,36000,1.00580720093
286334,286344,287016,10,672,2,36000,1.01488095238
286335,286349,287213,14,864,2,36000,1.0162037037
286337,286354,287210,17,856,2,36000,1.01985981308
286364,286370,287246,6,876,2,36000,1.00684931507
286366,286376,287200,10,824,2,36000,1.01213592233
286367,286381,287207,14,826,2,36000,1.01694915254
286403,286409,287182,6,773,2,36000,1.00776196636
286445,286451,287237,6,786,2,36000,1.00763358779
286472,288161,290371,1689,2210,64,7200,1.76425339367
286476,286482,287247,6,765,2,36000,1.00784313725
286506,286512,287428,6,916,2,36000,1.00655021834
286521,286527,287370,6,843,2,36000,1.00711743772
286535,286711,288149,176,1438,32,7200,1.1223922114
286543,286549,287459,6,910,2,36000,1.00659340659
286558,286564,287324,6,760,2,36000,1.00789473684
286578,286584,287548,6,964,2,36000,1.00622406639
286579,286590,287505,11,915,2,36000,1.01202185792
286580,286595,287430,15,835,2,36000,1.01796407186
286602,286608,287501,6,893,2,36000,1.00671892497
286628,286635,287433,7,798,2,36000,1.00877192982
286630,286641,287601,11,960,2,36000,1.01145833333
286645,286652,287390,7,738,2,36000,1.00948509485
286674,286680,287587,6,907,2,36000,1.00661521499
286699,286705,287682,6,977,2,36000,1.00614124872
286714,286720,287478,6,758,2,36000,1.00791556728
286730,286736,287568,6,832,2,36000,1.00721153846
286755,286761,287620,6,859,2,36000,1.00698486612
286757,286767,287524,10,757,2,36000,1.01321003963
286777,286783,287676,6,893,2,36000,1.00671892497
286799,286805,287584,6,779,2,36000,1.00770218228
286814,286820,287672,6,852,2,36000,1.00704225352
286830,286836,287658,6,822,2,36000,1.00729927007
286853,286860,287674,7,814,2,36000,1.0085995086
286882,286888,287699,6,811,2,36000,1.00739827374
286934,286940,287852,6,912,2,36000,1.00657894737
286957,286962,287776,5,814,2,36000,1.00614250614
286972,286978,287806,6,828,2,36000,1.00724637681
286988,286995,287842,7,847,2,36000,1.00826446281
287004,287010,287783,6,773,2,36000,1.00776196636
287022,287028,287888,6,860,2,36000,1.00697674419
287023,287034,287829,11,795,2,36000,1.01383647799
287192,287198,287942,6,744,2,36000,1.00806451613
287193,287209,287895,16,686,2,36000,1.02332361516
287210,287216,287979,6,763,2,36000,1.00786369594
287212,287222,288046,10,824,2,36000,1.01213592233
287213,287227,288082,14,855,2,36000,1.01637426901
287214,287232,288103,18,871,2,36000,1.02066590126
287231,287239,288044,8,805,2,36000,1.0099378882
287249,287256,288122,7,866,2,36000,1.00808314088
287251,287261,288075,10,814,2,36000,1.01228501229
287252,287267,288031,15,764,2,36000,1.01963350785
287324,287330,288239,6,909,2,36000,1.00660066007
287385,287391,288146,6,755,2,36000,1.00794701987
287412,287418,288233,6,815,2,36000,1.00736196319
287429,287435,288207,6,772,2,36000,1.00777202073
287430,287441,288155,11,714,2,36000,1.01540616246
287446,287452,288340,6,888,2,36000,1.00675675676
287462,287468,288181,6,713,2,36000,1.00841514727
287482,287488,288230,6,742,2,36000,1.00808625337
287502,287509,288250,7,741,2,36000,1.00944669366
287521,287527,288278,6,751,2,36000,1.00798934754
287539,287545,288230,6,685,2,36000,1.00875912409
287560,287566,288385,6,819,2,36000,1.00732600733
287575,287582,288297,7,715,2,36000,1.00979020979
287592,287597,288401,5,804,2,36000,1.00621890547
287593,287604,288365,11,761,2,36000,1.01445466491
287609,287615,288400,6,785,2,36000,1.0076433121
287624,287630,288403,6,773,2,36000,1.00776196636
287668,287674,288556,6,882,2,36000,1.00680272109
287701,287707,288513,6,806,2,36000,1.00744416873
287702,287713,288587,11,874,2,36000,1.01258581236
287704,287718,288531,14,813,2,36000,1.0172201722
287705,287723,288583,18,860,2,36000,1.02093023256
287707,287729,288521,22,792,2,36000,1.02777777778
287787,287794,288560,7,766,2,36000,1.0091383812
287789,287800,288632,11,832,2,36000,1.01322115385
287810,287816,288642,6,826,2,36000,1.00726392252
287834,287840,288566,6,726,2,36000,1.00826446281
287855,287861,288616,6,755,2,36000,1.00794701987
287856,287867,288616,11,749,2,36000,1.01468624833
287881,287888,288706,7,818,2,36000,1.00855745721
287897,287903,288741,6,838,2,36000,1.00715990453
287946,287952,288728,6,776,2,36000,1.00773195876
287986,287992,288733,6,741,2,36000,1.00809716599
288035,288041,288839,6,798,2,36000,1.00751879699
288053,288059,288851,6,792,2,36000,1.00757575758
288054,288065,288996,11,931,2,36000,1.01181525242
288077,288083,288838,6,755,2,36000,1.00794701987
288093,288099,288835,6,736,2,36000,1.00815217391
288109,288115,288945,6,830,2,36000,1.00722891566
288124,288130,289062,6,932,2,36000,1.00643776824
288149,288155,288968,6,813,2,36000,1.0073800738
288165,288171,288865,6,694,2,36000,1.00864553314
288183,288190,288909,7,719,2,36000,1.00973574409
288209,288216,289038,7,822,2,36000,1.00851581509
288242,288249,289196,7,947,2,36000,1.00739176346
288244,288255,289104,11,849,2,36000,1.01295641932
288245,288260,289044,15,784,2,36000,1.01913265306
288247,288265,289054,18,789,2,36000,1.02281368821
288273,288279,289115,6,836,2,36000,1.00717703349
288288,288294,289177,6,883,2,36000,1.00679501699
288304,288310,289086,6,776,2,36000,1.00773195876
288342,288348,289275,6,927,2,36000,1.00647249191
288367,288373,289077,6,704,2,36000,1.00852272727
288388,288394,289282,6,888,2,36000,1.00675675676
288404,288410,289216,6,806,2,36000,1.00744416873
288406,288416,289127,10,711,2,36000,1.01406469761
288407,288421,289242,14,821,2,36000,1.01705237515
288517,288524,289297,7,773,2,36000,1.00905562743
288534,288540,289330,6,790,2,36000,1.00759493671
288536,288546,289238,10,692,2,36000,1.01445086705
288559,288565,289337,6,772,2,36000,1.00777202073
288579,288585,289398,6,813,2,36000,1.0073800738
288580,288591,289385,11,794,2,36000,1.01385390428
288596,288602,289328,6,726,2,36000,1.00826446281
288597,288608,289384,11,776,2,36000,1.01417525773
288618,288624,289651,6,1027,2,36000,1.00584225901
288619,288630,289442,11,812,2,36000,1.01354679803
288636,288642,289474,6,832,2,36000,1.00721153846
288654,288660,289451,6,791,2,36000,1.00758533502
288709,288715,289707,6,992,2,36000,1.0060483871
288731,288737,289499,6,762,2,36000,1.00787401575
288732,288743,289562,11,819,2,36000,1.01343101343
288764,288771,289548,7,777,2,36000,1.00900900901
288839,288845,289593,6,748,2,36000,1.00802139037
288841,288851,289681,10,830,2,36000,1.01204819277
288842,288856,289661,14,805,2,36000,1.01739130435
288860,288866,289700,6,834,2,36000,1.0071942446
288876,288882,289728,6,846,2,36000,1.00709219858
288928,288934,289813,6,879,2,36000,1.00682593857
288949,288955,289668,6,713,2,36000,1.00841514727
288972,288978,289742,6,764,2,36000,1.00785340314
288998,289004,289845,6,841,2,36000,1.00713436385
289045,289052,289945,7,893,2,36000,1.0078387458
289047,289058,289950,11,892,2,36000,1.01233183857
289079,289085,289843,6,758,2,36000,1.00791556728
289080,289091,289793,11,702,2,36000,1.01566951567
289081,289096,289895,15,799,2,36000,1.01877346683
289098,289104,289900,6,796,2,36000,1.00753768844
289115,289121,289945,6,824,2,36000,1.0072815534
289116,289127,289899,11,772,2,36000,1.01424870466
289132,289138,290118,6,980,2,36000,1.00612244898
289186,289192,289950,6,758,2,36000,1.00791556728
289202,289208,290437,6,1229,2,36000,1.0048820179
289218,289224,290031,6,807,2,36000,1.00743494424
289242,289248,290067,6,819,2,36000,1.00732600733
289243,289254,289979,11,725,2,36000,1.01517241379
289288,289294,290094,6,800,2,36000,1.0075
289290,289300,290102,10,802,2,36000,1.01246882793
289311,289317,290115,6,798,2,36000,1.00751879699
289338,289344,290204,6,860,2,36000,1.00697674419
289340,289350,290134,10,784,2,36000,1.01275510204
289341,289355,290127,14,772,2,36000,1.01813471503
289388,289394,290160,6,766,2,36000,1.00783289817
289389,289400,290106,11,706,2,36000,1.01558073654
289406,289412,290186,6,774,2,36000,1.00775193798
289448,289454,290272,6,818,2,36000,1.00733496333
289465,289471,290306,6,835,2,36000,1.00718562874
289484,289490,290194,6,704,2,36000,1.00852272727
289502,289509,290317,7,808,2,36000,1.00866336634
289550,289556,290330,6,774,2,36000,1.00775193798
289578,289584,290344,6,760,2,36000,1.00789473684
289607,289613,290349,6,736,2,36000,1.00815217391
289655,289661,290461,6,800,2,36000,1.0075
289671,289677,290577,6,900,2,36000,1.00666666667
289672,289683,290521,11,838,2,36000,1.01312649165
289688,289694,290398,6,704,2,36000,1.00852272727
289705,289711,290517,6,806,2,36000,1.00744416873
289722,289728,290595,6,867,2,36000,1.00692041522
289738,289745,290548,7,803,2,36000,1.00871731009
289754,289760,290592,6,832,2,36000,1.00721153846
289796,289802,290662,6,860,2,36000,1.00697674419
289837,289843,290691,6,848,2,36000,1.0070754717
289860,289866,290736,6,870,2,36000,1.00689655172
289861,289872,290650,11,778,2,36000,1.01413881748
289897,289903,290731,6,828,2,36000,1.00724637681
289913,289920,290621,7,701,2,36000,1.00998573466
289915,289926,290777,11,851,2,36000,1.01292596945
289952,289958,290793,6,835,2,36000,1.00718562874
289953,289964,290895,11,931,2,36000,1.01181525242
289954,289969,290772,15,803,2,36000,1.01867995019
289956,289974,290787,18,813,2,36000,1.0221402214
289984,289990,290778,6,788,2,36000,1.0076142132
290036,290042,290734,6,692,2,36000,1.00867052023
290070,290077,290927,7,850,2,36000,1.00823529412
290097,290104,290881,7,777,2,36000,1.00900900901
290131,290137,290953,6,816,2,36000,1.00735294118
290133,290143,290927,10,784,2,36000,1.01275510204
290134,290148,290984,14,836,2,36000,1.01674641148
290136,290153,290872,17,719,2,36000,1.02364394993
290137,290159,290958,22,799,2,36000,1.02753441802
290158,290165,290979,7,814,2,36000,1.0085995086
290176,290182,290935,6,753,2,36000,1.00796812749
290196,290202,291083,6,881,2,36000,1.00681044268
290197,290208,291013,11,805,2,36000,1.01366459627
290217,290223,290993,6,770,2,36000,1.00779220779
290274,290280,291129,6,849,2,36000,1.00706713781
290317,290324,291127,7,803,2,36000,1.00871731009
290319,290330,291138,11,808,2,36000,1.01361386139
290343,290349,291117,6,768,2,36000,1.0078125
290362,290368,291256,6,888,2,36000,1.00675675676
290363,290374,291227,11,853,2,36000,1.01289566237
290405,290411,291313,6,902,2,36000,1.0066518847
290441,290447,291327,6,880,2,36000,1.00681818182
290490,290496,291313,6,817,2,36000,1.00734394125
290525,290531,291428,6,897,2,36000,1.00668896321
290526,290537,291352,11,815,2,36000,1.01349693252
290552,290558,291378,6,820,2,36000,1.00731707317
290580,290586,291415,6,829,2,36000,1.00723763571
290599,290605,291479,6,874,2,36000,1.00686498856
290600,290611,291634,11,1023,2,36000,1.01075268817
290626,290632,291504,6,872,2,36000,1.00688073394
290654,290660,291430,6,770,2,36000,1.00779220779
290670,290676,291546,6,870,2,36000,1.00689655172
290691,290697,291535,6,838,2,36000,1.00715990453
290753,290759,291565,6,806,2,36000,1.00744416873
290755,290765,291524,10,759,2,36000,1.01317523057
290756,290770,291651,14,881,2,36000,1.01589103292
290774,290780,291642,6,862,2,36000,1.00696055684
290790,290796,291633,6,837,2,36000,1.00716845878
290791,290802,291553,11,751,2,36000,1.01464713715
290793,290807,291684,14,877,2,36000,1.01596351197
290809,290815,291630,6,815,2,36000,1.00736196319
290876,290883,291580,7,697,2,36000,1.01004304161
290892,290898,291744,6,846,2,36000,1.00709219858
290909,290915,291593,6,678,2,36000,1.00884955752
290930,290936,291780,6,844,2,36000,1.00710900474
290931,290942,291752,11,810,2,36000,1.01358024691
290947,290953,291775,6,822,2,36000,1.00729927007
290978,290985,291751,7,766,2,36000,1.0091383812
290980,290991,291807,11,816,2,36000,1.01348039216
290981,290996,291766,15,770,2,36000,1.01948051948
291008,291014,291759,6,745,2,36000,1.00805369128
291009,291020,291821,11,801,2,36000,1.01373283396
291026,291032,291781,6,749,2,36000,1.00801068091
291083,291089,291840,6,751,2,36000,1.00798934754
291115,291495,295091,380,3596,32,3540,1.10567296997
291118,291124,291927,6,803,2,36000,1.00747198007
291134,291140,292106,6,966,2,36000,1.00621118012
291135,291146,291987,11,841,2,36000,1.01307966706
291151,291157,291959,6,802,2,36000,1.00748129676
291243,291249,291951,6,702,2,36000,1.00854700855
291264,291271,292204,7,933,2,36000,1.00750267953
291315,291321,292162,6,841,2,36000,1.00713436385
291316,291327,292338,11,1011,2,36000,1.01088031652
291332,291338,292147,6,809,2,36000,1.00741656366
291351,291357,292285,6,928,2,36000,1.00646551724
291380,291386,292072,6,686,2,36000,1.00874635569
291418,291425,292202,7,777,2,36000,1.00900900901
291440,291446,292216,6,770,2,36000,1.00779220779
291442,291452,292154,10,702,2,36000,1.01424501425
291483,291489,292395,6,906,2,36000,1.00662251656
291509,291515,292340,6,825,2,36000,1.00727272727
291532,291538,292304,6,766,2,36000,1.00783289817
291552,291557,292392,5,835,2,36000,1.00598802395
291553,291563,292392,10,829,2,36000,1.01206272618
291576,291582,292392,6,810,2,36000,1.00740740741
291577,291588,292392,11,804,2,36000,1.01368159204
291626,291632,292348,6,716,2,36000,1.00837988827
291628,291639,292392,11,753,2,36000,1.01460823373
291651,291658,292392,7,734,2,36000,1.00953678474
291653,291664,292392,11,728,2,36000,1.01510989011
291654,291669,292392,15,723,2,36000,1.02074688797
291656,291674,292392,18,718,2,36000,1.02506963788
291657,291680,292392,23,712,2,36000,1.03230337079
291735,291741,292392,6,651,2,36000,1.00921658986
291751,291757,292392,6,635,2,36000,1.0094488189
291752,291763,292392,11,629,2,36000,1.01748807631
291753,291768,292392,15,624,2,36000,1.02403846154
291769,291775,292392,6,617,2,36000,1.00972447326
291771,291781,292392,10,611,2,36000,1.01636661211
291788,291794,292392,6,598,2,36000,1.01003344482
291789,291800,292392,11,592,2,36000,1.01858108108
291790,291805,292392,15,587,2,36000,1.02555366269
291816,291822,292392,6,570,2,36000,1.01052631579
291837,291843,292392,6,549,2,36000,1.01092896175
291855,291861,292392,6,531,2,36000,1.01129943503
291936,291942,292392,6,450,2,36000,1.01333333333
291953,291959,292392,6,433,2,36000,1.01385681293
291973,291979,292392,6,413,2,36000,1.01452784504
291997,292003,292392,6,389,2,36000,1.01542416452
292076,292082,292392,6,310,2,36000,1.01935483871
292116,292122,292392,6,270,2,36000,1.02222222222
292150,292156,292392,6,236,2,36000,1.02542372881
292165,292172,292392,7,220,2,36000,1.03181818182
292167,292177,292392,10,215,2,36000,1.04651162791
292205,292211,292392,6,181,2,36000,1.03314917127
292206,292217,292392,11,175,2,36000,1.06285714286
292222,292227,292392,5,165,2,36000,1.0303030303
292288,292294,292392,6,98,2,36000,1.0612244898
292308,292314,292392,6,78,2,36000,1.07692307692
292342,292349,292392,7,43,2,36000,1.16279069767
292344,292355,292392,11,37,2,36000,1.2972972973
292361,292367,292393,6,26,2,36000,1.23076923077
292705,292711,292749,6,38,2,36000,1.15789473684
292706,292717,292754,11,37,2,36000,1.2972972973
292708,292722,292759,14,37,2,36000,1.37837837838
292709,292727,292765,18,38,2,36000,1.47368421053
292710,292733,292770,23,37,2,36000,1.62162162162
292712,292739,292776,27,37,2,36000,1.72972972973
292714,292744,292784,30,40,2,36000,1.75
292715,292749,292787,34,38,2,36000,1.89473684211
292716,292754,292793,38,39,2,36000,1.97435897436
292718,292760,292798,42,38,2,36000,2.10526315789
292719,292765,292803,46,38,2,36000,2.21052631579
292720,292770,292809,50,39,2,36000,2.28205128205
292722,292775,292815,53,40,2,36000,2.325
292723,292781,292822,58,41,2,36000,2.41463414634
292725,292786,292824,61,38,2,36000,2.60526315789
292726,292791,292829,65,38,2,36000,2.71052631579
292728,292796,292838,68,42,2,36000,2.61904761905
292729,292801,292841,72,40,2,36000,2.8
292731,292806,292845,75,39,2,36000,2.92307692308
292732,292813,292854,81,41,2,36000,2.9756097561
292733,292818,292857,85,39,2,36000,3.17948717949
292735,292825,292861,90,36,2,36000,3.5
292736,292830,292866,94,36,2,36000,3.61111111111
292737,292835,292871,98,36,2,36000,3.72222222222
292739,292840,292877,101,37,2,36000,3.72972972973
292741,292845,292882,104,37,2,36000,3.81081081081
292742,292851,292889,109,38,2,36000,3.86842105263
292744,292856,292895,112,39,2,36000,3.87179487179
292745,292861,292898,116,37,2,36000,4.13513513514
292747,292866,292901,119,35,2,36000,4.4
292748,292871,292907,123,36,2,36000,4.41666666667
292750,292877,292911,127,34,2,36000,4.73529411765
292751,292882,292911,131,29,2,36000,5.51724137931
292753,292887,292911,134,24,2,36000,6.58333333333
292755,292892,292911,137,19,2,36000,8.21052631579
292756,292897,292911,141,14,2,36000,11.0714285714
292758,292903,292913,145,10,2,36000,15.5
292760,292908,292912,148,4,2,36000,15.2
292762,292913,292914,151,1,2,36000,15.2
292764,292918,292919,154,1,2,36000,15.5
292766,292923,292924,157,1,2,36000,15.8
292768,292929,292932,161,3,2,36000,16.4
292770,292934,292936,164,2,2,36000,16.6
292772,292939,292943,167,4,2,36000,17.1
292774,292944,292945,170,1,2,36000,17.1
293237,293243,293902,6,659,2,36000,1.0091047041
293238,293249,293875,11,626,2,36000,1.01757188498
293240,293254,293888,14,634,2,36000,1.02208201893
293241,293259,293884,18,625,2,36000,1.0288
293242,293264,294397,22,1133,2,36000,1.01941747573
293244,293270,293913,26,643,2,36000,1.04043545879
293246,293276,293932,30,656,2,36000,1.04573170732
293247,293281,293933,34,652,2,36000,1.05214723926
293249,293286,294008,37,722,2,36000,1.0512465374
293250,293291,293922,41,631,2,36000,1.06497622821
293252,293296,293920,44,624,2,36000,1.07051282051
293253,293302,293938,49,636,2,36000,1.07704402516
293255,293307,293931,52,624,2,36000,1.08333333333
293257,293312,293943,55,631,2,36000,1.08716323296
293259,293317,293957,58,640,2,36000,1.090625
293261,293322,293950,61,628,2,36000,1.09713375796
293262,293327,293958,65,631,2,36000,1.1030110935
293264,293333,294006,69,673,2,36000,1.10252600297
293265,293338,293965,73,627,2,36000,1.11642743222
293267,293344,294014,77,670,2,36000,1.11492537313
293269,293349,293989,80,640,2,36000,1.125
293272,293354,293984,82,630,2,36000,1.13015873016
293275,293360,294091,85,731,2,36000,1.11627906977
293277,293365,294037,88,672,2,36000,1.13095238095
293279,293370,293992,91,622,2,36000,1.1463022508
293281,293375,293994,94,619,2,36000,1.15185783522
293282,293380,294002,98,622,2,36000,1.1575562701
293284,293385,294007,101,622,2,36000,1.16237942122
293286,293391,294010,105,619,2,36000,1.16962843296
293288,293396,294017,108,621,2,36000,1.17391304348
293292,293401,294025,109,624,2,36000,1.17467948718
293293,293406,294028,113,622,2,36000,1.18167202572
293295,293411,294029,116,618,2,36000,1.18770226537
293297,293417,294041,120,624,2,36000,1.19230769231
293299,293422,294052,123,630,2,36000,1.19523809524
293301,293427,294061,126,634,2,36000,1.19873817035
293302,293432,294171,130,739,2,36000,1.17591339648
293304,293437,294058,133,621,2,36000,1.21417069243
293306,293443,294069,137,626,2,36000,1.21884984026
293308,293448,294073,140,625,2,36000,1.224
293310,293453,294084,143,631,2,36000,1.22662440571
293313,293458,294083,145,625,2,36000,1.232
293315,293463,294092,148,629,2,36000,1.23529411765
293317,293469,294142,152,673,2,36000,1.22585438336
293319,293474,294103,155,629,2,36000,1.24642289348
293321,293479,294112,158,633,2,36000,1.24960505529
293323,293484,294313,161,829,2,36000,1.19420989144
293325,293490,294157,165,667,2,36000,1.24737631184
293327,293495,294177,168,682,2,36000,1.24633431085
293328,293500,294281,172,781,2,36000,1.22023047375
293331,293506,294145,175,639,2,36000,1.27386541471
293333,293511,294154,178,643,2,36000,1.2768273717
293335,293516,294163,181,647,2,36000,1.27975270479
293337,293521,294169,184,648,2,36000,1.28395061728
293339,293527,294158,188,631,2,36000,1.29793977813
293341,293532,294162,191,630,2,36000,1.30317460317
293343,293537,294186,194,649,2,36000,1.29892141757
293345,293543,294168,198,625,2,36000,1.3168
293347,293548,294258,201,710,2,36000,1.28309859155
293349,293553,294192,204,639,2,36000,1.31924882629
293351,293558,294180,207,622,2,36000,1.33279742765
293353,293563,294194,210,631,2,36000,1.33280507132
293355,293569,294211,214,642,2,36000,1.33333333333
293357,293825,294455,468,630,2,36000,1.74285714286
293359,293844,294533,485,689,2,36000,1.70391872279
293361,293855,294477,494,622,2,36000,1.79421221865
293363,293887,294507,524,620,2,36000,1.84516129032
293365,293895,294524,530,629,2,36000,1.8426073132
293366,293901,294525,535,624,2,36000,1.85737179487
293368,293913,294534,545,621,2,36000,1.87761674718
293369,293924,294534,555,610,2,36000,1.90983606557
293370,293931,294534,561,603,2,36000,1.93034825871
293372,293937,294534,565,597,2,36000,1.94639865997
293373,293943,294534,570,591,2,36000,1.96446700508
293375,293948,294534,573,586,2,36000,1.97781569966
293390,293954,294534,564,580,2,36000,1.9724137931
293391,293959,294534,568,575,2,36000,1.98782608696
293393,293965,294534,572,569,2,36000,2.00527240773
293394,293971,294534,577,563,2,36000,2.02486678508
293396,293976,294534,580,558,2,36000,2.0394265233
293397,293982,294534,585,552,2,36000,2.0597826087
293399,293988,294534,589,546,2,36000,2.07875457875
293400,293995,294534,595,539,2,36000,2.1038961039
293402,294002,294534,600,532,2,36000,2.12781954887
293403,294008,294534,605,526,2,36000,2.15019011407
293405,294013,294534,608,521,2,36000,2.1669865643
293406,294019,294534,613,515,2,36000,2.19029126214
293408,294024,294534,616,510,2,36000,2.20784313725
293409,294030,294534,621,504,2,36000,2.23214285714
293411,294035,294534,624,499,2,36000,2.250501002
293413,294041,294534,628,493,2,36000,2.2738336714
293415,294046,294534,631,488,2,36000,2.29303278689
293417,294052,294534,635,482,2,36000,2.31742738589
293419,294057,294534,638,477,2,36000,2.33752620545
293420,294062,294534,642,472,2,36000,2.36016949153
293422,294067,294534,645,467,2,36000,2.38115631692
293424,294073,294534,649,461,2,36000,2.40780911063
293425,294079,294535,654,456,2,36000,2.43421052632
293427,294084,294535,657,451,2,36000,2.45676274945
293429,294089,294535,660,446,2,36000,2.4798206278
293430,294094,294535,664,441,2,36000,2.50566893424
293432,294100,294535,668,435,2,36000,2.53563218391
293434,294105,294535,671,430,2,36000,2.56046511628
293436,294111,294535,675,424,2,36000,2.59198113208
293438,294116,294535,678,419,2,36000,2.61813842482
293440,294122,294535,682,413,2,36000,2.65133171913
293441,294127,294535,686,408,2,36000,2.68137254902
293443,294133,294535,690,402,2,36000,2.71641791045
293444,294139,294535,695,396,2,36000,2.75505050505
293446,294153,294535,707,382,2,36000,2.85078534031
293448,294159,294535,711,376,2,36000,2.89095744681
293450,294166,294535,716,369,2,36000,2.94037940379
293452,294172,294535,720,363,2,36000,2.98347107438
293453,294177,294535,724,358,2,36000,3.02234636872
293455,294184,294535,729,351,2,36000,3.07692307692
293877,294190,294535,313,345,2,36000,1.90724637681
293892,294195,294535,303,340,2,36000,1.89117647059
293893,294200,294535,307,335,2,36000,1.91641791045
293909,294205,294535,296,330,2,36000,1.89696969697
293927,294211,294535,284,324,2,36000,1.87654320988
293928,294216,294535,288,319,2,36000,1.90282131661
293930,294222,294535,292,313,2,36000,1.93290734824
293947,294227,294535,280,308,2,36000,1.90909090909
293949,294232,294535,283,303,2,36000,1.93399339934
293950,294238,294535,288,297,2,36000,1.9696969697
293952,294270,294535,318,265,2,36000,2.2
293953,294292,294535,339,243,2,36000,2.3950617284
293954,294324,294535,370,211,2,36000,2.75355450237
293970,294408,294535,438,127,2,36000,4.44881889764
293972,294466,294535,494,69,2,36000,8.15942028986
293973,294488,294535,515,47,2,36000,11.9574468085
293988,294518,294535,530,17,2,36000,32.1764705882
294686,294692,295280,6,588,2,36000,1.01020408163
294687,294698,295394,11,696,2,36000,1.0158045977
294688,294703,295412,15,709,2,36000,1.02115655853
294689,294708,295383,19,675,2,36000,1.02814814815
294691,294714,295471,23,757,2,36000,1.03038309115
294692,294719,295395,27,676,2,36000,1.0399408284
294694,294725,295398,31,673,2,36000,1.04606240713
294696,294730,295472,34,742,2,36000,1.04582210243
294698,294735,295434,37,699,2,36000,1.05293276109
294700,294740,295417,40,677,2,36000,1.05908419498
294702,294746,295397,44,651,2,36000,1.06758832565
294704,294751,295508,47,757,2,36000,1.06208718626
294705,294756,295475,51,719,2,36000,1.07093184979
294707,294761,295358,54,597,2,36000,1.09045226131
294709,294766,295399,57,633,2,36000,1.09004739336
294711,294771,295396,60,625,2,36000,1.096
294713,294777,295546,64,769,2,36000,1.08322496749
294714,294782,295456,68,674,2,36000,1.10089020772
294717,294787,295504,70,717,2,36000,1.09762900976
294718,294792,295574,74,782,2,36000,1.09462915601
294719,294797,295520,78,723,2,36000,1.10788381743
294721,294804,295546,83,742,2,36000,1.11185983827
294723,294809,295506,86,697,2,36000,1.12338593974
294725,294814,295473,89,659,2,36000,1.13505311077
294727,294819,295463,92,644,2,36000,1.14285714286
294728,294825,295618,97,793,2,36000,1.12232030265
294730,294830,295503,100,673,2,36000,1.1485884101
294732,294835,295557,103,722,2,36000,1.14265927978
294733,294840,295702,107,862,2,36000,1.12412993039
294735,294845,295453,110,608,2,36000,1.18092105263
294736,294850,295478,114,628,2,36000,1.18152866242
294738,294856,295536,118,680,2,36000,1.17352941176
294739,294861,295565,122,704,2,36000,1.17329545455
294741,294866,295576,125,710,2,36000,1.17605633803
294742,294871,295585,129,714,2,36000,1.18067226891
294744,294876,295601,132,725,2,36000,1.18206896552
294745,294882,295602,137,720,2,36000,1.19027777778
294747,294887,295593,140,706,2,36000,1.19830028329
294748,294892,295474,144,582,2,36000,1.24742268041
294749,294897,295517,148,620,2,36000,1.23870967742
294950,294956,295673,6,717,2,36000,1.00836820084
294952,294962,295604,10,642,2,36000,1.01557632399
294953,294967,295694,14,727,2,36000,1.01925722146
294954,294972,295695,18,723,2,36000,1.02489626556
294956,294978,295824,22,846,2,36000,1.02600472813
294957,294984,295744,27,760,2,36000,1.03552631579
294959,294989,295638,30,649,2,36000,1.04622496148
294960,294994,295639,34,645,2,36000,1.05271317829
294961,295000,295772,39,772,2,36000,1.05051813472
294963,295005,295670,42,665,2,36000,1.06315789474
294964,295010,295653,46,643,2,36000,1.07153965785
294966,295015,295636,49,621,2,36000,1.07890499195
294967,295020,295702,53,682,2,36000,1.07771260997
294969,295025,295765,56,740,2,36000,1.07567567568
294970,295031,295885,61,854,2,36000,1.07142857143
294972,295036,295867,64,831,2,36000,1.0770156438
294973,295041,295697,68,656,2,36000,1.10365853659
294974,295046,295644,72,598,2,36000,1.12040133779
294976,295051,295701,75,650,2,36000,1.11538461538
294977,295057,295778,80,721,2,36000,1.11095700416
295282,295288,295950,6,662,2,36000,1.00906344411
295391,295397,296050,6,653,2,36000,1.00918836141
295392,295403,296197,11,794,2,36000,1.01385390428
295418,295424,296081,6,657,2,36000,1.00913242009
295420,295430,296094,10,664,2,36000,1.01506024096
295421,295435,296198,14,763,2,36000,1.01834862385
295422,295440,296093,18,653,2,36000,1.02756508423
295424,295446,296102,22,656,2,36000,1.03353658537
295425,295452,296166,27,714,2,36000,1.03781512605
295427,295457,296056,30,599,2,36000,1.05008347245
295428,295462,296154,34,692,2,36000,1.04913294798
295455,295469,296179,14,710,2,36000,1.01971830986
295456,295474,296182,18,708,2,36000,1.02542372881
295477,295483,296179,6,696,2,36000,1.00862068966
295479,295489,296113,10,624,2,36000,1.01602564103
295480,295494,296179,14,685,2,36000,1.0204379562
295481,295500,296127,19,627,2,36000,1.0303030303
295483,295505,296098,22,593,2,36000,1.0370994941
295484,295511,296211,27,700,2,36000,1.03857142857
295485,295516,296240,31,724,2,36000,1.04281767956
295505,295521,296293,16,772,2,36000,1.0207253886
295507,295534,296231,27,697,2,36000,1.0387374462
295508,295528,297025,20,1497,32,7200,1.01336005344
295508,295539,296252,31,713,2,36000,1.04347826087
295510,295544,296246,34,702,2,36000,1.04843304843
295528,295550,296243,22,693,2,36000,1.03174603175
295529,295555,296272,26,717,2,36000,1.03626220363
295530,295561,296209,31,648,2,36000,1.04783950617
295551,295567,296262,16,695,2,36000,1.02302158273
295552,295572,296289,20,717,2,36000,1.02789400279
295553,295577,296247,24,670,2,36000,1.03582089552
295573,295584,296268,11,684,2,36000,1.01608187135
295574,295589,296279,15,690,2,36000,1.02173913043
295593,295599,296289,6,690,2,36000,1.00869565217
295594,295605,296301,11,696,2,36000,1.0158045977
295596,295610,296285,14,675,2,36000,1.02074074074
295597,295615,296309,18,694,2,36000,1.02593659942
295630,295636,296362,6,726,2,36000,1.00826446281
295632,295642,296373,10,731,2,36000,1.01367989056
295633,295647,296357,14,710,2,36000,1.01971830986
295635,295652,296467,17,815,2,36000,1.02085889571
295670,295676,296372,6,696,2,36000,1.00862068966
295672,295682,296508,10,826,2,36000,1.01210653753
295673,295687,296302,14,615,2,36000,1.02276422764
295674,295692,296467,18,775,2,36000,1.02322580645
295676,295697,296339,21,642,2,36000,1.03271028037
295677,295704,296439,27,735,2,36000,1.03673469388
295695,295709,296464,14,755,2,36000,1.01854304636
295697,295714,296466,17,752,2,36000,1.02260638298
295698,295719,296601,21,882,2,36000,1.02380952381
295717,295725,296367,8,642,2,36000,1.01246105919
295718,295731,296414,13,683,2,36000,1.01903367496
295719,295736,296472,17,736,2,36000,1.02309782609
295721,295742,296457,21,715,2,36000,1.02937062937
295746,295752,296318,6,566,2,36000,1.01060070671
295765,295771,296412,6,641,2,36000,1.00936037441
295781,295787,296406,6,619,2,36000,1.00969305331
295782,295793,296518,11,725,2,36000,1.01517241379
295826,295832,296537,6,705,2,36000,1.0085106383
295869,295875,296617,6,742,2,36000,1.00808625337
295903,295909,296800,6,891,2,36000,1.00673400673
295949,295955,296606,6,651,2,36000,1.00921658986
296050,296056,296831,6,775,2,36000,1.00774193548
296065,296071,296902,6,831,2,36000,1.00722021661
296084,296090,296749,6,659,2,36000,1.0091047041
296101,296108,296734,7,626,2,36000,1.01118210863
296103,296113,296768,10,655,2,36000,1.01526717557
296104,296119,296830,15,711,2,36000,1.02109704641
296105,296124,296917,19,793,2,36000,1.02395964691
296123,296130,297183,7,1053,2,36000,1.00664767331
296140,296146,297057,6,911,2,36000,1.00658616905
296161,296168,296809,7,641,2,36000,1.01092043682
296187,296193,296879,6,686,2,36000,1.00874635569
296188,296199,296903,11,704,2,36000,1.015625
296190,296204,296970,14,766,2,36000,1.0182767624
296191,296209,296901,18,692,2,36000,1.02601156069
296192,296215,296890,23,675,2,36000,1.03407407407
296211,296221,296889,10,668,2,36000,1.01497005988
296213,296226,296947,13,721,2,36000,1.01803051318
296214,296231,296982,17,751,2,36000,1.02263648469
296215,296237,296887,22,650,2,36000,1.03384615385
296232,296243,296997,11,754,2,36000,1.01458885942
296250,296256,297158,6,902,2,36000,1.0066518847
296252,296262,296964,10,702,2,36000,1.01424501425
296253,296267,296955,14,688,2,36000,1.02034883721
296254,296272,296989,18,717,2,36000,1.02510460251
296271,296278,297046,7,768,2,36000,1.00911458333
296272,296283,297080,11,797,2,36000,1.01380175659
296274,296289,297020,15,731,2,36000,1.02051983584
296275,296294,297093,19,799,2,36000,1.02377972466
296293,296300,297030,7,730,2,36000,1.0095890411
296295,296306,296969,11,663,2,36000,1.01659125189
296296,296311,297032,15,721,2,36000,1.02080443828
296297,296316,297092,19,776,2,36000,1.02448453608
296299,296322,297069,23,747,2,36000,1.03078982597
296316,296328,296982,12,654,2,36000,1.01834862385
296317,296333,296993,16,660,2,36000,1.02424242424
296319,296339,297072,20,733,2,36000,1.0272851296
296335,296345,297055,10,710,2,36000,1.01408450704
296354,296361,297113,7,752,2,36000,1.00930851064
296374,296380,297131,6,751,2,36000,1.00798934754
296375,296386,297182,11,796,2,36000,1.01381909548
296376,296391,297021,15,630,2,36000,1.02380952381
296378,296396,297250,18,854,2,36000,1.02107728337
296379,296402,297164,23,762,2,36000,1.03018372703
296463,296469,297240,6,771,2,36000,1.00778210117
296464,296474,297141,10,667,2,36000,1.01499250375
296466,296480,297081,14,601,2,36000,1.02329450915
296468,296485,297256,17,771,2,36000,1.02204928664
296469,296490,297279,21,789,2,36000,1.02661596958
296491,296497,297242,6,745,2,36000,1.00805369128
296492,296503,297143,11,640,2,36000,1.0171875
296494,296508,297185,14,677,2,36000,1.02067946824
296495,296513,297235,18,722,2,36000,1.02493074792
296496,296518,297361,22,843,2,36000,1.02609727165
296516,296525,297249,9,724,2,36000,1.01243093923
296535,296542,297145,7,603,2,36000,1.01160862355
296553,296559,297211,6,652,2,36000,1.00920245399
296613,296619,297332,6,713,2,36000,1.00841514727
296614,296625,297345,11,720,2,36000,1.01527777778
296630,296637,297306,7,669,2,36000,1.01046337818
296736,296743,297468,7,725,2,36000,1.00965517241
296755,296761,297447,6,686,2,36000,1.00874635569
296772,296779,297417,7,638,2,36000,1.01097178683
296801,296808,297676,7,868,2,36000,1.00806451613
296816,296822,297495,6,673,2,36000,1.00891530461
296832,296838,297455,6,617,2,36000,1.00972447326
296833,296844,297563,11,719,2,36000,1.01529902643
296883,296890,297549,7,659,2,36000,1.01062215478
296904,296910,297565,6,655,2,36000,1.00916030534
296906,296916,297748,10,832,2,36000,1.01201923077
296907,296921,297676,14,755,2,36000,1.01854304636
296908,296927,297609,19,682,2,36000,1.02785923754
296910,296932,297611,22,679,2,36000,1.0324005891
296911,296938,297692,27,754,2,36000,1.03580901857
296943,296949,297627,6,678,2,36000,1.00884955752
296962,296969,297724,7,755,2,36000,1.00927152318
296964,296975,297770,11,795,2,36000,1.01383647799
296979,296985,297633,6,648,2,36000,1.00925925926
296981,296991,297723,10,732,2,36000,1.01366120219
296982,296996,297581,14,585,2,36000,1.02393162393
297002,297008,297746,6,738,2,36000,1.0081300813
297004,297014,297863,10,849,2,36000,1.01177856302
297005,297019,297730,14,711,2,36000,1.01969057665
297006,297025,297775,19,750,2,36000,1.02533333333
297008,297030,297709,22,679,2,36000,1.0324005891
297024,297036,297668,12,632,2,36000,1.01898734177
297026,297041,297834,15,793,2,36000,1.01891551072
297042,297048,297712,6,664,2,36000,1.00903614458
297044,297054,297782,10,728,2,36000,1.01373626374
297062,297068,297764,6,696,2,36000,1.00862068966
297063,297074,297720,11,646,2,36000,1.01702786378
297065,297079,297771,14,692,2,36000,1.02023121387
297082,297091,297680,9,589,2,36000,1.01528013582
297083,297096,297887,13,791,2,36000,1.01643489254
297084,297101,297875,17,774,2,36000,1.02196382429
297086,297107,297760,21,653,2,36000,1.03215926493
297104,297113,297826,9,713,2,36000,1.0126227209
297106,297118,297829,12,711,2,36000,1.01687763713
297121,297127,297970,6,843,2,36000,1.00711743772
297136,297142,297762,6,620,2,36000,1.00967741935
297151,297158,297847,7,689,2,36000,1.01015965167
297153,297164,297842,11,678,2,36000,1.01622418879
297154,297169,297871,15,702,2,36000,1.02136752137
297169,297175,297919,6,744,2,36000,1.00806451613
297170,297181,297957,11,776,2,36000,1.01417525773
297186,297192,297944,6,752,2,36000,1.0079787234
297187,297198,297864,11,666,2,36000,1.01651651652
297188,297203,297904,15,701,2,36000,1.02139800285
297214,297220,297874,6,654,2,36000,1.00917431193
297235,297242,297856,7,614,2,36000,1.01140065147
297252,297258,297934,6,676,2,36000,1.00887573964
297253,297264,297922,11,658,2,36000,1.01671732523
297254,297269,298087,15,818,2,36000,1.01833740831
297256,297275,298029,19,754,2,36000,1.02519893899
297273,297281,298023,8,742,2,36000,1.01078167116
297288,297294,297991,6,697,2,36000,1.00860832138
297306,297312,298019,6,707,2,36000,1.00848656294
297332,297338,298074,6,736,2,36000,1.00815217391
297348,297355,298153,7,798,2,36000,1.00877192982
297364,297370,298032,6,662,2,36000,1.00906344411
297419,297425,298140,6,715,2,36000,1.00839160839
297449,297455,298108,6,653,2,36000,1.00918836141
297464,297470,298251,6,781,2,36000,1.00768245839
297479,297485,298239,6,754,2,36000,1.00795755968
297497,297504,298206,7,702,2,36000,1.00997150997
297552,297558,298275,6,717,2,36000,1.00836820084
297567,297573,298395,6,822,2,36000,1.00729927007
297568,297579,298332,11,753,2,36000,1.01460823373
297583,297589,298233,6,644,2,36000,1.00931677019
297611,297617,298326,6,709,2,36000,1.00846262341
297612,297623,298307,11,684,2,36000,1.01608187135
297627,297633,298425,6,792,2,36000,1.00757575758
297642,297648,298403,6,755,2,36000,1.00794701987
297669,297676,298416,7,740,2,36000,1.00945945946
297685,297691,298415,6,724,2,36000,1.00828729282
297686,297697,298362,11,665,2,36000,1.01654135338
297687,297702,298555,15,853,2,36000,1.01758499414
297704,297710,298471,6,761,2,36000,1.00788436268
297720,297726,298457,6,731,2,36000,1.00820793434
297721,297737,298402,16,665,2,36000,1.02406015038
297722,297742,298378,20,636,2,36000,1.03144654088
297739,297748,298394,9,646,2,36000,1.01393188854
297740,297753,298459,13,706,2,36000,1.01841359773
297742,297758,298493,16,735,2,36000,1.02176870748
297763,297770,298436,7,666,2,36000,1.01051051051
297765,297776,298412,11,636,2,36000,1.01729559748
297766,297781,298506,15,725,2,36000,1.02068965517
297767,297787,298611,20,824,2,36000,1.02427184466
297787,297793,298483,6,690,2,36000,1.00869565217
297788,297799,298639,11,840,2,36000,1.0130952381
297790,297804,298519,14,715,2,36000,1.01958041958
297791,297809,298537,18,728,2,36000,1.02472527473
297792,297814,298504,22,690,2,36000,1.03188405797
297827,297833,298668,6,835,2,36000,1.00718562874
297842,297848,298539,6,691,2,36000,1.00868306802
297844,297854,298558,10,704,2,36000,1.01420454545
297845,297859,298649,14,790,2,36000,1.01772151899
297860,297867,298709,7,842,2,36000,1.00831353919
297862,297873,298507,11,634,2,36000,1.01735015773
297878,297884,298590,6,706,2,36000,1.00849858357
297879,297890,298637,11,747,2,36000,1.01472556894
297880,297895,298686,15,791,2,36000,1.01896333755
297882,297900,298558,18,658,2,36000,1.0273556231
297883,297906,298524,23,618,2,36000,1.03721682848
297900,297912,298685,12,773,2,36000,1.01552393273
297916,297922,298640,6,718,2,36000,1.00835654596
297932,297938,298630,6,692,2,36000,1.00867052023
297933,297944,298677,11,733,2,36000,1.01500682128
297949,297955,298655,6,700,2,36000,1.00857142857
297950,297961,298609,11,648,2,36000,1.01697530864
297969,297975,298664,6,689,2,36000,1.00870827286
297984,297990,298633,6,643,2,36000,1.00933125972
298001,298008,298690,7,682,2,36000,1.01026392962
298023,298030,298829,7,799,2,36000,1.00876095119
298025,298036,298678,11,642,2,36000,1.01713395639
298043,298049,298636,6,587,2,36000,1.01022146508
298044,298055,298700,11,645,2,36000,1.01705426357
298075,298081,298795,6,714,2,36000,1.00840336134
298090,298096,298817,6,721,2,36000,1.00832177531
298108,298114,298926,6,812,2,36000,1.00738916256
298142,298148,298870,6,722,2,36000,1.00831024931
298157,298163,298962,6,799,2,36000,1.00750938673
298206,298213,298944,7,731,2,36000,1.00957592339
298234,298240,298961,6,721,2,36000,1.00832177531
298249,298255,298988,6,733,2,36000,1.00818553888
298264,298270,299012,6,742,2,36000,1.00808625337
298279,298285,298972,6,687,2,36000,1.00873362445
298308,298314,299080,6,766,2,36000,1.00783289817
298328,298334,298928,6,594,2,36000,1.0101010101
298345,298351,299084,6,733,2,36000,1.00818553888
298363,298369,299006,6,637,2,36000,1.00941915228
298378,298384,299040,6,656,2,36000,1.00914634146
298398,298404,299132,6,728,2,36000,1.00824175824
298399,298410,299041,11,631,2,36000,1.01743264659
298421,298427,299097,6,670,2,36000,1.00895522388
298422,298433,299118,11,685,2,36000,1.01605839416
298423,298438,299069,15,631,2,36000,1.02377179081
298425,298443,299247,18,804,2,36000,1.0223880597
298426,298449,299147,23,698,2,36000,1.0329512894
298447,298455,299268,8,813,2,36000,1.0098400984
298448,298460,299119,12,659,2,36000,1.01820940819
298463,298472,299135,9,663,2,36000,1.01357466063
298465,298477,299120,12,643,2,36000,1.01866251944
298481,298492,299234,11,742,2,36000,1.01482479784
298496,298502,299184,6,682,2,36000,1.00879765396
298497,298508,299213,11,705,2,36000,1.01560283688
298506,298514,340640,8,42126,4,216000,1.00018990647
298517,298523,299200,6,677,2,36000,1.00886262925
298519,298529,299270,10,741,2,36000,1.01349527665
298520,298534,299201,14,667,2,36000,1.02098950525
298526,298540,337461,14,38921,4,216000,1.00035970299
298536,298546,299226,10,680,2,36000,1.01470588235
298537,298551,299368,14,817,2,36000,1.01713586291
298555,298561,299154,6,593,2,36000,1.01011804384
298557,298567,299390,10,823,2,36000,1.01215066829
298558,298572,299221,14,649,2,36000,1.02157164869
298574,298580,299431,6,851,2,36000,1.00705052879
298575,298586,299365,11,779,2,36000,1.01412066752
298590,298596,299374,6,778,2,36000,1.00771208226
298612,298618,299346,6,728,2,36000,1.00824175824
298613,298624,299437,11,813,2,36000,1.0135301353
298631,298637,299365,6,728,2,36000,1.00824175824
298647,298653,299314,6,661,2,36000,1.00907715582
298648,298659,299318,11,659,2,36000,1.01669195751
298650,298664,299371,14,707,2,36000,1.0198019802
298651,298670,299404,19,734,2,36000,1.02588555858
298652,298675,299251,23,576,2,36000,1.03993055556
298668,298681,299298,13,617,2,36000,1.02106969206
298670,298687,299412,17,725,2,36000,1.02344827586
298671,298692,299458,21,766,2,36000,1.0274151436
298672,298697,299419,25,722,2,36000,1.03462603878
298696,298704,299255,8,551,2,36000,1.01451905626
298697,298709,299487,12,778,2,36000,1.01542416452
298698,298715,299363,17,648,2,36000,1.0262345679
298700,298720,299402,20,682,2,36000,1.0293255132
298701,298726,299437,25,711,2,36000,1.03516174402
298717,298732,299315,15,583,2,36000,1.02572898799
298718,298737,299458,19,721,2,36000,1.02635228849
298798,298805,299519,7,714,2,36000,1.00980392157
298817,298823,299458,6,635,2,36000,1.0094488189
298832,298838,299541,6,703,2,36000,1.00853485064
298871,298878,299604,7,726,2,36000,1.00964187328
298929,298935,299600,6,665,2,36000,1.00902255639
298930,298941,299615,11,674,2,36000,1.01632047478
298945,298951,299637,6,686,2,36000,1.00874635569
298964,298970,299747,6,777,2,36000,1.00772200772
298965,298976,299689,11,713,2,36000,1.01542776999
298980,298986,299605,6,619,2,36000,1.00969305331
298995,299000,299705,5,705,2,36000,1.00709219858
299010,299016,299689,6,673,2,36000,1.00891530461
299024,299031,299938,7,907,2,36000,1.00771775083
299043,299049,299940,6,891,2,36000,1.00673400673
299044,299055,299810,11,755,2,36000,1.01456953642
299071,299077,299855,6,778,2,36000,1.00771208226
299086,299092,299758,6,666,2,36000,1.00900900901
299087,299098,299776,11,678,2,36000,1.01622418879
299102,299108,299703,6,595,2,36000,1.01008403361
299106,299114,331266,8,32152,1,511200,1.00024881811
299121,299128,299785,7,657,2,36000,1.01065449011
299123,299133,299837,10,704,2,36000,1.01420454545
299124,299145,299877,21,732,2,36000,1.02868852459
299133,299139,389119,6,89980,4,216000,1.00006668148
299140,299151,299832,11,681,2,36000,1.01615271659
299141,299156,299872,15,716,2,36000,1.02094972067
299157,299169,299807,12,638,2,36000,1.01880877743
299158,299174,299823,16,649,2,36000,1.02465331279
299161,342098,355202,42937,13104,128,36000,4.27663308913
299183,355214,358813,56031,3599,128,36000,16.5684912476
299185,299192,299883,7,691,2,36000,1.01013024602
299188,358826,362356,59638,3530,128,36000,17.8946175637
299200,299207,299873,7,666,2,36000,1.01051051051
299202,299215,299892,13,677,2,36000,1.01920236337
299216,299231,299945,15,714,2,36000,1.02100840336
299232,299239,299908,7,669,2,36000,1.01046337818
299233,299246,299906,13,660,2,36000,1.0196969697
299248,299256,299986,8,730,2,36000,1.01095890411
299250,299263,299936,13,673,2,36000,1.01931649331
299265,299271,300004,6,733,2,36000,1.00818553888
299267,299278,299902,11,624,2,36000,1.01762820513
299282,299288,299984,6,696,2,36000,1.00862068966
299283,299296,299959,13,663,2,36000,1.01960784314
299299,299305,300039,6,734,2,36000,1.00817438692
299309,299315,299319,6,4,1,86400,1.0
299315,299322,300057,7,735,2,36000,1.00952380952
299316,299327,299991,11,664,2,36000,1.01656626506
299331,299338,300124,7,786,2,36000,1.00890585242
299346,299353,299939,7,586,2,36000,1.01194539249
299364,299370,299383,6,13,1,86400,1.46153846154
299365,299377,299996,12,619,2,36000,1.01938610662
299366,299382,300093,16,711,2,36000,1.02250351617
299368,299388,300505,20,1117,2,36000,1.01790510295
299369,299393,300194,24,801,2,36000,1.02996254682
299385,299400,300121,15,721,2,36000,1.02080443828
299386,299405,300161,19,756,2,36000,1.02513227513
299402,299412,300058,10,646,2,36000,1.01547987616
299403,299417,300125,14,708,2,36000,1.0197740113
299425,299432,300082,7,650,2,36000,1.01076923077
299427,299439,300165,12,726,2,36000,1.01652892562
299428,299444,300145,16,701,2,36000,1.02282453638
299448,299454,300251,6,797,2,36000,1.00752823087
299449,299461,300242,12,781,2,36000,1.01536491677
299450,299467,300110,17,643,2,36000,1.02643856921
299466,299474,300226,8,752,2,36000,1.01063829787
299467,299479,300185,12,706,2,36000,1.01699716714
299469,299486,300101,17,615,2,36000,1.02764227642
299490,299497,300136,7,639,2,36000,1.01095461659
299520,299526,300197,6,671,2,36000,1.00894187779
299541,299547,310073,6,10526,2,36000,1.0005700171
299542,299555,300175,13,620,2,36000,1.02096774194
299572,331278,340069,31706,8791,1,86400,4.60664315777
299601,299607,300238,6,631,2,36000,1.00950871632
299618,299624,300323,6,699,2,36000,1.00858369099
299619,299632,299637,13,5,4,30,1.8
299620,299637,300394,17,757,2,36000,1.02245706737
299621,299642,300225,21,583,2,36000,1.03602058319
299638,299649,300603,11,954,2,36000,1.01153039832
299690,299696,300443,6,747,2,36000,1.00803212851
299691,299704,300331,13,627,2,36000,1.02073365231
299709,299718,300553,9,835,2,36000,1.01077844311
299711,299723,300330,12,607,2,36000,1.0197693575
299750,299757,300405,7,648,2,36000,1.01080246914
299767,299774,300484,7,710,2,36000,1.00985915493
299782,299790,300503,8,713,2,36000,1.01122019635
299797,299804,300477,7,673,2,36000,1.01040118871
299813,299820,300498,7,678,2,36000,1.01032448378
299814,299825,300572,11,747,2,36000,1.01472556894
299832,299838,300702,6,864,2,36000,1.00694444444
299833,299846,300567,13,721,2,36000,1.01803051318
299848,299854,300570,6,716,2,36000,1.00837988827
299863,299870,300588,7,718,2,36000,1.00974930362
299883,299890,300534,7,644,2,36000,1.01086956522
299885,299897,300668,12,771,2,36000,1.01556420233
299886,299902,300712,16,810,2,36000,1.01975308642
299887,299907,300624,20,717,2,36000,1.02789400279
299903,299914,300627,11,713,2,36000,1.01542776999
299904,299919,300615,15,696,2,36000,1.02155172414
299919,299926,300623,7,697,2,36000,1.01004304161
299921,299937,300590,16,653,2,36000,1.02450229709
299935,299944,300690,9,746,2,36000,1.01206434316
299952,299958,300574,6,616,2,36000,1.00974025974
299953,299965,300578,12,613,2,36000,1.01957585644
299954,299971,300717,17,746,2,36000,1.02278820375
299956,299976,300579,20,603,2,36000,1.03316749585
299971,299983,300731,12,748,2,36000,1.01604278075
299986,299993,300660,7,667,2,36000,1.01049475262
299988,300000,300703,12,703,2,36000,1.01706970128
300003,300010,300756,7,746,2,36000,1.00938337802
300005,300016,300758,11,742,2,36000,1.01482479784
300006,300023,300752,17,729,2,36000,1.02331961591
300039,300045,300829,6,784,2,36000,1.00765306122
300058,300064,300753,6,689,2,36000,1.00870827286
300059,300072,300813,13,741,2,36000,1.01754385965
300078,300264,302290,186,2026,32,7200,1.0918065153
300084,300090,300785,6,695,2,36000,1.00863309353
300099,300106,300738,7,632,2,36000,1.01107594937
300101,300112,300853,11,741,2,36000,1.01484480432
300116,300123,300896,7,773,2,36000,1.00905562743
300132,300139,300929,7,790,2,36000,1.00886075949
300133,300145,300771,12,626,2,36000,1.01916932907
300135,300152,300766,17,614,2,36000,1.02768729642
300150,300159,300861,9,702,2,36000,1.01282051282
300151,300164,300735,13,571,2,36000,1.02276707531
300167,300174,300878,7,704,2,36000,1.00994318182
300168,300180,300909,12,729,2,36000,1.01646090535
300183,300189,300861,6,672,2,36000,1.00892857143
300199,300206,300982,7,776,2,36000,1.00902061856
300200,300213,300858,13,645,2,36000,1.02015503876
300202,300218,300824,16,606,2,36000,1.02640264026
300227,300233,301153,6,920,2,36000,1.00652173913
300228,300241,300837,13,596,2,36000,1.02181208054
300244,300250,300991,6,741,2,36000,1.00809716599
300245,300257,300891,12,634,2,36000,1.01892744479
300260,300270,301062,10,792,2,36000,1.01262626263
300322,300328,300930,6,602,2,36000,1.00996677741
300338,300344,300931,6,587,2,36000,1.01022146508
300339,300350,301080,11,730,2,36000,1.01506849315
300394,300400,300944,6,544,2,36000,1.01102941176
300409,300416,301160,7,744,2,36000,1.00940860215
300445,300451,301154,6,703,2,36000,1.00853485064
300478,300484,301334,6,850,2,36000,1.00705882353
300494,300500,301029,6,529,2,36000,1.01134215501
300510,300517,301265,7,748,2,36000,1.00935828877
300512,300523,301182,11,659,2,36000,1.01669195751
300513,300529,301164,16,635,2,36000,1.02519685039
300536,300543,301311,7,768,2,36000,1.00911458333
300555,300561,301219,6,658,2,36000,1.00911854103
300571,300577,301298,6,721,2,36000,1.00832177531
300572,300585,301359,13,774,2,36000,1.01679586563
300588,300594,301453,6,859,2,36000,1.00698486612
300590,300602,301346,12,744,2,36000,1.01612903226
300591,300607,301254,16,647,2,36000,1.02472952087
300592,300613,301424,21,811,2,36000,1.02589395808
300593,300618,301297,25,679,2,36000,1.03681885125
300610,300625,301284,15,659,2,36000,1.02276176024
300611,300630,301243,19,613,2,36000,1.03099510604
300627,300637,301324,10,687,2,36000,1.01455604076
300629,300642,301300,13,658,2,36000,1.01975683891
300630,300648,301342,18,694,2,36000,1.02593659942
300631,300655,301320,24,665,2,36000,1.03609022556
300667,300674,301227,7,553,2,36000,1.01265822785
300669,300682,301327,13,645,2,36000,1.02015503876
300690,300698,301413,8,715,2,36000,1.01118881119
300705,300713,301411,8,698,2,36000,1.01146131805
300707,300718,301485,11,767,2,36000,1.01434159061
300722,300729,301383,7,654,2,36000,1.01070336391
300723,300736,301403,13,667,2,36000,1.01949025487
300739,300745,301468,6,723,2,36000,1.00829875519
300741,300752,301436,11,684,2,36000,1.01608187135
300742,300757,301459,15,702,2,36000,1.02136752137
300752,300764,330121,12,29357,2,43200,1.00040876111
300758,300771,301417,13,646,2,36000,1.02012383901
300759,300776,301575,17,799,2,36000,1.02127659574
300761,300781,301501,20,720,2,36000,1.02777777778
300762,300787,301370,25,583,2,36000,1.04288164666
300779,300794,301508,15,714,2,36000,1.02100840336
300780,300799,301460,19,661,2,36000,1.02874432678
300795,300806,301405,11,599,2,36000,1.0183639399
300813,300819,301486,6,667,2,36000,1.00899550225
300828,300834,301559,6,725,2,36000,1.00827586207
300843,300850,301686,7,836,2,36000,1.00837320574
300844,300856,301503,12,647,2,36000,1.01854714065
300861,300869,301581,8,712,2,36000,1.01123595506
300862,300875,301533,13,658,2,36000,1.01975683891
300863,300881,301523,18,642,2,36000,1.02803738318
300878,300888,301574,10,686,2,36000,1.01457725948
300880,300894,301548,14,654,2,36000,1.02140672783
300895,300903,301703,8,800,2,36000,1.01
300910,300917,301621,7,704,2,36000,1.00994318182
300911,300924,301676,13,752,2,36000,1.01728723404
300930,300936,301590,6,654,2,36000,1.00917431193
300931,300943,301642,12,699,2,36000,1.01716738197
300947,300954,301643,7,689,2,36000,1.01015965167
300948,300961,301699,13,738,2,36000,1.01761517615
300987,300994,301748,7,754,2,36000,1.00928381963
301002,301009,301759,7,750,2,36000,1.00933333333
301030,301037,301653,7,616,2,36000,1.01136363636
301065,301072,301860,7,788,2,36000,1.00888324873
301082,301088,301726,6,638,2,36000,1.00940438871
301152,301158,301829,6,671,2,36000,1.00894187779
301167,301175,301992,8,817,2,36000,1.00979192166
301168,301180,301858,12,678,2,36000,1.01769911504
301170,301187,301992,17,805,2,36000,1.02111801242
301185,301194,301899,9,705,2,36000,1.01276595745
301222,301229,301885,7,656,2,36000,1.01067073171
301237,301244,301935,7,691,2,36000,1.01013024602
301243,363388,401657,62145,38269,10,57600,2.62389923959
301252,301258,301945,6,687,2,36000,1.00873362445
301270,301276,301992,6,716,2,36000,1.00837988827
301272,301282,302073,10,791,2,36000,1.01264222503
301289,301296,301939,7,643,2,36000,1.01088646967
301304,301311,302008,7,697,2,36000,1.01004304161
301306,301318,301990,12,672,2,36000,1.01785714286
301307,301324,302016,17,692,2,36000,1.02456647399
301323,301331,301972,8,641,2,36000,1.01248049922
301324,301336,301987,12,651,2,36000,1.01843317972
301325,301343,302118,18,775,2,36000,1.02322580645
301338,310100,356526,8762,46426,1,576000,1.18873045276
301341,301350,302061,9,711,2,36000,1.01265822785
301342,301355,301986,13,631,2,36000,1.0206022187
301344,301362,301995,18,633,2,36000,1.02843601896
301359,301369,302147,10,778,2,36000,1.01285347044
301360,301374,302023,14,649,2,36000,1.02157164869
301376,301384,302034,8,650,2,36000,1.01230769231
301391,301398,302119,7,721,2,36000,1.00970873786
301406,301412,302117,6,705,2,36000,1.0085106383
301407,301420,302090,13,670,2,36000,1.01940298507
301423,301430,302139,7,709,2,36000,1.00987306065
301424,301435,302043,11,608,2,36000,1.01809210526
301426,301443,302048,17,605,2,36000,1.02809917355
301427,301448,302162,21,714,2,36000,1.02941176471
301442,301455,302100,13,645,2,36000,1.02015503876
301457,301464,302064,7,600,2,36000,1.01166666667
301472,301479,302298,7,819,2,36000,1.00854700855
301474,301486,302186,12,700,2,36000,1.01714285714
301475,301491,302080,16,589,2,36000,1.02716468591
301490,301498,302309,8,811,2,36000,1.00986436498
301491,301503,302125,12,622,2,36000,1.0192926045
301507,301515,302249,8,734,2,36000,1.01089918256
301508,301520,302232,12,712,2,36000,1.01685393258
301523,301531,302244,8,713,2,36000,1.01122019635
301525,301536,302223,11,687,2,36000,1.01601164483
301539,301546,302553,7,1007,2,36000,1.00695134062
301554,301561,302284,7,723,2,36000,1.00968188105
301569,301576,302344,7,768,2,36000,1.00911458333
301585,301592,302516,7,924,2,36000,1.00757575758
301586,301599,302322,13,723,2,36000,1.01798063624
301587,301604,302235,17,631,2,36000,1.02694136292
301602,301612,302269,10,657,2,36000,1.01522070015
301620,301627,302340,7,713,2,36000,1.00981767181
301645,301651,302405,6,754,2,36000,1.00795755968
301647,301659,302510,12,851,2,36000,1.01410105758
301662,301668,302387,6,719,2,36000,1.0083449235
301676,301684,302305,8,621,2,36000,1.01288244767
301680,328857,329244,27177,387,1,511200,71.2248062016
301691,301698,302367,7,669,2,36000,1.01046337818
301708,301715,302428,7,713,2,36000,1.00981767181
301709,301722,302458,13,736,2,36000,1.01766304348
301727,301735,302360,8,625,2,36000,1.0128
301754,329256,386298,27502,57042,1,439200,1.48213596999
301754,301760,302566,6,806,2,36000,1.00744416873
301769,301775,302490,6,715,2,36000,1.00839160839
301769,331130,386364,29361,55234,1,439200,1.53157475468
301830,301837,302584,7,747,2,36000,1.0093708166
301862,301868,302735,6,867,2,36000,1.00692041522
301863,301876,302510,13,634,2,36000,1.02050473186
301886,301893,302527,7,634,2,36000,1.01104100946
301901,301907,302590,6,683,2,36000,1.00878477306
301937,301944,302666,7,722,2,36000,1.00969529086
301952,301960,302632,8,672,2,36000,1.0119047619
301954,301965,302656,11,691,2,36000,1.01591895803
301974,301981,302720,7,739,2,36000,1.00947225981
301991,301998,302675,7,677,2,36000,1.01033973412
301992,302005,302659,13,654,2,36000,1.01987767584
301993,302011,302731,18,720,2,36000,1.025
301995,302016,302715,21,699,2,36000,1.03004291845
302017,302023,302668,6,645,2,36000,1.00930232558
302018,302031,302738,13,707,2,36000,1.01838755304
302019,302036,302812,17,776,2,36000,1.02190721649
302020,302042,302697,22,655,2,36000,1.03358778626
302022,302047,302807,25,760,2,36000,1.03289473684
302043,302054,302705,11,651,2,36000,1.01689708141
302044,302059,302729,15,670,2,36000,1.0223880597
302046,302065,302809,19,744,2,36000,1.02553763441
302069,302076,302778,7,702,2,36000,1.00997150997
302070,302083,302751,13,668,2,36000,1.01946107784
302071,302088,302746,17,658,2,36000,1.02583586626
302092,302099,302837,7,738,2,36000,1.00948509485
302093,302106,302856,13,750,2,36000,1.01733333333
302094,302111,302935,17,824,2,36000,1.02063106796
302110,302118,302900,8,782,2,36000,1.01023017903
302125,302132,303072,7,940,2,36000,1.00744680851
302126,302138,302889,12,751,2,36000,1.01597869507
302127,302145,302927,18,782,2,36000,1.02301790281
302129,302150,302866,21,716,2,36000,1.02932960894
302144,302158,302745,14,587,2,36000,1.02385008518
302159,302167,302952,8,785,2,36000,1.0101910828
302174,302181,302955,7,774,2,36000,1.00904392765
302189,302195,302965,6,770,2,36000,1.00779220779
302225,302232,302889,7,657,2,36000,1.01065449011
302241,302249,302920,8,671,2,36000,1.01192250373
302242,302254,302958,12,704,2,36000,1.01704545455
302258,302265,302967,7,702,2,36000,1.00997150997
302259,302271,303074,12,803,2,36000,1.01494396015
302274,302282,302978,8,696,2,36000,1.01149425287
302289,302296,302945,7,649,2,36000,1.01078582435
302292,302303,331118,11,28815,1,28800,1.00038174562
302305,302311,302972,6,661,2,36000,1.00907715582
302306,302318,303451,12,1133,2,36000,1.0105913504
302321,302328,302979,7,651,2,36000,1.01075268817
302323,302336,302918,13,582,2,36000,1.02233676976
302342,302349,302933,7,584,2,36000,1.01198630137
302356,302364,303101,8,737,2,36000,1.01085481682
302371,302378,303115,7,737,2,36000,1.00949796472
302373,302385,303123,12,738,2,36000,1.0162601626
302388,302394,303122,6,728,2,36000,1.00824175824
302388,302750,302759,362,9,32,3600,37.1
302406,302413,303145,7,732,2,36000,1.00956284153
302428,302435,303055,7,620,2,36000,1.01129032258
302458,302465,303287,7,822,2,36000,1.00851581509
302491,302498,303189,7,691,2,36000,1.01013024602
302509,302515,303220,6,705,2,36000,1.0085106383
302524,302531,303230,7,699,2,36000,1.01001430615
302526,302539,303314,13,775,2,36000,1.01677419355
302540,302548,303125,8,577,2,36000,1.01386481802
302555,302562,303370,7,808,2,36000,1.00866336634
302570,302577,303128,7,551,2,36000,1.01270417423
302585,302592,303254,7,662,2,36000,1.01057401813
302600,302607,303267,7,660,2,36000,1.01060606061
302633,302639,303376,6,737,2,36000,1.00814111262
302657,302664,303343,7,679,2,36000,1.01030927835
302672,302679,303397,7,718,2,36000,1.00974930362
302674,302686,303519,12,833,2,36000,1.0144057623
302675,302691,303518,16,827,2,36000,1.01934703748
302695,302702,303519,7,817,2,36000,1.00856793146
302714,302721,303492,7,771,2,36000,1.00907911803
302715,302728,303402,13,674,2,36000,1.01928783383
302717,302733,303401,16,668,2,36000,1.02395209581
302744,302755,303518,11,763,2,36000,1.01441677588
302745,302763,303456,18,693,2,36000,1.02597402597
302746,302768,303473,22,705,2,36000,1.03120567376
302748,302773,303551,25,778,2,36000,1.03213367609
302749,302778,303665,29,887,2,36000,1.03269447576
302750,302783,303384,33,601,2,36000,1.05490848586
302767,302790,303421,23,631,2,36000,1.03645007924
302768,302795,303445,27,650,2,36000,1.04153846154
302784,302803,303570,19,767,2,36000,1.02477183833
302810,302816,303569,6,753,2,36000,1.00796812749
302811,302824,303559,13,735,2,36000,1.01768707483
302828,302834,303633,6,799,2,36000,1.00750938673
302845,302851,303415,6,564,2,36000,1.01063829787
302861,302867,303568,6,701,2,36000,1.00855920114
302876,302883,303656,7,773,2,36000,1.00905562743
302891,302897,303659,6,762,2,36000,1.00787401575
302892,302905,303529,13,624,2,36000,1.02083333333
302911,302917,303780,6,863,2,36000,1.00695249131
302929,302937,303609,8,672,2,36000,1.0119047619
302931,302944,303688,13,744,2,36000,1.01747311828
302932,302949,303564,17,615,2,36000,1.02764227642
302948,302957,303662,9,705,2,36000,1.01276595745
302949,302962,303699,13,737,2,36000,1.01763907734
302951,302969,303643,18,674,2,36000,1.02670623145
302967,302977,303640,10,663,2,36000,1.01508295626
302968,302982,303724,14,742,2,36000,1.01886792453
302969,302988,303761,19,773,2,36000,1.02457956016
302971,302995,303657,24,662,2,36000,1.03625377644
302972,303000,303680,28,680,2,36000,1.04117647059
302988,303005,303670,17,665,2,36000,1.02556390977
302989,303012,303651,23,639,2,36000,1.03599374022
302990,303017,303666,27,649,2,36000,1.04160246533
303056,303063,303683,7,620,2,36000,1.01129032258
303074,303081,303745,7,664,2,36000,1.01054216867
303089,303095,303672,6,577,2,36000,1.01039861352
303104,303110,303860,6,750,2,36000,1.008
303119,303125,303997,6,872,2,36000,1.00688073394
303135,303142,303860,7,718,2,36000,1.00974930362
303136,303149,303929,13,780,2,36000,1.01666666667
303138,303154,303841,16,687,2,36000,1.02328966521
303139,303159,303977,20,818,2,36000,1.02444987775
303154,303166,303896,12,730,2,36000,1.01643835616
303191,303197,303996,6,799,2,36000,1.00750938673
303221,303228,304022,7,794,2,36000,1.00881612091
303237,303244,303909,7,665,2,36000,1.01052631579
303255,303261,304042,6,781,2,36000,1.00768245839
303270,303276,303838,6,562,2,36000,1.01067615658
303288,303294,304028,6,734,2,36000,1.00817438692
303317,303325,304046,8,721,2,36000,1.01109570042
303345,303352,304104,7,752,2,36000,1.00930851064
303372,303379,304158,7,779,2,36000,1.00898587933
303392,303398,304183,6,785,2,36000,1.0076433121
303393,303406,304172,13,766,2,36000,1.01697127937
303409,303416,304104,7,688,2,36000,1.0101744186
303410,303422,304069,12,647,2,36000,1.01854714065
303412,303429,304078,17,649,2,36000,1.02619414484
303427,303436,304133,9,697,2,36000,1.01291248207
303429,303442,304079,13,637,2,36000,1.02040816327
303447,303454,304209,7,755,2,36000,1.00927152318
303465,303472,304206,7,734,2,36000,1.00953678474
303466,303479,304272,13,793,2,36000,1.01639344262
303485,303492,304116,7,624,2,36000,1.01121794872
303501,303509,304317,8,808,2,36000,1.0099009901
303526,303533,304326,7,793,2,36000,1.00882723834
303528,303540,304165,12,625,2,36000,1.0192
303529,303545,304223,16,678,2,36000,1.02359882006
303531,303551,304259,20,708,2,36000,1.02824858757
303551,303558,304314,7,756,2,36000,1.00925925926
303552,303565,304194,13,629,2,36000,1.02066772655
303569,303576,304379,7,803,2,36000,1.00871731009
303570,303583,304224,13,641,2,36000,1.02028081123
303572,303589,304539,17,950,2,36000,1.01789473684
303573,303594,304296,21,702,2,36000,1.02991452991
303593,303601,304267,8,666,2,36000,1.01201201201
303611,303617,304301,6,684,2,36000,1.00877192982
303636,303642,304335,6,693,2,36000,1.00865800866
303652,303658,304443,6,785,2,36000,1.0076433121
303653,303666,304252,13,586,2,36000,1.02218430034
303654,303671,304388,17,717,2,36000,1.02370990237
303669,303698,310912,29,7214,16,7200,1.00401996119
303672,303681,304388,9,707,2,36000,1.01272984441
303673,303686,304377,13,691,2,36000,1.01881331404
303674,303691,304339,17,648,2,36000,1.0262345679
303676,303704,304426,28,722,2,36000,1.03878116343
303677,303709,304391,32,682,2,36000,1.04692082111
303678,303714,304390,36,676,2,36000,1.05325443787
303680,303719,304407,39,688,2,36000,1.05668604651
303681,303724,304421,43,697,2,36000,1.06169296987
303697,303732,304662,35,930,2,36000,1.0376344086
303699,303738,304430,39,692,2,36000,1.0563583815
303700,303743,304327,43,584,2,36000,1.07363013699
303716,303748,304489,32,741,2,36000,1.04318488529
303731,303755,304469,24,714,2,36000,1.03361344538
303746,303760,304541,14,781,2,36000,1.01792573624
303761,303769,304531,8,762,2,36000,1.01049868766
303782,303789,304533,7,744,2,36000,1.00940860215
303836,303844,304993,8,1149,2,36000,1.00696257615
303851,303858,304589,7,731,2,36000,1.00957592339
303866,303874,304573,8,699,2,36000,1.01144492132
303868,303879,304650,11,771,2,36000,1.01426718547
303888,303895,304630,7,735,2,36000,1.00952380952
303889,303902,304588,13,686,2,36000,1.01895043732
303890,303907,304593,17,686,2,36000,1.02478134111
303892,303913,304585,21,672,2,36000,1.03125
303893,303918,304635,25,717,2,36000,1.03486750349
303894,303923,304670,29,747,2,36000,1.03882195448
303896,303930,304562,34,632,2,36000,1.05379746835
303898,303935,304592,37,657,2,36000,1.05631659056
303899,303941,304734,42,793,2,36000,1.05296343001
303901,303946,304604,45,658,2,36000,1.06838905775
303902,303951,304760,49,809,2,36000,1.06056860321
303903,303956,304636,53,680,2,36000,1.07794117647
303905,303961,304547,56,586,2,36000,1.09556313993
303906,303967,304697,61,730,2,36000,1.08356164384
303908,303972,304655,64,683,2,36000,1.09370424597
303909,303977,304580,68,603,2,36000,1.1127694859
303910,303982,304656,72,674,2,36000,1.10682492582
303912,303987,304652,75,665,2,36000,1.11278195489
303913,303992,304737,79,745,2,36000,1.10604026846
303915,303998,304627,83,629,2,36000,1.1319554849
303926,304005,304706,79,701,2,36000,1.11269614836
303928,304011,304667,83,656,2,36000,1.12652439024
303943,304016,304638,73,622,2,36000,1.11736334405
303977,304021,304669,44,648,2,36000,1.06790123457
303999,304028,304750,29,722,2,36000,1.04016620499
304000,304033,304658,33,625,2,36000,1.0528
304022,304041,304770,19,729,2,36000,1.02606310014
304037,304048,304815,11,767,2,36000,1.01434159061
304053,304060,304781,7,721,2,36000,1.00970873786
304054,304066,304694,12,628,2,36000,1.01910828025
304061,311089,314708,7028,3619,64,3600,2.9419729207
304070,304077,304807,7,730,2,36000,1.0095890411
304089,304095,304890,6,795,2,36000,1.00754716981
304090,304103,304665,13,562,2,36000,1.0231316726
304107,304114,304879,7,765,2,36000,1.0091503268
304108,304121,304835,13,714,2,36000,1.01820728291
304123,304206,304944,83,738,2,36000,1.11246612466
304138,304313,305016,175,703,2,36000,1.24893314367
304164,304338,305024,174,686,2,36000,1.25364431487
304183,304345,304999,162,654,2,36000,1.24770642202
304184,304352,305115,168,763,2,36000,1.22018348624
304185,304390,305165,205,775,2,36000,1.26451612903
304185,304265,311017,80,6752,32,7200,1.01184834123
304201,304401,305199,200,798,2,36000,1.25062656642
304217,304408,305173,191,765,2,36000,1.24967320261
304218,304419,305222,201,803,2,36000,1.2503113325
304233,304434,305171,201,737,2,36000,1.27272727273
304235,304455,305139,220,684,2,36000,1.3216374269
304255,304502,305301,247,799,2,36000,1.30913642053
304272,304547,305323,275,776,2,36000,1.3543814433
304274,304554,305247,280,693,2,36000,1.40404040404
304275,304561,305331,286,770,2,36000,1.37142857143
304297,304585,305266,288,681,2,36000,1.42290748899
304312,304592,305212,280,620,2,36000,1.45161290323
304327,304599,305324,272,725,2,36000,1.37517241379
304329,304606,305338,277,732,2,36000,1.37841530055
304330,304611,305332,281,721,2,36000,1.38973647712
304331,304617,305261,286,644,2,36000,1.44409937888
304346,304624,305339,278,715,2,36000,1.38881118881
304348,304640,305256,292,616,2,36000,1.47402597403
304379,304647,305357,268,710,2,36000,1.37746478873
304380,304652,305432,272,780,2,36000,1.34871794872
304391,363394,399632,59003,36238,10,43200,2.6282079585
304396,304659,305432,263,773,2,36000,1.34023285899
304398,304664,305410,266,746,2,36000,1.35656836461
304399,304671,305425,272,754,2,36000,1.36074270557
304400,304676,305332,276,656,2,36000,1.42073170732
304415,304682,305526,267,844,2,36000,1.3163507109
304431,304687,305438,256,751,2,36000,1.34087882823
304433,304692,305496,259,804,2,36000,1.32213930348
304434,304699,305328,265,629,2,36000,1.4213036566
304449,304705,305476,256,771,2,36000,1.33203631647
304470,304710,305404,240,694,2,36000,1.34582132565
304492,304715,305412,223,697,2,36000,1.31994261119
304529,314344,321565,9815,7221,32,7200,2.35923002354
304536,304720,305316,184,596,2,36000,1.30872483221
304537,304727,305433,190,706,2,36000,1.26912181303
304555,304732,305570,177,838,2,36000,1.21121718377
304556,304737,305373,181,636,2,36000,1.28459119497
304557,304747,305450,190,703,2,36000,1.27027027027
304573,304754,305547,181,793,2,36000,1.22824716267
304574,304763,305485,189,722,2,36000,1.26177285319
304590,304772,305454,182,682,2,36000,1.26686217009
304592,304782,305495,190,713,2,36000,1.26647966339
304593,304794,305564,201,770,2,36000,1.26103896104
304594,304820,305542,226,722,2,36000,1.31301939058
304597,314720,321740,10123,7020,32,7200,2.44202279202
304610,304827,305423,217,596,2,36000,1.36409395973
304612,304847,305452,235,605,2,36000,1.38842975207
304613,304891,305607,278,716,2,36000,1.38826815642
304628,304902,305668,274,766,2,36000,1.35770234987
304647,304956,305602,309,646,2,36000,1.47832817337
304649,305012,305765,363,753,2,36000,1.48207171315
304650,305029,305780,379,751,2,36000,1.50466045273
304651,305036,305808,385,772,2,36000,1.49870466321
304697,305127,305924,430,797,2,36000,1.53952321205
304698,305151,305942,453,791,2,36000,1.57269279393
304700,305177,305838,477,661,2,36000,1.72163388805
304701,305184,305860,483,676,2,36000,1.71449704142
304702,305191,306019,489,828,2,36000,1.59057971014
304704,305211,305836,507,625,2,36000,1.8112
304705,305225,305922,520,697,2,36000,1.74605451937
304706,305234,305964,528,730,2,36000,1.72328767123
304708,305259,306021,551,762,2,36000,1.72309711286
304709,305268,305954,559,686,2,36000,1.81486880466
304710,305275,305911,565,636,2,36000,1.88836477987
304712,305282,306051,570,769,2,36000,1.74122236671
304732,305313,306150,581,837,2,36000,1.69414575866
304750,305329,306004,579,675,2,36000,1.85777777778
304752,305336,306154,584,818,2,36000,1.71393643032
304771,305342,306105,571,763,2,36000,1.74836173001
304773,305349,306035,576,686,2,36000,1.83965014577
304774,305354,306081,580,727,2,36000,1.79779917469
304789,305359,306172,570,813,2,36000,1.70110701107
304807,305364,306132,557,768,2,36000,1.72526041667
304824,305371,306037,547,666,2,36000,1.82132132132
304839,305377,306275,538,898,2,36000,1.5991091314
304881,305382,306038,501,656,2,36000,1.7637195122
304896,305389,306133,493,744,2,36000,1.6626344086
304945,305417,306189,472,772,2,36000,1.61139896373
304997,305424,306099,427,675,2,36000,1.63259259259
305013,305430,306373,417,943,2,36000,1.44220572641
305028,305437,306209,409,772,2,36000,1.52979274611
305029,305442,306201,413,759,2,36000,1.5441370224
305116,305449,306190,333,741,2,36000,1.44939271255
305140,305454,306136,314,682,2,36000,1.46041055718
305168,305460,306115,292,655,2,36000,1.44580152672
305184,305467,306184,283,717,2,36000,1.39470013947
305185,305472,306116,287,644,2,36000,1.44565217391
305200,305478,306135,278,657,2,36000,1.42313546423
305216,305483,306099,267,616,2,36000,1.43344155844
305231,305490,306178,259,688,2,36000,1.37645348837
305250,305498,306289,248,791,2,36000,1.31352718078
305265,305508,306275,243,767,2,36000,1.31681877445
305267,305513,306196,246,683,2,36000,1.36017569546
305268,305539,306251,271,712,2,36000,1.38061797753
305302,305554,306230,252,676,2,36000,1.37278106509
305317,305561,306298,244,737,2,36000,1.33107191316
305334,305576,306510,242,934,2,36000,1.2591006424
305335,305583,306299,248,716,2,36000,1.34636871508
305337,305614,306365,277,751,2,36000,1.36884154461
305338,305626,306304,288,678,2,36000,1.42477876106
305339,305680,306433,341,753,2,36000,1.45285524568
305341,305777,306438,436,661,2,36000,1.65960665658
305357,305793,306569,436,776,2,36000,1.5618556701
305358,305824,306546,466,722,2,36000,1.64542936288
305359,305848,306484,489,636,2,36000,1.76886792453
305375,305855,306574,480,719,2,36000,1.66759388039
305406,305864,306559,458,695,2,36000,1.65899280576
305421,305872,306663,451,791,2,36000,1.57016434893
305422,305923,306602,501,679,2,36000,1.73784977909
305442,305935,306564,493,629,2,36000,1.78378378378
305444,305942,306709,498,767,2,36000,1.64928292047
305445,305954,306605,509,651,2,36000,1.78187403994
305446,305967,306539,521,572,2,36000,1.91083916084
305447,305977,306745,530,768,2,36000,1.69010416667
305449,306016,306785,567,769,2,36000,1.73732119636
305464,306032,306701,568,669,2,36000,1.8490284006
305466,306044,306700,578,656,2,36000,1.88109756098
305467,306051,306846,584,795,2,36000,1.73459119497
305482,306056,306721,574,665,2,36000,1.86315789474
305499,306062,306796,563,734,2,36000,1.76702997275
305500,306069,306743,569,674,2,36000,1.84421364985
305501,306094,306805,593,711,2,36000,1.83403656821
305532,306111,306757,579,646,2,36000,1.89628482972
305548,306116,306809,568,693,2,36000,1.81962481962
305550,306124,306910,574,786,2,36000,1.73027989822
305565,306136,306799,571,663,2,36000,1.86123680241
305580,306142,306985,562,843,2,36000,1.66666666667
305604,306149,306863,545,714,2,36000,1.76330532213
305609,305621,305622,12,1,1,600,1.3
305620,306155,306899,535,744,2,36000,1.71908602151
305668,306160,306859,492,699,2,36000,1.70386266094
305758,305766,305767,8,1,1,600,1.0
305767,306165,306887,398,722,2,36000,1.5512465374
305784,306172,306900,388,728,2,36000,1.53296703297
305811,306177,306934,366,757,2,36000,1.48348745046
305836,306184,306842,348,658,2,36000,1.52887537994
305853,306191,306917,338,726,2,36000,1.46556473829
305869,306198,306860,329,662,2,36000,1.49697885196
305913,306205,306895,292,690,2,36000,1.4231884058
305929,306210,306888,281,678,2,36000,1.41445427729
305930,306218,306886,288,668,2,36000,1.43113772455
305948,306223,306784,275,561,2,36000,1.49019607843
305963,306231,307093,268,862,2,36000,1.31090487239
305977,306243,306996,266,753,2,36000,1.35325365206
306006,306264,307032,258,768,2,36000,1.3359375
306025,306287,307033,262,746,2,36000,1.35120643432
306026,306292,307005,266,713,2,36000,1.37307152875
306045,306307,306939,262,632,2,36000,1.41455696203
306046,306314,307026,268,712,2,36000,1.37640449438
306047,306320,306971,273,651,2,36000,1.41935483871
306062,306327,307047,265,720,2,36000,1.36805555556
306076,306083,306084,7,1,1,600,1.0
306083,306377,307044,294,667,2,36000,1.44077961019
306099,306386,307245,287,859,2,36000,1.33410942957
306115,306445,307179,330,734,2,36000,1.44959128065
306116,306452,307093,336,641,2,36000,1.52418096724
306117,306497,307233,380,736,2,36000,1.51630434783
306119,306522,307279,403,757,2,36000,1.53236459709
306135,306552,307260,417,708,2,36000,1.58898305085
306136,306559,307247,423,688,2,36000,1.6148255814
306138,306570,307322,432,752,2,36000,1.57446808511
306139,306578,307278,439,700,2,36000,1.62714285714
306154,306585,307320,431,735,2,36000,1.58639455782
306156,306592,307267,436,675,2,36000,1.64592592593
306171,306615,307301,444,686,2,36000,1.6472303207
306186,306622,307403,436,781,2,36000,1.55825864277
306188,306676,307292,488,616,2,36000,1.79220779221
306204,306713,307349,509,636,2,36000,1.80031446541
306206,306718,307453,512,735,2,36000,1.69659863946
306207,306725,307398,518,673,2,36000,1.76968796434
306208,306733,307415,525,682,2,36000,1.76979472141
306223,306755,307536,532,781,2,36000,1.68117797695
306238,306769,307433,531,664,2,36000,1.79969879518
306253,306776,307660,523,884,2,36000,1.59162895928
306278,306796,307586,518,790,2,36000,1.65569620253
306279,306803,307431,524,628,2,36000,1.83439490446
306294,306810,307606,516,796,2,36000,1.64824120603
306310,306817,307585,507,768,2,36000,1.66015625
306311,306824,307519,513,695,2,36000,1.7381294964
306312,306829,307477,517,648,2,36000,1.79783950617
306365,306858,307597,493,739,2,36000,1.66711772666
306383,306863,307443,480,580,2,36000,1.8275862069
306435,306870,307557,435,687,2,36000,1.63318777293
306450,306877,307579,427,702,2,36000,1.60826210826
306484,306882,307560,398,678,2,36000,1.58702064897
306512,306898,307478,386,580,2,36000,1.66551724138
306543,306905,307681,362,776,2,36000,1.46649484536
306563,306910,307602,347,692,2,36000,1.50144508671
306565,306918,307633,353,715,2,36000,1.49370629371
306566,306923,307595,357,672,2,36000,1.53125
306582,306928,307603,346,675,2,36000,1.51259259259
306583,306940,307563,357,623,2,36000,1.57303370787
306604,306945,307674,341,729,2,36000,1.46776406036
306619,306953,307663,334,710,2,36000,1.47042253521
306664,306958,307568,294,610,2,36000,1.48196721311
306701,306984,307700,283,716,2,36000,1.39525139665
306702,306997,307706,295,709,2,36000,1.41607898449
306712,335521,362719,28809,27198,2,43200,2.05923229649
306718,307008,307635,290,627,2,36000,1.4625199362
306732,307016,307688,284,672,2,36000,1.42261904762
306747,307044,307800,297,756,2,36000,1.39285714286
306749,307049,307752,300,703,2,36000,1.42674253201
306750,306763,306765,13,2,1,600,1.5
306763,307056,307773,293,717,2,36000,1.40864714086
306785,307061,307732,276,671,2,36000,1.41132637854
306786,307068,307730,282,662,2,36000,1.42598187311
306802,307106,307801,304,695,2,36000,1.43741007194
306803,307111,307892,308,781,2,36000,1.39436619718
306818,307192,307776,374,584,2,36000,1.6404109589
306820,307245,307944,425,699,2,36000,1.60801144492
306844,307259,308048,415,789,2,36000,1.52598225602
306860,307264,307956,404,692,2,36000,1.5838150289
306861,307273,307926,412,653,2,36000,1.63093415008
306862,307280,307963,418,683,2,36000,1.61200585652
306877,307290,308049,413,759,2,36000,1.5441370224
306894,307297,307959,403,662,2,36000,1.60876132931
306895,307304,308004,409,700,2,36000,1.58428571429
306897,307313,308039,416,726,2,36000,1.57300275482
306898,307333,308030,435,697,2,36000,1.62410329986
306914,307340,307977,426,637,2,36000,1.66875981162
306916,307361,308167,445,806,2,36000,1.55210918114
306917,307410,308058,493,648,2,36000,1.76080246914
306932,307417,308044,485,627,2,36000,1.77352472089
306948,307426,308102,478,676,2,36000,1.70710059172
306950,307444,308157,494,713,2,36000,1.69284712482
306973,307451,308183,478,732,2,36000,1.65300546448
306990,307458,308081,468,623,2,36000,1.75120385233
307005,307465,308189,460,724,2,36000,1.63535911602
307007,307489,308324,482,835,2,36000,1.57724550898
307028,307501,308280,473,779,2,36000,1.60718870347
307044,307531,308273,487,742,2,36000,1.65633423181
307045,307548,308223,503,675,2,36000,1.74518518519
307047,307569,308246,522,677,2,36000,1.77104874446
307062,307576,308191,514,615,2,36000,1.83577235772
307092,307098,307099,6,1,1,600,1.0
307093,307581,308299,488,718,2,36000,1.67966573816
307094,307588,308367,494,779,2,36000,1.63414634146
307182,307595,308356,413,761,2,36000,1.54270696452
307233,307602,308253,369,651,2,36000,1.5668202765
307242,307251,307369,9,118,1,600,1.07627118644
307248,307607,308282,359,675,2,36000,1.53185185185
307249,307614,308366,365,752,2,36000,1.48537234043
307264,307619,308369,355,750,2,36000,1.47333333333
307280,307624,308337,344,713,2,36000,1.4824684432
307281,307631,308264,350,633,2,36000,1.55292259084
307282,307636,308287,354,651,2,36000,1.54377880184
307297,307650,308288,353,638,2,36000,1.55329153605
307312,307655,308461,343,806,2,36000,1.42555831266
307328,307673,308360,345,687,2,36000,1.50218340611
307329,307680,308298,351,618,2,36000,1.56796116505
307351,307687,308372,336,685,2,36000,1.49051094891
307402,307694,308475,292,781,2,36000,1.37387964149
307404,307701,308327,297,626,2,36000,1.47444089457
307420,307712,308374,292,662,2,36000,1.44108761329
307435,307719,308358,284,639,2,36000,1.44444444444
307436,307742,308454,306,712,2,36000,1.4297752809
307451,307749,308321,298,572,2,36000,1.52097902098
307466,307764,308501,298,737,2,36000,1.40434192673
307481,307786,308501,305,715,2,36000,1.42657342657
307483,307793,308439,310,646,2,36000,1.47987616099
307485,307496,307497,11,1,1,600,1.2
307499,307509,307512,10,3,32,3600,1.3
307520,307813,308518,293,705,2,36000,1.41560283688
307528,307538,307651,10,113,1,600,1.08849557522
307538,307818,308576,280,758,2,36000,1.36939313984
307559,307905,308688,346,783,2,36000,1.44189016603
307575,307939,308607,364,668,2,36000,1.54491017964
307577,307956,308711,379,755,2,36000,1.50198675497
307578,307969,308697,391,728,2,36000,1.53708791209
307595,307976,308744,381,768,2,36000,1.49609375
307596,307981,308745,385,764,2,36000,1.50392670157
307598,307995,308742,397,747,2,36000,1.53145917001
307599,308016,308701,417,685,2,36000,1.60875912409
307614,308042,308721,428,679,2,36000,1.63033873343
307616,308051,308757,435,706,2,36000,1.61614730878
307617,308058,308783,441,725,2,36000,1.60827586207
307618,308065,308747,447,682,2,36000,1.65542521994
307631,307642,307757,11,115,2,600,1.09565217391
307633,308070,308898,437,828,2,36000,1.52777777778
307648,308082,308750,434,668,2,36000,1.6497005988
307664,308096,308821,432,725,2,36000,1.59586206897
307665,308114,308836,449,722,2,36000,1.62188365651
307681,308169,308791,488,622,2,36000,1.7845659164
307682,308178,308947,496,769,2,36000,1.64499349805
307697,308195,308960,498,765,2,36000,1.65098039216
307713,308202,308922,489,720,2,36000,1.67916666667
307715,308209,308919,494,710,2,36000,1.69577464789
307731,308235,308981,504,746,2,36000,1.67560321716
307733,308258,308978,525,720,2,36000,1.72916666667
307760,308265,309001,505,736,2,36000,1.68614130435
307775,308276,309011,501,735,2,36000,1.68163265306
307777,308290,308975,513,685,2,36000,1.74890510949
307801,308298,309002,497,704,2,36000,1.70596590909
307803,308303,309031,500,728,2,36000,1.68681318681
307893,308310,308956,417,646,2,36000,1.64551083591
307910,307918,307985,8,67,2,600,1.11940298507
307930,308315,309077,385,762,2,36000,1.50524934383
307945,308321,309167,376,846,2,36000,1.44444444444
307960,308328,309129,368,801,2,36000,1.45942571785
307961,308335,308950,374,615,2,36000,1.6081300813
307971,307988,308131,17,143,1,600,1.11888111888
307976,308342,308995,366,653,2,36000,1.56049004594
307991,308347,309056,356,709,2,36000,1.50211565585
308006,308355,309079,349,724,2,36000,1.4820441989
308030,308369,309116,339,747,2,36000,1.45381526104
308046,308376,309104,330,728,2,36000,1.4532967033
308047,308381,309082,334,701,2,36000,1.47646219686
308063,308389,309034,326,645,2,36000,1.50542635659
308064,308394,309255,330,861,2,36000,1.38327526132
308065,308399,309063,334,664,2,36000,1.50301204819
308065,308077,308149,12,72,4,600,1.16666666667
308080,308404,309055,324,651,2,36000,1.49769585253
308102,308410,309020,308,610,2,36000,1.50491803279
308156,308452,309246,296,794,2,36000,1.37279596977
308171,308466,309247,295,781,2,36000,1.37772087068
308188,308474,309119,286,645,2,36000,1.44341085271
308205,308488,309248,283,760,2,36000,1.37236842105
308206,308513,309304,307,791,2,36000,1.38811630847
308225,308518,309286,293,768,2,36000,1.38151041667
308247,308531,309295,284,764,2,36000,1.37172774869
308262,308589,309310,327,721,2,36000,1.45353675451
308278,308619,309262,341,643,2,36000,1.53032659409
308280,308700,309438,420,738,2,36000,1.56910569106
308298,308709,309541,411,832,2,36000,1.49399038462
308300,308716,309304,416,588,2,36000,1.7074829932
308301,308724,309459,423,735,2,36000,1.57551020408
308302,308733,309351,431,618,2,36000,1.69741100324
308304,308754,309505,450,751,2,36000,1.59920106525
308305,308761,309439,456,678,2,36000,1.67256637168
308325,308767,309395,442,628,2,36000,1.70382165605
308326,308772,309415,446,643,2,36000,1.69362363919
308341,308779,309334,438,555,2,36000,1.78918918919
308343,308784,309675,441,891,2,36000,1.49494949495
308358,308796,309475,438,679,2,36000,1.64506627393
308360,308804,309599,444,795,2,36000,1.55849056604
308376,308833,309629,457,796,2,36000,1.57412060302
308378,308847,309568,469,721,2,36000,1.65048543689
308379,308910,309739,531,829,2,36000,1.64053075995
308380,308931,309570,551,639,2,36000,1.86228482003
308381,308938,309686,557,748,2,36000,1.74465240642
308383,308960,309769,577,809,2,36000,1.71322620519
308441,308967,309766,526,799,2,36000,1.65832290363
308456,308974,309715,518,741,2,36000,1.69905533063
308471,308979,309693,508,714,2,36000,1.71148459384
308486,308992,309752,506,760,2,36000,1.66578947368
308502,308997,309742,495,745,2,36000,1.6644295302
308503,309003,309605,500,602,2,36000,1.83056478405
308519,309010,309799,491,789,2,36000,1.62230671736
308577,309017,310024,440,1007,2,36000,1.43694141013
308609,309022,309721,413,699,2,36000,1.59084406295
308689,309029,309625,340,596,2,36000,1.57046979866
308702,314726,318364,6024,3638,32,3600,2.65585486531
308704,309036,309761,332,725,2,36000,1.45793103448
308706,309043,309749,337,706,2,36000,1.47733711048
308721,309051,309737,330,686,2,36000,1.48104956268
308723,309067,309862,344,795,2,36000,1.43270440252
308745,309074,309866,329,792,2,36000,1.4154040404
308746,309081,309747,335,666,2,36000,1.503003003
308748,309090,309776,342,686,2,36000,1.49854227405
308764,309097,309817,333,720,2,36000,1.4625
308765,309102,309816,337,714,2,36000,1.47198879552
308766,309116,309869,350,753,2,36000,1.46480743692
308785,309128,309825,343,697,2,36000,1.49210903874
308800,309135,309918,335,783,2,36000,1.42784163474
308824,309142,309904,318,762,2,36000,1.41732283465
308840,309179,309899,339,720,2,36000,1.47083333333
308899,309258,310021,359,763,2,36000,1.47051114024
308921,309265,309974,344,709,2,36000,1.48519040903
308923,309270,310124,347,854,2,36000,1.40632318501
308954,309278,310076,324,798,2,36000,1.40601503759
308955,309283,310070,328,787,2,36000,1.416772554
308976,309298,310269,322,971,2,36000,1.3316168898
308977,309311,309994,334,683,2,36000,1.48901903367
308978,309318,310038,340,720,2,36000,1.47222222222
308995,309323,309940,328,617,2,36000,1.53160453809
308996,309330,310039,334,709,2,36000,1.47108603667
309014,309346,310041,332,695,2,36000,1.47769784173
309016,309363,310015,347,652,2,36000,1.53220858896
309017,309407,310048,390,641,2,36000,1.60842433697
309018,309428,310090,410,662,2,36000,1.61933534743
309050,309451,310125,401,674,2,36000,1.59495548961
309051,309456,310141,405,685,2,36000,1.59124087591
309053,309471,310182,418,711,2,36000,1.58790436006
309074,309488,310224,414,736,2,36000,1.5625
309075,309518,310216,443,698,2,36000,1.63467048711
309076,309554,310233,478,679,2,36000,1.70397643594
309092,309580,310272,488,692,2,36000,1.70520231214
309093,309587,310227,494,640,2,36000,1.771875
309095,309612,310310,517,698,2,36000,1.74068767908
309110,309619,310336,509,717,2,36000,1.70990237099
309126,309638,310447,512,809,2,36000,1.63288009889
309127,309645,310346,518,701,2,36000,1.73894436519
309142,309688,310355,546,667,2,36000,1.81859070465
309167,309698,310450,531,752,2,36000,1.70611702128
309251,309705,310435,454,730,2,36000,1.62191780822
309252,309727,310440,475,713,2,36000,1.66619915849
309253,309734,310445,481,711,2,36000,1.67651195499
309269,309749,310468,480,719,2,36000,1.66759388039
309270,309756,310467,486,711,2,36000,1.6835443038
309285,309761,310620,476,859,2,36000,1.55413271246
309307,309768,310545,461,777,2,36000,1.59330759331
309308,309773,310596,465,823,2,36000,1.56500607533
309310,309779,310452,469,673,2,36000,1.69687964339
309329,309786,310511,457,725,2,36000,1.63034482759
309345,309791,310646,446,855,2,36000,1.5216374269
309360,309796,310454,436,658,2,36000,1.66261398176
309374,309380,309383,6,3,16,30,1.0
309397,309804,310443,407,639,2,36000,1.63693270736
309418,309811,310516,393,705,2,36000,1.55744680851
309441,309829,310602,388,773,2,36000,1.50194049159
309442,309834,310575,392,741,2,36000,1.5290148448
309460,309841,310477,381,636,2,36000,1.59905660377
309475,309875,310489,400,614,2,36000,1.65146579805
309494,309501,309504,7,3,32,30,1.0
309505,309882,310636,377,754,2,36000,1.5
309542,309888,310606,346,718,2,36000,1.48189415042
309570,309911,310588,341,677,2,36000,1.50369276219
309571,309918,310591,347,673,2,36000,1.51560178306
309599,309930,310933,331,1003,2,36000,1.33000997009
309612,311030,311040,1418,10,64,30,142.8
309613,309952,310790,339,838,2,36000,1.40453460621
309629,309987,310735,358,748,2,36000,1.47860962567
309630,310006,310677,376,671,2,36000,1.56035767511
309676,310027,310806,351,779,2,36000,1.45057766367
309692,310034,310673,342,639,2,36000,1.53521126761
309707,310041,310753,334,712,2,36000,1.4691011236
309722,310050,310773,328,723,2,36000,1.45366528354
309723,310056,310892,333,836,2,36000,1.39832535885
309738,310062,310694,324,632,2,36000,1.51265822785
309755,310069,310731,314,662,2,36000,1.47432024169
309756,310082,310805,326,723,2,36000,1.45089903181
309758,310089,310833,331,744,2,36000,1.44489247312
309759,310094,310812,335,718,2,36000,1.46657381616
309760,310107,310788,347,681,2,36000,1.50954478708
309777,310136,310902,359,766,2,36000,1.46866840731
309778,310143,310884,365,741,2,36000,1.49257759784
309779,310154,310857,375,703,2,36000,1.53342816501
309781,310194,310927,413,733,2,36000,1.56343792633
309803,310228,310971,425,743,2,36000,1.57200538358
309818,310236,311023,418,787,2,36000,1.53113087675
309819,310243,311112,424,869,2,36000,1.48791714614
309835,310250,311111,415,861,2,36000,1.48199767712
309862,310281,310986,419,705,2,36000,1.59432624113
309877,310288,310866,411,578,2,36000,1.71107266436
309879,310322,311050,443,728,2,36000,1.60851648352
309900,310348,311115,448,767,2,36000,1.58409387223
309915,310358,311047,443,689,2,36000,1.64296081277
309930,310367,311081,437,714,2,36000,1.61204481793
309945,310447,311206,502,759,2,36000,1.66139657444
309976,310454,311122,478,668,2,36000,1.71556886228
309994,310461,311167,467,706,2,36000,1.66147308782
310015,310466,311149,451,683,2,36000,1.66032210835
310030,310472,311202,442,730,2,36000,1.60547945205
310032,310479,311152,447,673,2,36000,1.66419019316
310048,310484,311219,436,735,2,36000,1.59319727891
310050,310489,311133,439,644,2,36000,1.68167701863
310051,310495,311149,444,654,2,36000,1.67889908257
310052,310502,311308,450,806,2,36000,1.55831265509
310069,310507,311328,438,821,2,36000,1.53349573691
310084,310513,311321,429,808,2,36000,1.53094059406
310100,310523,311196,423,673,2,36000,1.62852897474
310125,310530,311222,405,692,2,36000,1.58526011561
310127,310557,311344,430,787,2,36000,1.54637865311
310142,310587,311242,445,655,2,36000,1.67938931298
310182,310600,311258,418,658,2,36000,1.63525835866
310221,310607,311350,386,743,2,36000,1.51951547779
310236,310614,311292,378,678,2,36000,1.55752212389
310238,310619,311351,381,732,2,36000,1.52049180328
310239,310626,311503,387,877,2,36000,1.44127708096
310273,310633,311286,360,653,2,36000,1.55130168453
310275,310648,311327,373,679,2,36000,1.54933726068
310312,310658,311371,346,713,2,36000,1.48527349229
310337,310685,311370,348,685,2,36000,1.50802919708
310352,310692,311444,340,752,2,36000,1.45212765957
310367,310706,311383,339,677,2,36000,1.50073855244
310441,310743,311506,302,763,2,36000,1.39580602883
310442,310750,311438,308,688,2,36000,1.4476744186
310459,310766,311581,307,815,2,36000,1.37668711656
310460,310785,311635,325,850,2,36000,1.38235294118
310462,310801,311449,339,648,2,36000,1.52314814815
310463,310808,311477,345,669,2,36000,1.51569506726
310464,310817,311576,353,759,2,36000,1.465085639
310466,310823,311398,357,575,2,36000,1.62086956522
310481,310829,311471,348,642,2,36000,1.54205607477
310483,310846,311538,363,692,2,36000,1.52456647399
310484,310869,311519,385,650,2,36000,1.59230769231
310499,310878,311649,379,771,2,36000,1.4915693904
310515,310897,311761,382,864,2,36000,1.44212962963
310516,310904,311621,388,717,2,36000,1.54114365411
310547,310914,311561,367,647,2,36000,1.56723338485
310564,310571,310646,7,75,1,60,1.09333333333
310576,310939,311891,363,952,2,36000,1.38130252101
310592,310946,311584,354,638,2,36000,1.55485893417
310593,310983,311650,390,667,2,36000,1.58470764618
310615,310998,311674,383,676,2,36000,1.56656804734
310616,311035,311778,419,743,2,36000,1.56393001346
310617,311040,311766,423,726,2,36000,1.5826446281
310632,311045,311835,413,790,2,36000,1.52278481013
310648,311051,311771,403,720,2,36000,1.55972222222
310649,311056,311830,407,774,2,36000,1.52583979328
310674,311061,311704,387,643,2,36000,1.60186625194
310691,311066,311817,375,751,2,36000,1.49933422104
310712,311072,311857,360,785,2,36000,1.45859872611
310734,311077,311852,343,775,2,36000,1.44258064516
310755,311082,311870,327,788,2,36000,1.41497461929
310756,311094,311772,338,678,2,36000,1.49852507375
310777,311099,311793,322,694,2,36000,1.46397694524
310792,311105,311722,313,617,2,36000,1.50729335494
310794,311112,311743,318,631,2,36000,1.50396196513
310810,311123,311805,313,682,2,36000,1.45894428152
310811,311130,311815,319,685,2,36000,1.46569343066
310812,311135,311831,323,696,2,36000,1.46408045977
310835,311142,311889,307,747,2,36000,1.4109772423
310860,311149,311877,289,728,2,36000,1.39697802198
310877,311161,311812,284,651,2,36000,1.43625192012
310892,311166,311853,274,687,2,36000,1.39883551674
310893,311173,311831,280,658,2,36000,1.42553191489
310909,311180,311789,271,609,2,36000,1.44499178982
310927,311209,311881,282,672,2,36000,1.41964285714
310942,311216,312159,274,943,2,36000,1.29056203606
310972,311223,312614,251,1391,2,36000,1.1804457225
310987,311231,312023,244,792,2,36000,1.30808080808
311024,311238,311967,214,729,2,36000,1.29355281207
311049,311255,312402,206,1147,2,36000,1.17959895379
311064,311270,311945,206,675,2,36000,1.30518518519
311083,311298,312069,215,771,2,36000,1.27885862516
311084,311488,312539,404,1051,1,18000,1.38439581351
311112,311305,311983,193,678,2,36000,1.28466076696
311128,311320,312078,192,758,2,36000,1.25329815303
311130,311333,312009,203,676,2,36000,1.30029585799
311131,311340,311996,209,656,2,36000,1.31859756098
311147,311345,312074,198,729,2,36000,1.27160493827
311163,311356,312088,193,732,2,36000,1.26366120219
311164,311363,312104,199,741,2,36000,1.2685560054
311165,311368,311979,203,611,2,36000,1.33224222586
311181,311382,312140,201,758,2,36000,1.26517150396
311196,311389,312239,193,850,2,36000,1.22705882353
311212,311396,312143,184,747,2,36000,1.24631860776
311213,311410,312100,197,690,2,36000,1.28550724638
311229,311450,312059,221,609,2,36000,1.36288998358
311230,311457,312121,227,664,2,36000,1.34186746988
311245,311464,312165,219,701,2,36000,1.31241084165
311261,311483,312253,222,770,2,36000,1.28831168831
311286,311495,312271,209,776,2,36000,1.26932989691
311301,311516,312294,215,778,2,36000,1.2763496144
311316,311523,312369,207,846,2,36000,1.24468085106
311332,311531,312307,199,776,2,36000,1.25644329897
311333,311550,312286,217,736,2,36000,1.29483695652
311335,311573,312377,238,804,2,36000,1.2960199005
311351,311589,312261,238,672,2,36000,1.35416666667
311352,311596,312297,244,701,2,36000,1.34807417974
311353,311601,312391,248,790,2,36000,1.31392405063
311373,311634,312262,261,628,2,36000,1.41560509554
311374,311648,312493,274,845,2,36000,1.32426035503
311389,311661,312348,272,687,2,36000,1.39592430859
311405,311668,312375,263,707,2,36000,1.37199434229
311583,311686,312411,103,725,2,36000,1.14206896552
311584,311716,312408,132,692,2,36000,1.19075144509
311585,311734,312417,149,683,2,36000,1.21815519766
311625,311755,312514,130,759,2,36000,1.17127799736
311642,311773,312539,131,766,2,36000,1.17101827676
311658,311780,312502,122,722,2,36000,1.16897506925
311659,311787,312580,128,793,2,36000,1.16141235813
311674,311792,312544,118,752,2,36000,1.15691489362
311705,311799,312529,94,730,2,36000,1.12876712329
311723,311806,312483,83,677,2,36000,1.12259970458
311745,311811,312550,66,739,2,36000,1.08930987821
311761,311818,312424,57,606,2,36000,1.09405940594
311776,311825,312512,49,687,2,36000,1.07132459971
311777,311832,312471,55,639,2,36000,1.08607198748
311779,311837,312504,58,667,2,36000,1.08695652174
311780,311844,312585,64,741,2,36000,1.08636977058
311800,311849,312548,49,699,2,36000,1.07010014306
311801,311854,312635,53,781,2,36000,1.06786171575
311817,311862,312653,45,791,2,36000,1.05689001264
311818,311869,312531,51,662,2,36000,1.07703927492
311820,311874,312561,54,687,2,36000,1.07860262009
311821,311879,312493,58,614,2,36000,1.09446254072
311837,311886,312575,49,689,2,36000,1.07111756168
311839,311893,312461,54,568,2,36000,1.09507042254
311840,311898,312690,58,792,2,36000,1.07323232323
311841,311905,312444,64,539,2,36000,1.11873840445
311858,311910,312596,52,686,2,36000,1.07580174927
311859,311958,312732,99,774,2,36000,1.12790697674
311860,311979,312578,119,599,2,36000,1.19866444073
311877,311992,312861,115,869,2,36000,1.13233601841
311878,311999,312766,121,767,2,36000,1.15775749674
311894,312008,312680,114,672,2,36000,1.16964285714
311895,312021,312878,126,857,2,36000,1.14702450408
311896,312035,312731,139,696,2,36000,1.19971264368
311946,312071,312701,125,630,2,36000,1.19841269841
311971,312081,312757,110,676,2,36000,1.16272189349
311987,312088,312733,101,645,2,36000,1.15658914729
311988,312095,312742,107,647,2,36000,1.16537867079
312003,312102,312795,99,693,2,36000,1.14285714286
312018,312112,312926,94,814,2,36000,1.11547911548
312033,312119,312785,86,666,2,36000,1.12912912913
312061,312133,312869,72,736,2,36000,1.09782608696
312076,312152,312795,76,643,2,36000,1.11819595645
312078,312159,312949,81,790,2,36000,1.10253164557
312093,312172,312981,79,809,2,36000,1.09765142151
312094,312179,312887,85,708,2,36000,1.12005649718
312110,312251,312950,141,699,2,36000,1.2017167382
312111,312266,313054,155,788,2,36000,1.19670050761
312126,312274,312931,148,657,2,36000,1.22526636225
312145,312279,312956,134,677,2,36000,1.19793205318
312146,312286,312965,140,679,2,36000,1.20618556701
312166,312298,313042,132,744,2,36000,1.17741935484
312167,312306,313036,139,730,2,36000,1.1904109589
312241,312313,312905,72,592,2,36000,1.12162162162
312256,312319,313060,63,741,2,36000,1.08502024291
312273,312361,313069,88,708,2,36000,1.12429378531
312274,312381,313122,107,741,2,36000,1.14439946019
312275,312389,313169,114,780,2,36000,1.14615384615
312290,312394,313132,104,738,2,36000,1.14092140921
312306,312403,312979,97,576,2,36000,1.16840277778
312308,312415,313153,107,738,2,36000,1.14498644986
312309,312422,313084,113,662,2,36000,1.17069486405
312349,312429,313071,80,642,2,36000,1.1246105919
312373,312434,313222,61,788,2,36000,1.07741116751
312383,313693,325912,1310,12219,2,18000,1.10721008266
312388,312441,313237,53,796,2,36000,1.06658291457
312389,312456,313066,67,610,2,36000,1.10983606557
312405,312474,313249,69,775,2,36000,1.08903225806
312406,312483,313165,77,682,2,36000,1.11290322581
312423,312495,313205,72,710,2,36000,1.1014084507
312424,312505,313313,81,808,2,36000,1.10024752475
312425,312510,313298,85,788,2,36000,1.1078680203
312441,312517,313200,76,683,2,36000,1.11127379209
312460,312522,313297,62,775,2,36000,1.08
312475,312529,313252,54,723,2,36000,1.07468879668
312476,312534,313255,58,721,2,36000,1.08044382802
312492,312541,313209,49,668,2,36000,1.07335329341
312509,312548,313267,39,719,2,36000,1.05424200278
312510,312555,313316,45,761,2,36000,1.05913272011
312512,312562,313318,50,756,2,36000,1.06613756614
312513,312567,313251,54,684,2,36000,1.07894736842
312529,312573,313226,44,653,2,36000,1.067381317
312530,312580,313310,50,730,2,36000,1.06849315068
312532,312586,313335,54,749,2,36000,1.07209612817
312549,312594,313304,45,710,2,36000,1.06338028169
312550,312599,313306,49,707,2,36000,1.06930693069
312552,312606,313201,54,595,2,36000,1.09075630252
312553,312613,313363,60,750,2,36000,1.08
312554,312627,313404,73,777,2,36000,1.09395109395
312570,312647,313424,77,777,2,36000,1.0990990991
312598,312665,313412,67,747,2,36000,1.08969210174
312599,312692,313433,93,741,2,36000,1.12550607287
312600,312702,313465,102,763,2,36000,1.13368283093
312602,312713,313468,111,755,2,36000,1.14701986755
312603,312743,313503,140,760,2,36000,1.18421052632
312618,312750,313479,132,729,2,36000,1.18106995885
312637,312755,313361,118,606,2,36000,1.19471947195
312644,313925,314012,1281,87,14,7980,15.724137931
312653,312762,313540,109,778,2,36000,1.14010282776
312681,312768,313447,87,679,2,36000,1.12812960236
312697,312778,313537,81,759,2,36000,1.10671936759
312712,312797,313497,85,700,2,36000,1.12142857143
312731,312807,313481,76,674,2,36000,1.11275964392
312733,312812,313601,79,789,2,36000,1.10012674271
312749,312873,313546,124,673,2,36000,1.18424962853
312751,312881,313549,130,668,2,36000,1.19461077844
312765,363050,363074,50285,24,9,72000,2096.20833333
312766,312890,313607,124,717,2,36000,1.17294281729
312767,312900,313649,133,749,2,36000,1.17757009346
312786,312917,313605,131,688,2,36000,1.19040697674
312802,312938,313766,136,828,2,36000,1.16425120773
312804,312945,313681,141,736,2,36000,1.19157608696
312862,312961,313634,99,673,2,36000,1.147102526
312878,312967,313600,89,633,2,36000,1.14060031596
312880,312972,313657,92,685,2,36000,1.13430656934
312895,312979,313695,84,716,2,36000,1.11731843575
312912,312992,313643,80,651,2,36000,1.12288786482
312927,312999,313906,72,907,2,36000,1.07938257993
312942,313049,313615,107,566,2,36000,1.1890459364
312958,313056,313835,98,779,2,36000,1.12580231065
312959,313066,313744,107,678,2,36000,1.15781710914
312961,313073,313867,112,794,2,36000,1.14105793451
312978,313080,313869,102,789,2,36000,1.12927756654
312996,313087,313883,91,796,2,36000,1.11432160804
312997,313092,313887,95,795,2,36000,1.11949685535
313037,313099,313693,62,594,2,36000,1.10437710438
313053,313134,313844,81,710,2,36000,1.11408450704
313054,313144,313858,90,714,2,36000,1.12605042017
313070,313166,313861,96,695,2,36000,1.1381294964
313071,313177,313961,106,784,2,36000,1.13520408163
313073,313184,313831,111,647,2,36000,1.171561051
313074,313213,313908,139,695,2,36000,1.2
313091,313218,313831,127,613,2,36000,1.20717781403
313122,313225,314008,103,783,2,36000,1.13154533844
313137,313230,313920,93,690,2,36000,1.1347826087
313156,313237,313835,81,598,2,36000,1.13545150502
313173,313244,314015,71,771,2,36000,1.09208819715
313174,313251,313999,77,748,2,36000,1.10294117647
313201,313263,314023,62,760,2,36000,1.08157894737
313202,313268,313954,66,686,2,36000,1.09620991254
313218,313275,313948,57,673,2,36000,1.08469539376
313220,313280,313958,60,678,2,36000,1.08849557522
313236,313287,314052,51,765,2,36000,1.06666666667
313237,313310,314001,73,691,2,36000,1.10564399421
313252,313317,314046,65,729,2,36000,1.08916323731
313254,313322,314309,68,987,2,36000,1.06889564336
313255,313329,314135,74,806,2,36000,1.09181141439
313256,313334,314087,78,753,2,36000,1.10358565737
313272,313339,314115,67,776,2,36000,1.08634020619
313274,313344,314039,70,695,2,36000,1.10071942446
313303,313352,314054,49,702,2,36000,1.0698005698
313304,313357,314131,53,774,2,36000,1.0684754522
313306,313373,313994,67,621,2,36000,1.10789049919
313330,313380,314157,50,777,2,36000,1.06435006435
313331,313416,314208,85,792,2,36000,1.10732323232
313333,313424,314116,91,692,2,36000,1.13150289017
313334,313436,314149,102,713,2,36000,1.14305750351
313336,313444,314151,108,707,2,36000,1.15275813296
313352,313459,314204,107,745,2,36000,1.14362416107
313371,313478,314286,107,808,2,36000,1.13242574257
313372,313485,314273,113,788,2,36000,1.14340101523
313405,313492,314251,87,759,2,36000,1.11462450593
313421,313499,314248,78,749,2,36000,1.1041388518
313436,313509,314260,73,751,2,36000,1.09720372836
313437,313516,314171,79,655,2,36000,1.12061068702
313453,313549,314246,96,697,2,36000,1.13773314204
313468,313556,314287,88,731,2,36000,1.12038303694
313469,313563,314287,94,724,2,36000,1.12983425414
313486,313568,314251,82,683,2,36000,1.12005856515
313487,313612,314352,125,740,2,36000,1.16891891892
313503,313619,314340,116,721,2,36000,1.16088765603
313505,313624,314318,119,694,2,36000,1.17146974063
313539,313629,314439,90,810,2,36000,1.11111111111
313554,313636,314332,82,696,2,36000,1.11781609195
313555,313647,314377,92,730,2,36000,1.12602739726
313557,313656,314285,99,629,2,36000,1.1573926868
313600,313668,314393,68,725,2,36000,1.09379310345
313601,313675,314260,74,585,2,36000,1.1264957265
313617,313707,314352,90,645,2,36000,1.13953488372
313618,313756,314426,138,670,2,36000,1.20597014925
313619,313778,314480,159,702,2,36000,1.2264957265
313636,313847,314558,211,711,2,36000,1.29676511955
313652,313856,314501,204,645,2,36000,1.31627906977
313653,313871,314606,218,735,2,36000,1.29659863946
313671,313878,314618,207,740,2,36000,1.27972972973
313691,313895,314570,204,675,2,36000,1.30222222222
313706,313902,314728,196,826,2,36000,1.23728813559
313708,313918,314639,210,721,2,36000,1.29126213592
313745,313960,314635,215,675,2,36000,1.31851851852
313767,313967,314718,200,751,2,36000,1.26631158455
313832,313974,314780,142,806,2,36000,1.17617866005
313833,314007,314678,174,671,2,36000,1.25931445604
313851,314014,314655,163,641,2,36000,1.25429017161
313853,314019,314662,166,643,2,36000,1.25816485226
313854,314043,314847,189,804,2,36000,1.23507462687
313871,314048,314727,177,679,2,36000,1.26067746686
313872,314055,314759,183,704,2,36000,1.25994318182
313874,314143,314836,269,693,2,36000,1.38816738817
313875,314161,314863,286,702,2,36000,1.40740740741
313890,314168,315089,278,921,2,36000,1.30184581976
313891,314183,314823,292,640,2,36000,1.45625
313907,314217,314911,310,694,2,36000,1.44668587896
313922,314224,314968,302,744,2,36000,1.40591397849
313923,314259,315083,336,824,2,36000,1.40776699029
313948,314266,315030,318,764,2,36000,1.41623036649
313964,314271,314888,307,617,2,36000,1.49756888169
313965,314278,315055,313,777,2,36000,1.40283140283
313966,314283,315067,317,784,2,36000,1.40433673469
313994,314290,314895,296,605,2,36000,1.48925619835
314009,314297,314991,288,694,2,36000,1.41498559078
314010,314026,314028,16,2,1,60,1.8
314010,314031,314038,21,7,1,900,2.8
314011,314304,314993,293,689,2,36000,1.42525399129
314012,314322,315008,310,686,2,36000,1.45189504373
314021,314038,314125,17,87,14,7980,1.19540229885
314027,314331,315054,304,723,2,36000,1.42047026279
314029,314349,315177,320,828,2,36000,1.38647342995
314044,314385,315130,341,745,2,36000,1.45771812081
314060,314390,315243,330,853,2,36000,1.38686987104
314062,314397,315235,335,838,2,36000,1.39976133652
314063,314405,315141,342,736,2,36000,1.46467391304
314088,314438,315039,350,601,2,36000,1.58236272879
314115,314451,315315,336,864,2,36000,1.38888888889
314117,314492,315173,375,681,2,36000,1.55066079295
314123,314130,314137,7,7,1,900,1.4
314131,314137,314331,6,194,14,7980,1.03092783505
314132,314513,315200,381,687,2,36000,1.55458515284
314147,314570,315224,423,654,2,36000,1.64678899083
314163,314581,315261,418,680,2,36000,1.61470588235
314164,314619,315281,455,662,2,36000,1.68731117825
314166,314630,315328,464,698,2,36000,1.66475644699
314181,314647,315549,466,902,2,36000,1.51662971175
314205,314654,315367,449,713,2,36000,1.62973352034
314220,314668,315299,448,631,2,36000,1.70998415214
314248,314675,315329,427,654,2,36000,1.65290519878
314250,314690,315382,440,692,2,36000,1.63583815029
314266,314733,315528,467,795,2,36000,1.58742138365
314267,314740,315408,473,668,2,36000,1.70808383234
314268,314745,315476,477,731,2,36000,1.65253077975
314269,314771,315592,502,821,2,36000,1.61144945189
314285,314792,315538,507,746,2,36000,1.67962466488
314287,314835,315579,548,744,2,36000,1.73655913978
314288,314847,315498,559,651,2,36000,1.85867895545
314303,314859,315485,556,626,2,36000,1.88817891374
314305,314875,315629,570,754,2,36000,1.75596816976
314321,314900,315653,579,753,2,36000,1.76892430279
314322,314907,315690,585,783,2,36000,1.74712643678
314328,314338,314344,10,6,1,900,1.6
314336,318377,318634,4041,257,14,7980,16.7237354086
314338,314924,315689,586,765,2,36000,1.7660130719
314354,314980,315658,626,678,2,36000,1.92330383481
314355,315003,315713,648,710,2,36000,1.91267605634
314356,315010,315824,654,814,2,36000,1.80343980344
314378,315021,315732,643,711,2,36000,1.90436005626
314397,315041,315693,644,652,2,36000,1.98773006135
314425,315052,315713,627,661,2,36000,1.94856278366
314440,315066,315742,626,676,2,36000,1.92603550296
314480,315072,315750,592,678,2,36000,1.87315634218
314502,315080,315775,578,695,2,36000,1.83165467626
314549,363084,373467,48535,10383,8,172800,5.67446788019
314559,315095,315736,536,641,2,36000,1.83619344774
314574,315102,315793,528,691,2,36000,1.76410998553
314608,315146,315901,538,755,2,36000,1.71258278146
314623,315153,315803,530,650,2,36000,1.81538461538
314639,315185,315891,546,706,2,36000,1.77337110482
314641,315192,315868,551,676,2,36000,1.8150887574
314659,315211,315906,552,695,2,36000,1.79424460432
314677,315235,315888,558,653,2,36000,1.85451761103
314678,315247,315836,569,589,2,36000,1.96604414261
314721,315256,315994,535,738,2,36000,1.72493224932
314737,315273,316012,536,739,2,36000,1.72530446549
314738,315293,316015,555,722,2,36000,1.76869806094
314759,315310,316024,551,714,2,36000,1.77170868347
314781,315328,316061,547,733,2,36000,1.74624829468
314816,314822,314829,6,7,1,3600,1.3
314824,315339,315925,515,586,2,36000,1.87883959044
314839,315346,316095,507,749,2,36000,1.67690253672
314855,315379,316566,524,1187,2,36000,1.44144903117
314873,315394,316245,521,851,2,36000,1.61222091657
314889,315420,316177,531,757,2,36000,1.70145310436
314907,315488,316227,581,739,2,36000,1.78619756428
314922,315496,316835,574,1339,2,36000,1.428678118
314946,314953,314955,7,2,1,3600,1.0
314968,315511,316281,543,770,2,36000,1.70519480519
314994,315540,316205,546,665,2,36000,1.82105263158
314995,315550,316175,555,625,2,36000,1.888
315015,315561,316247,546,686,2,36000,1.79591836735
315030,315591,316231,561,640,2,36000,1.8765625
315046,315604,316411,558,807,2,36000,1.69144981413
315065,315641,316319,576,678,2,36000,1.84955752212
315066,315665,316353,599,688,2,36000,1.87063953488
315083,315672,316311,589,639,2,36000,1.92175273865
315084,315701,316435,617,734,2,36000,1.84059945504
315099,315708,316531,609,823,2,36000,1.73997569866
315132,315139,315913,7,774,1,3600,1.00904392765
315136,315713,316492,577,779,2,36000,1.74069319641
315151,315725,316530,574,805,2,36000,1.71304347826
315173,315730,316455,557,725,2,36000,1.76827586207
315188,315745,316490,557,745,2,36000,1.74765100671
315205,315752,316453,547,701,2,36000,1.78031383738
315229,315759,316370,530,611,2,36000,1.8674304419
315245,315766,316419,521,653,2,36000,1.797856049
315246,315788,316422,542,634,2,36000,1.85488958991
315262,315805,316577,543,772,2,36000,1.70336787565
315280,315815,316605,535,790,2,36000,1.67721518987
315299,315837,316575,538,738,2,36000,1.72899728997
315317,315847,316596,530,749,2,36000,1.70761014686
315333,315880,316602,547,722,2,36000,1.75761772853
315334,315900,316720,566,820,2,36000,1.69024390244
315369,315907,316660,538,753,2,36000,1.71447543161
315384,315914,316510,530,596,2,36000,1.88926174497
315408,315921,316485,513,564,2,36000,1.90957446809
315475,315937,316644,462,707,2,36000,1.65346534653
315491,316005,316691,514,686,2,36000,1.74927113703
315507,316025,316721,518,696,2,36000,1.74425287356
315528,316032,316776,504,744,2,36000,1.67741935484
315543,316039,316774,496,735,2,36000,1.67482993197
315558,316073,316745,515,672,2,36000,1.76636904762
315579,316107,316786,528,679,2,36000,1.77761413844
315595,316188,316951,593,763,2,36000,1.77719528178
315628,316193,317081,565,888,2,36000,1.63626126126
315654,316217,316968,563,751,2,36000,1.74966711052
315670,316239,317005,569,766,2,36000,1.74281984334
315692,316245,316919,553,674,2,36000,1.82047477745
315693,316258,316924,565,666,2,36000,1.84834834835
315708,316264,317041,556,777,2,36000,1.71557271557
315724,316295,316945,571,650,2,36000,1.87846153846
315725,316323,317078,598,755,2,36000,1.79205298013
315740,316332,317093,592,761,2,36000,1.77792378449
315742,316366,317072,624,706,2,36000,1.88385269122
315757,316382,317206,625,824,2,36000,1.75849514563
315758,316423,317166,665,743,2,36000,1.89502018843
315776,316431,317117,655,686,2,36000,1.95481049563
315795,316438,317083,643,645,2,36000,1.99689922481
315810,316448,317157,638,709,2,36000,1.89985895628
315825,316465,317111,640,646,2,36000,1.9907120743
315841,316472,317245,631,773,2,36000,1.81630012937
315869,316497,317209,628,712,2,36000,1.88202247191
315890,316503,317350,613,847,2,36000,1.72373081464
315892,316508,317678,616,1170,2,36000,1.5264957265
315907,316522,317281,615,759,2,36000,1.81027667984
315908,316541,317267,633,726,2,36000,1.87190082645
315928,316548,317292,620,744,2,36000,1.83333333333
315999,316579,317243,580,664,2,36000,1.8734939759
316016,316587,317301,571,714,2,36000,1.79971988796
316018,316594,317231,576,637,2,36000,1.90423861852
316034,316609,317345,575,736,2,36000,1.78125
316062,316616,317317,554,701,2,36000,1.79029957204
316098,316622,317325,524,703,2,36000,1.7453769559
316106,316114,316683,8,569,1,3600,1.01405975395
316177,316656,317319,479,663,2,36000,1.72247360483
316178,316672,317404,494,732,2,36000,1.67486338798
316206,316703,317449,497,746,2,36000,1.66621983914
316226,316732,317425,506,693,2,36000,1.73015873016
316241,316739,317397,498,658,2,36000,1.75683890578
316256,316757,317367,501,610,2,36000,1.82131147541
316257,316786,317798,529,1012,2,36000,1.52272727273
316282,316288,317018,6,730,1,1800,1.00821917808
316282,316793,317490,511,697,2,36000,1.7331420373
316316,316799,317501,483,702,2,36000,1.68803418803
316332,316848,317495,516,647,2,36000,1.79752704791
316353,316931,317567,578,636,2,36000,1.90880503145
316372,316938,317623,566,685,2,36000,1.82627737226
316413,316956,317624,543,668,2,36000,1.8128742515
316429,316963,317657,534,694,2,36000,1.76945244957
316430,316980,317719,550,739,2,36000,1.74424898512
316445,317016,317629,571,613,2,36000,1.93148450245
316462,317054,317847,592,793,2,36000,1.74653215637
316463,317084,317723,621,639,2,36000,1.97183098592
316486,317091,318131,605,1040,2,36000,1.58173076923
316501,317098,317853,597,755,2,36000,1.79072847682
316503,317103,317920,600,817,2,36000,1.73439412485
316518,317110,317747,592,637,2,36000,1.92935635793
316533,317124,317791,591,667,2,36000,1.88605697151
316534,317131,317764,597,633,2,36000,1.94312796209
316568,317168,317921,600,753,2,36000,1.796812749
316583,317178,317952,595,774,2,36000,1.76873385013
316585,317219,317932,634,713,2,36000,1.88920056101
316600,317226,317981,626,755,2,36000,1.82913907285
316616,317244,317949,628,705,2,36000,1.89078014184
316617,317254,318048,637,794,2,36000,1.80226700252
316644,317261,317935,617,674,2,36000,1.91543026706
316659,317280,318059,621,779,2,36000,1.7971758665
316690,317293,317963,603,670,2,36000,1.9
316721,317304,317956,583,652,2,36000,1.89417177914
316722,317313,318221,591,908,2,36000,1.65088105727
316747,317329,318068,582,739,2,36000,1.78755074425
316775,317336,318071,561,735,2,36000,1.76326530612
316776,317343,318052,567,709,2,36000,1.79971791255
316794,317357,318054,563,697,2,36000,1.80774748924
316837,317364,318065,527,701,2,36000,1.7517831669
316920,317379,318049,459,670,2,36000,1.68507462687
316935,317409,318088,474,679,2,36000,1.69808541973
316951,317416,318204,465,788,2,36000,1.59010152284
316953,317437,318118,484,681,2,36000,1.7107195301
316971,317461,318114,490,653,2,36000,1.75038284839
317008,317502,318286,494,784,2,36000,1.63010204082
317044,317508,318166,464,658,2,36000,1.70516717325
317072,317515,318221,443,706,2,36000,1.62747875354
317087,317580,318261,493,681,2,36000,1.72393538913
317089,317635,318399,546,764,2,36000,1.71465968586
317090,317642,318398,552,756,2,36000,1.73015873016
317106,317647,318449,541,802,2,36000,1.67456359102
317121,317669,318372,548,703,2,36000,1.77951635846
317122,317690,318487,568,797,2,36000,1.71267252196
317159,317731,318415,572,684,2,36000,1.83625730994
317178,317738,318483,560,745,2,36000,1.75167785235
317210,317758,318469,548,711,2,36000,1.77074542897
317211,317776,318533,565,757,2,36000,1.7463672391
317232,317804,318664,572,860,2,36000,1.66511627907
317248,317811,318472,563,661,2,36000,1.8517397882
317249,317859,318499,610,640,2,36000,1.953125
317268,317871,318590,603,719,2,36000,1.83866481224
317283,317932,318665,649,733,2,36000,1.88540245566
317298,317939,318709,641,770,2,36000,1.83246753247
317308,317319,317347,11,28,1,3600,1.39285714286
317313,317945,318585,632,640,2,36000,1.9875
317322,363383,651413,46061,288030,18,288000,1.15991736972
317328,317952,318737,624,785,2,36000,1.7949044586
317330,317961,318698,631,737,2,36000,1.85617367707
317331,317968,318699,637,731,2,36000,1.87140902873
317347,317973,318684,626,711,2,36000,1.88045007032
317354,337667,380895,20313,43228,2,43200,1.46990376608
317362,317980,318645,618,665,2,36000,1.92932330827
317378,317993,318618,615,625,2,36000,1.984
317399,318060,318922,661,862,2,36000,1.76682134571
317414,318067,318669,653,602,2,36000,2.08471760797
317429,318072,318856,643,784,2,36000,1.82015306122
317451,318077,318803,626,726,2,36000,1.86225895317
317494,318084,318838,590,754,2,36000,1.7824933687
317495,318089,318812,594,723,2,36000,1.82157676349
317514,318094,318869,580,775,2,36000,1.74838709677
317522,317528,317856,6,328,1,1800,1.01829268293
317568,318099,318752,531,653,2,36000,1.81316998469
317623,318106,318894,483,788,2,36000,1.61294416244
317625,318126,318807,501,681,2,36000,1.73568281938
317640,318133,318892,493,759,2,36000,1.64953886693
317645,317653,317685,8,32,1,3600,1.25
317659,318143,318833,484,690,2,36000,1.70144927536
317679,318178,318884,499,706,2,36000,1.70679886686
317720,318216,319001,496,785,2,36000,1.63184713376
317735,318234,319017,499,783,2,36000,1.63729246488
317752,318239,318891,487,652,2,36000,1.74693251534
317767,318273,318988,506,715,2,36000,1.70769230769
317795,318298,319030,503,732,2,36000,1.68715846995
317810,318384,319099,574,715,2,36000,1.8027972028
317824,317830,318088,6,258,1,3000,1.02325581395
317847,318410,319118,563,708,2,36000,1.79519774011
317854,317866,319683,12,1817,1,1800,1.00660429279
317862,318417,319223,555,806,2,36000,1.68858560794
317922,318427,319338,505,911,2,36000,1.55433589462
317923,318462,319156,539,694,2,36000,1.77665706052
317940,318480,319139,540,659,2,36000,1.81942336874
317941,318487,319127,546,640,2,36000,1.853125
317956,318495,319221,539,726,2,36000,1.74242424242
317958,318502,319193,544,691,2,36000,1.78726483357
317959,318511,319272,552,761,2,36000,1.72536136662
317975,318545,319316,570,771,2,36000,1.73929961089
317990,318597,319215,607,618,2,36000,1.98220064725
318049,318604,319398,555,794,2,36000,1.69899244332
318050,318630,319317,580,687,2,36000,1.8442503639
318067,318659,319388,592,729,2,36000,1.81207133059
318068,318676,319517,608,841,2,36000,1.72294887039
318069,318683,319346,614,663,2,36000,1.92609351433
318071,318688,319461,617,773,2,36000,1.79818887451
318086,318697,319486,611,789,2,36000,1.77439797212
318087,318709,319516,622,807,2,36000,1.770755886
318103,318716,319512,613,796,2,36000,1.77010050251
318118,318723,319430,605,707,2,36000,1.85572842999
318120,318749,319668,629,919,2,36000,1.68443960827
318135,318765,319460,630,695,2,36000,1.90647482014
318271,318280,318836,9,556,1,3600,1.01618705036
318312,318319,318367,7,48,1,3000,1.14583333333
318363,318370,318731,7,361,1,3000,1.01939058172
318457,318815,319478,358,663,2,36000,1.53996983409
318472,318822,319543,350,721,2,36000,1.4854368932
318473,318829,319560,356,731,2,36000,1.48700410397
318489,318846,319701,357,855,2,36000,1.41754385965
318491,318853,319568,362,715,2,36000,1.50629370629
318506,318868,319521,362,653,2,36000,1.55436447167
318533,318881,319621,348,740,2,36000,1.47027027027
318586,318898,319598,312,700,2,36000,1.44571428571
318601,318909,319511,308,602,2,36000,1.51162790698
318620,318915,319530,295,615,2,36000,1.47967479675
318633,318639,318648,6,9,1,900,1.5
318646,318653,318886,7,233,14,7980,1.03004291845
318647,318922,319698,275,776,2,36000,1.3543814433
318666,318934,319692,268,758,2,36000,1.35356200528
318667,319001,319622,334,621,2,36000,1.53784219002
318683,319013,319728,330,715,2,36000,1.46153846154
318684,319029,319754,345,725,2,36000,1.47586206897
318701,319043,319736,342,693,2,36000,1.49350649351
318703,319111,319767,408,656,2,36000,1.62195121951
318720,319130,319802,410,672,2,36000,1.61011904762
318728,318734,320764,6,2030,1,3000,1.00295566502
318739,319148,319881,409,733,2,36000,1.55798090041
318756,319155,319823,399,668,2,36000,1.59730538922
318807,319169,319841,362,672,2,36000,1.53869047619
318808,319206,319958,398,752,2,36000,1.52925531915
318824,319227,320057,403,830,2,36000,1.48554216867
318844,319234,319934,390,700,2,36000,1.55714285714
318846,319241,320040,395,799,2,36000,1.49436795995
318863,319285,320055,422,770,2,36000,1.54805194805
318879,319328,320076,449,748,2,36000,1.60026737968
318884,318891,318899,7,8,1,900,1.5
318894,318904,319132,10,228,14,7980,1.04385964912
318895,319335,320044,440,709,2,36000,1.62059238364
318897,319351,320102,454,751,2,36000,1.60452729694
318898,319363,320108,465,745,2,36000,1.62416107383
318899,319401,320167,502,766,2,36000,1.65535248042
318924,319410,320143,486,733,2,36000,1.66302864939
318989,319442,320071,453,629,2,36000,1.72019077901
319004,319471,320173,467,702,2,36000,1.66524216524
319019,319478,320177,459,699,2,36000,1.65665236052
319034,319490,320155,456,665,2,36000,1.68571428571
319101,319498,320282,397,784,2,36000,1.50637755102
319119,319523,320180,404,657,2,36000,1.61491628615
319130,319137,319144,7,7,1,900,1.4
319135,319530,320201,395,671,2,36000,1.58867362146
319137,319143,319340,6,197,14,7980,1.03045685279
319151,319535,320279,384,744,2,36000,1.51612903226
319166,319540,320246,374,706,2,36000,1.52974504249
319197,319547,320223,350,676,2,36000,1.51775147929
319215,319552,320235,337,683,2,36000,1.4934114202
319230,319564,320287,334,723,2,36000,1.46196403873
319232,319578,320217,346,639,2,36000,1.54147104851
319274,319585,320395,311,810,2,36000,1.38395061728
319320,319610,320450,290,840,2,36000,1.34523809524
319321,319633,320329,312,696,2,36000,1.44827586207
319337,319344,319352,7,8,1,900,1.5
319340,319638,320271,298,633,2,36000,1.47077409163
319347,319358,319552,11,194,14,7980,1.05670103093
319356,319680,320445,324,765,2,36000,1.42352941176
319389,319704,320455,315,751,2,36000,1.41944074567
319404,319711,320435,307,724,2,36000,1.42403314917
319432,319718,320402,286,684,2,36000,1.41812865497
319463,319745,320451,282,706,2,36000,1.39943342776
319464,319757,320367,293,610,2,36000,1.48032786885
319480,319766,320501,286,735,2,36000,1.38911564626
319497,319779,320521,282,742,2,36000,1.38005390836
319516,319814,320521,298,707,2,36000,1.42149929279
319518,319835,320525,317,690,2,36000,1.45942028986
319519,319853,320651,334,798,2,36000,1.41854636591
319539,319893,320668,354,775,2,36000,1.45677419355
319540,319946,320648,406,702,2,36000,1.57834757835
319542,319970,320668,428,698,2,36000,1.61318051576
319550,319559,319569,9,10,1,900,1.9
319557,320052,320811,495,759,2,36000,1.65217391304
319559,319571,319735,12,164,14,7980,1.07317073171
319573,320058,320869,485,811,2,36000,1.598027127
319574,320068,320599,494,531,2,36000,1.93032015066
319599,320074,320765,475,691,2,36000,1.68740955137
319623,320083,320660,460,577,2,36000,1.7972270364
319625,320089,320707,464,618,2,36000,1.75080906149
319671,320114,320883,443,769,2,36000,1.57607282185
319695,320121,320812,426,691,2,36000,1.61649782923
319710,320155,320965,445,810,2,36000,1.54938271605
319712,320167,320944,455,777,2,36000,1.58558558559
319730,320180,320982,450,802,2,36000,1.56109725686
319733,319739,319750,6,11,1,900,1.54545454545
319741,319751,320026,10,275,14,7980,1.03636363636
319745,320186,320879,441,693,2,36000,1.63636363636
319761,320193,320968,432,775,2,36000,1.55741935484
319777,320198,320948,421,750,2,36000,1.56133333333
319802,320214,320928,412,714,2,36000,1.57703081232
319823,320229,320894,406,665,2,36000,1.61052631579
319841,320236,320882,395,646,2,36000,1.61145510836
319881,320247,321055,366,808,2,36000,1.45297029703
319934,320258,320959,324,701,2,36000,1.46219686163
319958,320293,320963,335,670,2,36000,1.5
320023,320030,320048,7,18,1,900,1.38888888889
320032,320039,320277,7,238,14,7980,1.02941176471
320038,320301,321032,263,731,2,36000,1.35978112175
320055,320306,321052,251,746,2,36000,1.33646112601
320056,320311,320969,255,658,2,36000,1.38753799392
320072,320341,321067,269,726,2,36000,1.37052341598
320073,320379,321048,306,669,2,36000,1.45739910314
320088,320408,321159,320,751,2,36000,1.42609853529
320104,320415,321107,311,692,2,36000,1.44942196532
320120,320452,321141,332,689,2,36000,1.48185776488
320146,320465,321201,319,736,2,36000,1.43342391304
320162,320472,321218,310,746,2,36000,1.41554959786
320177,320477,321317,300,840,2,36000,1.35714285714
320178,320482,321142,304,660,2,36000,1.46060606061
320180,320513,321225,333,712,2,36000,1.46769662921
320195,320533,321289,338,756,2,36000,1.44708994709
320210,320538,321126,328,588,2,36000,1.55782312925
320225,320545,321239,320,694,2,36000,1.46109510086
320226,320611,321306,385,695,2,36000,1.55395683453
320242,320660,321292,418,632,2,36000,1.66139240506
320257,320667,321403,410,736,2,36000,1.55706521739
320272,320674,321382,402,708,2,36000,1.56779661017
320275,320281,320289,6,8,1,900,1.4
320281,320288,320444,7,156,14,7980,1.04487179487
320287,320681,321340,394,659,2,36000,1.59787556904
320289,320686,321397,397,711,2,36000,1.55836849508
320290,320719,321426,429,707,2,36000,1.60678925035
320330,320776,322171,446,1395,2,36000,1.31971326165
320367,320822,321555,455,733,2,36000,1.6207366985
320394,320830,321640,436,810,2,36000,1.53827160494
320410,320881,321685,471,804,2,36000,1.58582089552
320436,320891,321535,455,644,2,36000,1.70652173913
320439,320446,320456,7,10,1,900,1.7
320448,320459,320694,11,235,14,7980,1.04680851064
320452,320898,321643,446,745,2,36000,1.59865771812
320453,320903,321567,450,664,2,36000,1.67771084337
320454,320910,321673,456,763,2,36000,1.59764089122
320470,320941,321659,471,718,2,36000,1.65598885794
320503,320956,321624,453,668,2,36000,1.67814371257
320522,320968,321622,446,654,2,36000,1.68195718654
320524,320980,321662,456,682,2,36000,1.66862170088
320539,320985,321627,446,642,2,36000,1.69470404984
320602,320992,321828,390,836,2,36000,1.46650717703
320652,320997,321675,345,678,2,36000,1.50884955752
320653,321002,321653,349,651,2,36000,1.53609831029
320669,321009,321717,340,708,2,36000,1.4802259887
320670,321049,321699,379,650,2,36000,1.58307692308
320672,321061,321781,389,720,2,36000,1.54027777778
320688,320696,320704,8,8,1,900,1.6
320696,320702,320958,6,256,14,7980,1.0234375
320708,321068,321714,360,646,2,36000,1.5572755418
320767,321073,321720,306,647,2,36000,1.47295208655
320811,321080,321846,269,766,2,36000,1.35117493473
320813,321120,321810,307,690,2,36000,1.44492753623
320871,321138,321798,267,660,2,36000,1.40454545455
320886,321152,321814,266,662,2,36000,1.40181268882
320888,321159,321953,271,794,2,36000,1.34130982368
320889,321170,321921,281,751,2,36000,1.3741677763
320904,321213,322034,309,821,2,36000,1.37637028015
320929,321234,321917,305,683,2,36000,1.44655929722
320944,321241,321908,297,667,2,36000,1.44527736132
320956,320962,320971,6,9,1,900,1.5
320960,321251,321863,291,612,2,36000,1.47549019608
320961,321301,322005,340,704,2,36000,1.48295454545
320965,320974,321215,9,241,14,7980,1.03734439834
320977,321308,322097,331,789,2,36000,1.41951837769
320978,321317,321969,339,652,2,36000,1.51993865031
320980,321329,322125,349,796,2,36000,1.43844221106
320981,321353,322023,372,670,2,36000,1.5552238806
320996,321394,322042,398,648,2,36000,1.61419753086
321033,321409,322114,376,705,2,36000,1.53333333333
321037,321044,323421,7,2377,1,7200,1.00294488851
321051,321416,322115,365,699,2,36000,1.52217453505
321067,321438,322206,371,768,2,36000,1.48307291667
321068,321548,322155,480,607,2,36000,1.79077429984
321069,321568,322336,499,768,2,36000,1.64973958333
321110,321578,322285,468,707,2,36000,1.66195190948
321128,321634,322337,506,703,2,36000,1.71977240398
321144,321641,322495,497,854,2,36000,1.58196721311
321145,321646,322368,501,722,2,36000,1.69390581717
321160,321653,322201,493,548,2,36000,1.8996350365
321204,321660,322365,456,705,2,36000,1.64680851064
321213,321220,321227,7,7,1,900,1.4
321219,321667,322345,448,678,2,36000,1.66076696165
321222,321228,321483,6,255,14,7980,1.02352941176
321234,321673,322411,439,738,2,36000,1.59485094851
321249,321679,322435,430,756,2,36000,1.56878306878
321294,321685,322312,391,627,2,36000,1.62360446571
321296,321697,322427,401,730,2,36000,1.54931506849
321311,321704,322416,393,712,2,36000,1.55196629213
321326,321710,322416,384,706,2,36000,1.54390934844
321341,321726,322506,385,780,2,36000,1.49358974359
321384,321733,322396,349,663,2,36000,1.52639517345
321399,321738,322527,339,789,2,36000,1.42965779468
321415,321795,322576,380,781,2,36000,1.48655569782
321430,321811,322508,381,697,2,36000,1.54662840746
321481,321488,321496,7,8,1,900,1.5
321489,321495,321785,6,290,14,7980,1.02068965517
321536,321823,322481,287,658,2,36000,1.43617021277
321559,321829,322578,270,749,2,36000,1.36048064085
321574,321840,322579,266,739,2,36000,1.3599458728
321623,321859,322559,236,700,2,36000,1.33714285714
321624,321875,322593,251,718,2,36000,1.3495821727
321640,321920,322726,280,806,2,36000,1.34739454094
321641,321930,322663,289,733,2,36000,1.39427012278
321657,321937,322528,280,591,2,36000,1.47377326565
321658,321964,322668,306,704,2,36000,1.43465909091
321675,321982,322696,307,714,2,36000,1.4299719888
321676,322017,322671,341,654,2,36000,1.52140672783
321678,322035,322804,357,769,2,36000,1.46423927178
321679,322046,322825,367,779,2,36000,1.47111681643
321685,321692,321693,7,1,1,1200,1.0
321694,322054,322755,360,701,2,36000,1.51355206847
321710,322109,322909,399,800,2,36000,1.49875
321725,322126,322998,401,872,2,36000,1.45986238532
321726,322133,322918,407,785,2,36000,1.51847133758
321728,322140,322803,412,663,2,36000,1.62141779789
321782,321788,321817,6,29,1,900,1.20689655172
321783,322167,322850,384,683,2,36000,1.56222547584
321791,321801,322077,10,276,14,7980,1.03623188406
321802,322184,322927,382,743,2,36000,1.51413189771
321823,322213,322935,390,722,2,36000,1.54016620499
321824,322220,322896,396,676,2,36000,1.58579881657
321843,322297,323035,454,738,2,36000,1.61517615176
321859,322324,323031,465,707,2,36000,1.65770862801
321874,322348,323097,474,749,2,36000,1.63284379172
321911,322355,323050,444,695,2,36000,1.63884892086
321928,322361,323100,433,739,2,36000,1.58592692828
321929,322376,323138,447,762,2,36000,1.58661417323
321954,322384,323133,430,749,2,36000,1.5740987984
321972,322408,323200,436,792,2,36000,1.55050505051
322010,322423,323178,413,755,2,36000,1.54701986755
322028,322429,323115,401,686,2,36000,1.58454810496
322044,322434,323290,390,856,2,36000,1.45560747664
322045,322442,323217,397,775,2,36000,1.51225806452
322076,322083,322092,7,9,1,900,1.6
322084,322091,322383,7,292,14,7980,1.02397260274
322097,322448,323272,351,824,2,36000,1.42597087379
322116,322494,323280,378,786,2,36000,1.48091603053
322117,322506,323180,389,674,2,36000,1.57715133531
322132,322518,323197,386,679,2,36000,1.56848306333
322156,322525,323236,369,711,2,36000,1.51898734177
322172,322538,323217,366,679,2,36000,1.53902798233
322203,322545,323199,342,654,2,36000,1.52293577982
322219,322571,323244,352,673,2,36000,1.52303120357
322287,322589,323324,302,735,2,36000,1.41088435374
322312,322596,323279,284,683,2,36000,1.41581259151
322338,322601,323282,263,681,2,36000,1.38619676946
322340,322608,323489,268,881,2,36000,1.30419977299
322355,322674,323456,319,782,2,36000,1.40792838875
322370,322682,323454,312,772,2,36000,1.40414507772
322372,322687,323404,315,717,2,36000,1.43933054393
322381,322391,322398,10,7,1,900,1.7
322390,322398,322652,8,254,14,7980,1.03149606299
322396,322707,323504,311,797,2,36000,1.39021329987
322412,322738,323381,326,643,2,36000,1.50699844479
322428,322767,323429,339,662,2,36000,1.51208459215
322429,322815,323506,386,691,2,36000,1.55861070912
322430,322821,323511,391,690,2,36000,1.56666666667
322448,322837,323591,389,754,2,36000,1.51591511936
322482,322862,323675,380,813,2,36000,1.46740467405
322499,322908,323582,409,674,2,36000,1.60682492582
322515,322922,323633,407,711,2,36000,1.57243319269
322516,322930,323589,414,659,2,36000,1.6282245827
322532,322948,323687,416,739,2,36000,1.56292286874
322533,322955,323809,422,854,2,36000,1.49414519906
322561,323010,324161,449,1151,2,36000,1.39009556907
322578,323043,323743,465,700,2,36000,1.66428571429
322580,323050,323771,470,721,2,36000,1.65187239945
322595,323062,323699,467,637,2,36000,1.73312401884
322597,323109,323887,512,778,2,36000,1.65809768638
322649,322657,322680,8,23,1,900,1.34782608696
322659,322665,322929,6,264,14,7980,1.02272727273
322668,323116,323866,448,750,2,36000,1.59733333333
322670,323127,323928,457,801,2,36000,1.57053682896
322685,323145,323846,460,701,2,36000,1.65620542083
322701,323151,323794,450,643,2,36000,1.699844479
322728,323190,323836,462,646,2,36000,1.71517027864
322756,323197,323898,441,701,2,36000,1.62910128388
322805,323209,323848,404,639,2,36000,1.63223787167
322806,323221,323969,415,748,2,36000,1.55481283422
322827,323226,323989,399,763,2,36000,1.52293577982
322852,323238,323913,386,675,2,36000,1.57185185185
322897,323243,323832,346,589,2,36000,1.58743633277
322913,323250,324011,337,761,2,36000,1.44283837057
322927,322936,322944,9,8,1,900,1.7
322929,323257,323927,328,670,2,36000,1.48955223881
322930,323284,323976,354,692,2,36000,1.51156069364
322936,322943,323210,7,267,14,7980,1.02621722846
322945,323293,324071,348,778,2,36000,1.44730077121
322997,323298,324012,301,714,2,36000,1.42156862745
323030,323305,323955,275,650,2,36000,1.42307692308
323045,323310,324026,265,716,2,36000,1.37011173184
323060,323337,324144,277,807,2,36000,1.34324659232
323097,323393,324035,296,642,2,36000,1.46105919003
323112,323419,324168,307,749,2,36000,1.40987983979
323127,323441,324212,314,771,2,36000,1.40726329442
323145,323467,324496,322,1029,2,36000,1.31292517007
323146,323474,324242,328,768,2,36000,1.42708333333
323180,323506,324374,326,868,2,36000,1.37557603687
323182,323520,324161,338,641,2,36000,1.52730109204
323200,323525,324189,325,664,2,36000,1.48945783133
323202,323532,324263,330,731,2,36000,1.45143638851
323203,323595,324314,392,719,2,36000,1.54520166898
323208,323216,323232,8,16,1,900,1.5
323216,323232,323495,16,263,14,7980,1.0608365019
323219,323601,324349,382,748,2,36000,1.51069518717
323220,323609,324301,389,692,2,36000,1.56213872832
323236,323645,324358,409,713,2,36000,1.57363253857
323251,323687,324579,436,892,2,36000,1.48878923767
323278,323699,324412,421,713,2,36000,1.5904628331
323280,323711,324544,431,833,2,36000,1.51740696279
323307,323755,324543,448,788,2,36000,1.56852791878
323308,323783,324559,475,776,2,36000,1.61211340206
323309,323812,324566,503,754,2,36000,1.66710875332
323328,323822,324499,494,677,2,36000,1.72968980798
323382,323844,324611,462,767,2,36000,1.60234680574
323404,323851,324526,447,675,2,36000,1.66222222222
323406,323412,325517,6,2105,1,7200,1.00285035629
323428,323857,324553,429,696,2,36000,1.61637931034
323456,323864,324563,408,699,2,36000,1.58369098712
323457,323879,324491,422,612,2,36000,1.68954248366
323491,323899,324608,408,709,2,36000,1.5754583921
323493,323499,323507,6,8,1,900,1.4
323501,323512,323790,11,278,14,7980,1.03956834532
323506,323910,324671,404,761,2,36000,1.5308804205
323508,323925,324617,417,692,2,36000,1.60260115607
323523,323940,324692,417,752,2,36000,1.5545212766
323586,323945,324620,359,675,2,36000,1.53185185185
323601,323967,324806,366,839,2,36000,1.43623361144
323602,323981,324745,379,764,2,36000,1.49607329843
323636,323989,324694,353,705,2,36000,1.50070921986
323676,324000,324824,324,824,2,36000,1.3932038835
323694,324023,324701,329,678,2,36000,1.48525073746
323709,324030,324755,321,725,2,36000,1.44275862069
323746,324039,324834,293,795,2,36000,1.36855345912
323773,324048,324858,275,810,2,36000,1.33950617284
323788,323795,323802,7,7,1,900,1.4
323795,324083,324825,288,742,2,36000,1.38814016173
323798,323805,324048,7,243,14,7980,1.02880658436
323810,324156,324855,346,699,2,36000,1.49499284692
323833,324173,324891,340,718,2,36000,1.47353760446
323849,324178,324863,329,685,2,36000,1.4802919708
323850,324185,324867,335,682,2,36000,1.49120234604
323852,324202,324876,350,674,2,36000,1.51928783383
323870,324224,325003,354,779,2,36000,1.45442875481
323889,324254,324909,365,655,2,36000,1.5572519084
323909,324276,324994,367,718,2,36000,1.51114206128
323925,324313,325039,388,726,2,36000,1.53443526171
323940,324331,325208,391,877,2,36000,1.44583808438
323941,324361,325067,420,706,2,36000,1.59490084986
323956,324370,325063,414,693,2,36000,1.5974025974
323972,324387,325151,415,764,2,36000,1.54319371728
323987,324424,325203,437,779,2,36000,1.56097560976
323989,324502,325277,513,775,2,36000,1.66193548387
324013,324509,325251,496,742,2,36000,1.66846361186
324015,324516,325212,501,696,2,36000,1.71982758621
324030,324538,325328,508,790,2,36000,1.64303797468
324045,324555,325239,510,684,2,36000,1.74561403509
324046,324055,324062,9,7,1,900,1.6
324055,324061,324309,6,248,14,7980,1.02419354839
324072,324561,325355,489,794,2,36000,1.61586901763
324151,324567,325312,416,745,2,36000,1.55838926174
324168,324575,325248,407,673,2,36000,1.60475482912
324169,324580,325271,411,691,2,36000,1.59479015919
324171,324592,325286,421,694,2,36000,1.60662824207
324193,324604,325393,411,789,2,36000,1.52091254753
324214,324620,325320,406,700,2,36000,1.58
324243,324626,325279,383,653,2,36000,1.5865237366
324265,324633,325381,368,748,2,36000,1.49197860963
324303,324638,325289,335,651,2,36000,1.51459293395
324307,324319,324339,12,20,1,900,1.6
324315,324326,324578,11,252,14,7980,1.04365079365
324318,324683,325410,365,727,2,36000,1.50206327373
324353,324706,325582,353,876,2,36000,1.40296803653
324368,324711,325412,343,701,2,36000,1.48930099857
324384,324718,325424,334,706,2,36000,1.4730878187
324414,324757,325478,343,721,2,36000,1.47572815534
324493,324767,325511,274,744,2,36000,1.36827956989
324509,324817,325528,308,711,2,36000,1.43319268636
324510,324836,325606,326,770,2,36000,1.42337662338
324528,324843,325501,315,658,2,36000,1.47872340426
324544,324850,325530,306,680,2,36000,1.45
324545,324872,325514,327,642,2,36000,1.50934579439
324561,324884,325677,323,793,2,36000,1.40731399748
324562,324889,325738,327,849,2,36000,1.3851590106
324576,324587,324594,11,7,1,900,1.8
324578,324894,325519,316,625,2,36000,1.5056
324579,324901,325609,322,708,2,36000,1.45480225989
324587,324599,324862,12,263,14,7980,1.04562737643
324595,324909,325636,314,727,2,36000,1.43191196699
324610,324921,325622,311,701,2,36000,1.44365192582
324626,325005,325667,379,662,2,36000,1.57250755287
324627,325015,325781,388,766,2,36000,1.50652741514
324628,325051,325729,423,678,2,36000,1.62389380531
324674,325076,325786,402,710,2,36000,1.5661971831
324696,325083,325790,387,707,2,36000,1.54738330976
324697,325162,325998,465,836,2,36000,1.55622009569
324713,325215,325892,502,677,2,36000,1.74150664697
324747,325221,325875,474,654,2,36000,1.7247706422
324766,325228,325989,462,761,2,36000,1.60709592641
324808,325251,325939,443,688,2,36000,1.64389534884
324824,325260,326011,436,751,2,36000,1.58055925433
324825,325266,326051,441,785,2,36000,1.56178343949
324841,325284,325971,443,687,2,36000,1.64483260553
324856,325290,326056,434,766,2,36000,1.56657963446
324860,324867,324895,7,28,1,900,1.25
324872,324879,325134,7,255,14,7980,1.02745098039
324876,325295,325980,419,685,2,36000,1.61167883212
324877,325303,326084,426,781,2,36000,1.54545454545
324879,325308,326022,429,714,2,36000,1.60084033613
324880,325324,326021,444,697,2,36000,1.63701578192
324897,325333,325992,436,659,2,36000,1.66160849772
324915,325340,326116,425,776,2,36000,1.54768041237
324999,325367,326135,368,768,2,36000,1.47916666667
325014,325394,326212,380,818,2,36000,1.46454767726
325041,325407,326050,366,643,2,36000,1.56920684292
325066,325423,326180,357,757,2,36000,1.4715984148
325082,325430,326096,348,666,2,36000,1.52252252252
325133,325140,325150,7,10,1,900,1.7
325141,325148,325398,7,250,14,7980,1.028
325155,325437,326224,282,787,2,36000,1.3583227446
325204,325490,326172,286,682,2,36000,1.41935483871
325219,325514,326203,295,689,2,36000,1.42815674891
325221,325523,326193,302,670,2,36000,1.45074626866
325239,325529,326247,290,718,2,36000,1.40389972145
325254,325536,326322,282,786,2,36000,1.35877862595
325256,325543,326223,287,680,2,36000,1.42205882353
325271,325548,326205,277,657,2,36000,1.42161339422
325287,325594,326238,307,644,2,36000,1.47670807453
325288,325619,326367,331,748,2,36000,1.44251336898
325290,325626,326204,336,578,2,36000,1.58131487889
325305,325634,326299,329,665,2,36000,1.49473684211
325320,325648,326443,328,795,2,36000,1.41257861635
325321,325678,326417,357,739,2,36000,1.48308525034
325337,325692,326334,355,642,2,36000,1.55295950156
325364,325741,326326,377,585,2,36000,1.64444444444
325384,325750,326520,366,770,2,36000,1.47532467532
325394,325400,325414,6,14,1,900,1.42857142857
325402,325793,326545,391,752,2,36000,1.51994680851
325407,325413,325666,6,253,14,7980,1.02371541502
325418,325800,326437,382,637,2,36000,1.59968602826
325419,325807,326450,388,643,2,36000,1.6034214619
325435,325887,326624,452,737,2,36000,1.61329715061
325481,325904,326624,423,720,2,36000,1.5875
325505,325950,326828,445,878,2,36000,1.50683371298
325521,325983,326661,462,678,2,36000,1.6814159292
325522,325992,326756,470,764,2,36000,1.61518324607
325523,326001,326693,478,692,2,36000,1.69075144509
325540,326008,326712,468,704,2,36000,1.66477272727
325542,326015,326692,473,677,2,36000,1.69867060561
325575,325581,330389,6,4808,1,7200,1.00124792013
325588,326024,326821,436,797,2,36000,1.54705144291
325610,326033,326809,423,776,2,36000,1.54510309278
325611,326040,326679,429,639,2,36000,1.67136150235
325627,326062,326792,435,730,2,36000,1.59589041096
325643,326069,326848,426,779,2,36000,1.54685494223
325663,325670,325694,7,24,1,900,1.29166666667
325669,326074,326718,405,644,2,36000,1.62888198758
325677,325685,325938,8,253,14,7980,1.03162055336
325686,326097,326802,411,705,2,36000,1.5829787234
325730,326108,326789,378,681,2,36000,1.5550660793
325746,326128,326797,382,669,2,36000,1.57100149477
325783,326148,326782,365,634,2,36000,1.57570977918
325799,326184,326887,385,703,2,36000,1.54765291607
325800,326192,326956,392,764,2,36000,1.51308900524
325876,326205,326906,329,701,2,36000,1.46932952924
325895,326218,326928,323,710,2,36000,1.45492957746
325934,325942,325959,8,17,1,900,1.47058823529
325939,326223,326928,284,705,2,36000,1.40283687943
325946,325957,326205,11,248,14,7980,1.04435483871
325974,326228,326926,254,698,2,36000,1.36389684814
325993,326240,326961,247,721,2,36000,1.34257975035
325994,326245,326955,251,710,2,36000,1.35352112676
325995,326252,326931,257,679,2,36000,1.37849779087
326011,326257,327073,246,816,2,36000,1.30147058824
326013,326264,327001,251,737,2,36000,1.34056987788
326028,326311,327080,283,769,2,36000,1.36801040312
326029,326335,327136,306,801,2,36000,1.38202247191
326051,326342,327028,291,686,2,36000,1.42419825073
326053,326349,327123,296,774,2,36000,1.38242894057
326068,326379,327124,311,745,2,36000,1.41744966443
326091,326430,327189,339,759,2,36000,1.44664031621
326106,326450,327232,344,782,2,36000,1.43989769821
326122,326457,327065,335,608,2,36000,1.55098684211
326137,326464,327199,327,735,2,36000,1.44489795918
326174,326532,327176,358,644,2,36000,1.55590062112
326189,326557,327221,368,664,2,36000,1.55421686747
326203,326211,326221,8,10,1,900,1.8
326204,326636,327342,432,706,2,36000,1.611898017
326206,326641,327291,435,650,2,36000,1.66923076923
326207,326674,327379,467,705,2,36000,1.66241134752
326213,326235,326496,22,261,14,7980,1.08429118774
326222,326691,327282,469,591,2,36000,1.79357021997
326224,326704,327332,480,628,2,36000,1.76433121019
326225,326711,327364,486,653,2,36000,1.74425727412
326226,326725,327491,499,766,2,36000,1.65143603133
326243,326732,327434,489,702,2,36000,1.69658119658
326258,326778,327449,520,671,2,36000,1.77496274218
326301,326794,327408,493,614,2,36000,1.80293159609
326323,326806,327463,483,657,2,36000,1.73515981735
326324,326813,327493,489,680,2,36000,1.71911764706
326340,326818,327574,478,756,2,36000,1.63227513228
326367,326825,327582,458,757,2,36000,1.60501981506
326420,326830,327493,410,663,2,36000,1.61840120664
326440,326836,327471,396,635,2,36000,1.62362204724
326460,326842,327560,382,718,2,36000,1.53203342618
326462,326860,327410,398,550,2,36000,1.72363636364
326493,326501,326510,8,9,1,900,1.7
326500,326507,326783,7,276,14,7980,1.02536231884
326521,326899,327540,378,641,2,36000,1.58970358814
326545,326918,327666,373,748,2,36000,1.4986631016
326625,326939,327684,314,745,2,36000,1.42147651007
326627,326946,327579,319,633,2,36000,1.50394944708
326663,326951,327493,288,542,2,36000,1.53136531365
326682,326956,327612,274,656,2,36000,1.41768292683
326700,326966,327659,266,693,2,36000,1.38383838384
326702,326973,327709,271,736,2,36000,1.36820652174
326724,326978,327632,254,654,2,36000,1.38837920489
326726,327013,327715,287,702,2,36000,1.40883190883
326776,326785,326810,9,25,1,900,1.36
326782,327041,327805,259,764,2,36000,1.3390052356
326784,327082,327842,298,760,2,36000,1.39210526316
326790,326801,327073,11,272,14,7980,1.04044117647
326807,327094,327945,287,851,2,36000,1.33725029377
326808,327101,327817,293,716,2,36000,1.40921787709
326810,327135,327789,325,654,2,36000,1.49694189602
326811,327141,327823,330,682,2,36000,1.48387096774
326827,327148,327790,321,642,2,36000,1.5
326829,327188,327998,359,810,2,36000,1.44320987654
326844,327201,327898,357,697,2,36000,1.51219512195
326859,327212,327926,353,714,2,36000,1.4943977591
326887,327233,327930,346,697,2,36000,1.49641319943
326909,327244,327980,335,736,2,36000,1.45516304348
326927,327294,328041,367,747,2,36000,1.49129852744
326929,327304,328067,375,763,2,36000,1.49148099607
326956,327344,328121,388,777,2,36000,1.49935649936
326957,327354,327958,397,604,2,36000,1.65728476821
326958,327380,328184,422,804,2,36000,1.52487562189
326960,327394,328085,434,691,2,36000,1.62807525326
326978,327420,328115,442,695,2,36000,1.63597122302
327002,327426,328151,424,725,2,36000,1.58482758621
327031,327446,328166,415,720,2,36000,1.57638888889
327068,327461,328120,393,659,2,36000,1.59635811836
327068,327075,327089,7,14,1,900,1.5
327081,327088,327369,7,281,14,7980,1.02491103203
327084,327475,328315,391,840,2,36000,1.46547619048
327085,327483,328311,398,828,2,36000,1.4806763285
327132,327503,328203,371,700,2,36000,1.53
327133,327510,328274,377,764,2,36000,1.49345549738
327149,327515,328183,366,668,2,36000,1.54790419162
327177,327520,328355,343,835,2,36000,1.41077844311
327192,327552,328282,360,730,2,36000,1.49315068493
327207,327572,328259,365,687,2,36000,1.53129548763
327222,327586,328423,364,837,2,36000,1.4348864994
327241,327592,328264,351,672,2,36000,1.52232142857
327284,327600,328356,316,756,2,36000,1.41798941799
327300,327625,328372,325,747,2,36000,1.43507362784
327321,327328,335764,7,8436,2,18000,1.00082977715
327334,327644,328320,310,676,2,36000,1.45857988166
327349,327361,335767,12,8406,2,18000,1.00142755175
327350,327671,328476,321,805,2,36000,1.39875776398
327366,327372,327384,6,12,1,900,1.5
327366,327682,328362,316,680,2,36000,1.46470588235
327374,327387,327671,13,284,14,7980,1.04577464789
327381,327697,328384,316,687,2,36000,1.45997088792
327409,327721,328365,312,644,2,36000,1.48447204969
327424,327728,328465,304,737,2,36000,1.41248303935
327440,327802,328603,362,801,2,36000,1.45193508115
327455,327807,328540,352,733,2,36000,1.48021828104
327476,327817,328528,341,711,2,36000,1.47960618847
327478,327829,328572,351,743,2,36000,1.47240915209
327493,327836,328464,343,628,2,36000,1.54617834395
327494,327854,328600,360,746,2,36000,1.48257372654
327496,327910,328567,414,657,2,36000,1.6301369863
327497,327938,328638,441,700,2,36000,1.63
327541,327945,328573,404,628,2,36000,1.64331210191
327562,327957,328643,395,686,2,36000,1.57580174927
327577,327970,328792,393,822,2,36000,1.47810218978
327596,327992,328707,396,715,2,36000,1.55384615385
327597,328010,328757,413,747,2,36000,1.55287817938
327613,328053,328774,440,721,2,36000,1.61026352288
327634,328079,328768,445,689,2,36000,1.64586357039
327661,328097,328862,436,765,2,36000,1.56993464052
327668,327677,327698,9,21,1,900,1.42857142857
327679,328127,328856,448,729,2,36000,1.61454046639
327679,327690,327962,11,272,14,7980,1.04044117647
327695,328133,328898,438,765,2,36000,1.57254901961
327715,328139,328937,424,798,2,36000,1.5313283208
327716,328163,328825,447,662,2,36000,1.6752265861
327791,328178,328834,387,656,2,36000,1.58993902439
327792,328194,328936,402,742,2,36000,1.54177897574
327808,328200,328932,392,732,2,36000,1.53551912568
327823,328215,328983,392,768,2,36000,1.51041666667
327839,328271,329487,432,1216,2,36000,1.35526315789
327854,328283,328962,429,679,2,36000,1.63181148748
327901,328290,329018,389,728,2,36000,1.53434065934
327926,328297,328938,371,641,2,36000,1.57878315133
327941,328324,329058,383,734,2,36000,1.52179836512
327957,328331,329070,374,739,2,36000,1.50608930988
327957,327963,327974,6,11,1,900,1.54545454545
327965,327977,328233,12,256,14,7980,1.046875
327972,328338,329013,366,675,2,36000,1.54222222222
327987,328366,329031,379,665,2,36000,1.56992481203
328002,328373,328975,371,602,2,36000,1.61627906977
328048,328380,329123,332,743,2,36000,1.4468371467
328067,328385,329056,318,671,2,36000,1.4739195231
328085,328392,329031,307,639,2,36000,1.48043818466
328116,328399,328998,283,599,2,36000,1.47245409015
328131,328437,329260,306,823,2,36000,1.37181044957
328133,328475,329126,342,651,2,36000,1.52534562212
328154,328482,329259,328,777,2,36000,1.42213642214
328169,328494,329217,325,723,2,36000,1.44951590595
328185,328544,329258,359,714,2,36000,1.50280112045
328187,328553,329300,366,747,2,36000,1.48995983936
328205,328580,329261,375,681,2,36000,1.55066079295
328226,328233,342061,7,13828,12,14400,1.00050621927
328231,328239,328247,8,8,1,900,1.6
328239,328246,328525,7,279,14,7980,1.02508960573
328261,328587,329311,326,724,2,36000,1.45027624309
328266,328277,328284,11,7,64,30,1.8
328277,328592,329343,315,751,2,36000,1.41944074567
328278,328611,329287,333,676,2,36000,1.4926035503
328293,328619,329424,326,805,2,36000,1.4049689441
328312,328650,329372,338,722,2,36000,1.46814404432
328329,328657,329365,328,708,2,36000,1.46327683616
328330,328719,329444,389,725,2,36000,1.53655172414
328358,328769,329486,411,717,2,36000,1.57322175732
328360,328779,329434,419,655,2,36000,1.63969465649
328377,328786,329538,409,752,2,36000,1.54388297872
328378,328804,329480,426,676,2,36000,1.63017751479
328380,328837,329456,457,619,2,36000,1.73828756058
328408,328852,329546,444,694,2,36000,1.63976945245
328420,328426,340870,6,12444,12,14400,1.00048216008
328427,328870,329553,443,683,2,36000,1.6486090776
328469,328877,329509,408,632,2,36000,1.64556962025
328470,328910,329665,440,755,2,36000,1.58278145695
328477,328489,341529,12,13040,12,14400,1.0009202454
328484,328537,328543,53,6,64,30,5.9
328487,328945,329701,458,756,2,36000,1.60582010582
328523,328529,328543,6,14,1,900,1.42857142857
328531,328560,328839,29,279,14,7980,1.10394265233
328532,328952,329591,420,639,2,36000,1.65727699531
328550,328957,329744,407,787,2,36000,1.51715374841
328573,328962,329577,389,615,2,36000,1.6325203252
328574,328974,329674,400,700,2,36000,1.57142857143
328590,328986,329595,396,609,2,36000,1.65024630542
328594,342074,342087,13480,13,128,30,1037.92307692
328606,328995,329711,389,716,2,36000,1.54329608939
328607,329010,329662,403,652,2,36000,1.61809815951
328638,329025,329823,387,798,2,36000,1.48496240602
328653,329031,329765,378,734,2,36000,1.51498637602
328708,329043,329812,335,769,2,36000,1.43563068921
328757,329049,329742,292,693,2,36000,1.42135642136
328773,329068,329803,295,735,2,36000,1.40136054422
328788,329075,329855,287,780,2,36000,1.36794871795
328803,329083,329820,280,737,2,36000,1.37991858887
328825,329140,329917,315,777,2,36000,1.40540540541
328838,328845,328854,7,9,1,900,1.6
328840,329145,329821,305,676,2,36000,1.45118343195
328846,328864,329130,18,266,14,7980,1.06766917293
328856,329229,329903,373,674,2,36000,1.55341246291
328871,329271,329976,400,705,2,36000,1.56737588652
328899,329276,330054,377,778,2,36000,1.48457583548
328932,329281,330037,349,756,2,36000,1.46164021164
328949,329287,330029,338,742,2,36000,1.45552560647
328950,329299,330016,349,717,2,36000,1.48675034868
328951,329312,330074,361,762,2,36000,1.47375328084
328966,329324,329989,358,665,2,36000,1.53834586466
328981,329355,330143,374,788,2,36000,1.47461928934
328997,329377,330625,380,1248,2,36000,1.30448717949
328998,329383,330113,385,730,2,36000,1.52739726027
329014,329436,330061,422,625,2,36000,1.6752
329029,329446,330103,417,657,2,36000,1.63470319635
329044,329457,330197,413,740,2,36000,1.55810810811
329046,329467,330139,421,672,2,36000,1.62648809524
329061,329492,330311,431,819,2,36000,1.52625152625
329062,329498,330284,436,786,2,36000,1.55470737913
329078,329504,330196,426,692,2,36000,1.61560693642
329110,340899,387474,11789,46575,1,79200,1.25311862587
329126,329522,330289,396,767,2,36000,1.51629726206
329127,329551,330212,424,661,2,36000,1.64145234493
329128,329133,329154,5,21,1,900,1.2380952381
329138,329152,329413,14,261,14,7980,1.05363984674
329220,329558,330168,338,610,2,36000,1.55409836066
329259,329565,330318,306,753,2,36000,1.40637450199
329260,329589,330338,329,749,2,36000,1.43925233645
329261,329603,330278,342,675,2,36000,1.50666666667
329263,329609,330416,346,807,2,36000,1.42874845105
329292,329674,330375,382,701,2,36000,1.54493580599
329292,356538,386434,27246,29896,1,511200,1.91135937918
329307,329680,330383,373,703,2,36000,1.53058321479
329323,329687,330356,364,669,2,36000,1.54409566517
329344,329715,330358,371,643,2,36000,1.57698289269
329366,329728,330393,362,665,2,36000,1.54436090226
329381,329753,330469,372,716,2,36000,1.51955307263
329410,329417,329425,7,8,1,900,1.5
329418,329424,329704,6,280,14,7980,1.02142857143
329427,329759,330527,332,768,2,36000,1.43229166667
329442,329777,330528,335,751,2,36000,1.44607190413
329457,329815,330567,358,752,2,36000,1.47606382979
329459,329824,330512,365,688,2,36000,1.53052325581
329480,329832,330461,352,629,2,36000,1.55961844197
329496,329839,330570,343,731,2,36000,1.46922024624
329497,329844,330587,347,743,2,36000,1.46702557201
329512,329866,330544,354,678,2,36000,1.52212389381
329540,329915,330722,375,807,2,36000,1.46468401487
329556,329929,330548,373,619,2,36000,1.60258481422
329557,329988,330736,431,748,2,36000,1.57620320856
329578,330006,330895,428,889,2,36000,1.48143982002
329593,330028,330677,435,649,2,36000,1.67026194145
329609,330041,330742,432,701,2,36000,1.61626248217
329662,330050,330803,388,753,2,36000,1.51527224436
329679,330066,330837,387,771,2,36000,1.50194552529
329680,330072,330828,392,756,2,36000,1.51851851852
329701,329708,329715,7,7,1,900,1.4
329705,330085,330769,380,684,2,36000,1.55555555556
329715,329721,329975,6,254,14,7980,1.02362204724
329720,330115,330830,395,715,2,36000,1.55244755245
329745,330124,330827,379,703,2,36000,1.53911806543
329747,330151,330834,404,683,2,36000,1.59150805271
329768,330158,330831,390,673,2,36000,1.57949479941
329804,330180,330894,376,714,2,36000,1.52661064426
329821,330208,330866,387,658,2,36000,1.58814589666
329822,330215,330925,393,710,2,36000,1.55352112676
329824,330225,330971,401,746,2,36000,1.53753351206
329825,330289,331018,464,729,2,36000,1.63648834019
329859,330296,331150,437,854,2,36000,1.51170960187
329904,330304,331002,400,698,2,36000,1.57306590258
329920,330323,331001,403,678,2,36000,1.59439528024
329974,329981,329996,7,15,1,900,1.46666666667
329979,330331,330937,352,606,2,36000,1.58085808581
329992,329999,330231,7,232,14,7980,1.03017241379
329995,330350,331068,355,718,2,36000,1.49442896936
330020,330368,331008,348,640,2,36000,1.54375
330036,330375,331011,339,636,2,36000,1.53301886792
330037,330386,331130,349,744,2,36000,1.46908602151
330056,330395,331153,339,758,2,36000,1.44722955145
330071,330404,331349,333,945,2,36000,1.35238095238
330087,330427,331187,340,760,2,36000,1.44736842105
330105,330479,331145,374,666,2,36000,1.56156156156
330123,330485,331229,362,744,2,36000,1.48655913978
330139,330525,331251,386,726,2,36000,1.53168044077
330154,330539,331226,385,687,2,36000,1.56040756914
330169,330545,331297,376,752,2,36000,1.5
330197,330555,331312,358,757,2,36000,1.47291941876
330198,330562,331287,364,725,2,36000,1.50206896552
330215,330579,331277,364,698,2,36000,1.52148997135
330231,330238,330261,7,23,1,900,1.30434782609
330247,330253,330503,6,250,14,7980,1.024
330281,330585,331507,304,922,2,36000,1.32971800434
330296,330598,331227,302,629,2,36000,1.48012718601
330298,330638,331336,340,698,2,36000,1.48710601719
330314,330689,331384,375,695,2,36000,1.53956834532
330329,330734,331409,405,675,2,36000,1.6
330345,330747,331466,402,719,2,36000,1.55910987483
330360,330754,331492,394,738,2,36000,1.53387533875
330362,330782,331597,420,815,2,36000,1.51533742331
330377,330814,331865,437,1051,2,36000,1.41579448145
330392,330838,331536,446,698,2,36000,1.63896848138
330394,330845,331562,451,717,2,36000,1.6290097629
330420,330850,331585,430,735,2,36000,1.58503401361
330463,330855,331884,392,1029,2,36000,1.38095238095
330479,330862,331614,383,752,2,36000,1.50930851064
330502,330508,330515,6,7,1,900,1.3
330510,330516,330760,6,244,14,7980,1.02459016393
330515,330867,331509,352,642,2,36000,1.54828660436
330531,330878,331604,347,726,2,36000,1.47796143251
330532,330907,331593,375,686,2,36000,1.54664723032
330547,330912,331558,365,646,2,36000,1.56501547988
330563,330936,331587,373,651,2,36000,1.57296466974
330578,330949,331731,371,782,2,36000,1.47442455243
330579,330982,331668,403,686,2,36000,1.58746355685
330594,331012,331771,418,759,2,36000,1.55072463768
330625,331019,331702,394,683,2,36000,1.57686676428
330677,331024,331774,347,750,2,36000,1.46266666667
330723,331031,331742,308,711,2,36000,1.43319268636
330738,331036,331701,298,665,2,36000,1.44812030075
330754,331079,331825,325,746,2,36000,1.43565683646
330758,330768,330775,10,7,1,900,1.7
330766,330775,331065,9,290,14,7980,1.03103448276
330769,331142,331885,373,743,2,36000,1.50201884253
330806,331162,331894,356,732,2,36000,1.48633879781
330829,331168,331888,339,720,2,36000,1.47083333333
330830,331174,331860,344,686,2,36000,1.50145772595
330846,331199,331904,353,705,2,36000,1.50070921986
330847,331238,332004,391,766,2,36000,1.51044386423
330849,331245,331965,396,720,2,36000,1.55
330850,331250,331919,400,669,2,36000,1.59790732436
330868,331264,331957,396,693,2,36000,1.57142857143
330901,331290,332046,389,756,2,36000,1.51455026455
330903,331300,332114,397,814,2,36000,1.48771498771
330927,331309,332082,382,773,2,36000,1.49417852523
330943,331328,332002,385,674,2,36000,1.57121661721
330968,331347,332116,379,769,2,36000,1.49284785436
331002,331361,332007,359,646,2,36000,1.55572755418
331003,331397,332003,394,606,2,36000,1.6501650165
331019,331420,332092,401,672,2,36000,1.59672619048
331020,331478,332219,458,741,2,36000,1.61808367072
331022,331504,332269,482,765,2,36000,1.63006535948
331063,331069,331083,6,14,1,900,1.42857142857
331069,331522,332355,453,833,2,36000,1.54381752701
331076,331086,331320,10,234,14,7980,1.04273504274
331130,331529,332279,399,750,2,36000,1.532
331145,331547,332251,402,704,2,36000,1.57102272727
331161,331570,332294,409,724,2,36000,1.56491712707
331162,331577,332318,415,741,2,36000,1.56005398111
331187,331598,332332,411,734,2,36000,1.55994550409
331227,331604,332251,377,647,2,36000,1.58268933539
331228,331609,332215,381,606,2,36000,1.62871287129
331243,331616,332349,373,733,2,36000,1.50886766712
331259,331621,332329,362,708,2,36000,1.51129943503
331280,331627,332258,347,631,2,36000,1.5499207607
331296,331680,332362,384,682,2,36000,1.56304985337
331312,331712,332433,400,721,2,36000,1.5547850208
331313,331720,332457,407,737,2,36000,1.55223880597
331317,331323,331343,6,20,1,900,1.3
331325,331334,331440,9,106,14,7980,1.08490566038
331338,331743,332431,405,688,2,36000,1.5886627907
331353,331753,332442,400,689,2,36000,1.58055152395
331387,331782,332477,395,695,2,36000,1.56834532374
331411,331790,332525,379,735,2,36000,1.5156462585
331472,331837,332769,365,932,2,36000,1.39163090129
331495,331871,332451,376,580,2,36000,1.64827586207
331530,331879,332608,349,729,2,36000,1.47873799726
331531,331896,332662,365,766,2,36000,1.47650130548
331547,331903,332533,356,630,2,36000,1.56507936508
331565,331908,332560,343,652,2,36000,1.52607361963
331566,331914,332685,348,771,2,36000,1.4513618677
331587,331922,332702,335,780,2,36000,1.42948717949
331588,331930,332589,342,659,2,36000,1.51896813354
331604,331969,332653,365,684,2,36000,1.53362573099
331605,331976,332648,371,672,2,36000,1.55208333333
331607,332014,332782,407,768,2,36000,1.52994791667
331622,332020,332748,398,728,2,36000,1.5467032967
331669,332027,332803,358,776,2,36000,1.46134020619
331703,332032,332701,329,669,2,36000,1.49177877429
331704,332059,332895,355,836,2,36000,1.42464114833
331731,332094,332815,363,721,2,36000,1.50346740638
331747,332103,332854,356,751,2,36000,1.47403462051
331771,332125,332887,354,762,2,36000,1.46456692913
331787,332131,332856,344,725,2,36000,1.47448275862
331827,332228,332906,401,678,2,36000,1.59144542773
331860,332234,333096,374,862,2,36000,1.43387470998
331876,332262,332945,386,683,2,36000,1.56515373353
331891,332267,332970,376,703,2,36000,1.53485064011
331892,332274,333010,382,736,2,36000,1.51902173913
331894,332280,333022,386,742,2,36000,1.52021563342
331910,332291,333057,381,766,2,36000,1.49738903394
331911,332306,332972,395,666,2,36000,1.59309309309
331926,332329,333073,403,744,2,36000,1.54166666667
331960,332340,333217,380,877,2,36000,1.43329532497
331975,332347,333097,372,750,2,36000,1.496
332003,332362,333117,359,755,2,36000,1.47549668874
332005,332369,333140,364,771,2,36000,1.47211413748
332006,332376,333205,370,829,2,36000,1.44632086852
332021,332444,333308,423,864,2,36000,1.48958333333
332046,332450,333269,404,819,2,36000,1.49328449328
332083,332457,333223,374,766,2,36000,1.48825065274
332098,332464,333102,366,638,2,36000,1.5736677116
332117,332471,333230,354,759,2,36000,1.46640316206
332118,332489,333193,371,704,2,36000,1.52698863636
332218,332537,333291,319,754,2,36000,1.42307692308
332233,332545,333296,312,751,2,36000,1.4154460719
332252,332572,333343,320,771,2,36000,1.41504539559
332253,332602,333359,349,757,2,36000,1.46103038309
332268,332620,333396,352,776,2,36000,1.45360824742
332270,332660,333270,390,610,2,36000,1.6393442623
332285,332666,333387,381,721,2,36000,1.52843273232
332301,332673,333432,372,759,2,36000,1.49011857708
332319,332697,333513,378,816,2,36000,1.46323529412
332335,332712,333397,377,685,2,36000,1.5503649635
332336,332719,333579,383,860,2,36000,1.44534883721
332351,332759,333518,408,759,2,36000,1.53754940711
332367,332780,333393,413,613,2,36000,1.67373572594
332368,332793,333395,425,602,2,36000,1.70598006645
332387,332394,332395,7,1,2,3540,1.0
332432,332814,333524,382,710,2,36000,1.53802816901
332448,332827,333548,379,721,2,36000,1.52565880721
332449,332866,333626,417,760,2,36000,1.54868421053
332465,332873,333510,408,637,2,36000,1.64050235479
332466,332900,333601,434,701,2,36000,1.61911554922
332481,332908,333589,427,681,2,36000,1.62701908957
332525,332917,333620,392,703,2,36000,1.55761024182
332540,332956,333652,416,696,2,36000,1.59770114943
332562,332982,333633,420,651,2,36000,1.64516129032
332593,332989,333618,396,629,2,36000,1.62957074722
332609,333022,333721,413,699,2,36000,1.59084406295
332648,333034,333788,386,754,2,36000,1.51193633952
332665,333068,333759,403,691,2,36000,1.58321273517
332666,333086,333787,420,701,2,36000,1.59914407989
332688,333108,333779,420,671,2,36000,1.6259314456
332704,333114,333923,410,809,2,36000,1.50679851669
332705,333120,333848,415,728,2,36000,1.57005494505
332750,333128,333783,378,655,2,36000,1.57709923664
332772,333152,333790,380,638,2,36000,1.59561128527
332791,333205,333908,414,703,2,36000,1.58890469417
332809,333216,333879,407,663,2,36000,1.61387631976
332826,333229,333943,403,714,2,36000,1.56442577031
332854,333235,333988,381,753,2,36000,1.50597609562
332870,333242,333977,372,735,2,36000,1.50612244898
332892,333281,334036,389,755,2,36000,1.51523178808
332909,333287,334039,378,752,2,36000,1.50265957447
332910,333302,334047,392,745,2,36000,1.52617449664
332947,333309,334051,362,742,2,36000,1.48787061995
332972,333320,334108,348,788,2,36000,1.44162436548
332974,333355,334109,381,754,2,36000,1.50530503979
333012,333370,333971,358,601,2,36000,1.59567387687
333028,333398,334165,370,767,2,36000,1.48239895698
333061,333406,334181,345,775,2,36000,1.44516129032
333077,333413,334174,336,761,2,36000,1.44152431012
333099,333418,334104,319,686,2,36000,1.46501457726
333100,333424,334144,324,720,2,36000,1.45
333116,333444,334183,328,739,2,36000,1.44384303112
333117,333523,334207,406,684,2,36000,1.59356725146
333142,333529,334291,387,762,2,36000,1.50787401575
333194,333534,334176,340,642,2,36000,1.52959501558
333210,333540,334180,330,640,2,36000,1.515625
333226,333560,334193,334,633,2,36000,1.52764612954
333227,333590,334286,363,696,2,36000,1.52155172414
333243,333601,334355,358,754,2,36000,1.47480106101
333271,333613,334313,342,700,2,36000,1.48857142857
333272,333631,334473,359,842,2,36000,1.42636579572
333294,333637,334410,343,773,2,36000,1.44372574386
333309,333643,334360,334,717,2,36000,1.46582984658
333311,333650,334438,339,788,2,36000,1.43020304569
333344,333664,334446,320,782,2,36000,1.40920716113
333360,333732,334496,372,764,2,36000,1.48691099476
333388,333771,334634,383,863,2,36000,1.44380069525
333404,333791,334441,387,650,2,36000,1.59538461538
333405,333798,334451,393,653,2,36000,1.60183767228
333407,333805,334456,398,651,2,36000,1.6113671275
333408,333810,334643,402,833,2,36000,1.48259303721
333433,333815,334533,382,718,2,36000,1.53203342618
333513,333859,334422,346,563,2,36000,1.61456483126
333514,333891,334638,377,747,2,36000,1.5046854083
333530,333920,334651,390,731,2,36000,1.53351573187
333531,333935,334670,404,735,2,36000,1.54965986395
333550,333955,334660,405,705,2,36000,1.57446808511
333580,333983,335017,403,1034,2,36000,1.38974854932
333596,333990,334792,394,802,2,36000,1.49127182045
333611,334001,334691,390,690,2,36000,1.5652173913
333628,334048,334689,420,641,2,36000,1.65522620905
333630,334055,334653,425,598,2,36000,1.71070234114
333631,334061,334747,430,686,2,36000,1.62682215743
333648,334069,334710,421,641,2,36000,1.65678627145
333663,334117,334834,454,717,2,36000,1.63319386332
333723,334124,334898,401,774,2,36000,1.5180878553
333760,334129,334818,369,689,2,36000,1.53555878084
333779,334156,334861,377,705,2,36000,1.53475177305
333796,334176,335338,380,1162,2,36000,1.32702237522
333797,334186,334960,389,774,2,36000,1.50258397933
333798,334192,334916,394,724,2,36000,1.54419889503
333800,334197,334965,397,768,2,36000,1.51692708333
333850,334202,334931,352,729,2,36000,1.48285322359
333881,334209,334945,328,736,2,36000,1.44565217391
333908,334214,334913,306,699,2,36000,1.43776824034
333924,334221,334963,297,742,2,36000,1.40026954178
333946,334297,335048,351,751,2,36000,1.46737683089
333973,334305,334973,332,668,2,36000,1.49700598802
333994,334324,335057,330,733,2,36000,1.45020463847
333996,334366,335039,370,673,2,36000,1.54977711738
334039,334373,335035,334,662,2,36000,1.50453172205
334040,334423,335207,383,784,2,36000,1.48852040816
334056,334433,335059,377,626,2,36000,1.60223642173
334057,334449,335181,392,732,2,36000,1.53551912568
334107,334457,335325,350,868,2,36000,1.40322580645
334108,334464,335232,356,768,2,36000,1.46354166667
334124,334469,335148,345,679,2,36000,1.50810014728
334146,334475,335130,329,655,2,36000,1.50229007634
334167,334486,335176,319,690,2,36000,1.46231884058
334184,334509,335280,325,771,2,36000,1.4215304799
334185,334545,335203,360,658,2,36000,1.54711246201
334187,334646,335509,459,863,2,36000,1.53186558517
334188,334653,335432,465,779,2,36000,1.59691912709
334189,334660,335452,471,792,2,36000,1.5946969697
334205,334667,335626,462,959,2,36000,1.48175182482
334221,334672,335711,451,1039,2,36000,1.43407122233
334286,334678,335560,392,882,2,36000,1.44444444444
334301,334685,335948,384,1263,2,36000,1.30403800475
334317,334702,335464,385,762,2,36000,1.50524934383
334357,334708,335396,351,688,2,36000,1.5101744186
334372,334721,335358,349,637,2,36000,1.54788069074
334412,334758,335421,346,663,2,36000,1.52187028658
334432,334808,335520,376,712,2,36000,1.52808988764
334448,334831,335638,383,807,2,36000,1.47459727385
334449,334846,335621,397,775,2,36000,1.51225806452
334451,334873,335634,422,761,2,36000,1.55453350854
334467,334911,335570,444,659,2,36000,1.67374810319
334468,334926,335636,458,710,2,36000,1.64507042254
334483,334933,335714,450,781,2,36000,1.576184379
334499,334943,335639,444,696,2,36000,1.63793103448
334536,334958,335718,422,760,2,36000,1.55526315789
334638,334977,335667,339,690,2,36000,1.49130434783
334639,334982,335676,343,694,2,36000,1.49423631124
334658,334987,335726,329,739,2,36000,1.4451962111
334659,334995,335830,336,835,2,36000,1.40239520958
334661,335029,335691,368,662,2,36000,1.55589123867
334677,335047,335696,370,649,2,36000,1.57010785824
334679,335054,335707,375,653,2,36000,1.57427258806
334694,335060,335858,366,798,2,36000,1.45864661654
334696,335068,335744,372,676,2,36000,1.55029585799
334711,335074,335829,363,755,2,36000,1.48079470199
334748,335141,335842,393,701,2,36000,1.56062767475
334794,335161,335915,367,754,2,36000,1.48673740053
334819,335188,335929,369,741,2,36000,1.4979757085
334835,335194,335760,359,566,2,36000,1.63427561837
334863,335215,335962,352,747,2,36000,1.47121820616
334901,335222,336030,321,808,2,36000,1.39727722772
334922,335244,335936,322,692,2,36000,1.46531791908
334923,335291,335958,368,667,2,36000,1.55172413793
334942,335337,335976,395,639,2,36000,1.61815336463
334958,335349,335965,391,616,2,36000,1.63474025974
334975,335370,336110,395,740,2,36000,1.53378378378
334976,335408,336136,432,728,2,36000,1.59340659341
334977,335433,336168,456,735,2,36000,1.62040816327
334979,335444,336177,465,733,2,36000,1.6343792633
335021,335463,336219,442,756,2,36000,1.58465608466
335041,335476,336173,435,697,2,36000,1.62410329986
335042,335526,336406,484,880,2,36000,1.55
335061,335533,336258,472,725,2,36000,1.65103448276
335063,335571,336197,508,626,2,36000,1.81150159744
335064,335582,336284,518,702,2,36000,1.73789173789
335131,335633,336246,502,613,2,36000,1.8189233279
335149,335639,336306,490,667,2,36000,1.73463268366
335177,335647,336419,470,772,2,36000,1.60880829016
335193,335653,336459,460,806,2,36000,1.57071960298
335209,335659,336342,450,683,2,36000,1.6588579795
335210,335664,336341,454,677,2,36000,1.670605613
335232,335679,336359,447,680,2,36000,1.65735294118
335282,335689,336362,407,673,2,36000,1.60475482912
335325,335702,336417,377,715,2,36000,1.52727272727
335341,335710,336344,369,634,2,36000,1.58201892744
335359,335719,336378,360,659,2,36000,1.54628224583
335397,335725,336497,328,772,2,36000,1.42487046632
335422,335732,336411,310,679,2,36000,1.45655375552
335438,335737,336418,299,681,2,36000,1.43906020558
335454,335744,336307,290,563,2,36000,1.51509769094
335470,335757,336386,287,629,2,36000,1.45627980922
335510,335772,336504,262,732,2,36000,1.35792349727
335526,335843,336657,317,814,2,36000,1.38943488943
335560,335848,336549,288,701,2,36000,1.41084165478
335575,335855,336485,280,630,2,36000,1.44444444444
335624,335874,336521,250,647,2,36000,1.38639876352
335651,335927,336668,276,741,2,36000,1.37246963563
335652,335941,336541,289,600,2,36000,1.48166666667
335653,335947,336670,294,723,2,36000,1.40663900415
335655,335960,336590,305,630,2,36000,1.48412698413
335656,335970,336686,314,716,2,36000,1.43854748603
335676,335976,336708,300,732,2,36000,1.40983606557
335677,335981,336617,304,636,2,36000,1.47798742138
335699,335988,336772,289,784,2,36000,1.36862244898
335700,336043,336813,343,770,2,36000,1.44545454545
335718,336123,336947,405,824,2,36000,1.49150485437
335719,336149,336857,430,708,2,36000,1.60734463277
335720,336179,336938,459,759,2,36000,1.604743083
335721,336187,336939,466,752,2,36000,1.61968085106
335738,336193,336892,455,699,2,36000,1.65092989986
335754,336213,336939,459,726,2,36000,1.63223140496
335770,336231,337032,461,801,2,36000,1.57553058677
335834,336258,337079,424,821,2,36000,1.51644336175
335835,336270,337009,435,739,2,36000,1.58863328823
335860,336296,337107,436,811,2,36000,1.53760789149
335861,336317,336967,456,650,2,36000,1.70153846154
335918,336323,337002,405,679,2,36000,1.59646539028
335934,336352,337267,418,915,2,36000,1.45683060109
335950,336359,337096,409,737,2,36000,1.55495251018
335952,336364,337073,412,709,2,36000,1.58110014104
335968,336370,337112,402,742,2,36000,1.54177897574
335969,336377,337219,408,842,2,36000,1.48456057007
335970,336389,337084,419,695,2,36000,1.60287769784
335986,336398,337127,412,729,2,36000,1.56515775034
336032,336417,337195,385,778,2,36000,1.49485861183
336111,336425,337252,314,827,2,36000,1.37968561064
336112,363065,394910,26953,31845,2,345600,1.84638090752
336112,337470,343453,1358,5983,2,345600,1.22697643323
336112,363055,591798,26943,228743,2,345600,1.11778721097
336112,363060,393195,26948,30135,2,345600,1.89424257508
336112,363409,709017,27297,345608,2,345600,1.0789825467
336113,363689,393721,27576,30032,2,345600,1.91822056473
336113,363694,396031,27581,32337,2,345600,1.85292389523
336137,336432,337082,295,650,2,36000,1.45384615385
336168,336437,337197,269,760,2,36000,1.35394736842
336184,336442,337222,258,780,2,36000,1.33076923077
336186,336471,337117,285,646,2,36000,1.44117647059
336201,336497,337222,296,725,2,36000,1.40827586207
336220,336508,337209,288,701,2,36000,1.41084165478
336250,336515,337301,265,786,2,36000,1.33715012723
336266,336532,337320,266,788,2,36000,1.33756345178
336285,336554,337252,269,698,2,36000,1.38538681948
336309,336561,337272,252,711,2,36000,1.35443037975
336311,336602,337344,291,742,2,36000,1.39218328841
336352,336628,337615,276,987,2,36000,1.27963525836
336354,336668,337475,314,807,2,36000,1.38909541512
336355,336680,337371,325,691,2,36000,1.47033285094
336377,336686,337253,309,567,2,36000,1.54497354497
336378,336698,337342,320,644,2,36000,1.49689440994
336394,336720,337536,326,816,2,36000,1.39950980392
336396,336784,337512,388,728,2,36000,1.53296703297
336412,336825,337647,413,822,2,36000,1.50243309002
336413,336868,337522,455,654,2,36000,1.69571865443
336430,336904,337580,474,676,2,36000,1.70118343195
336432,336951,337579,519,628,2,36000,1.82643312102
336433,336956,337681,523,725,2,36000,1.72137931034
336460,336961,337626,501,665,2,36000,1.75338345865
336488,336968,337706,480,738,2,36000,1.65040650407
336505,336979,337802,474,823,2,36000,1.57594167679
336507,337013,337803,506,790,2,36000,1.64050632911
336522,337020,337686,498,666,2,36000,1.74774774775
336541,337045,337816,504,771,2,36000,1.65369649805
336557,337085,337853,528,768,2,36000,1.6875
336591,337093,337696,502,603,2,36000,1.83250414594
336619,337099,337838,480,739,2,36000,1.64952638701
336620,343478,354795,6858,11317,2,18000,1.60599098701
336624,343498,346311,6874,2813,2,18000,3.44365446143
336659,337104,337881,445,777,2,36000,1.57271557272
336675,337111,337910,436,799,2,36000,1.54568210263
336676,337119,337783,443,664,2,36000,1.6671686747
336693,337126,337874,433,748,2,36000,1.57887700535
336708,337132,337820,424,688,2,36000,1.61627906977
336773,337139,337774,366,635,2,36000,1.57637795276
336816,337207,338069,391,862,2,36000,1.4535962877
336859,337213,338028,354,815,2,36000,1.43435582822
336894,337221,337842,327,621,2,36000,1.52657004831
336947,337231,338051,284,820,2,36000,1.34634146341
336949,337238,337922,289,684,2,36000,1.42251461988
336950,337243,337899,293,656,2,36000,1.44664634146
336951,337264,337985,313,721,2,36000,1.43411927878
336970,337269,337931,299,662,2,36000,1.45166163142
337008,337276,338063,268,787,2,36000,1.34053367217
337009,337283,338163,274,880,2,36000,1.31136363636
337037,337290,338006,253,716,2,36000,1.35335195531
337077,337313,337995,236,682,2,36000,1.34604105572
337093,337333,338133,240,800,2,36000,1.3
337094,337354,338066,260,712,2,36000,1.36516853933
337096,337362,338156,266,794,2,36000,1.33501259446
337113,337383,338237,270,854,2,36000,1.31615925059
337114,337488,338153,374,665,2,36000,1.56240601504
337116,337524,338232,408,708,2,36000,1.57627118644
337133,337534,338227,401,693,2,36000,1.57864357864
337134,337548,338332,414,784,2,36000,1.52806122449
337197,337591,338354,394,763,2,36000,1.51638269987
337199,337597,338363,398,766,2,36000,1.51958224543
337215,337628,338347,413,719,2,36000,1.57440890125
337230,337638,338283,408,645,2,36000,1.63255813953
337232,337659,338355,427,696,2,36000,1.61350574713
337233,337692,338439,459,747,2,36000,1.61445783133
337252,337699,338418,447,719,2,36000,1.62169680111
337254,337708,338372,454,664,2,36000,1.68373493976
337270,337719,338436,449,717,2,36000,1.62622036262
337272,337786,338566,514,780,2,36000,1.65897435897
337287,337796,338494,509,698,2,36000,1.72922636103
337303,337814,338490,511,676,2,36000,1.75591715976
337322,337821,338481,499,660,2,36000,1.75606060606
337344,337828,338593,484,765,2,36000,1.63267973856
337345,337835,338520,490,685,2,36000,1.71532846715
337373,337849,338694,476,845,2,36000,1.56331360947
337476,337855,338684,379,829,2,36000,1.45717732207
337513,337865,338665,352,800,2,36000,1.44
337528,337887,338677,359,790,2,36000,1.45443037975
337544,337894,338608,350,714,2,36000,1.49019607843
337579,337911,338678,332,767,2,36000,1.43285528031
337594,337935,338647,341,712,2,36000,1.47893258427
337616,337940,338650,324,710,2,36000,1.45633802817
337633,337947,338571,314,624,2,36000,1.50320512821
337648,337996,338800,348,804,2,36000,1.4328358209
337686,338007,338711,321,704,2,36000,1.45596590909
337687,338013,338682,326,669,2,36000,1.48729446936
337703,338020,338707,317,687,2,36000,1.46142649199
337719,338040,338726,321,686,2,36000,1.46793002915
337776,338063,338781,287,718,2,36000,1.39972144847
337793,338075,338708,282,633,2,36000,1.44549763033
337808,338082,338797,274,715,2,36000,1.38321678322
337810,338087,338806,277,719,2,36000,1.38525730181
337826,338146,338902,320,756,2,36000,1.42328042328
337827,338164,338749,337,585,2,36000,1.57606837607
337843,338171,338877,328,706,2,36000,1.46458923513
337844,338178,338866,334,688,2,36000,1.48546511628
337861,338239,338889,378,650,2,36000,1.58153846154
337877,338246,339107,369,861,2,36000,1.42857142857
337896,338252,338900,356,648,2,36000,1.54938271605
337914,338295,338972,381,677,2,36000,1.56277695716
337915,338345,339087,430,742,2,36000,1.5795148248
337931,338360,339006,429,646,2,36000,1.66408668731
337932,338367,339078,435,711,2,36000,1.61181434599
337990,338372,339096,382,724,2,36000,1.52762430939
338007,338379,339170,372,791,2,36000,1.47029077118
338008,338386,339069,378,683,2,36000,1.55344070278
338028,338431,339107,403,676,2,36000,1.59615384615
338053,338447,339079,394,632,2,36000,1.62341772152
338070,338454,339118,384,664,2,36000,1.57831325301
338071,338493,339237,422,744,2,36000,1.56720430108
338073,338502,339224,429,722,2,36000,1.59418282548
338137,338509,339250,372,741,2,36000,1.5020242915
338156,338533,339255,377,722,2,36000,1.52216066482
338157,338578,339253,421,675,2,36000,1.6237037037
338173,338585,339354,412,769,2,36000,1.53576072822
338228,338604,339278,376,674,2,36000,1.55786350148
338243,338621,339403,378,782,2,36000,1.48337595908
338245,338658,339320,413,662,2,36000,1.62386706949
338285,338665,339572,380,907,2,36000,1.41896361632
338335,338678,339746,343,1068,2,36000,1.32116104869
338351,338689,339326,338,637,2,36000,1.5306122449
338367,338695,339514,328,819,2,36000,1.40048840049
338368,338700,339515,332,815,2,36000,1.40736196319
338370,338705,339493,335,788,2,36000,1.42512690355
338385,338713,339414,328,701,2,36000,1.46790299572
338420,338720,339377,300,657,2,36000,1.45662100457
338439,338725,339392,286,667,2,36000,1.4287856072
338440,338737,339476,297,739,2,36000,1.40189445196
338484,338744,339519,260,775,2,36000,1.33548387097
338500,338762,339519,262,757,2,36000,1.34610303831
338501,338793,339603,292,810,2,36000,1.36049382716
338524,338810,339529,286,719,2,36000,1.39777468707
338571,338817,339458,246,641,2,36000,1.38377535101
338589,338823,339586,234,763,2,36000,1.30668414155
338605,338879,339620,274,741,2,36000,1.3697705803
338621,338889,339826,268,937,2,36000,1.28601921025
338650,338901,339627,251,726,2,36000,1.34573002755
338652,338912,339621,260,709,2,36000,1.36671368124
338669,338919,339568,250,649,2,36000,1.38520801233
338693,338984,339714,291,730,2,36000,1.39863013699
338694,339018,339856,324,838,2,36000,1.38663484487
338695,339081,339736,386,655,2,36000,1.5893129771
338697,339090,339825,393,735,2,36000,1.53469387755
338713,339097,339801,384,704,2,36000,1.54545454545
338715,339104,339813,389,709,2,36000,1.54866008463
338716,339111,339884,395,773,2,36000,1.51099611902
338717,339119,339819,402,700,2,36000,1.57428571429
338733,339124,339781,391,657,2,36000,1.59512937595
338752,339131,339880,379,749,2,36000,1.50600801068
338783,339182,339944,399,762,2,36000,1.52362204724
338800,339236,339913,436,677,2,36000,1.64401772526
338801,339250,339980,449,730,2,36000,1.61506849315
338817,339263,340001,446,738,2,36000,1.60433604336
338868,339270,339888,402,618,2,36000,1.65048543689
338883,339275,340046,392,771,2,36000,1.5084306096
338899,339290,340036,391,746,2,36000,1.52412868633
338900,339332,340015,432,683,2,36000,1.63250366032
338916,339339,340010,423,671,2,36000,1.6304023845
338975,339366,340129,391,763,2,36000,1.5124508519
339009,339389,340027,380,638,2,36000,1.59561128527
339072,339405,340072,333,667,2,36000,1.49925037481
339089,339414,340115,325,701,2,36000,1.46362339515
339091,339426,340162,335,736,2,36000,1.45516304348
339092,339470,340215,378,745,2,36000,1.50738255034
339107,339488,340202,381,714,2,36000,1.53361344538
339109,339509,340217,400,708,2,36000,1.56497175141
339110,339526,340227,416,701,2,36000,1.59343794579
339126,339533,340274,407,741,2,36000,1.54925775978
339172,339538,340197,366,659,2,36000,1.55538694992
339224,339543,340317,319,774,2,36000,1.41214470284
339234,339243,339244,9,1,1,1200,1.0
339244,339549,340337,305,788,2,36000,1.38705583756
339264,339579,340383,315,804,2,36000,1.39179104478
339266,339586,340145,320,559,2,36000,1.57245080501
339267,339599,340234,332,635,2,36000,1.52283464567
339288,339616,340369,328,753,2,36000,1.43559096946
339323,339632,340309,309,677,2,36000,1.4564254062
339339,339638,340431,299,793,2,36000,1.37704918033
339355,339645,340415,290,770,2,36000,1.37662337662
339383,339725,340437,342,712,2,36000,1.48033707865
339404,339749,340373,345,624,2,36000,1.55288461538
339405,339758,340456,353,698,2,36000,1.50573065903
339424,339793,340499,369,706,2,36000,1.52266288952
339459,339813,340592,354,779,2,36000,1.45442875481
339478,339824,340564,346,740,2,36000,1.46756756757
339495,339836,340593,341,757,2,36000,1.45046235139
339527,339842,340588,315,746,2,36000,1.42225201072
339528,339847,340520,319,673,2,36000,1.47399702823
339529,339868,340587,339,719,2,36000,1.47148817803
339531,339892,340683,361,791,2,36000,1.45638432364
339547,339899,340761,352,862,2,36000,1.40835266821
339569,339905,340580,336,675,2,36000,1.49777777778
339584,339924,340608,340,684,2,36000,1.49707602339
339600,339956,340716,356,760,2,36000,1.46842105263
339616,339992,340657,376,665,2,36000,1.56541353383
339632,340013,340822,381,809,2,36000,1.47095179234
339634,340022,340672,388,650,2,36000,1.59692307692
339635,340034,340680,399,646,2,36000,1.61764705882
339717,340041,340715,324,674,2,36000,1.48071216617
339738,340047,340835,309,788,2,36000,1.3921319797
339754,340058,340804,304,746,2,36000,1.40750670241
339782,340085,340882,303,797,2,36000,1.38017565872
339801,340127,340892,326,765,2,36000,1.42614379085
339817,340141,340746,324,605,2,36000,1.53553719008
339833,340157,340820,324,663,2,36000,1.48868778281
339835,340174,340951,339,777,2,36000,1.43629343629
339836,340209,341035,373,826,2,36000,1.45157384988
339858,340216,340986,358,770,2,36000,1.46493506494
339884,340228,341412,344,1184,2,36000,1.29054054054
339885,340234,340942,349,708,2,36000,1.49293785311
339901,340241,340901,340,660,2,36000,1.51515151515
339916,340248,340970,332,722,2,36000,1.45983379501
339947,340287,341097,340,810,2,36000,1.41975308642
339982,340321,341004,339,683,2,36000,1.49633967789
340004,340330,341041,326,711,2,36000,1.45850914205
340020,340349,341125,329,776,2,36000,1.42396907216
340022,340382,341094,360,712,2,36000,1.50561797753
340038,340388,341120,350,732,2,36000,1.4781420765
340039,340395,341080,356,685,2,36000,1.5197080292
340057,340428,341148,371,720,2,36000,1.51527777778
340075,340444,341267,369,823,2,36000,1.44835965978
340115,340451,341220,336,769,2,36000,1.43693107932
340130,340468,341152,338,684,2,36000,1.49415204678
340149,340512,341284,363,772,2,36000,1.47020725389
340166,340533,341320,367,787,2,36000,1.46632782719
340199,340576,341417,377,841,2,36000,1.44827586207
340215,340592,341176,377,584,2,36000,1.64554794521
340217,340598,341322,381,724,2,36000,1.52624309392
340218,340605,341371,387,766,2,36000,1.50522193211
340237,340610,341412,373,802,2,36000,1.4650872818
340239,340615,341335,376,720,2,36000,1.52222222222
340279,340622,341346,343,724,2,36000,1.47375690608
340312,340670,341348,358,678,2,36000,1.52802359882
340328,340684,341369,356,685,2,36000,1.5197080292
340343,340692,341396,349,704,2,36000,1.49573863636
340373,340699,341384,326,685,2,36000,1.47591240876
340374,340727,341464,353,737,2,36000,1.4789687924
340391,340733,341494,342,761,2,36000,1.4494086728
340416,340758,341414,342,656,2,36000,1.52134146341
340433,340773,341560,340,787,2,36000,1.43202033037
340455,340817,341503,362,686,2,36000,1.527696793
340471,340832,341449,361,617,2,36000,1.585089141
340500,340839,341685,339,846,2,36000,1.40070921986
340517,340523,340524,6,1,1,1200,1.0
340522,340847,341686,325,839,2,36000,1.3873659118
340529,340539,340540,10,1,1,1200,1.1
340565,340894,341599,329,705,2,36000,1.46666666667
340581,340911,341644,330,733,2,36000,1.45020463847
340597,340954,341676,357,722,2,36000,1.4944598338
340599,340963,341613,364,650,2,36000,1.56
340600,340982,341732,382,750,2,36000,1.50933333333
340601,340998,341744,397,746,2,36000,1.53217158177
340617,341015,341718,398,703,2,36000,1.56614509246
340652,340659,340661,7,2,1,1200,1.0
340658,341047,341769,389,722,2,36000,1.53878116343
340674,341060,341778,386,718,2,36000,1.53760445682
340690,341092,341857,402,765,2,36000,1.52549019608
340691,341107,341839,416,732,2,36000,1.56830601093
340717,341114,341824,397,710,2,36000,1.55915492958
340718,341132,341880,414,748,2,36000,1.55347593583
340747,341138,341897,391,759,2,36000,1.51515151515
340768,341160,341869,392,709,2,36000,1.55289139633
340807,341166,341785,359,619,2,36000,1.57996768982
340824,341188,341860,364,672,2,36000,1.54166666667
340825,341232,341948,407,716,2,36000,1.56843575419
340841,341279,341983,438,704,2,36000,1.62215909091
340884,341296,342089,412,793,2,36000,1.51954602774
340891,340906,340908,15,2,1,1200,1.7
340901,341332,342344,431,1012,2,36000,1.42588932806
340902,341339,342140,437,801,2,36000,1.54556803995
340943,341346,342139,403,793,2,36000,1.50819672131
340959,341358,342098,399,740,2,36000,1.53918918919
340975,341364,342070,389,706,2,36000,1.55099150142
340992,341381,342146,389,765,2,36000,1.50849673203
341011,341387,342068,376,681,2,36000,1.55212922173
341037,341396,342056,359,660,2,36000,1.54393939394
341053,341408,342023,355,615,2,36000,1.57723577236
341083,341424,342237,341,813,2,36000,1.41943419434
341104,341430,342170,326,740,2,36000,1.44054054054
341105,341437,342218,332,781,2,36000,1.42509603073
341121,341442,342158,321,716,2,36000,1.44832402235
341137,341461,342096,324,635,2,36000,1.51023622047
341153,341477,342465,324,988,2,36000,1.32793522267
341154,341507,342218,353,711,2,36000,1.4964838256
341176,341514,342157,338,643,2,36000,1.52566096423
341220,341572,342294,352,722,2,36000,1.48753462604
341267,341611,342304,344,693,2,36000,1.49639249639
341286,341626,342312,340,686,2,36000,1.49562682216
341322,341655,342368,333,713,2,36000,1.46704067321
341323,341688,342363,365,675,2,36000,1.54074074074
341342,341697,342383,355,686,2,36000,1.51749271137
341358,341704,342456,346,752,2,36000,1.46010638298
341360,341730,342477,370,747,2,36000,1.4953145917
341377,341745,342533,368,788,2,36000,1.46700507614
341379,341757,342500,378,743,2,36000,1.50874831763
341396,341780,342650,384,870,2,36000,1.44137931034
341397,341790,342585,393,795,2,36000,1.49433962264
341416,341797,342507,381,710,2,36000,1.53661971831
341417,341835,342679,418,844,2,36000,1.49526066351
341418,341850,342603,432,753,2,36000,1.57370517928
341435,341868,342497,433,629,2,36000,1.68839427663
341451,341875,342572,424,697,2,36000,1.60832137733
341469,341882,342590,413,708,2,36000,1.58333333333
341498,341892,342644,394,752,2,36000,1.52393617021
341518,341908,342530,390,622,2,36000,1.6270096463
341563,341959,342672,396,713,2,36000,1.5553997195
341602,341994,342712,392,718,2,36000,1.54596100279
341620,342036,342743,416,707,2,36000,1.58840169731
341645,342067,342865,422,798,2,36000,1.52882205514
341685,342081,342851,396,770,2,36000,1.51428571429
341686,342086,342814,400,728,2,36000,1.54945054945
341688,342106,342712,418,606,2,36000,1.6897689769
341723,342113,342921,390,808,2,36000,1.48267326733
341742,342118,342880,376,762,2,36000,1.49343832021
341762,342151,342831,389,680,2,36000,1.57205882353
341780,342156,342926,376,770,2,36000,1.48831168831
341781,342163,342904,382,741,2,36000,1.51551956815
341799,342171,342850,372,679,2,36000,1.54786450663
341827,342176,342958,349,782,2,36000,1.4462915601
341846,342183,342990,337,807,2,36000,1.4175960347
341868,342229,342869,361,640,2,36000,1.5640625
341869,342235,343010,366,775,2,36000,1.47225806452
341888,342248,342968,360,720,2,36000,1.5
341890,342305,342905,415,600,2,36000,1.69166666667
341906,342316,343047,410,731,2,36000,1.560875513
341948,342324,343036,376,712,2,36000,1.52808988764
341986,342356,343035,370,679,2,36000,1.54491899853
342025,342375,343127,350,752,2,36000,1.46542553191
342058,342383,343098,325,715,2,36000,1.45454545455
342077,342395,343129,318,734,2,36000,1.43324250681
342078,342467,343237,389,770,2,36000,1.50519480519
342095,342476,343213,381,737,2,36000,1.51696065129
342097,342489,343301,392,812,2,36000,1.48275862069
342117,342508,343206,391,698,2,36000,1.56017191977
342143,342515,343323,372,808,2,36000,1.4603960396
342144,342523,343314,379,791,2,36000,1.4791403287
342160,342542,343275,382,733,2,36000,1.52114597544
342162,342550,343221,388,671,2,36000,1.5782414307
342163,342584,343300,421,716,2,36000,1.58798882682
342179,342597,343338,418,741,2,36000,1.5641025641
342220,342604,343418,384,814,2,36000,1.47174447174
342222,342615,343321,393,706,2,36000,1.5566572238
342238,342657,343422,419,765,2,36000,1.5477124183
342302,342664,343385,362,721,2,36000,1.50208044383
342318,342683,343384,365,701,2,36000,1.52068473609
342319,342690,343552,371,862,2,36000,1.43039443155
342347,342723,343425,376,702,2,36000,1.53561253561
342364,342730,343531,366,801,2,36000,1.45692883895
342386,342755,343618,369,863,2,36000,1.42757821553
342387,342826,343521,439,695,2,36000,1.63165467626
342459,342844,343709,385,865,2,36000,1.4450867052
342477,342862,343477,385,615,2,36000,1.62601626016
342479,342869,343554,390,685,2,36000,1.56934306569
342498,342877,343599,379,722,2,36000,1.52493074792
342525,342885,343581,360,696,2,36000,1.51724137931
342527,342892,343657,365,765,2,36000,1.47712418301
342544,342915,343937,371,1022,2,36000,1.36301369863
342546,342922,343649,376,727,2,36000,1.51719394773
342573,342933,343636,360,703,2,36000,1.51209103841
342589,342940,343656,351,716,2,36000,1.49022346369
342590,342970,343713,380,743,2,36000,1.51144010767
342607,342982,343610,375,628,2,36000,1.59713375796
342647,343002,343745,355,743,2,36000,1.47779273217
342663,343022,343728,359,706,2,36000,1.50849858357
342679,343047,343940,368,893,2,36000,1.41209406495
342680,343054,343816,374,762,2,36000,1.49081364829
342715,343060,343681,345,621,2,36000,1.55555555556
342716,343110,343823,394,713,2,36000,1.55259467041
342745,343139,343778,394,639,2,36000,1.61658841941
342816,343145,343795,329,650,2,36000,1.50615384615
342833,343218,343976,385,758,2,36000,1.50791556728
342852,343225,344069,373,844,2,36000,1.44194312796
342853,343234,343969,381,735,2,36000,1.51836734694
342873,343250,343918,377,668,2,36000,1.56437125749
342874,343286,343951,412,665,2,36000,1.61954887218
342894,343312,344030,418,718,2,36000,1.58217270195
342906,349032,374705,6126,25673,12,28800,1.23861644529
342910,343318,344027,408,709,2,36000,1.5754583921
342911,343325,344039,414,714,2,36000,1.57983193277
342934,343333,344148,399,815,2,36000,1.48957055215
342935,343339,344048,404,709,2,36000,1.56981664316
342950,363399,387914,20449,24515,12,28800,1.83414236182
342960,343349,344071,389,722,2,36000,1.53878116343
342977,343395,344008,418,613,2,36000,1.68189233279
342994,343403,344155,409,752,2,36000,1.54388297872
343003,363404,387734,20401,24330,12,28800,1.83851212495
343013,343431,344047,418,616,2,36000,1.67857142857
343035,343438,344217,403,779,2,36000,1.51732991014
343037,343443,344437,406,994,2,36000,1.40845070423
343052,343490,344143,438,653,2,36000,1.67075038285
343077,363089,401958,20012,38869,1,86400,1.5148575986
343099,343533,344198,434,665,2,36000,1.65263157895
343110,343464,343466,354,2,2,3540,35.6
343131,343544,344291,413,747,2,36000,1.55287817938
343132,343563,344319,431,756,2,36000,1.57010582011
343209,343570,344351,361,781,2,36000,1.46222791293
343231,343592,344349,361,757,2,36000,1.47688243065
343232,343612,344293,380,681,2,36000,1.55800293686
343247,343621,344341,374,720,2,36000,1.51944444444
343278,343629,344288,351,659,2,36000,1.53262518968
343302,343648,344354,346,706,2,36000,1.49008498584
343303,343661,344364,358,703,2,36000,1.50924608819
343320,343668,344408,348,740,2,36000,1.47027027027
343343,343675,344609,332,934,2,36000,1.35546038544
343344,343693,344397,349,704,2,36000,1.49573863636
343345,343721,344424,376,703,2,36000,1.53485064011
343384,343728,344548,344,820,2,36000,1.41951219512
343386,343740,344402,354,662,2,36000,1.53474320242
343420,343757,344598,337,841,2,36000,1.40071343639
343436,343790,344553,354,763,2,36000,1.46395806029
343437,343807,344569,370,762,2,36000,1.48556430446
343478,343828,344447,350,619,2,36000,1.56542810985
343523,343834,344470,311,636,2,36000,1.48899371069
343539,343930,344709,391,779,2,36000,1.50192554557
343555,343948,344728,393,780,2,36000,1.50384615385
343556,343956,344695,400,739,2,36000,1.54127198917
343585,343963,344759,378,796,2,36000,1.47487437186
343600,343982,344734,382,752,2,36000,1.5079787234
343616,343988,344648,372,660,2,36000,1.56363636364
343632,344021,344752,389,731,2,36000,1.53214774282
343648,344040,344707,392,667,2,36000,1.58770614693
343665,344047,344760,382,713,2,36000,1.53576437588
343666,344054,344770,388,716,2,36000,1.54189944134
343667,344061,344793,394,732,2,36000,1.53825136612
343683,344066,344833,383,767,2,36000,1.49934810952
343711,344081,344762,370,681,2,36000,1.54331864905
343734,344088,344888,354,800,2,36000,1.4425
343735,344155,344884,420,729,2,36000,1.57613168724
343740,363473,385208,19733,21735,1,57600,1.90789049919
343754,344161,344979,407,818,2,36000,1.49755501222
343780,344168,344793,388,625,2,36000,1.6208
343795,344210,344933,415,723,2,36000,1.57399723375
343816,344229,344942,413,713,2,36000,1.57924263675
343833,344301,345025,468,724,2,36000,1.64640883978
343919,344308,345109,389,801,2,36000,1.48564294632
343939,344313,345078,374,765,2,36000,1.48888888889
343940,344331,345075,391,744,2,36000,1.52553763441
343956,344353,345291,397,938,2,36000,1.42324093817
343973,344360,345019,387,659,2,36000,1.58725341426
343989,344368,345057,379,689,2,36000,1.55007256894
344011,344373,345071,362,698,2,36000,1.51862464183
344030,344379,345068,349,689,2,36000,1.50653120464
344031,344409,345130,378,721,2,36000,1.52427184466
344048,344416,345116,368,700,2,36000,1.52571428571
344050,344422,345106,372,684,2,36000,1.54385964912
344051,344435,345346,384,911,2,36000,1.42151481888
344071,344449,345154,378,705,2,36000,1.53617021277
344072,344459,345174,387,715,2,36000,1.54125874126
344144,344482,345140,338,658,2,36000,1.51367781155
344161,344560,345261,399,701,2,36000,1.56918687589
344162,344567,345234,405,667,2,36000,1.6071964018
344200,344582,345223,382,641,2,36000,1.59594383775
344218,344611,345290,393,679,2,36000,1.57879234168
344247,345567,345574,1320,7,1,1200,132.7
344290,344620,345302,330,682,2,36000,1.48387096774
344291,344660,345419,369,759,2,36000,1.48616600791
344307,344707,345293,400,586,2,36000,1.68259385666
344324,344719,345478,395,759,2,36000,1.52042160738
344348,344725,345429,377,704,2,36000,1.53551136364
344349,344740,345505,391,765,2,36000,1.51111111111
344366,344747,345493,381,746,2,36000,1.51072386059
344368,344763,345495,395,732,2,36000,1.53961748634
344369,344771,345497,402,726,2,36000,1.55371900826
344399,344778,345410,379,632,2,36000,1.5996835443
344416,344783,345593,367,810,2,36000,1.45308641975
344417,344790,345519,373,729,2,36000,1.51165980796
344434,344805,345535,371,730,2,36000,1.50821917808
344466,344811,345689,345,878,2,36000,1.39293849658
344468,344845,345562,377,717,2,36000,1.52580195258
344486,344895,345671,409,776,2,36000,1.52706185567
344549,344903,345650,354,747,2,36000,1.47389558233
344571,344945,345602,374,657,2,36000,1.56925418569
344573,344954,345695,381,741,2,36000,1.51417004049
344602,344992,345833,390,841,2,36000,1.46373365042
344618,345030,345754,412,724,2,36000,1.56906077348
344654,345037,345847,383,810,2,36000,1.47283950617
344697,345069,345741,372,672,2,36000,1.55357142857
344714,345081,346275,367,1194,2,36000,1.30737018425
344715,345087,345966,372,879,2,36000,1.42320819113
344731,345093,345636,362,543,2,36000,1.66666666667
344748,345100,345782,352,682,2,36000,1.51612903226
344766,345118,345893,352,775,2,36000,1.45419354839
344767,345125,345784,358,659,2,36000,1.54324734446
344768,345132,345953,364,821,2,36000,1.44336175396
344770,345142,345916,372,774,2,36000,1.48062015504
344785,345151,345823,366,672,2,36000,1.54464285714
344801,345166,345969,365,803,2,36000,1.45454545455
344802,345187,346073,385,886,2,36000,1.43453724605
344834,345236,345824,402,588,2,36000,1.68367346939
344889,345247,345983,358,736,2,36000,1.48641304348
344890,345273,345998,383,725,2,36000,1.52827586207
344942,345302,346128,360,826,2,36000,1.43583535109
344944,345309,346068,365,759,2,36000,1.48089591568
344982,345314,346295,332,981,2,36000,1.33843017329
345020,345321,345960,301,639,2,36000,1.4710485133
345036,345358,346019,322,661,2,36000,1.48714069592
345058,345422,346146,364,724,2,36000,1.50276243094
345079,345431,346031,352,600,2,36000,1.58666666667
345080,345441,346140,361,699,2,36000,1.51645207439
345082,345491,346194,409,703,2,36000,1.58179231863
345083,345505,346665,422,1160,2,36000,1.36379310345
345117,345512,346285,395,773,2,36000,1.51099611902
345119,345517,346385,398,868,2,36000,1.45852534562
345120,345524,346355,404,831,2,36000,1.4861612515
345136,345531,346342,395,811,2,36000,1.48705302096
345153,345547,346332,394,785,2,36000,1.50191082803
345154,345573,346356,419,783,2,36000,1.53512132822
345177,345605,346348,428,743,2,36000,1.57604306864
345224,345614,346259,390,645,2,36000,1.60465116279
345241,345649,346376,408,727,2,36000,1.56121045392
345263,345663,346487,400,824,2,36000,1.4854368932
345292,345684,346442,392,758,2,36000,1.51715039578
345293,345701,346366,408,665,2,36000,1.61353383459
345294,345708,346466,414,758,2,36000,1.54617414248
345310,345752,346410,442,658,2,36000,1.6717325228
345348,345767,346418,419,651,2,36000,1.64362519201
345413,345796,346528,383,732,2,36000,1.52322404372
345429,345802,346496,373,694,2,36000,1.53746397695
345445,345836,346559,391,723,2,36000,1.540802213
345480,345841,346636,361,795,2,36000,1.45408805031
345497,345847,346629,350,782,2,36000,1.44757033248
345498,345859,346558,361,699,2,36000,1.51645207439
345499,345905,346656,406,751,2,36000,1.54061251664
345516,345928,346629,412,701,2,36000,1.5877318117
345532,345965,346665,433,700,2,36000,1.61857142857
345547,345973,346859,426,886,2,36000,1.48081264108
345564,345979,346606,415,627,2,36000,1.66188197767
345596,345986,346661,390,675,2,36000,1.57777777778
345613,345995,346702,382,707,2,36000,1.54031117397
345638,346010,346733,372,723,2,36000,1.51452282158
345654,346032,346723,378,691,2,36000,1.54703328509
345674,346044,346619,370,575,2,36000,1.64347826087
345692,346081,346868,389,787,2,36000,1.49428208386
345709,346088,346867,379,779,2,36000,1.486521181
345745,346140,346841,395,701,2,36000,1.5634807418
345763,346151,346787,388,636,2,36000,1.61006289308
345797,346158,347157,361,999,2,36000,1.36136136136
345799,346206,347005,407,799,2,36000,1.50938673342
345825,346271,346955,446,684,2,36000,1.65204678363
345826,346288,347034,462,746,2,36000,1.61930294906
345843,346297,347082,454,785,2,36000,1.57834394904
345859,346307,347055,448,748,2,36000,1.59893048128
345893,346344,347214,451,870,2,36000,1.5183908046
345919,346354,347031,435,677,2,36000,1.64254062038
345953,346361,347098,408,737,2,36000,1.55359565807
345970,346368,347139,398,771,2,36000,1.51621271077
345972,346373,347077,401,704,2,36000,1.56960227273
345973,346379,347107,406,728,2,36000,1.55769230769
345990,346387,347052,397,665,2,36000,1.5969924812
346006,346397,347222,391,825,2,36000,1.47393939394
346022,346422,347204,400,782,2,36000,1.51150895141
346038,346430,347127,392,697,2,36000,1.56241032999
346069,346454,347094,385,640,2,36000,1.6015625
346085,346478,347278,393,800,2,36000,1.49125
346128,346499,347208,371,709,2,36000,1.52327221439
346144,346508,347196,364,688,2,36000,1.52906976744
346160,346540,347287,380,747,2,36000,1.50870147256
346195,346570,347276,375,706,2,36000,1.53116147309
346260,346577,347391,317,814,2,36000,1.38943488943
346276,346618,347312,342,694,2,36000,1.49279538905
346292,346631,347307,339,676,2,36000,1.50147928994
346309,346641,347265,332,624,2,36000,1.53205128205
346335,346646,347406,311,760,2,36000,1.40921052632
346351,346653,347287,302,634,2,36000,1.47634069401
346353,346669,347357,316,688,2,36000,1.45930232558
346373,346675,347369,302,694,2,36000,1.43515850144
346374,346682,347533,308,851,2,36000,1.36192714454
346376,346687,347352,311,665,2,36000,1.46766917293
346396,346714,347395,318,681,2,36000,1.46696035242
346398,346734,347415,336,681,2,36000,1.49339207048
346417,346746,347439,329,693,2,36000,1.47474747475
346418,346799,347560,381,761,2,36000,1.50065703022
346444,346852,347581,408,729,2,36000,1.55967078189
346468,346871,347573,403,702,2,36000,1.57407407407
346490,346879,347638,389,759,2,36000,1.51251646904
346506,346885,347562,379,677,2,36000,1.55982274742
346528,346967,347709,439,742,2,36000,1.59164420485
346560,347018,347764,458,746,2,36000,1.61394101877
346562,347045,347644,483,599,2,36000,1.80634390651
346609,347051,347697,442,646,2,36000,1.68421052632
346626,347063,347752,437,689,2,36000,1.63425253991
346649,347070,347876,421,806,2,36000,1.5223325062
346651,347089,347762,438,673,2,36000,1.65081723626
346652,347095,347844,443,749,2,36000,1.5914552737
346672,347107,347836,435,729,2,36000,1.59670781893
346673,347114,347789,441,675,2,36000,1.65333333333
346675,347120,347808,445,688,2,36000,1.64680232558
346676,347139,347793,463,654,2,36000,1.70795107034
346703,347150,347872,447,722,2,36000,1.61911357341
346726,347168,347959,442,791,2,36000,1.5587863464
346745,347208,347964,463,756,2,36000,1.61243386243
346789,347216,347994,427,778,2,36000,1.54884318766
346843,347223,347980,380,757,2,36000,1.50198150594
346859,347230,347981,371,751,2,36000,1.49400798935
346875,347236,347930,361,694,2,36000,1.52017291066
346877,347278,347979,401,701,2,36000,1.57203994294
346958,347288,348105,330,817,2,36000,1.40391676867
347008,347295,348044,287,749,2,36000,1.38317757009
347034,347302,348018,268,716,2,36000,1.37430167598
347035,347307,348055,272,748,2,36000,1.36363636364
347056,347320,348000,264,680,2,36000,1.38823529412
347057,347327,348257,270,930,2,36000,1.29032258065
347079,347364,348092,285,728,2,36000,1.39148351648
347096,347371,348079,275,708,2,36000,1.3884180791
347097,347382,348089,285,707,2,36000,1.40311173975
347115,347404,348132,289,728,2,36000,1.39697802198
347116,347411,348101,295,690,2,36000,1.42753623188
347132,347419,348331,287,912,2,36000,1.31469298246
347148,347427,348144,279,717,2,36000,1.38912133891
347164,347451,348294,287,843,2,36000,1.34045077106
347199,347545,348261,346,716,2,36000,1.48324022346
347222,347572,349081,350,1509,2,36000,1.23194168323
347224,347579,348334,355,755,2,36000,1.4701986755
347225,347586,348257,361,671,2,36000,1.53800298063
347226,347592,348271,366,679,2,36000,1.53902798233
347265,347649,348432,384,783,2,36000,1.49042145594
347282,347657,348478,375,821,2,36000,1.45676004872
347284,347710,348465,426,755,2,36000,1.5642384106
347302,347721,348390,419,669,2,36000,1.62630792227
347304,347763,348416,459,653,2,36000,1.70290964778
347326,347774,348457,448,683,2,36000,1.65592972182
347327,347781,348481,454,700,2,36000,1.64857142857
347354,347801,348478,447,677,2,36000,1.66026587888
347371,347808,348566,437,758,2,36000,1.5765171504
347372,347821,348477,449,656,2,36000,1.68445121951
347392,347847,348496,455,649,2,36000,1.70107858243
347410,347855,348500,445,645,2,36000,1.68992248062
347411,347884,348625,473,741,2,36000,1.6383265857
347426,347891,348700,465,809,2,36000,1.57478368356
347443,347942,348716,499,774,2,36000,1.64470284238
347533,347971,348685,438,714,2,36000,1.61344537815
347562,347978,348979,416,1001,2,36000,1.41558441558
347563,347991,348678,428,687,2,36000,1.6229985444
347580,347997,348668,417,671,2,36000,1.62146050671
347596,348003,348689,407,686,2,36000,1.59329446064
347640,348010,348648,370,638,2,36000,1.57993730408
347656,348017,348677,361,660,2,36000,1.54696969697
347700,348029,348755,329,726,2,36000,1.45316804408
347717,348056,348760,339,704,2,36000,1.48153409091
347755,348068,348777,313,709,2,36000,1.44146685472
347772,348091,348741,319,650,2,36000,1.49076923077
347773,348101,348786,328,685,2,36000,1.47883211679
347793,348108,348738,315,630,2,36000,1.5
347795,348115,348879,320,764,2,36000,1.41884816754
347812,348121,348827,309,706,2,36000,1.43767705382
347836,348144,348746,308,602,2,36000,1.51162790698
347852,348155,348871,303,716,2,36000,1.42318435754
347876,348268,348983,392,715,2,36000,1.54825174825
347878,348273,348988,395,715,2,36000,1.55244755245
347931,348281,349007,350,726,2,36000,1.48209366391
347962,348288,349063,326,775,2,36000,1.42064516129
347980,348306,349102,326,796,2,36000,1.40954773869
347981,348343,349014,362,671,2,36000,1.53949329359
347983,348350,348994,367,644,2,36000,1.5698757764
347984,348402,349104,418,702,2,36000,1.59544159544
348001,348428,349124,427,696,2,36000,1.61350574713
348002,348445,349166,443,721,2,36000,1.61442441054
348021,348469,349178,448,709,2,36000,1.63187588152
348046,348477,349121,431,644,2,36000,1.66925465839
348063,348489,349257,426,768,2,36000,1.5546875
348081,348496,349259,415,763,2,36000,1.54390563565
348098,348501,349135,403,634,2,36000,1.6356466877
348099,348506,349504,407,998,2,36000,1.40781563126
348115,348513,349274,398,761,2,36000,1.52299605782
348117,348518,349241,401,723,2,36000,1.55463347165
348133,348579,349237,446,658,2,36000,1.67781155015
348149,348637,349371,488,734,2,36000,1.66485013624
348258,348660,349457,402,797,2,36000,1.50439146801
348259,348679,349378,420,699,2,36000,1.6008583691
348276,348688,349506,412,818,2,36000,1.50366748166
348277,348695,349336,418,641,2,36000,1.65210608424
348297,348702,349381,405,679,2,36000,1.59646539028
348334,348707,349294,373,587,2,36000,1.63543441227
348336,348713,349414,377,701,2,36000,1.53780313837
348392,348728,349394,336,666,2,36000,1.5045045045
348416,348750,349450,334,700,2,36000,1.47714285714
348435,348757,349520,322,763,2,36000,1.42201834862
348457,348763,349371,306,608,2,36000,1.50328947368
348473,348770,349574,297,804,2,36000,1.36940298507
348490,348776,349444,286,668,2,36000,1.42814371257
348492,348788,349532,296,744,2,36000,1.39784946237
348493,348798,349582,305,784,2,36000,1.38903061224
348494,348839,349656,345,817,2,36000,1.42227662179
348510,348883,349599,373,716,2,36000,1.52094972067
348512,348890,349590,378,700,2,36000,1.54
348568,348991,349695,423,704,2,36000,1.60085227273
348627,348998,349683,371,685,2,36000,1.54160583942
348648,349004,349757,356,753,2,36000,1.47277556441
348671,349011,349725,340,714,2,36000,1.47619047619
348687,349019,349766,332,747,2,36000,1.44444444444
348689,349025,349822,336,797,2,36000,1.42158092848
348690,349074,349739,384,665,2,36000,1.57744360902
348706,349093,349995,387,902,2,36000,1.42904656319
348708,349114,349997,406,883,2,36000,1.45979614949
348723,349120,349694,397,574,2,36000,1.69163763066
348739,349133,349829,394,696,2,36000,1.56609195402
348757,349140,349870,383,730,2,36000,1.52465753425
348758,349146,349940,388,794,2,36000,1.48866498741
348760,349178,349792,418,614,2,36000,1.68078175896
348776,349190,349900,414,710,2,36000,1.58309859155
348777,349248,349999,471,751,2,36000,1.62716378162
348794,349254,350009,460,755,2,36000,1.60927152318
348828,349270,349999,442,729,2,36000,1.60631001372
348872,349277,350002,405,725,2,36000,1.55862068966
348888,349285,350046,397,761,2,36000,1.52168199737
348979,349306,350002,327,696,2,36000,1.46982758621
348997,349349,350150,352,801,2,36000,1.43945068664
348998,349382,350058,384,676,2,36000,1.56804733728
348999,349387,350260,388,873,2,36000,1.44444444444
349015,349395,350174,380,779,2,36000,1.48780487805
349016,349400,350135,384,735,2,36000,1.52244897959
349066,349406,350050,340,644,2,36000,1.52795031056
349082,349427,350223,345,796,2,36000,1.43341708543
349104,349455,350192,351,737,2,36000,1.4762550882
349105,349463,350160,358,697,2,36000,1.51362984218
349122,349470,350137,348,667,2,36000,1.52173913043
349138,349516,350145,378,629,2,36000,1.60095389507
349139,349522,350279,383,757,2,36000,1.50594451783
349168,349533,350213,365,680,2,36000,1.53676470588
349185,349544,350247,359,703,2,36000,1.5106685633
349238,349585,350379,347,794,2,36000,1.43702770781
349254,349594,350176,340,582,2,36000,1.58419243986
349271,349602,350361,331,759,2,36000,1.43610013175
349272,349610,350418,338,808,2,36000,1.41831683168
349288,349667,350461,379,794,2,36000,1.47732997481
349304,349695,350444,391,749,2,36000,1.5220293725
349338,349706,350475,368,769,2,36000,1.47854356307
349373,349713,350399,340,686,2,36000,1.49562682216
349374,349737,350450,363,713,2,36000,1.50911640954
349391,349750,350404,359,654,2,36000,1.54892966361
349392,349769,350630,377,861,2,36000,1.43786295006
349409,349778,350497,369,719,2,36000,1.51321279555
349424,349803,350413,379,610,2,36000,1.62131147541
349447,349833,350544,386,711,2,36000,1.54289732771
349464,349841,350651,377,810,2,36000,1.46543209877
349465,349882,350573,417,691,2,36000,1.60347322721
349503,349913,350552,410,639,2,36000,1.64162754304
349504,349951,350678,447,727,2,36000,1.61485557084
349523,350008,350801,485,793,2,36000,1.61160151324
349540,350015,350722,475,707,2,36000,1.67185289958
349574,350020,350727,446,707,2,36000,1.63083451202
349591,350025,350825,434,800,2,36000,1.5425
349592,350030,350764,438,734,2,36000,1.59673024523
349608,350035,350694,427,659,2,36000,1.64795144158
349658,350043,350739,385,696,2,36000,1.55316091954
349683,350058,350789,375,731,2,36000,1.51299589603
349699,350065,350843,366,778,2,36000,1.47043701799
349701,350072,350835,371,763,2,36000,1.48623853211
349726,350148,350857,422,709,2,36000,1.5952045134
349742,350155,350887,413,732,2,36000,1.56420765027
349758,350161,350932,403,771,2,36000,1.52269779507
349773,350166,350831,393,665,2,36000,1.59097744361
349792,350173,350783,381,610,2,36000,1.62459016393
349824,350185,350861,361,676,2,36000,1.53402366864
349840,350192,350801,352,609,2,36000,1.57799671593
349871,350204,350952,333,748,2,36000,1.44518716578
349903,350225,350956,322,731,2,36000,1.44049247606
349940,350235,350943,295,708,2,36000,1.41666666667
349999,350259,350995,260,736,2,36000,1.35326086957
350000,350272,351067,272,795,2,36000,1.34213836478
350002,350290,350960,288,670,2,36000,1.42985074627
350003,350372,351050,369,678,2,36000,1.54424778761
350020,350391,351137,371,746,2,36000,1.49731903485
350022,350411,351174,389,763,2,36000,1.50982961992
350023,350418,351190,395,772,2,36000,1.51165803109
350053,350425,351244,372,819,2,36000,1.45421245421
350055,350432,351196,377,764,2,36000,1.49345549738
350071,350456,351214,385,758,2,36000,1.50791556728
350137,350462,351206,325,744,2,36000,1.43682795699
350138,350473,351444,335,971,2,36000,1.34500514933
350155,350487,351189,332,702,2,36000,1.47293447293
350156,350509,351217,353,708,2,36000,1.49858757062
350172,350555,351395,383,840,2,36000,1.45595238095
350189,350569,351207,380,638,2,36000,1.59561128527
350190,350584,351353,394,769,2,36000,1.51235370611
350205,350641,351396,436,755,2,36000,1.57748344371
350221,350662,351368,441,706,2,36000,1.62464589235
350237,350690,351391,453,701,2,36000,1.64621968616
350253,350706,351424,453,718,2,36000,1.63091922006
350269,350733,351442,464,709,2,36000,1.65444287729
350285,350740,351387,455,647,2,36000,1.70324574961
350362,350751,351455,389,704,2,36000,1.55255681818
350381,350775,351382,394,607,2,36000,1.64909390445
350401,350794,351614,393,820,2,36000,1.47926829268
350417,350802,351547,385,745,2,36000,1.51677852349
350419,350814,351655,395,841,2,36000,1.46967895363
350420,350819,351530,399,711,2,36000,1.5611814346
350446,350836,351486,390,650,2,36000,1.6
350462,350843,351477,381,634,2,36000,1.60094637224
350463,350850,351539,387,689,2,36000,1.56168359942
350479,350856,351558,377,702,2,36000,1.53703703704
350499,350870,351637,371,767,2,36000,1.48370273794
350545,350877,351687,332,810,2,36000,1.40987654321
350553,350563,350568,10,5,1,1200,1.5
350561,350900,351544,339,644,2,36000,1.52639751553
350577,350944,351587,367,643,2,36000,1.57076205288
350633,350955,351752,322,797,2,36000,1.40401505646
350652,350964,351656,312,692,2,36000,1.45086705202
350680,350971,351664,291,693,2,36000,1.41991341991
350696,350978,351708,282,730,2,36000,1.38630136986
350722,351007,351704,285,697,2,36000,1.40889526542
350737,351062,351771,325,709,2,36000,1.45839210155
350753,351079,351899,326,820,2,36000,1.39756097561
350769,351149,351825,380,676,2,36000,1.56213017751
350785,351186,351998,401,812,2,36000,1.49384236453
350800,351201,351903,401,702,2,36000,1.57122507123
350802,351208,351959,406,751,2,36000,1.54061251664
350819,351213,351941,394,728,2,36000,1.54120879121
350835,351220,352006,385,786,2,36000,1.48982188295
350836,351225,351900,389,675,2,36000,1.5762962963
350838,351232,351989,394,757,2,36000,1.52047556143
350857,351237,352012,380,775,2,36000,1.49032258065
350858,351256,351951,398,695,2,36000,1.5726618705
350874,351364,352128,490,764,2,36000,1.64136125654
350890,351381,352189,491,808,2,36000,1.60767326733
350933,351394,352023,461,629,2,36000,1.73290937997
350949,351400,352168,451,768,2,36000,1.58723958333
350965,351408,352158,443,750,2,36000,1.59066666667
350967,351413,352112,446,699,2,36000,1.63805436338
350968,351418,352154,450,736,2,36000,1.61141304348
350997,351436,352131,439,695,2,36000,1.63165467626
351051,351454,352235,403,781,2,36000,1.51600512164
351070,351460,352149,390,689,2,36000,1.56603773585
351138,351467,352226,329,759,2,36000,1.43346508564
351176,351488,352189,312,701,2,36000,1.44507845934
351192,351499,352168,307,669,2,36000,1.45889387145
351193,351542,352263,349,721,2,36000,1.48404993065
351211,351552,352258,341,706,2,36000,1.48300283286
351213,351558,352683,345,1125,2,36000,1.30666666667
351214,351563,352311,349,748,2,36000,1.46657754011
351230,351570,352204,340,634,2,36000,1.53627760252
351231,351599,352297,368,698,2,36000,1.52722063037
351247,351625,352331,378,706,2,36000,1.53541076487
351355,351648,352361,293,713,2,36000,1.41093969144
351372,351666,352446,294,780,2,36000,1.37692307692
351389,351674,352417,285,743,2,36000,1.38358008075
351390,351680,352449,290,769,2,36000,1.37711313394
351408,351700,352358,292,658,2,36000,1.44376899696
351409,351716,352489,307,773,2,36000,1.39715394567
351411,351724,352605,313,881,2,36000,1.35527809308
351417,363371,363676,11954,305,32,7200,40.193442623
351427,351764,352490,337,726,2,36000,1.46418732782
351443,351782,352534,339,752,2,36000,1.45079787234
351459,351837,352526,378,689,2,36000,1.54862119013
351460,351910,352664,450,754,2,36000,1.59681697613
351479,351918,352710,439,792,2,36000,1.55429292929
351495,351923,352532,428,609,2,36000,1.70279146141
351530,351952,352688,422,736,2,36000,1.57336956522
351546,351963,352691,417,728,2,36000,1.5728021978
351548,351972,352695,424,723,2,36000,1.58644536653
351549,352001,352742,452,741,2,36000,1.60998650472
351566,352011,352719,445,708,2,36000,1.62853107345
351588,352017,352693,429,676,2,36000,1.63461538462
351615,352024,352744,409,720,2,36000,1.56805555556
351641,352034,353045,393,1011,2,36000,1.38872403561
351657,352063,352718,406,655,2,36000,1.61984732824
351658,352123,352851,465,728,2,36000,1.63873626374
351674,352140,352879,466,739,2,36000,1.63058186739
351690,352147,352882,457,735,2,36000,1.62176870748
351706,352161,352820,455,659,2,36000,1.6904400607
351707,352167,352948,460,781,2,36000,1.58898847631
351752,352174,352878,422,704,2,36000,1.59943181818
351771,352181,352944,410,763,2,36000,1.5373525557
351776,362367,362693,10591,326,128,14400,33.4877300613
351828,352186,352917,358,731,2,36000,1.48974008208
351829,363039,363365,11210,326,64,14400,35.3865030675
351901,352200,352896,299,696,2,36000,1.42959770115
351902,352206,353021,304,815,2,36000,1.37300613497
351918,352217,352887,299,670,2,36000,1.44626865672
351940,352237,352974,297,737,2,36000,1.40298507463
351956,352246,352993,290,747,2,36000,1.38821954485
351972,352270,352968,298,698,2,36000,1.42693409742
351991,352277,352946,286,669,2,36000,1.42750373692
352007,352308,352967,301,659,2,36000,1.45675265554
352008,352323,353109,315,786,2,36000,1.40076335878
352024,352343,353053,319,710,2,36000,1.44929577465
352026,352370,353109,344,739,2,36000,1.46549391069
352052,363376,363699,11324,323,32,7200,36.0588235294
352056,363044,363358,10988,314,64,14400,35.9936305732
352059,362704,363028,10645,324,128,14400,33.8549382716
352113,352377,353167,264,790,2,36000,1.33417721519
352132,352429,353168,297,739,2,36000,1.40189445196
352134,352458,353322,324,864,2,36000,1.375
352150,352464,353182,314,718,2,36000,1.43732590529
352167,352500,353198,333,698,2,36000,1.4770773639
352168,352508,353318,340,810,2,36000,1.41975308642
352185,352538,353232,353,694,2,36000,1.50864553314
352186,352544,353196,358,652,2,36000,1.5490797546
352203,352552,353322,349,770,2,36000,1.45324675325
352204,352618,353326,414,708,2,36000,1.58474576271
352220,352675,353461,455,786,2,36000,1.57888040712
352236,352695,353302,459,607,2,36000,1.75617792422
352238,352702,353386,464,684,2,36000,1.6783625731
352260,352708,353445,448,737,2,36000,1.6078697422
352276,352714,353398,438,684,2,36000,1.64035087719
352298,352719,353483,421,764,2,36000,1.55104712042
352313,352725,353459,412,734,2,36000,1.56130790191
352332,352732,353423,400,691,2,36000,1.57887120116
352358,352737,353437,379,700,2,36000,1.54142857143
352373,352755,353416,382,661,2,36000,1.57791225416
352420,352761,353375,341,614,2,36000,1.55537459283
352448,352831,353552,383,721,2,36000,1.53120665742
352449,352863,353545,414,682,2,36000,1.60703812317
352490,352890,353717,400,827,2,36000,1.48367593712
352492,352897,353595,405,698,2,36000,1.58022922636
352530,352902,353664,372,762,2,36000,1.48818897638
352546,352909,353638,363,729,2,36000,1.49794238683
352548,352914,353669,366,755,2,36000,1.48476821192
352609,352930,353662,321,732,2,36000,1.43852459016
352665,352956,353648,291,692,2,36000,1.42052023121
352684,352964,353612,280,648,2,36000,1.43209876543
352701,352969,353848,268,879,2,36000,1.30489192264
352702,352980,353700,278,720,2,36000,1.38611111111
352703,352985,353768,282,783,2,36000,1.3601532567
352705,352991,353743,286,752,2,36000,1.38031914894
352721,353004,353834,283,830,2,36000,1.34096385542
352723,353032,353832,309,800,2,36000,1.38625
352724,353056,353815,332,759,2,36000,1.43741765481
352743,353065,353802,322,737,2,36000,1.4369063772
352745,353120,353805,375,685,2,36000,1.54744525547
352823,353125,353807,302,682,2,36000,1.44281524927
352851,353178,353782,327,604,2,36000,1.54139072848
352880,353186,353921,306,735,2,36000,1.41632653061
352882,353194,353850,312,656,2,36000,1.4756097561
352899,353208,353973,309,765,2,36000,1.40392156863
352900,353215,353909,315,694,2,36000,1.45389048991
352902,353244,353873,342,629,2,36000,1.54372019078
352921,353313,354102,392,789,2,36000,1.49683143219
352946,353330,354127,384,797,2,36000,1.48180677541
352948,353337,354021,389,684,2,36000,1.56871345029
352964,353342,354056,378,714,2,36000,1.52941176471
352980,353349,354099,369,750,2,36000,1.492
352981,353387,354063,406,676,2,36000,1.60059171598
352983,353397,354007,414,610,2,36000,1.67868852459
352999,353410,354083,411,673,2,36000,1.61069836553
353024,353428,354153,404,725,2,36000,1.55724137931
353046,353434,354182,388,748,2,36000,1.51871657754
353062,353448,354654,386,1206,2,36000,1.32006633499
353112,353456,354233,344,777,2,36000,1.44272844273
353113,353471,354273,358,802,2,36000,1.4463840399
353167,353477,354391,310,914,2,36000,1.33916849015
353168,353495,354223,327,728,2,36000,1.44917582418
353185,353557,354256,372,699,2,36000,1.5321888412
353202,353564,354307,362,743,2,36000,1.48721399731
353203,353606,354303,403,697,2,36000,1.57819225251
353235,353624,354391,389,767,2,36000,1.50717079531
353303,353650,354632,347,982,2,36000,1.3533604888
353320,353660,354374,340,714,2,36000,1.47619047619
353321,353674,354437,353,763,2,36000,1.4626474443
353337,353681,354438,344,757,2,36000,1.45442536328
353339,353686,354420,347,734,2,36000,1.4727520436
353377,353712,354390,335,678,2,36000,1.49410029499
353393,353729,354479,336,750,2,36000,1.448
353409,353755,354424,346,669,2,36000,1.51718983558
353425,353780,354483,355,703,2,36000,1.50497866287
353426,353793,354485,367,692,2,36000,1.53034682081
353442,353815,354605,373,790,2,36000,1.47215189873
353459,353822,354561,363,739,2,36000,1.49120433018
353460,353827,354532,367,705,2,36000,1.52056737589
353477,353834,354590,357,756,2,36000,1.47222222222
353493,353848,354780,355,932,2,36000,1.38090128755
353545,353853,354488,308,635,2,36000,1.48503937008
353561,353860,354563,299,703,2,36000,1.4253200569
353596,353866,354608,270,742,2,36000,1.36388140162
353614,353885,354544,271,659,2,36000,1.41122913505
353640,353920,354581,280,661,2,36000,1.42360060514
353656,353932,354643,276,711,2,36000,1.38818565401
353672,353985,354821,313,836,2,36000,1.37440191388
353674,354019,354747,345,728,2,36000,1.4739010989
353675,354033,354913,358,880,2,36000,1.40681818182
353700,354069,354814,369,745,2,36000,1.49530201342
353719,354076,354770,357,694,2,36000,1.5144092219
353744,354094,354871,350,777,2,36000,1.45045045045
353770,354110,354828,340,718,2,36000,1.47353760446
353786,354117,354870,331,753,2,36000,1.4395750332
353802,354139,354919,337,780,2,36000,1.43205128205
353818,354165,354838,347,673,2,36000,1.51560178306
353820,354193,354974,373,781,2,36000,1.47759282971
353821,354235,355106,414,871,2,36000,1.47531572905
353833,353840,353844,7,4,2,3540,1.1
353848,354245,355121,397,876,2,36000,1.45319634703
353849,354269,354952,420,683,2,36000,1.6149341142
353850,354284,354962,434,678,2,36000,1.6401179941
353867,354315,355099,448,784,2,36000,1.57142857143
353882,354322,355095,440,773,2,36000,1.56921086675
353911,354386,355053,475,667,2,36000,1.71214392804
353927,354403,355172,476,769,2,36000,1.61898569571
353974,354408,355208,434,800,2,36000,1.5425
354006,354413,355122,407,709,2,36000,1.57404795487
354025,354432,355068,407,636,2,36000,1.63993710692
354057,354440,355151,383,711,2,36000,1.53867791842
354072,354449,355147,377,698,2,36000,1.54011461318
354088,354455,355177,367,722,2,36000,1.50831024931
354104,354491,355242,387,751,2,36000,1.51531291611
354105,354498,355313,393,815,2,36000,1.48220858896
354128,354503,355265,375,762,2,36000,1.49212598425
354153,354509,355521,356,1012,2,36000,1.35177865613
354184,354543,355139,359,596,2,36000,1.60234899329
354225,354555,355317,330,762,2,36000,1.43307086614
354241,354572,355321,331,749,2,36000,1.44192256342
354260,354579,355309,319,730,2,36000,1.43698630137
354277,354593,355272,316,679,2,36000,1.46539027982
354305,354602,355324,297,722,2,36000,1.41135734072
354321,354617,355360,296,743,2,36000,1.39838492598
354374,354624,355252,250,628,2,36000,1.39808917197
354394,354644,355364,250,720,2,36000,1.34722222222
354395,354655,355435,260,780,2,36000,1.33333333333
354396,354666,355602,270,936,2,36000,1.28846153846
354422,354759,355426,337,667,2,36000,1.50524737631
354438,354782,355514,344,732,2,36000,1.46994535519
354440,354792,355558,352,766,2,36000,1.45953002611
354441,354807,355610,366,803,2,36000,1.45579078456
354483,354826,355613,343,787,2,36000,1.43583227446
354484,354833,355446,349,613,2,36000,1.56933115824
354500,354839,355589,339,750,2,36000,1.452
354502,354850,355581,348,731,2,36000,1.47606019152
354533,354882,355647,349,765,2,36000,1.45620915033
354550,354888,355637,338,749,2,36000,1.45126835781
354566,354925,355676,359,751,2,36000,1.47802929427
354567,354937,355710,370,773,2,36000,1.4786545925
354584,354964,355679,380,715,2,36000,1.53146853147
354600,354974,355678,374,704,2,36000,1.53125
354616,354985,355773,369,788,2,36000,1.46827411168
354618,355064,355684,446,620,2,36000,1.71935483871
354633,355081,355901,448,820,2,36000,1.54634146341
354652,355106,355806,454,700,2,36000,1.64857142857
354672,355113,355915,441,802,2,36000,1.54987531172
354749,355119,355891,370,772,2,36000,1.4792746114
354771,355134,355767,363,633,2,36000,1.57345971564
354787,355139,355909,352,770,2,36000,1.45714285714
354816,355150,355748,334,598,2,36000,1.55852842809
354832,355159,355858,327,699,2,36000,1.4678111588
354833,355166,355952,333,786,2,36000,1.42366412214
354849,355184,355876,335,692,2,36000,1.48410404624
354871,355191,355925,320,734,2,36000,1.43596730245
354872,355220,356476,348,1256,2,36000,1.27707006369
354917,355225,355841,308,616,2,36000,1.5
354923,354932,355107,9,175,1,3600,1.05142857143
354932,355230,356023,298,793,2,36000,1.37578814628
354955,355235,355928,280,693,2,36000,1.40404040404
354971,355242,355908,271,666,2,36000,1.40690690691
354987,355255,355998,268,743,2,36000,1.36069986541
355055,355264,356026,209,762,2,36000,1.27427821522
355071,355276,355941,205,665,2,36000,1.30827067669
355097,355283,356110,186,827,2,36000,1.22490931076
355113,355320,356109,207,789,2,36000,1.26235741445
355114,355327,356103,213,776,2,36000,1.27448453608
355130,355333,356005,203,672,2,36000,1.30208333333
355131,355338,356131,207,793,2,36000,1.26103404792
355150,355345,355992,195,647,2,36000,1.30139103555
355151,355372,356020,221,648,2,36000,1.34104938272
355153,355379,356091,226,712,2,36000,1.31741573034
355172,355438,356197,266,759,2,36000,1.35046113307
355188,355447,356119,259,672,2,36000,1.38541666667
355210,355457,356230,247,773,2,36000,1.31953428202
355245,355527,356334,282,807,2,36000,1.34944237918
355262,355533,356310,271,777,2,36000,1.34877734878
355278,355569,356277,291,708,2,36000,1.41101694915
355280,355593,356352,313,759,2,36000,1.41238471673
355288,358839,359208,3551,369,1,3600,10.6233062331
355312,355600,356290,288,690,2,36000,1.41739130435
355329,355614,356414,285,800,2,36000,1.35625
355330,355622,356378,292,756,2,36000,1.38624338624
355331,355629,356318,298,689,2,36000,1.43251088534
355333,355649,356388,316,739,2,36000,1.42760487145
355361,355659,356412,298,753,2,36000,1.39575033201
355378,355687,356433,309,746,2,36000,1.41420911528
355428,355694,356411,266,717,2,36000,1.3709902371
355444,355699,356401,255,702,2,36000,1.36324786325
355460,355705,356477,245,772,2,36000,1.31735751295
355516,355722,356415,206,693,2,36000,1.29725829726
355532,355759,356447,227,688,2,36000,1.32994186047
355560,355778,356422,218,644,2,36000,1.33850931677
355583,355785,356466,202,681,2,36000,1.2966226138
355598,355819,356879,221,1060,2,36000,1.20849056604
355615,355852,356471,237,619,2,36000,1.38287560582
355616,355869,356577,253,708,2,36000,1.35734463277
355617,355888,356602,271,714,2,36000,1.37955182073
355639,355904,356613,265,709,2,36000,1.37376586742
355655,355913,356732,258,819,2,36000,1.31501831502
355678,355919,356693,241,774,2,36000,1.31136950904
355679,355926,356673,247,747,2,36000,1.33065595716
355680,355931,356716,251,785,2,36000,1.31974522293
355697,355937,356575,240,638,2,36000,1.37617554859
355713,355944,356668,231,724,2,36000,1.31906077348
355751,355954,356734,203,780,2,36000,1.26025641026
355770,355963,356615,193,652,2,36000,1.29601226994
355786,356004,356812,218,808,2,36000,1.2698019802
355808,356010,356629,202,619,2,36000,1.32633279483
355843,356018,356644,175,626,2,36000,1.27955271565
355859,356032,356825,173,793,2,36000,1.21815889029
355878,356038,356831,160,793,2,36000,1.20176544767
355894,356044,356834,150,790,2,36000,1.18987341772
355911,356103,356748,192,645,2,36000,1.2976744186
355912,356115,356892,203,777,2,36000,1.26126126126
355914,356121,356832,207,711,2,36000,1.29113924051
355931,356126,356956,195,830,2,36000,1.23493975904
355932,356134,356845,202,711,2,36000,1.2841068917
355934,356142,356836,208,694,2,36000,1.29971181556
355950,356209,356949,259,740,2,36000,1.35
355967,356241,357140,274,899,2,36000,1.30478309232
355992,356289,357074,297,785,2,36000,1.37834394904
356008,356301,357024,293,723,2,36000,1.40525587828
356010,356321,357076,311,755,2,36000,1.4119205298
356027,356330,356975,303,645,2,36000,1.46976744186
356028,356346,357117,318,771,2,36000,1.41245136187
356029,356364,357051,335,687,2,36000,1.48762736536
356092,356391,357083,299,692,2,36000,1.43208092486
356109,356401,357057,292,656,2,36000,1.44512195122
356110,356413,357139,303,726,2,36000,1.4173553719
356111,356424,357060,313,636,2,36000,1.49213836478
356129,356429,357203,300,774,2,36000,1.38759689922
356145,356436,357190,291,754,2,36000,1.38594164456
356199,356441,357482,242,1041,2,36000,1.23246878002
356237,356446,357166,209,720,2,36000,1.29027777778
356277,356452,357166,175,714,2,36000,1.24509803922
356293,356459,357250,166,791,2,36000,1.20986093552
356312,356479,357309,167,830,2,36000,1.20120481928
356329,356485,357369,156,884,2,36000,1.17647058824
356345,356492,357128,147,636,2,36000,1.23113207547
356362,356497,357157,135,660,2,36000,1.20454545455
356380,356587,357443,207,856,2,36000,1.24182242991
356401,356594,357319,193,725,2,36000,1.26620689655
356402,356614,357364,212,750,2,36000,1.28266666667
356423,356625,357343,202,718,2,36000,1.28133704735
356424,356632,357444,208,812,2,36000,1.25615763547
356426,356642,357469,216,827,2,36000,1.26118500605
356427,356655,357288,228,633,2,36000,1.36018957346
356428,356680,357390,252,710,2,36000,1.35492957746
356444,356686,357498,242,812,2,36000,1.29802955665
356461,356704,357329,243,625,2,36000,1.3888
356479,356728,357407,249,679,2,36000,1.36671575847
356480,356745,357435,265,690,2,36000,1.38405797101
356481,356751,357425,270,674,2,36000,1.40059347181
356483,356760,357569,277,809,2,36000,1.34239802225
356578,356823,357450,245,627,2,36000,1.39074960128
356580,356836,357502,256,666,2,36000,1.38438438438
356605,356843,357562,238,719,2,36000,1.33101529903
356621,356848,357609,227,761,2,36000,1.29829172142
356623,356855,357532,232,677,2,36000,1.34268833087
356640,356860,357593,220,733,2,36000,1.30013642565
356661,356866,357564,205,698,2,36000,1.29369627507
356681,356893,357634,212,741,2,36000,1.28609986505
356682,356903,357724,221,821,2,36000,1.26918392205
356698,356962,357723,264,761,2,36000,1.34691195795
356717,356968,357682,251,714,2,36000,1.35154061625
356734,356987,357715,253,728,2,36000,1.34752747253
356735,357036,357739,301,703,2,36000,1.42816500711
356752,357064,357764,312,700,2,36000,1.44571428571
356815,357071,357772,256,701,2,36000,1.36519258203
356833,357077,357865,244,788,2,36000,1.30964467005
356834,357086,357836,252,750,2,36000,1.336
356836,357093,357933,257,840,2,36000,1.30595238095
356837,357099,357861,262,762,2,36000,1.343832021
356838,357129,357769,291,640,2,36000,1.4546875
356855,357139,357879,284,740,2,36000,1.38378378378
356881,357150,357827,269,677,2,36000,1.39734121123
356897,357157,357851,260,694,2,36000,1.37463976945
356949,357169,358004,220,835,2,36000,1.26347305389
356965,357178,358105,213,927,2,36000,1.22977346278
356981,357183,357784,202,601,2,36000,1.33610648918
357026,357202,357922,176,720,2,36000,1.24444444444
357060,357216,357818,156,602,2,36000,1.25913621262
357062,357262,357972,200,710,2,36000,1.28169014085
357063,357300,358013,237,713,2,36000,1.33239831697
357081,357321,358086,240,765,2,36000,1.3137254902
357082,357330,358039,248,709,2,36000,1.34978843441
357099,357341,358127,242,786,2,36000,1.30788804071
357120,357355,358081,235,726,2,36000,1.32369146006
357140,357375,357987,235,612,2,36000,1.3839869281
357141,357382,358123,241,741,2,36000,1.32523616734
357143,357403,358197,260,794,2,36000,1.3274559194
357169,357419,358174,250,755,2,36000,1.33112582781
357170,357437,358168,267,731,2,36000,1.36525307798
357171,357448,358177,277,729,2,36000,1.37997256516
357191,357455,358173,264,718,2,36000,1.36768802228
357207,357461,358136,254,675,2,36000,1.3762962963
357251,357466,358209,215,743,2,36000,1.28936742934
357294,357481,358220,187,739,2,36000,1.25304465494
357315,357495,358125,180,630,2,36000,1.28571428571
357332,357511,358310,179,799,2,36000,1.22403003755
357333,357518,358217,185,699,2,36000,1.26466380544
357349,357544,358249,195,705,2,36000,1.27659574468
357366,357574,358286,208,712,2,36000,1.29213483146
357382,357580,358309,198,729,2,36000,1.27160493827
357400,357585,358315,185,730,2,36000,1.25342465753
357418,357605,358502,187,897,2,36000,1.20847268673
357444,357621,358287,177,666,2,36000,1.26576576577
357446,357646,358463,200,817,2,36000,1.24479804162
357447,357695,358512,248,817,2,36000,1.3035495716
357449,357728,358350,279,622,2,36000,1.44855305466
357466,357735,358377,269,642,2,36000,1.41900311526
357484,357741,358423,257,682,2,36000,1.37683284457
357485,357750,358478,265,728,2,36000,1.36401098901
357502,357776,358432,274,656,2,36000,1.41768292683
357518,357782,358535,264,753,2,36000,1.35059760956
357534,357789,358482,255,693,2,36000,1.36796536797
357563,357796,358483,233,687,2,36000,1.33915574964
357579,357830,358478,251,648,2,36000,1.38734567901
357580,357839,358567,259,728,2,36000,1.35576923077
357597,357847,358538,250,691,2,36000,1.36179450072
357617,357863,358609,246,746,2,36000,1.32975871314
357636,357873,358672,237,799,2,36000,1.29662077597
357683,357880,358598,197,718,2,36000,1.27437325905
357719,357891,358576,172,685,2,36000,1.25109489051
357737,357933,358704,196,771,2,36000,1.2542153048
357738,357946,358740,208,794,2,36000,1.26196473552
357759,357983,358799,224,816,2,36000,1.27450980392
357789,363699,543728,5910,180029,1,180000,1.03282804437
357793,357998,358735,205,737,2,36000,1.27815468114
357795,358016,358734,221,718,2,36000,1.3077994429
357796,358024,358701,228,677,2,36000,1.33677991137
357798,358051,358808,253,757,2,36000,1.33421400264
357820,358094,358703,274,609,2,36000,1.44991789819
357837,358101,358901,264,800,2,36000,1.33
357838,358117,358741,279,624,2,36000,1.44711538462
357854,358134,358827,280,693,2,36000,1.40404040404
357871,358141,358903,270,762,2,36000,1.35433070866
357872,358146,358814,274,668,2,36000,1.41017964072
357891,358152,358828,261,676,2,36000,1.38609467456
357928,358180,358945,252,765,2,36000,1.32941176471
357946,358187,359524,241,1337,2,36000,1.18025430067
357977,358192,358937,215,745,2,36000,1.28859060403
357988,363705,379233,5717,15528,1,90000,1.36817362184
357996,358198,358890,202,692,2,36000,1.29190751445
358015,358208,358926,193,718,2,36000,1.26880222841
358016,358222,358955,206,733,2,36000,1.28103683492
358039,358228,358980,189,752,2,36000,1.25132978723
358074,363710,379004,5636,15294,1,90000,1.368510527
358084,358236,358882,152,646,2,36000,1.23529411765
358101,358260,358984,159,724,2,36000,1.21961325967
358117,358298,359045,181,747,2,36000,1.24230254351
358135,358303,358927,168,624,2,36000,1.26923076923
358137,358320,359141,183,821,2,36000,1.22289890378
358138,358327,359038,189,711,2,36000,1.26582278481
358139,358332,359083,193,751,2,36000,1.25699067909
358175,363715,406860,5540,43145,1,90000,1.12840421833
358178,358361,359114,183,753,2,36000,1.24302788845
358179,358389,359096,210,707,2,36000,1.29702970297
358181,358434,359230,253,796,2,36000,1.31783919598
358182,358443,359268,261,825,2,36000,1.31636363636
358203,358475,359201,272,726,2,36000,1.37465564738
358220,358489,359195,269,706,2,36000,1.38101983003
358221,358496,359116,275,620,2,36000,1.4435483871
358238,358501,359233,263,732,2,36000,1.35928961749
358254,358506,359263,252,757,2,36000,1.33289299868
358289,358515,359295,226,780,2,36000,1.28974358974
358290,358524,359203,234,679,2,36000,1.34462444772
358319,358547,359343,228,796,2,36000,1.2864321608
358320,358554,359270,234,716,2,36000,1.32681564246
358322,358580,359244,258,664,2,36000,1.38855421687
358351,358587,359316,236,729,2,36000,1.32373113855
358380,358610,359292,230,682,2,36000,1.33724340176
358427,358620,359282,193,662,2,36000,1.2915407855
358443,358683,359438,240,755,2,36000,1.3178807947
358465,358713,359563,248,850,2,36000,1.29176470588
358483,358720,359510,237,790,2,36000,1.3
358485,358725,359399,240,674,2,36000,1.35608308605
358486,358746,359460,260,714,2,36000,1.36414565826
358487,358752,359508,265,756,2,36000,1.35052910053
358505,358758,359473,253,715,2,36000,1.35384615385
358528,358763,359522,235,759,2,36000,1.30961791831
358543,358844,359023,301,179,1,3600,2.68156424581
358551,358810,359568,259,758,2,36000,1.34168865435
358553,358820,359546,267,726,2,36000,1.36776859504
358572,358832,359682,260,850,2,36000,1.30588235294
358589,358850,359582,261,732,2,36000,1.35655737705
358609,358894,359708,285,814,2,36000,1.35012285012
358610,358901,359655,291,754,2,36000,1.38594164456
358673,358914,359658,241,744,2,36000,1.32392473118
358702,358939,359601,237,662,2,36000,1.3580060423
358704,358949,359664,245,715,2,36000,1.34265734266
358705,358957,359618,252,661,2,36000,1.38124054463
358735,358967,359708,232,741,2,36000,1.31309041835
358736,358992,359705,256,713,2,36000,1.35904628331
358757,358998,359649,241,651,2,36000,1.37019969278
358759,359050,359757,291,707,2,36000,1.41159830269
358806,359096,359730,290,634,2,36000,1.45741324921
358824,359108,359878,284,770,2,36000,1.36883116883
358826,359127,359873,301,746,2,36000,1.40348525469
358842,359133,359831,291,698,2,36000,1.41690544413
358843,359153,360077,310,924,2,36000,1.3354978355
358885,359207,359891,322,684,2,36000,1.47076023392
358904,359219,359882,315,663,2,36000,1.47511312217
358906,359226,359857,320,631,2,36000,1.50713153724
358907,359242,359998,335,756,2,36000,1.44312169312
358944,359248,359986,304,738,2,36000,1.41192411924
358946,359256,360072,310,816,2,36000,1.37990196078
358947,359274,359953,327,679,2,36000,1.48159057437
358949,359281,359914,332,633,2,36000,1.52448657188
358974,359286,359930,312,644,2,36000,1.48447204969
358991,359293,360025,302,732,2,36000,1.41256830601
358993,359303,359994,310,691,2,36000,1.4486251809
359039,359310,360076,271,766,2,36000,1.35378590078
359056,359355,360145,299,790,2,36000,1.37848101266
359086,359411,360061,325,650,2,36000,1.5
359104,359472,360278,368,806,2,36000,1.45657568238
359123,359485,360321,362,836,2,36000,1.43301435407
359124,359520,360306,396,786,2,36000,1.50381679389
359143,359526,360333,383,807,2,36000,1.47459727385
359197,359535,360226,338,691,2,36000,1.48914616498
359202,359213,359575,11,362,1,3600,1.03038674033
359221,359541,360164,320,623,2,36000,1.51364365971
359222,359558,360355,336,797,2,36000,1.42158092848
359239,359575,360251,336,676,2,36000,1.49704142012
359241,359581,360295,340,714,2,36000,1.47619047619
359257,359595,360369,338,774,2,36000,1.43669250646
359275,359617,360342,342,725,2,36000,1.47172413793
359277,359630,360403,353,773,2,36000,1.45666235446
359278,359661,360368,383,707,2,36000,1.54172560113
359296,359667,360423,371,756,2,36000,1.49074074074
359297,359674,360543,377,869,2,36000,1.43383199079
359298,359681,360509,383,828,2,36000,1.46256038647
359318,359693,360405,375,712,2,36000,1.52668539326
359345,359716,360422,371,706,2,36000,1.52549575071
359402,359723,360498,321,775,2,36000,1.41419354839
359440,359729,360438,289,709,2,36000,1.40761636107
359462,359742,360450,280,708,2,36000,1.39548022599
359478,359770,360595,292,825,2,36000,1.35393939394
359510,359842,360586,332,744,2,36000,1.44623655914
359511,359868,360534,357,666,2,36000,1.53603603604
359537,359886,360531,349,645,2,36000,1.54108527132
359538,359892,360676,354,784,2,36000,1.45153061224
359558,359898,360553,340,655,2,36000,1.51908396947
359579,359904,360597,325,693,2,36000,1.46897546898
359580,359926,360700,346,774,2,36000,1.44702842377
359597,359942,360621,345,679,2,36000,1.50810014728
359604,359611,360458,7,847,1,3600,1.00826446281
359614,359964,360691,350,727,2,36000,1.48143053645
359630,359997,360782,367,785,2,36000,1.46751592357
359649,360006,360713,357,707,2,36000,1.50495049505
359668,360013,360721,345,708,2,36000,1.48728813559
359669,360036,360749,367,713,2,36000,1.51472650771
359671,360072,360703,401,631,2,36000,1.63549920761
359691,360085,360916,394,831,2,36000,1.47412755716
359712,360092,360974,380,882,2,36000,1.43083900227
359713,360097,360774,384,677,2,36000,1.56720827179
359715,360156,360863,441,707,2,36000,1.62376237624
359732,360176,360809,444,633,2,36000,1.70142180095
359761,360238,360999,477,761,2,36000,1.62680683311
359835,360262,360958,427,696,2,36000,1.61350574713
359861,360290,360880,429,590,2,36000,1.72711864407
359883,360307,361015,424,708,2,36000,1.5988700565
359885,360317,361210,432,893,2,36000,1.48376259798
359886,360332,361106,446,774,2,36000,1.57622739018
359903,360345,361077,442,732,2,36000,1.60382513661
359924,360353,361146,429,793,2,36000,1.54098360656
359940,360367,361136,427,769,2,36000,1.55526657997
359957,360379,361020,422,641,2,36000,1.65834633385
359965,359971,360818,6,847,1,3600,1.00708382527
359986,360385,361043,399,658,2,36000,1.60638297872
360003,360415,361125,412,710,2,36000,1.58028169014
360005,360421,361164,416,743,2,36000,1.5598923284
360027,360433,361126,406,693,2,36000,1.58585858586
360065,360440,361174,375,734,2,36000,1.51089918256
360089,360451,361077,362,626,2,36000,1.57827476038
360090,360461,361237,371,776,2,36000,1.47809278351
360091,360510,361287,419,777,2,36000,1.53925353925
360146,360521,361325,375,804,2,36000,1.46641791045
360166,360542,361263,376,721,2,36000,1.52149791956
360231,360549,361278,318,729,2,36000,1.43621399177
360253,360557,361328,304,771,2,36000,1.39429312581
360281,360564,361271,283,707,2,36000,1.40028288543
360297,360597,361356,300,759,2,36000,1.395256917
360315,360607,361392,292,785,2,36000,1.37197452229
360337,360614,361347,277,733,2,36000,1.37789904502
360339,360633,361419,294,786,2,36000,1.37404580153
360362,360688,361416,326,728,2,36000,1.4478021978
360364,360703,361357,339,654,2,36000,1.51834862385
360382,360712,361506,330,794,2,36000,1.41561712846
360383,360718,361481,335,763,2,36000,1.43905635649
360406,360725,361425,319,700,2,36000,1.45571428571
360407,360733,361429,326,696,2,36000,1.4683908046
360425,360760,361467,335,707,2,36000,1.4738330976
360426,360786,361401,360,615,2,36000,1.58536585366
360443,360794,361519,351,725,2,36000,1.48413793103
360460,360821,361409,361,588,2,36000,1.61394557823
360505,360875,361521,370,646,2,36000,1.57275541796
360523,360891,361660,368,769,2,36000,1.47854356307
360540,360929,361883,389,954,2,36000,1.40775681342
360541,360969,361642,428,673,2,36000,1.63595839525
360558,360985,361749,427,764,2,36000,1.55890052356
360559,361011,361742,452,731,2,36000,1.61833105335
360589,361026,361771,437,745,2,36000,1.58657718121
360605,361033,361712,428,679,2,36000,1.63033873343
360606,361054,361863,448,809,2,36000,1.55377008653
360623,361088,361825,465,737,2,36000,1.63093622795
360684,361116,361778,432,662,2,36000,1.65256797583
360703,361122,361865,419,743,2,36000,1.56393001346
360704,361137,361936,433,799,2,36000,1.54192740926
360705,361142,361922,437,780,2,36000,1.56025641026
360722,361148,361970,426,822,2,36000,1.51824817518
360724,361157,361828,433,671,2,36000,1.64530551416
360752,361176,361895,424,719,2,36000,1.58970792768
360778,361186,361969,408,783,2,36000,1.52107279693
360799,361222,362437,423,1215,2,36000,1.34814814815
360816,361249,362011,433,762,2,36000,1.56824146982
360863,361275,362021,412,746,2,36000,1.55227882038
360883,361283,362003,400,720,2,36000,1.55555555556
360920,361289,361894,369,605,2,36000,1.60991735537
360961,361299,361962,338,663,2,36000,1.50980392157
360978,361338,362023,360,685,2,36000,1.52554744526
361001,361345,362032,344,687,2,36000,1.50072780204
361018,361358,362038,340,680,2,36000,1.5
361035,361368,362086,333,718,2,36000,1.46378830084
361051,361374,362103,323,729,2,36000,1.44307270233
361080,361404,362093,324,689,2,36000,1.4702467344
361082,361412,362234,330,822,2,36000,1.40145985401
361110,361427,362162,317,735,2,36000,1.43129251701
361132,361433,362186,301,753,2,36000,1.39973439575
361133,361439,362119,306,680,2,36000,1.45
361152,361445,362202,293,757,2,36000,1.38705416116
361153,361452,362150,299,698,2,36000,1.42836676218
361170,361479,362247,309,768,2,36000,1.40234375
361187,361492,362204,305,712,2,36000,1.42837078652
361212,361517,362268,305,751,2,36000,1.40612516644
361245,361530,362219,285,689,2,36000,1.41364296081
361267,361537,362248,270,711,2,36000,1.37974683544
361284,361654,362252,370,598,2,36000,1.61872909699
361285,361671,362297,386,626,2,36000,1.61661341853
361302,361725,362482,423,757,2,36000,1.55878467635
361335,361754,362522,419,768,2,36000,1.54557291667
361336,361760,362368,424,608,2,36000,1.69736842105
361355,361783,362551,428,768,2,36000,1.55729166667
361371,361789,362503,418,714,2,36000,1.58543417367
361373,361836,362521,463,685,2,36000,1.67591240876
361395,361842,363146,447,1304,2,36000,1.34279141104
361413,361876,362567,463,691,2,36000,1.67004341534
361414,361882,362533,468,651,2,36000,1.71889400922
361432,361895,362619,463,724,2,36000,1.63950276243
361433,361907,362635,474,728,2,36000,1.6510989011
361435,361912,362665,477,753,2,36000,1.63346613546
361436,361933,362602,497,669,2,36000,1.74289985052
361468,361948,362647,480,699,2,36000,1.68669527897
361484,361973,362758,489,785,2,36000,1.62292993631
361507,361981,362724,474,743,2,36000,1.63795423957
361527,361986,362767,459,781,2,36000,1.58770806658
361528,362015,362773,487,758,2,36000,1.64248021108
361644,362023,362784,379,761,2,36000,1.49802890933
361664,362032,362707,368,675,2,36000,1.54518518519
361715,362039,362959,324,920,2,36000,1.35217391304
361725,361732,361848,7,116,1,3600,1.06034482759
361748,362045,362802,297,757,2,36000,1.39233817701
361749,362051,362833,302,782,2,36000,1.38618925831
361774,362098,362865,324,767,2,36000,1.42242503259
361790,362104,362811,314,707,2,36000,1.4441301273
361827,362117,362815,290,698,2,36000,1.41547277937
361846,362131,362916,285,785,2,36000,1.36305732484
361873,362162,362800,289,638,2,36000,1.45297805643
361874,362173,362904,299,731,2,36000,1.40902872777
361896,362199,362864,303,665,2,36000,1.45563909774
361898,362213,363259,315,1046,2,36000,1.30114722753
361899,362220,362903,321,683,2,36000,1.46998535871
361925,362230,362942,305,712,2,36000,1.42837078652
361945,362246,362948,301,702,2,36000,1.42877492877
361967,362258,363001,291,743,2,36000,1.39165545087
361984,362266,363112,282,846,2,36000,1.33333333333
361985,362271,363061,286,790,2,36000,1.36202531646
362005,362279,363137,274,858,2,36000,1.31934731935
362022,362309,362918,287,609,2,36000,1.47126436782
362023,362379,363120,356,741,2,36000,1.48043184885
362042,362449,363127,407,678,2,36000,1.60029498525
362043,362494,363129,451,635,2,36000,1.71023622047
362044,362514,363179,470,665,2,36000,1.70676691729
362056,362062,362382,6,320,1,3600,1.01875
362089,362532,363323,443,791,2,36000,1.5600505689
362101,362111,362221,10,110,1,3600,1.09090909091
362106,362538,363218,432,680,2,36000,1.63529411765
362107,362546,363558,439,1012,2,36000,1.4337944664
362126,362562,363196,436,634,2,36000,1.68769716088
362154,362579,363282,425,703,2,36000,1.60455192034
362173,362614,363324,441,710,2,36000,1.62112676056
362189,362632,363429,443,797,2,36000,1.55583437892
362207,362648,363387,441,739,2,36000,1.59675236806
362208,362659,363322,451,663,2,36000,1.6802413273
362224,362676,363352,452,676,2,36000,1.66863905325
362229,362238,362358,9,120,1,1800,1.075
362242,362718,363477,476,759,2,36000,1.62714097497
362261,362735,363750,474,1015,2,36000,1.46699507389
362262,362769,363496,507,727,2,36000,1.69738651994
362264,362779,363444,515,665,2,36000,1.77443609023
362284,362785,363451,501,666,2,36000,1.75225225225
362301,362796,363452,495,656,2,36000,1.75457317073
362371,362811,363593,440,782,2,36000,1.56265984655
362411,362417,362747,6,330,1,3600,1.01818181818
362438,362817,363457,379,640,2,36000,1.5921875
362486,362824,363628,338,804,2,36000,1.42039800995
362506,362830,363447,324,617,2,36000,1.52512155592
362529,362847,363563,318,716,2,36000,1.44413407821
362530,362876,363595,346,719,2,36000,1.48122392211
362552,362881,363579,329,698,2,36000,1.47134670487
362553,362915,363730,362,815,2,36000,1.44417177914
362570,362921,363681,351,760,2,36000,1.46184210526
362604,362928,363518,324,590,2,36000,1.54915254237
362620,362935,363611,315,676,2,36000,1.46597633136
362636,362953,363658,317,705,2,36000,1.44964539007
362653,362959,363710,306,751,2,36000,1.40745672437
362660,362666,362768,6,102,1,1800,1.05882352941
362670,362972,363686,302,714,2,36000,1.42296918768
362709,363012,363728,303,716,2,36000,1.42318435754
362727,363072,363749,345,677,2,36000,1.50960118168
362764,363123,363891,359,768,2,36000,1.46744791667
362784,363131,363854,347,723,2,36000,1.47994467497
362785,363138,363799,353,661,2,36000,1.53403933434
362786,363146,363772,360,626,2,36000,1.5750798722
362805,363152,363904,347,752,2,36000,1.46143617021
362806,363158,363871,352,713,2,36000,1.49368863955
362823,363190,364012,367,822,2,36000,1.44647201946
362825,363208,363932,383,724,2,36000,1.52900552486
362835,362841,363459,6,618,1,3600,1.00970873786
362840,363230,363948,390,718,2,36000,1.54317548747
362870,363271,363986,401,715,2,36000,1.56083916084
362871,363295,363966,424,671,2,36000,1.63189269747
362914,363333,364143,419,810,2,36000,1.51728395062
362916,363340,364037,424,697,2,36000,1.60832137733
362932,363346,364077,414,731,2,36000,1.56634746922
362934,363365,364068,431,703,2,36000,1.61308677098
362951,363415,364182,464,767,2,36000,1.60495436767
362952,363441,364122,489,681,2,36000,1.71806167401
362969,363456,364228,487,772,2,36000,1.63082901554
363005,363462,364169,457,707,2,36000,1.64639321075
363068,363467,364187,399,720,2,36000,1.55416666667
363117,363479,364137,362,658,2,36000,1.55015197568
363136,363484,364198,348,714,2,36000,1.48739495798
363137,363490,364245,353,755,2,36000,1.46754966887
363138,363508,364277,370,769,2,36000,1.4811443433
363140,363530,364210,390,680,2,36000,1.57352941176
363158,363569,364336,411,767,2,36000,1.53585397653
363183,363576,364404,393,828,2,36000,1.47463768116
363193,364403,364997,1210,594,1,3600,3.03703703704
363204,363590,364433,386,843,2,36000,1.45788849348
363225,363605,364245,380,640,2,36000,1.59375
363261,363612,364353,351,741,2,36000,1.47368421053
363285,363623,364285,338,662,2,36000,1.51057401813
363326,363640,364402,314,762,2,36000,1.41207349081
363328,363670,364364,342,694,2,36000,1.49279538905
363329,363726,364527,397,801,2,36000,1.49563046192
363354,363731,364390,377,659,2,36000,1.57207890744
363389,363736,364369,347,633,2,36000,1.54818325434
363447,363741,364396,294,655,2,36000,1.44885496183
363448,363747,364451,299,704,2,36000,1.42471590909
363451,364408,364986,957,578,1,1800,2.65570934256
363477,363752,364435,275,683,2,36000,1.40263543192
363478,363757,364507,279,750,2,36000,1.372
363480,363762,364473,282,711,2,36000,1.39662447257
363481,363767,364541,286,774,2,36000,1.36950904393
363482,363773,364475,291,702,2,36000,1.41452991453
363499,363778,364449,279,671,2,36000,1.41579731744
363520,363785,364526,265,741,2,36000,1.35762483131
363563,363790,364551,227,761,2,36000,1.29829172142
363565,363795,364612,230,817,2,36000,1.28151774786
363586,363800,364512,214,712,2,36000,1.30056179775
363609,363806,364519,197,713,2,36000,1.2762973352
363610,363811,364573,201,762,2,36000,1.26377952756
363628,363816,364557,188,741,2,36000,1.25371120108
363630,363821,364560,191,739,2,36000,1.25845737483
363663,363842,364597,179,755,2,36000,1.23708609272
363683,363826,364547,143,721,2,36000,1.19833564494
363700,363831,364549,131,718,2,36000,1.18245125348
363722,363837,364514,115,677,2,36000,1.16986706056
363747,363847,364531,100,684,2,36000,1.14619883041
363748,363852,364583,104,731,2,36000,1.14227086183
363771,363857,364599,86,742,2,36000,1.11590296496
363773,363863,365133,90,1270,2,36000,1.07086614173
363791,363869,364671,78,802,2,36000,1.09725685786
363814,363874,364528,60,654,2,36000,1.09174311927
363859,363879,364555,20,676,2,36000,1.02958579882
363877,363886,364562,9,676,2,36000,1.01331360947
363894,363900,364571,6,671,2,36000,1.00894187779
363911,363917,364656,6,739,2,36000,1.00811907984
363934,363940,364689,6,749,2,36000,1.00801068091
363955,363961,364709,6,748,2,36000,1.00802139037
363976,363982,364767,6,785,2,36000,1.0076433121
364000,364006,364704,6,698,2,36000,1.00859598854
364016,364022,364654,6,632,2,36000,1.00949367089
364041,364047,364686,6,639,2,36000,1.00938967136
364070,364076,364818,6,742,2,36000,1.00808625337
364087,364093,364800,6,707,2,36000,1.00848656294
364124,364130,364804,6,674,2,36000,1.00890207715
364141,364148,364836,7,688,2,36000,1.0101744186
364159,364165,364857,6,692,2,36000,1.00867052023
364178,364184,364908,6,724,2,36000,1.00828729282
364194,364200,364867,6,667,2,36000,1.00899550225
364195,364206,365012,11,806,2,36000,1.01364764268
364214,364220,364980,6,760,2,36000,1.00789473684
364215,364227,364947,12,720,2,36000,1.01666666667
364232,364238,365084,6,846,2,36000,1.00709219858
364248,364254,364879,6,625,2,36000,1.0096
364249,364260,364938,11,678,2,36000,1.01622418879
364278,364284,364913,6,629,2,36000,1.00953895072
364294,364300,364992,6,692,2,36000,1.00867052023
364337,364344,365238,7,894,2,36000,1.00782997763
364356,364363,365081,7,718,2,36000,1.00974930362
364373,364379,365130,6,751,2,36000,1.00798934754
364374,364385,365163,11,778,2,36000,1.01413881748
364391,364397,365006,6,609,2,36000,1.00985221675
364408,364414,365088,6,674,2,36000,1.00890207715
364409,364420,365138,11,718,2,36000,1.01532033426
364410,364425,365129,15,704,2,36000,1.02130681818
364433,364439,365237,6,798,2,36000,1.00751879699
364453,364459,365170,6,711,2,36000,1.00843881857
364455,364465,365309,10,844,2,36000,1.01184834123
364456,364470,365155,14,685,2,36000,1.0204379562
364478,364484,365169,6,685,2,36000,1.00875912409
364479,364490,365166,11,676,2,36000,1.01627218935
364511,364517,365299,6,782,2,36000,1.00767263427
364513,364523,365231,10,708,2,36000,1.01412429379
364542,364548,365242,6,694,2,36000,1.00864553314
364543,364554,365163,11,609,2,36000,1.01806239737
364544,364559,365220,15,661,2,36000,1.02269288956
364546,364564,365333,18,769,2,36000,1.02340702211
364548,364570,365221,22,651,2,36000,1.03379416283
364549,364576,365241,27,665,2,36000,1.04060150376
364550,364582,365311,32,729,2,36000,1.0438957476
364572,364588,365247,16,659,2,36000,1.02427921093
364573,364593,365526,20,933,2,36000,1.02143622722
364575,364598,365332,23,734,2,36000,1.03133514986
364576,364604,365352,28,748,2,36000,1.03743315508
364577,364609,365406,32,797,2,36000,1.04015056462
364579,364614,365490,35,876,2,36000,1.0399543379
364580,364619,365317,39,698,2,36000,1.0558739255
364581,364624,365431,43,807,2,36000,1.05328376704
364583,364631,365372,48,741,2,36000,1.06477732794
364602,364636,365355,34,719,2,36000,1.04728789986
364603,364642,365304,39,662,2,36000,1.05891238671
364605,364647,365270,42,623,2,36000,1.06741573034
364622,364652,365402,30,750,2,36000,1.04
364666,364673,365413,7,740,2,36000,1.00945945946
364668,364679,365301,11,622,2,36000,1.01768488746
364688,364694,365330,6,636,2,36000,1.00943396226
364690,364700,365421,10,721,2,36000,1.01386962552
364711,364717,365428,6,711,2,36000,1.00843881857
364712,364723,365420,11,697,2,36000,1.01578192253
364714,364728,365393,14,665,2,36000,1.02105263158
364769,364775,365563,6,788,2,36000,1.0076142132
364801,364807,365539,6,732,2,36000,1.00819672131
364803,364813,365685,10,872,2,36000,1.01146788991
364820,364826,365469,6,643,2,36000,1.00933125972
364842,364848,365465,6,617,2,36000,1.00972447326
364858,364864,365608,6,744,2,36000,1.00806451613
364874,364880,365608,6,728,2,36000,1.00824175824
364890,364896,365547,6,651,2,36000,1.00921658986
364909,364915,365590,6,675,2,36000,1.00888888889
364924,364931,365726,7,795,2,36000,1.00880503145
364940,364947,365656,7,709,2,36000,1.00987306065
364956,364962,365622,6,660,2,36000,1.00909090909
364981,364988,365645,7,657,2,36000,1.01065449011
364997,365007,365700,10,693,2,36000,1.01443001443
365014,365020,365753,6,733,2,36000,1.00818553888
365015,365026,365752,11,726,2,36000,1.01515151515
365083,365090,365803,7,713,2,36000,1.00981767181
365085,365096,365994,11,898,2,36000,1.01224944321
365101,365107,365864,6,757,2,36000,1.00792602378
365130,365136,365912,6,776,2,36000,1.00773195876
365146,365152,365821,6,669,2,36000,1.00896860987
365147,365158,365837,11,679,2,36000,1.01620029455
365148,365163,365779,15,616,2,36000,1.02435064935
365165,365172,365913,7,741,2,36000,1.00944669366
365167,365177,365886,10,709,2,36000,1.01410437236
365168,365183,365847,15,664,2,36000,1.02259036145
365169,365189,365953,20,764,2,36000,1.02617801047
365187,365194,365854,7,660,2,36000,1.01060606061
365189,365200,365925,11,725,2,36000,1.01517241379
365228,365234,365989,6,755,2,36000,1.00794701987
365230,365240,365892,10,652,2,36000,1.01533742331
365255,365261,365976,6,715,2,36000,1.00839160839
365257,365267,365949,10,682,2,36000,1.0146627566
365258,365272,365933,14,661,2,36000,1.02118003026
365259,365277,366011,18,734,2,36000,1.02452316076
365260,365283,365992,23,709,2,36000,1.03244005642
365262,365289,366668,27,1379,2,36000,1.01957940537
365282,365294,365987,12,693,2,36000,1.01731601732
365306,365312,365928,6,616,2,36000,1.00974025974
365307,365318,366083,11,765,2,36000,1.01437908497
365309,365323,366038,14,715,2,36000,1.01958041958
365330,365336,366063,6,727,2,36000,1.00825309491
365331,365342,366096,11,754,2,36000,1.01458885942
365333,365347,366114,14,767,2,36000,1.01825293351
365334,365352,366093,18,741,2,36000,1.02429149798
365352,365358,365993,6,635,2,36000,1.0094488189
365353,365364,366079,11,715,2,36000,1.01538461538
365355,365369,366131,14,762,2,36000,1.01837270341
365378,365384,366089,6,705,2,36000,1.0085106383
365379,365390,366068,11,678,2,36000,1.01622418879
365396,365402,366171,6,769,2,36000,1.0078023407
365414,365420,366165,6,745,2,36000,1.00805369128
365415,365426,366206,11,780,2,36000,1.0141025641
365417,365431,366155,14,724,2,36000,1.01933701657
365433,365439,366163,6,724,2,36000,1.00828729282
365435,365445,366082,10,637,2,36000,1.01569858713
365436,365450,366241,14,791,2,36000,1.01769911504
365437,365455,366203,18,748,2,36000,1.02406417112
365468,365474,366124,6,650,2,36000,1.00923076923
365484,365490,366141,6,651,2,36000,1.00921658986
365500,365507,366350,7,843,2,36000,1.00830367734
365529,365535,366194,6,659,2,36000,1.0091047041
365545,365551,366249,6,698,2,36000,1.00859598854
365564,365570,366334,6,764,2,36000,1.00785340314
365565,365576,366355,11,779,2,36000,1.01412066752
365591,365597,366267,6,670,2,36000,1.00895522388
365611,365618,366803,7,1185,2,36000,1.005907173
365613,365624,366422,11,798,2,36000,1.01378446115
365629,365635,366336,6,701,2,36000,1.00855920114
365648,365654,366342,6,688,2,36000,1.00872093023
365663,365670,366481,7,811,2,36000,1.00863131936
365689,365695,366357,6,662,2,36000,1.00906344411
365705,365711,366451,6,740,2,36000,1.00810810811
365728,365734,366496,6,762,2,36000,1.00787401575
365754,365760,366483,6,723,2,36000,1.00829875519
365755,365766,366465,11,699,2,36000,1.01573676681
365780,365786,366535,6,749,2,36000,1.00801068091
365807,365813,366467,6,654,2,36000,1.00917431193
365823,365829,366660,6,831,2,36000,1.00722021661
365839,365846,366572,7,726,2,36000,1.00964187328
365859,365865,365989,6,124,1,1800,1.04838709677
365861,365871,366645,10,774,2,36000,1.01291989664
365863,365876,366578,13,702,2,36000,1.01851851852
365884,365890,366630,6,740,2,36000,1.00810810811
365900,365906,366634,6,728,2,36000,1.00824175824
365902,365912,366608,10,696,2,36000,1.01436781609
365926,365932,366566,6,634,2,36000,1.0094637224
365927,365938,366532,11,594,2,36000,1.01851851852
365929,365943,366711,14,768,2,36000,1.01822916667
365930,365949,366776,19,827,2,36000,1.02297460701
365950,365956,366672,6,716,2,36000,1.00837988827
365951,365962,366667,11,705,2,36000,1.01560283688
365968,365974,366689,6,715,2,36000,1.00839160839
365985,365991,366647,6,656,2,36000,1.00914634146
366003,366009,366684,6,675,2,36000,1.00888888889
366004,366015,366784,11,769,2,36000,1.01430429129
366005,366020,366739,15,719,2,36000,1.02086230876
366007,366025,366643,18,618,2,36000,1.02912621359
366008,366030,366689,22,659,2,36000,1.03338391502
366025,366037,366781,12,744,2,36000,1.01612903226
366041,366047,366770,6,723,2,36000,1.00829875519
366068,366074,366791,6,717,2,36000,1.00836820084
366085,366091,366756,6,665,2,36000,1.00902255639
366086,366097,366740,11,643,2,36000,1.01710730949
366088,366102,366779,14,677,2,36000,1.02067946824
366089,366107,366830,18,723,2,36000,1.02489626556
366107,366114,366777,7,663,2,36000,1.01055806938
366108,366119,366766,11,647,2,36000,1.0170015456
366109,366125,366928,16,803,2,36000,1.0199252802
366127,366133,367022,6,889,2,36000,1.00674915636
366128,366139,366864,11,725,2,36000,1.01517241379
366145,366151,366866,6,715,2,36000,1.00839160839
366146,366157,366824,11,667,2,36000,1.01649175412
366165,366171,366888,6,717,2,36000,1.00836820084
366167,366177,367016,10,839,2,36000,1.01191895113
366168,366182,366836,14,654,2,36000,1.02140672783
366185,366191,366823,6,632,2,36000,1.00949367089
366202,366208,366925,6,717,2,36000,1.00836820084
366204,366214,366967,10,753,2,36000,1.01328021248
366222,366228,367084,6,856,2,36000,1.00700934579
366247,366253,367008,6,755,2,36000,1.00794701987
366263,366270,367043,7,773,2,36000,1.00905562743
366279,366286,367076,7,790,2,36000,1.00886075949
366299,366361,366485,62,124,1,1800,1.5
366338,366344,367142,6,798,2,36000,1.00751879699
366339,366350,367138,11,788,2,36000,1.01395939086
366358,366367,367039,9,672,2,36000,1.01339285714
366359,366372,367137,13,765,2,36000,1.01699346405
366361,366378,367080,17,702,2,36000,1.02421652422
366362,366384,367082,22,698,2,36000,1.03151862464
366424,366430,367145,6,715,2,36000,1.00839160839
366454,366460,367151,6,691,2,36000,1.00868306802
366470,366476,367154,6,678,2,36000,1.00884955752
366471,366482,367282,11,800,2,36000,1.01375
366488,366495,367225,7,730,2,36000,1.0095890411
366489,366501,367337,12,836,2,36000,1.01435406699
366506,366512,367272,6,760,2,36000,1.00789473684
366532,366538,367230,6,692,2,36000,1.00867052023
366548,366554,367244,6,690,2,36000,1.00869565217
366552,366588,366638,36,50,1,1800,1.72
366570,366576,367314,6,738,2,36000,1.0081300813
366572,366582,367300,10,718,2,36000,1.0139275766
366588,366594,367351,6,757,2,36000,1.00792602378
366611,366617,367324,6,707,2,36000,1.00848656294
366633,366639,367503,6,864,2,36000,1.00694444444
366634,366645,367422,11,777,2,36000,1.01415701416
366653,366658,367363,5,705,2,36000,1.00709219858
366654,366664,367326,10,662,2,36000,1.01510574018
366655,366669,367371,14,702,2,36000,1.01994301994
366673,366679,367332,6,653,2,36000,1.00918836141
366674,366685,367372,11,687,2,36000,1.01601164483
366676,366691,367461,15,770,2,36000,1.01948051948
366677,366696,367386,19,690,2,36000,1.02753623188
366694,366702,367383,8,681,2,36000,1.01174743025
366696,366707,367349,11,642,2,36000,1.01713395639
366697,366713,367721,16,1008,2,36000,1.01587301587
366713,366719,367763,6,1044,2,36000,1.00574712644
366739,366745,367310,6,565,2,36000,1.01061946903
366755,366761,367480,6,719,2,36000,1.0083449235
366756,366767,367479,11,712,2,36000,1.0154494382
366774,366780,367476,6,696,2,36000,1.00862068966
366776,366786,367563,10,777,2,36000,1.01287001287
366777,366791,367529,14,738,2,36000,1.0189701897
366797,366803,367520,6,717,2,36000,1.00836820084
366798,366809,367507,11,698,2,36000,1.01575931232
366799,366814,367601,15,787,2,36000,1.01905972046
366801,366819,367624,18,805,2,36000,1.02236024845
366802,366824,367554,22,730,2,36000,1.0301369863
366819,366831,367592,12,761,2,36000,1.01576872536
366839,366845,367678,6,833,2,36000,1.00720288115
366840,366851,367635,11,784,2,36000,1.01403061224
366841,366857,367595,16,738,2,36000,1.0216802168
366843,366862,367497,19,635,2,36000,1.02992125984
366868,366874,367755,6,881,2,36000,1.00681044268
366869,366880,367630,11,750,2,36000,1.01466666667
366892,366898,367648,6,750,2,36000,1.008
366928,366934,367611,6,677,2,36000,1.00886262925
366929,366940,367714,11,774,2,36000,1.0142118863
366942,367027,367109,85,82,1,1800,2.03658536585
366968,366974,367745,6,771,2,36000,1.00778210117
367015,367021,367811,6,790,2,36000,1.00759493671
367032,367039,367770,7,731,2,36000,1.00957592339
367034,367045,367736,11,691,2,36000,1.01591895803
367051,367057,367820,6,763,2,36000,1.00786369594
367052,367063,367713,11,650,2,36000,1.01692307692
367079,367085,367761,6,676,2,36000,1.00887573964
367081,367091,367799,10,708,2,36000,1.01412429379
367097,367103,367786,6,683,2,36000,1.00878477306
367098,367109,367894,11,785,2,36000,1.01401273885
367137,367143,367862,6,719,2,36000,1.0083449235
367138,367149,367857,11,708,2,36000,1.01553672316
367156,367162,367825,6,663,2,36000,1.00904977376
367157,367168,367921,11,753,2,36000,1.01460823373
367158,367173,367863,15,690,2,36000,1.02173913043
367160,367178,367862,18,684,2,36000,1.02631578947
367172,367239,367798,67,559,1,1800,1.1198568873
367227,367233,367826,6,593,2,36000,1.01011804384
367243,367249,368000,6,751,2,36000,1.00798934754
367244,367255,368008,11,753,2,36000,1.01460823373
367273,367279,367906,6,627,2,36000,1.00956937799
367289,367295,367941,6,646,2,36000,1.0092879257
367305,367311,367959,6,648,2,36000,1.00925925926
367321,367328,368046,7,718,2,36000,1.00974930362
367323,367334,367998,11,664,2,36000,1.01656626506
367340,367347,368069,7,722,2,36000,1.00969529086
367342,367353,368053,11,700,2,36000,1.01571428571
367343,367358,368059,15,701,2,36000,1.02139800285
367344,367364,368164,20,800,2,36000,1.025
367361,367370,367938,9,568,2,36000,1.01584507042
367362,367375,368119,13,744,2,36000,1.01747311828
367381,367387,368089,6,702,2,36000,1.00854700855
367382,367393,368188,11,795,2,36000,1.01383647799
367383,367398,368239,15,841,2,36000,1.01783590963
367406,367412,368097,6,685,2,36000,1.00875912409
367407,367418,368145,11,727,2,36000,1.015130674
367429,367435,368118,6,683,2,36000,1.00878477306
367462,367468,368300,6,832,2,36000,1.00721153846
367485,367491,368161,6,670,2,36000,1.00895522388
367487,367497,368162,10,665,2,36000,1.01503759398
367488,367502,368178,14,676,2,36000,1.02071005917
367507,367513,368243,6,730,2,36000,1.00821917808
367508,367519,368265,11,746,2,36000,1.01474530831
367525,367530,368291,5,761,2,36000,1.00657030223
367526,367537,368158,11,621,2,36000,1.01771336554
367542,367549,368248,7,699,2,36000,1.01001430615
367559,367565,368215,6,650,2,36000,1.00923076923
367575,367581,368238,6,657,2,36000,1.00913242009
367594,367600,368342,6,742,2,36000,1.00808625337
367595,367606,368383,11,777,2,36000,1.01415701416
367612,367618,368299,6,681,2,36000,1.00881057269
367613,367624,368342,11,718,2,36000,1.01532033426
367630,367635,368271,5,636,2,36000,1.00786163522
367631,367641,368481,10,840,2,36000,1.0119047619
367648,367654,368344,6,690,2,36000,1.00869565217
367650,367660,368198,10,538,2,36000,1.01858736059
367681,367687,368336,6,649,2,36000,1.0092449923
367716,367722,368530,6,808,2,36000,1.00742574257
367718,367728,368505,10,777,2,36000,1.01287001287
367735,367741,368491,6,750,2,36000,1.008
367737,367747,368536,10,789,2,36000,1.01267427123
367755,367761,368429,6,668,2,36000,1.00898203593
367756,367767,368482,11,715,2,36000,1.01538461538
367780,367786,368530,6,744,2,36000,1.00806451613
367781,367792,368514,11,722,2,36000,1.01523545706
367782,367797,368527,15,730,2,36000,1.02054794521
367804,367810,368544,6,734,2,36000,1.00817438692
367806,367816,368588,10,772,2,36000,1.01295336788
367823,367829,368541,6,712,2,36000,1.00842696629
367825,367835,368525,10,690,2,36000,1.01449275362
367842,367848,368729,6,881,2,36000,1.00681044268
367843,367854,368627,11,773,2,36000,1.01423027167
367860,367866,368595,6,729,2,36000,1.00823045267
367876,367883,368548,7,665,2,36000,1.01052631579
367878,367889,368676,11,787,2,36000,1.01397712834
367879,367894,368658,15,764,2,36000,1.01963350785
367903,367909,368727,6,818,2,36000,1.00733496333
367921,367927,368692,6,765,2,36000,1.00784313725
367922,367933,368689,11,756,2,36000,1.01455026455
367940,367946,368662,6,716,2,36000,1.00837988827
367956,367962,368753,6,791,2,36000,1.00758533502
367973,367979,368636,6,657,2,36000,1.00913242009
367999,368005,368726,6,721,2,36000,1.00832177531
368015,368021,368713,6,692,2,36000,1.00867052023
368016,368027,368721,11,694,2,36000,1.01585014409
368048,368054,368791,6,737,2,36000,1.00814111262
368062,368068,368350,6,282,1,1800,1.02127659574
368065,368074,368718,9,644,2,36000,1.01397515528
368066,368079,368770,13,691,2,36000,1.01881331404
368082,368088,368827,6,739,2,36000,1.00811907984
368098,368105,368758,7,653,2,36000,1.01071975498
368100,368111,368833,11,722,2,36000,1.01523545706
368119,368125,368846,6,721,2,36000,1.00832177531
368121,368131,368928,10,797,2,36000,1.01254705144
368148,368154,368901,6,747,2,36000,1.00803212851
368166,368172,368980,6,808,2,36000,1.00742574257
368167,368178,368884,11,706,2,36000,1.01558073654
368168,368183,368871,15,688,2,36000,1.02180232558
368170,368188,368955,18,767,2,36000,1.02346805737
368186,368195,368842,9,647,2,36000,1.01391035549
368203,368209,368885,6,676,2,36000,1.00887573964
368204,368215,368866,11,651,2,36000,1.01689708141
368220,368226,368862,6,636,2,36000,1.00943396226
368240,368246,368974,6,728,2,36000,1.00824175824
368241,368252,369032,11,780,2,36000,1.0141025641
368257,368263,368946,6,683,2,36000,1.00878477306
368258,368269,368955,11,686,2,36000,1.01603498542
368275,368282,368911,7,629,2,36000,1.01112877583
368277,368288,369022,11,734,2,36000,1.01498637602
368293,368299,368976,6,677,2,36000,1.00886262925
368310,368316,369083,6,767,2,36000,1.00782268579
368311,368322,368990,11,668,2,36000,1.01646706587
368340,368346,369162,6,816,2,36000,1.00735294118
368341,368352,369011,11,659,2,36000,1.01669195751
368343,368357,369089,14,732,2,36000,1.01912568306
368360,368366,369068,6,702,2,36000,1.00854700855
368385,368391,369208,6,817,2,36000,1.00734394125
368429,368436,369127,7,691,2,36000,1.01013024602
368485,368491,369150,6,659,2,36000,1.0091047041
368486,368497,369157,11,660,2,36000,1.01666666667
368505,368511,369126,6,615,2,36000,1.00975609756
368507,368517,369209,10,692,2,36000,1.01445086705
368526,368532,369255,6,723,2,36000,1.00829875519
368528,368538,369270,10,732,2,36000,1.01366120219
368529,368543,369293,14,750,2,36000,1.01866666667
368549,368555,369314,6,759,2,36000,1.00790513834
368550,368561,369332,11,771,2,36000,1.01426718547
368551,368566,369200,15,634,2,36000,1.02365930599
368553,368571,369383,18,812,2,36000,1.02216748768
368554,368577,369295,23,718,2,36000,1.03203342618
368555,368582,369234,27,652,2,36000,1.04141104294
368589,368596,369437,7,841,2,36000,1.00832342449
368608,368614,369307,6,693,2,36000,1.00865800866
368630,368636,369342,6,706,2,36000,1.00849858357
368646,368653,369407,7,754,2,36000,1.00928381963
368663,368669,369379,6,710,2,36000,1.00845070423
368664,368675,369474,11,799,2,36000,1.01376720901
368681,368687,369367,6,680,2,36000,1.00882352941
368698,368703,369438,5,735,2,36000,1.00680272109
368699,368709,369386,10,677,2,36000,1.01477104874
368716,368722,369643,6,921,2,36000,1.00651465798
368732,368738,369507,6,769,2,36000,1.0078023407
368733,368744,369462,11,718,2,36000,1.01532033426
368735,368749,369451,14,702,2,36000,1.01994301994
368736,368755,369512,19,757,2,36000,1.0250990753
368737,368760,369603,23,843,2,36000,1.02728351127
368757,368766,369543,9,777,2,36000,1.01158301158
368773,368779,369420,6,641,2,36000,1.00936037441
368775,368785,369424,10,639,2,36000,1.01564945227
368793,368800,369640,7,840,2,36000,1.00833333333
368831,368837,369587,6,750,2,36000,1.008
368847,368853,369629,6,776,2,36000,1.00773195876
368849,368859,369623,10,764,2,36000,1.01308900524
368850,368864,369529,14,665,2,36000,1.02105263158
368867,368873,369560,6,687,2,36000,1.00873362445
368868,368879,369897,11,1018,2,36000,1.01080550098
368886,368892,370340,6,1448,2,36000,1.00414364641
368887,368898,369673,11,775,2,36000,1.01419354839
368888,368903,369602,15,699,2,36000,1.02145922747
368906,368911,369619,5,708,2,36000,1.00706214689
368921,368927,369691,6,764,2,36000,1.00785340314
368937,368944,369645,7,701,2,36000,1.00998573466
368954,368960,369647,6,687,2,36000,1.00873362445
368955,368966,369695,11,729,2,36000,1.01508916324
368973,368979,369778,6,799,2,36000,1.00750938673
368991,368997,369743,6,746,2,36000,1.00804289544
368993,369003,369612,10,609,2,36000,1.01642036125
368994,369008,369736,14,728,2,36000,1.01923076923
368995,369014,369756,19,742,2,36000,1.025606469
369021,369028,369644,7,616,2,36000,1.01136363636
369039,369045,369673,6,628,2,36000,1.00955414013
369041,369051,369654,10,603,2,36000,1.01658374793
369071,369078,369788,7,710,2,36000,1.00985915493
369092,369098,369791,6,693,2,36000,1.00865800866
369093,369104,369892,11,788,2,36000,1.01395939086
369128,369135,369853,7,718,2,36000,1.00974930362
369130,369140,369758,10,618,2,36000,1.01618122977
369153,369159,369745,6,586,2,36000,1.01023890785
369169,369175,369908,6,733,2,36000,1.00818553888
369170,369181,369847,11,666,2,36000,1.01651651652
369200,369207,369967,7,760,2,36000,1.00921052632
369217,369223,369831,6,608,2,36000,1.00986842105
369218,369229,369879,11,650,2,36000,1.01692307692
369234,369241,370126,7,885,2,36000,1.00790960452
369257,369263,370339,6,1076,2,36000,1.00557620818
369272,369278,370112,6,834,2,36000,1.0071942446
369294,369301,370070,7,769,2,36000,1.00910273082
369296,369307,370018,11,711,2,36000,1.01547116737
369313,369319,370067,6,748,2,36000,1.00802139037
369314,369325,370011,11,686,2,36000,1.01603498542
369334,369340,370080,6,740,2,36000,1.00810810811
369350,369356,370187,6,831,2,36000,1.00722021661
369367,369373,370118,6,745,2,36000,1.00805369128
369388,369394,370121,6,727,2,36000,1.00825309491
369390,369400,370180,10,780,2,36000,1.01282051282
369391,369405,370242,14,837,2,36000,1.01672640382
369411,369417,370151,6,734,2,36000,1.00817438692
369427,369434,370128,7,694,2,36000,1.01008645533
369429,369440,370165,11,725,2,36000,1.01517241379
369447,369453,370172,6,719,2,36000,1.0083449235
369448,369459,370209,11,750,2,36000,1.01466666667
369465,369472,370260,7,788,2,36000,1.00888324873
369467,369478,370257,11,779,2,36000,1.01412066752
369483,369490,370240,7,750,2,36000,1.00933333333
369509,369516,370246,7,730,2,36000,1.0095890411
369530,369536,370227,6,691,2,36000,1.00868306802
369531,369542,370310,11,768,2,36000,1.01432291667
369553,369559,370234,6,675,2,36000,1.00888888889
369570,369576,370246,6,670,2,36000,1.00895522388
369589,369595,370223,6,628,2,36000,1.00955414013
369606,369612,370287,6,675,2,36000,1.00888888889
369607,369618,370343,11,725,2,36000,1.01517241379
369615,369624,369671,9,47,1,1800,1.1914893617
369625,369631,370266,6,635,2,36000,1.0094488189
369626,369637,370341,11,704,2,36000,1.015625
369627,369642,370372,15,730,2,36000,1.02054794521
369645,369651,370362,6,711,2,36000,1.00843881857
369647,369657,370320,10,663,2,36000,1.01508295626
369648,369662,370406,14,744,2,36000,1.0188172043
369649,369667,370426,18,759,2,36000,1.02371541502
369651,369673,370276,22,603,2,36000,1.03648424544
369667,369681,370430,14,749,2,36000,1.01869158879
369668,369687,370451,19,764,2,36000,1.02486910995
369685,369693,370477,8,784,2,36000,1.01020408163
369686,369698,370334,12,636,2,36000,1.01886792453
369703,369709,370469,6,760,2,36000,1.00789473684
369704,369715,370363,11,648,2,36000,1.01697530864
369739,369745,370403,6,658,2,36000,1.00911854103
369755,369761,370416,6,655,2,36000,1.00916030534
369756,369767,370431,11,664,2,36000,1.01656626506
369758,369772,370365,14,593,2,36000,1.02360876897
369775,369781,370470,6,689,2,36000,1.00870827286
369791,369797,370505,6,708,2,36000,1.00847457627
369792,369803,370561,11,758,2,36000,1.01451187335
369794,369808,370553,14,745,2,36000,1.01879194631
369832,369838,370522,6,684,2,36000,1.00877192982
369848,369855,370555,7,700,2,36000,1.01
369864,369870,370694,6,824,2,36000,1.0072815534
369880,369887,370678,7,791,2,36000,1.00884955752
369896,369903,370579,7,676,2,36000,1.01035502959
369898,369909,370598,11,689,2,36000,1.01596516691
369914,369919,370588,5,669,2,36000,1.00747384155
369967,369973,370674,6,701,2,36000,1.00855920114
370007,370026,370115,19,89,1,1800,1.21348314607
370014,370020,370827,6,807,2,36000,1.00743494424
370031,370037,370705,6,668,2,36000,1.00898203593
370072,370078,370859,6,781,2,36000,1.00768245839
370073,370084,370736,11,652,2,36000,1.01687116564
370091,370097,370850,6,753,2,36000,1.00796812749
370114,370120,370934,6,814,2,36000,1.00737100737
370131,370137,370861,6,724,2,36000,1.00828729282
370132,370143,370841,11,698,2,36000,1.01575931232
370134,370148,370843,14,695,2,36000,1.02014388489
370135,370154,370914,19,760,2,36000,1.025
370268,370274,371004,6,730,2,36000,1.00821917808
370269,370280,371058,11,778,2,36000,1.01413881748
370270,370285,371037,15,752,2,36000,1.01994680851
370272,370291,371078,19,787,2,36000,1.02414231258
370273,370296,370947,23,651,2,36000,1.03533026114
370274,370301,370943,27,642,2,36000,1.04205607477
370276,370307,371050,31,743,2,36000,1.04172274563
370277,370312,371175,35,863,2,36000,1.0405561993
370278,370317,371155,39,838,2,36000,1.04653937947
370279,370323,371123,44,800,2,36000,1.055
370281,370328,371109,47,781,2,36000,1.06017925736
370282,370333,370907,51,574,2,36000,1.08885017422
370283,370338,371037,55,699,2,36000,1.07868383405
370285,370343,371013,58,670,2,36000,1.08656716418
370287,370349,371295,62,946,2,36000,1.06553911205
370288,370354,371044,66,690,2,36000,1.09565217391
370309,370361,370969,52,608,2,36000,1.08552631579
370311,370366,371058,55,692,2,36000,1.07947976879
370312,370371,371168,59,797,2,36000,1.07402760351
370328,370376,371153,48,777,2,36000,1.06177606178
370344,370381,371131,37,750,2,36000,1.04933333333
370346,370387,371041,41,654,2,36000,1.0626911315
370347,370392,371144,45,752,2,36000,1.05984042553
370348,370397,371140,49,743,2,36000,1.06594885599
370350,370402,371154,52,752,2,36000,1.06914893617
370366,370408,371051,42,643,2,36000,1.06531881804
370368,370413,371058,45,645,2,36000,1.06976744186
370369,370419,371021,50,602,2,36000,1.08305647841
370385,370424,371058,39,634,2,36000,1.06151419558
370407,370430,371160,23,730,2,36000,1.03150684932
370409,370436,371162,27,726,2,36000,1.03719008264
370425,370441,371128,16,687,2,36000,1.02328966521
370440,370447,371221,7,774,2,36000,1.00904392765
370442,370453,371322,11,869,2,36000,1.01265822785
370443,370459,371188,16,729,2,36000,1.0219478738
370459,370465,371170,6,705,2,36000,1.0085106383
370474,370480,371147,6,667,2,36000,1.00899550225
370476,370486,371521,10,1035,2,36000,1.00966183575
370492,370498,371199,6,701,2,36000,1.00855920114
370507,370513,371259,6,746,2,36000,1.00804289544
370522,370529,371264,7,735,2,36000,1.00952380952
370562,370568,371353,6,785,2,36000,1.0076433121
370563,370574,371296,11,722,2,36000,1.01523545706
370565,370579,371226,14,647,2,36000,1.02163833076
370585,370591,371328,6,737,2,36000,1.00814111262
370601,370607,371359,6,752,2,36000,1.0079787234
370603,370613,371235,10,622,2,36000,1.01607717042
370679,370685,371287,6,602,2,36000,1.00996677741
370681,370691,371377,10,686,2,36000,1.01457725948
370701,370707,371503,6,796,2,36000,1.00753768844
370716,370722,371399,6,677,2,36000,1.00886262925
370738,370744,371479,6,735,2,36000,1.00816326531
370827,370833,371545,6,712,2,36000,1.00842696629
370842,370849,371506,7,657,2,36000,1.01065449011
370844,370854,371573,10,719,2,36000,1.01390820584
370860,370866,371678,6,812,2,36000,1.00738916256
370862,370872,371580,10,708,2,36000,1.01412429379
370877,370883,371597,6,714,2,36000,1.00840336134
370908,370914,371553,6,639,2,36000,1.00938967136
370923,370930,371639,7,709,2,36000,1.00987306065
370943,370949,371664,6,715,2,36000,1.00839160839
370944,370955,371618,11,663,2,36000,1.01659125189
370966,370972,371684,6,712,2,36000,1.00842696629
370982,370988,371832,6,844,2,36000,1.00710900474
371004,371010,371683,6,673,2,36000,1.00891530461
371020,371027,371720,7,693,2,36000,1.0101010101
371036,371043,371764,7,721,2,36000,1.00970873786
371038,371049,371794,11,745,2,36000,1.01476510067
371039,371054,371790,15,736,2,36000,1.02038043478
371059,371065,371766,6,701,2,36000,1.00855920114
371061,371071,371744,10,673,2,36000,1.01485884101
371062,371077,371730,15,653,2,36000,1.02297090352
371063,371082,371868,19,786,2,36000,1.02417302799
371064,371087,371715,23,628,2,36000,1.03662420382
371066,371092,371831,26,739,2,36000,1.0351826793
371067,371098,371803,31,705,2,36000,1.04397163121
371068,371103,371843,35,740,2,36000,1.0472972973
371092,371109,371875,17,766,2,36000,1.02219321149
371112,371119,371763,7,644,2,36000,1.01086956522
371128,371134,371833,6,699,2,36000,1.00858369099
371130,371140,371886,10,746,2,36000,1.01340482574
371146,371152,371916,6,764,2,36000,1.00785340314
371147,371186,371472,39,286,1,1800,1.13636363636
371148,371158,371857,10,699,2,36000,1.01430615165
371149,371163,371855,14,692,2,36000,1.02023121387
371150,371168,371903,18,735,2,36000,1.02448979592
371168,371175,371789,7,614,2,36000,1.01140065147
371169,371180,371994,11,814,2,36000,1.01351351351
371171,371192,371991,21,799,2,36000,1.02628285357
371172,371198,371915,26,717,2,36000,1.03626220363
371173,371203,371927,30,724,2,36000,1.04143646409
371175,371208,371862,33,654,2,36000,1.0504587156
371177,371213,371924,36,711,2,36000,1.05063291139
371193,371219,371927,26,708,2,36000,1.03672316384
371194,371224,371952,30,728,2,36000,1.04120879121
371210,371230,371919,20,689,2,36000,1.0290275762
371227,371236,372032,9,796,2,36000,1.01130653266
371228,371241,371940,13,699,2,36000,1.01859799714
371244,371250,371952,6,702,2,36000,1.00854700855
371259,371265,372023,6,758,2,36000,1.00791556728
371274,371281,372011,7,730,2,36000,1.0095890411
371291,371297,372064,6,767,2,36000,1.00782268579
371307,371313,372025,6,712,2,36000,1.00842696629
371308,371319,372058,11,739,2,36000,1.0148849797
371323,371329,372001,6,672,2,36000,1.00892857143
371338,371344,371976,6,632,2,36000,1.00949367089
371354,371360,372101,6,741,2,36000,1.00809716599
371369,371375,372132,6,757,2,36000,1.00792602378
371384,371391,372062,7,671,2,36000,1.01043219076
371400,371406,372066,6,660,2,36000,1.00909090909
371480,371486,372160,6,674,2,36000,1.00890207715
371505,371511,372271,6,760,2,36000,1.00789473684
371506,371517,372369,11,852,2,36000,1.01291079812
371522,371528,372239,6,711,2,36000,1.00843881857
371547,371554,372297,7,743,2,36000,1.00942126514
371563,371570,372272,7,702,2,36000,1.00997150997
371580,371586,372224,6,638,2,36000,1.00940438871
371581,371592,372270,11,678,2,36000,1.01622418879
371602,371608,372286,6,678,2,36000,1.00884955752
371621,371628,372446,7,818,2,36000,1.00855745721
371640,371646,372453,6,807,2,36000,1.00743494424
371662,371669,372411,7,742,2,36000,1.00943396226
371679,371685,372355,6,670,2,36000,1.00895522388
371697,371703,372529,6,826,2,36000,1.00726392252
371698,371709,372401,11,692,2,36000,1.01589595376
371720,371726,372497,6,771,2,36000,1.00778210117
371721,371732,372483,11,751,2,36000,1.01464713715
371737,371743,372433,6,690,2,36000,1.00869565217
371752,371758,372389,6,631,2,36000,1.00950871632
371769,371775,372487,6,712,2,36000,1.00842696629
371770,371781,372434,11,653,2,36000,1.01684532925
371772,371786,372491,14,705,2,36000,1.01985815603
371792,371798,372537,6,739,2,36000,1.00811907984
371793,371804,372563,11,759,2,36000,1.01449275362
371809,371814,372416,5,602,2,36000,1.00830564784
371810,371820,372411,10,591,2,36000,1.01692047377
371833,371839,372572,6,733,2,36000,1.00818553888
371834,371845,372612,11,767,2,36000,1.01434159061
371836,371850,372670,14,820,2,36000,1.01707317073
371852,371858,372685,6,827,2,36000,1.00725513906
371869,371876,372568,7,692,2,36000,1.01011560694
371871,371882,372646,11,764,2,36000,1.01439790576
371872,371887,372647,15,760,2,36000,1.01973684211
371873,371893,372632,20,739,2,36000,1.02706359946
371890,371899,372672,9,773,2,36000,1.01164294955
371891,371905,372633,14,728,2,36000,1.01923076923
371907,371913,372489,6,576,2,36000,1.01041666667
371923,371929,372659,6,730,2,36000,1.00821917808
371924,371935,372638,11,703,2,36000,1.01564722617
371926,371940,372684,14,744,2,36000,1.0188172043
371943,371949,372593,6,644,2,36000,1.00931677019
371944,371955,372635,11,680,2,36000,1.01617647059
371945,371960,372624,15,664,2,36000,1.02259036145
371946,371965,372694,19,729,2,36000,1.02606310014
371963,371971,372689,8,718,2,36000,1.01114206128
371965,371976,372732,11,756,2,36000,1.01455026455
371980,371986,372745,6,759,2,36000,1.00790513834
371996,372002,372812,6,810,2,36000,1.00740740741
371998,372008,372795,10,787,2,36000,1.0127064803
372013,372019,372714,6,695,2,36000,1.00863309353
372015,372025,372812,10,787,2,36000,1.0127064803
372031,372037,372667,6,630,2,36000,1.00952380952
372033,372043,372764,10,721,2,36000,1.01386962552
372048,372054,372674,6,620,2,36000,1.00967741935
372064,372070,372813,6,743,2,36000,1.00807537012
372066,372076,372878,10,802,2,36000,1.01246882793
372067,372081,372794,14,713,2,36000,1.01963534362
372083,372089,372671,6,582,2,36000,1.01030927835
372102,372108,372832,6,724,2,36000,1.00828729282
372132,372138,372802,6,664,2,36000,1.00903614458
372162,372168,372805,6,637,2,36000,1.00941915228
372227,372233,372931,6,698,2,36000,1.00859598854
372243,372249,373039,6,790,2,36000,1.00759493671
372271,372277,372984,6,707,2,36000,1.00848656294
372272,372283,373046,11,763,2,36000,1.01441677588
372274,372288,372964,14,676,2,36000,1.02071005917
372290,372296,372984,6,688,2,36000,1.00872093023
372305,372312,372991,7,679,2,36000,1.01030927835
372355,372361,373023,6,662,2,36000,1.00906344411
372371,372377,373059,6,682,2,36000,1.00879765396
372390,372396,373245,6,849,2,36000,1.00706713781
372406,372412,373126,6,714,2,36000,1.00840336134
372424,372430,373088,6,658,2,36000,1.00911854103
372425,372436,373197,11,761,2,36000,1.01445466491
372427,372441,373205,14,764,2,36000,1.01832460733
372449,372455,373087,6,632,2,36000,1.00949367089
372450,372461,373184,11,723,2,36000,1.01521438451
372452,372466,373176,14,710,2,36000,1.01971830986
372468,372474,373084,6,610,2,36000,1.00983606557
372484,372490,373261,6,771,2,36000,1.00778210117
372501,372507,373230,6,723,2,36000,1.00829875519
372503,372513,373162,10,649,2,36000,1.01540832049
372504,372518,373224,14,706,2,36000,1.01983002833
372505,372523,373160,18,637,2,36000,1.02825745683
372531,372537,373294,6,757,2,36000,1.00792602378
372548,372554,373245,6,691,2,36000,1.00868306802
372566,372572,373221,6,649,2,36000,1.0092449923
372582,372588,373290,6,702,2,36000,1.00854700855
372583,372594,373330,11,736,2,36000,1.01494565217
372599,372605,373269,6,664,2,36000,1.00903614458
372615,372621,373273,6,652,2,36000,1.00920245399
372631,372637,373331,6,694,2,36000,1.00864553314
372632,372643,373305,11,662,2,36000,1.0166163142
372650,372656,373415,6,759,2,36000,1.00790513834
372651,372662,373408,11,746,2,36000,1.01474530831
372653,372668,373435,15,767,2,36000,1.01955671447
372654,372673,373595,19,922,2,36000,1.02060737527
372655,372678,373492,23,814,2,36000,1.02825552826
372672,372684,373433,12,749,2,36000,1.01602136182
372673,372689,373501,16,812,2,36000,1.0197044335
372674,372695,373497,21,802,2,36000,1.02618453865
372676,372700,373457,24,757,2,36000,1.03170409511
372677,372705,373500,28,795,2,36000,1.03522012579
372695,372711,373421,16,710,2,36000,1.02253521127
372696,372717,373426,21,709,2,36000,1.02961918195
372698,372722,373443,24,721,2,36000,1.03328710125
372699,372727,373441,28,714,2,36000,1.03921568627
372700,372732,373459,32,727,2,36000,1.04401650619
372716,372738,373490,22,752,2,36000,1.02925531915
372735,372744,373407,9,663,2,36000,1.01357466063
372751,372757,373489,6,732,2,36000,1.00819672131
372766,372773,373541,7,768,2,36000,1.00911458333
372795,372801,373491,6,690,2,36000,1.00869565217
372796,372807,373464,11,657,2,36000,1.01674277017
372813,372819,373533,6,714,2,36000,1.00840336134
372814,372825,373570,11,745,2,36000,1.01476510067
372815,372830,373551,15,721,2,36000,1.02080443828
372817,372836,373461,19,625,2,36000,1.0304
372818,372841,373496,23,655,2,36000,1.03511450382
372834,372847,373566,13,719,2,36000,1.01808066759
372878,372885,373640,7,755,2,36000,1.00927152318
372934,372940,373674,6,734,2,36000,1.00817438692
372965,372971,373681,6,710,2,36000,1.00845070423
372985,372991,373721,6,730,2,36000,1.00821917808
372986,372997,373795,11,798,2,36000,1.01378446115
373006,373012,373669,6,657,2,36000,1.00913242009
373023,373029,373823,6,794,2,36000,1.00755667506
373041,373048,373909,7,861,2,36000,1.0081300813
373057,373063,373745,6,682,2,36000,1.00879765396
373073,373079,373946,6,867,2,36000,1.00692041522
373089,373095,373741,6,646,2,36000,1.0092879257
373091,373101,373814,10,713,2,36000,1.01402524544
373092,373106,373907,14,801,2,36000,1.01747815231
373127,373133,373940,6,807,2,36000,1.00743494424
373162,373168,373816,6,648,2,36000,1.00925925926
373163,373174,373882,11,708,2,36000,1.01553672316
373180,373186,373824,6,638,2,36000,1.00940438871
373195,373201,373889,6,688,2,36000,1.00872093023
373211,373216,373900,5,684,2,36000,1.00730994152
373212,373222,373910,10,688,2,36000,1.01453488372
373229,373235,373875,6,640,2,36000,1.009375
373230,373241,373880,11,639,2,36000,1.0172143975
373246,373252,373872,6,620,2,36000,1.00967741935
373247,373258,373961,11,703,2,36000,1.01564722617
373248,373263,374040,15,777,2,36000,1.01930501931
373265,373272,374030,7,758,2,36000,1.0092348285
373281,373287,374073,6,786,2,36000,1.00763358779
373282,373293,374069,11,776,2,36000,1.01417525773
373298,373304,374084,6,780,2,36000,1.00769230769
373299,373310,373986,11,676,2,36000,1.01627218935
373315,373321,374133,6,812,2,36000,1.00738916256
373333,373340,374083,7,743,2,36000,1.00942126514
373335,373345,374088,10,743,2,36000,1.0134589502
373410,373416,374037,6,621,2,36000,1.00966183575
373411,373422,374132,11,710,2,36000,1.01549295775
373428,373435,374160,7,725,2,36000,1.00965517241
373430,373440,374193,10,753,2,36000,1.01328021248
373431,373446,374131,15,685,2,36000,1.02189781022
373448,373454,374323,6,869,2,36000,1.00690448792
373450,373460,374113,10,653,2,36000,1.01531393568
373451,373465,374139,14,674,2,36000,1.02077151335
373452,373470,374157,18,687,2,36000,1.02620087336
373469,373477,374114,8,637,2,36000,1.0125588697
373470,373482,374133,12,651,2,36000,1.01843317972
373471,373488,374092,17,604,2,36000,1.02814569536
373473,373494,374215,21,721,2,36000,1.02912621359
373479,373512,376003,33,2491,8,172800,1.01324769169
373489,373500,374328,11,828,2,36000,1.01328502415
373491,373505,374236,14,731,2,36000,1.01915184679
373509,373518,374401,9,883,2,36000,1.01019252548
373510,373523,374190,13,667,2,36000,1.01949025487
373512,373529,374362,17,833,2,36000,1.02040816327
373513,373535,374224,22,689,2,36000,1.03193033382
373514,373540,374223,26,683,2,36000,1.03806734993
373516,373545,374255,29,710,2,36000,1.04084507042
373535,373551,374243,16,692,2,36000,1.02312138728
373551,373557,374272,6,715,2,36000,1.00839160839
373552,373563,374425,11,862,2,36000,1.01276102088
373568,373574,374303,6,729,2,36000,1.00823045267
373583,373589,374299,6,710,2,36000,1.00845070423
373599,373605,374329,6,724,2,36000,1.00828729282
373642,373648,374342,6,694,2,36000,1.00864553314
373670,373676,374324,6,648,2,36000,1.00925925926
373685,373691,374468,6,777,2,36000,1.00772200772
373687,373697,374481,10,784,2,36000,1.01275510204
373722,373729,374320,7,591,2,36000,1.01184433164
373748,373754,374609,6,855,2,36000,1.00701754386
373749,373760,374426,11,666,2,36000,1.01651651652
373802,373808,374508,6,700,2,36000,1.00857142857
373819,373825,374566,6,741,2,36000,1.00809716599
373821,373831,374455,10,624,2,36000,1.01602564103
373837,373843,374502,6,659,2,36000,1.0091047041
373838,373849,374541,11,692,2,36000,1.01589595376
373874,373880,374592,6,712,2,36000,1.00842696629
373876,373886,374552,10,666,2,36000,1.01501501502
373892,373898,374652,6,754,2,36000,1.00795755968
373894,373904,374633,10,729,2,36000,1.01371742112
373895,373909,374744,14,835,2,36000,1.01676646707
373912,373918,374541,6,623,2,36000,1.00963081862
373913,373924,374591,11,667,2,36000,1.01649175412
373915,373929,374642,14,713,2,36000,1.01963534362
373916,373935,374673,19,738,2,36000,1.02574525745
373941,373947,374621,6,674,2,36000,1.00890207715
373957,373963,374583,6,620,2,36000,1.00967741935
373972,373978,374704,6,726,2,36000,1.00826446281
373988,373994,374807,6,813,2,36000,1.0073800738
374031,374037,374688,6,651,2,36000,1.00921658986
374047,374053,374736,6,683,2,36000,1.00878477306
374048,374059,374779,11,720,2,36000,1.01527777778
374071,374077,374750,6,673,2,36000,1.00891530461
374073,374083,374980,10,897,2,36000,1.01114827202
374101,374107,374906,6,799,2,36000,1.00750938673
374102,374113,374785,11,672,2,36000,1.01636904762
374103,374118,374723,15,605,2,36000,1.02479338843
374105,374123,374845,18,722,2,36000,1.02493074792
374130,374136,374765,6,629,2,36000,1.00953895072
374131,374142,374980,11,838,2,36000,1.01312649165
374148,374154,374904,6,750,2,36000,1.008
374150,374160,374885,10,725,2,36000,1.01379310345
374151,374165,374841,14,676,2,36000,1.02071005917
374152,374171,374858,19,687,2,36000,1.02765647744
374153,374176,375312,23,1136,2,36000,1.02024647887
374170,374182,374925,12,743,2,36000,1.01615074024
374171,374187,374984,16,797,2,36000,1.02007528231
374196,374201,374990,5,789,2,36000,1.00633713561
374197,374208,374895,11,687,2,36000,1.01601164483
374223,374229,375089,6,860,2,36000,1.00697674419
374241,374247,374866,6,619,2,36000,1.00969305331
374242,374253,374913,11,660,2,36000,1.01666666667
374243,374258,374923,15,665,2,36000,1.02255639098
374259,374265,375235,6,970,2,36000,1.00618556701
374260,374271,375045,11,774,2,36000,1.0142118863
374276,374282,374966,6,684,2,36000,1.00877192982
374301,374307,374967,6,660,2,36000,1.00909090909
374317,374323,374926,6,603,2,36000,1.00995024876
374334,374340,375146,6,806,2,36000,1.00744416873
374335,374346,374974,11,628,2,36000,1.01751592357
374337,374351,375044,14,693,2,36000,1.0202020202
374338,374357,375059,19,702,2,36000,1.02706552707
374339,374362,375140,23,778,2,36000,1.02956298201
374355,374368,375100,13,732,2,36000,1.01775956284
374371,374377,375179,6,802,2,36000,1.00748129676
374403,374409,375160,6,751,2,36000,1.00798934754
374428,374434,375144,6,710,2,36000,1.00845070423
374429,374441,375217,12,776,2,36000,1.01546391753
374457,374463,375430,6,967,2,36000,1.00620475698
374472,374479,375301,7,822,2,36000,1.00851581509
374488,374493,375250,5,757,2,36000,1.00660501982
374503,374509,375240,6,731,2,36000,1.00820793434
374519,374525,375244,6,719,2,36000,1.0083449235
374544,374550,375265,6,715,2,36000,1.00839160839
374545,374556,375176,11,620,2,36000,1.01774193548
374561,374567,375341,6,774,2,36000,1.00775193798
374576,374582,375345,6,763,2,36000,1.00786369594
374593,374599,375325,6,726,2,36000,1.00826446281
374594,374605,375280,11,675,2,36000,1.0162962963
374595,374610,375353,15,743,2,36000,1.0201884253
374618,374624,375367,6,743,2,36000,1.00807537012
374637,374643,375425,6,782,2,36000,1.00767263427
374639,374649,375424,10,775,2,36000,1.01290322581
374657,374663,375447,6,784,2,36000,1.00765306122
374658,374669,375369,11,700,2,36000,1.01571428571
374674,374680,375363,6,683,2,36000,1.00878477306
374692,374698,375510,6,812,2,36000,1.00738916256
374713,374719,375479,6,760,2,36000,1.00789473684
374734,374740,376138,6,1398,2,36000,1.00429184549
374751,374757,375470,6,713,2,36000,1.00841514727
374753,374763,375503,10,740,2,36000,1.01351351351
374754,374768,375522,14,754,2,36000,1.01856763926
374770,374776,375639,6,863,2,36000,1.00695249131
374786,374792,375452,6,660,2,36000,1.00909090909
374787,374798,375546,11,748,2,36000,1.01470588235
374809,374815,375555,6,740,2,36000,1.00810810811
374843,374849,375553,6,704,2,36000,1.00852272727
374859,374865,375592,6,727,2,36000,1.00825309491
374860,374871,375643,11,772,2,36000,1.01424870466
374876,374882,375593,6,711,2,36000,1.00843881857
374891,374897,375792,6,895,2,36000,1.00670391061
374907,374914,375731,7,817,2,36000,1.00856793146
374909,374920,375662,11,742,2,36000,1.01482479784
374910,374926,375740,16,814,2,36000,1.01965601966
374926,374932,375667,6,735,2,36000,1.00816326531
374928,374938,375670,10,732,2,36000,1.01366120219
374929,374943,375646,14,703,2,36000,1.01991465149
374930,374949,375529,19,580,2,36000,1.03275862069
374969,374975,375723,6,748,2,36000,1.00802139037
374970,374981,375733,11,752,2,36000,1.01462765957
374987,374993,375767,6,774,2,36000,1.00775193798
374988,374999,375734,11,735,2,36000,1.01496598639
374989,375004,375609,15,605,2,36000,1.02479338843
374991,375009,375722,18,713,2,36000,1.0252454418
375007,375016,375682,9,666,2,36000,1.01351351351
375047,375053,375752,6,699,2,36000,1.00858369099
375049,375059,375758,10,699,2,36000,1.01430615165
375064,375070,375965,6,895,2,36000,1.00670391061
375092,375098,375780,6,682,2,36000,1.00879765396
375108,375114,375847,6,733,2,36000,1.00818553888
375141,375147,375801,6,654,2,36000,1.00917431193
375161,375167,375816,6,649,2,36000,1.0092449923
375162,375173,375912,11,739,2,36000,1.0148849797
375164,375178,375918,14,740,2,36000,1.01891891892
375183,375189,375883,6,694,2,36000,1.00864553314
375185,375195,375920,10,725,2,36000,1.01379310345
375216,375223,375983,7,760,2,36000,1.00921052632
375236,375242,376047,6,805,2,36000,1.00745341615
375252,375258,375817,6,559,2,36000,1.01073345259
375253,375264,375951,11,687,2,36000,1.01601164483
375255,375269,376050,14,781,2,36000,1.01792573624
375271,375276,376021,5,745,2,36000,1.0067114094
375288,375294,375957,6,663,2,36000,1.00904977376
375307,375313,376080,6,767,2,36000,1.00782268579
375323,375329,375978,6,649,2,36000,1.0092449923
375339,375345,376046,6,701,2,36000,1.00855920114
375355,375361,376042,6,681,2,36000,1.00881057269
375357,375367,376044,10,677,2,36000,1.01477104874
375358,375372,376155,14,783,2,36000,1.01787994891
375376,375382,376090,6,708,2,36000,1.00847457627
375377,375388,376073,11,685,2,36000,1.01605839416
375379,375393,376150,14,757,2,36000,1.01849405548
375423,375429,376151,6,722,2,36000,1.00831024931
375438,375444,376194,6,750,2,36000,1.008
375440,375450,376139,10,689,2,36000,1.0145137881
375455,375461,376180,6,719,2,36000,1.0083449235
375457,375467,376063,10,596,2,36000,1.01677852349
375473,375479,376232,6,753,2,36000,1.00796812749
375489,375495,376231,6,736,2,36000,1.00815217391
375504,375510,376485,6,975,2,36000,1.00615384615
375520,375526,376237,6,711,2,36000,1.00843881857
375538,375544,376215,6,671,2,36000,1.00894187779
375539,375550,376188,11,638,2,36000,1.01724137931
375563,375569,376335,6,766,2,36000,1.00783289817
375564,375575,376186,11,611,2,36000,1.01800327332
375565,375580,376350,15,770,2,36000,1.01948051948
375595,375601,376369,6,768,2,36000,1.0078125
375596,375607,376227,11,620,2,36000,1.01774193548
375612,375619,376250,7,631,2,36000,1.01109350238
375642,375648,376311,6,663,2,36000,1.00904977376
375662,375668,376314,6,646,2,36000,1.0092879257
375663,375674,376423,11,749,2,36000,1.01468624833
375665,375679,376391,14,712,2,36000,1.01966292135
375689,375695,376403,6,708,2,36000,1.00847457627
375690,375701,376440,11,739,2,36000,1.0148849797
375692,375706,376398,14,692,2,36000,1.02023121387
375725,375730,376380,5,650,2,36000,1.00769230769
375725,376251,404098,526,27847,9,72000,1.01888892879
375726,375736,376399,10,663,2,36000,1.01508295626
375743,375749,376386,6,637,2,36000,1.00941915228
375744,375755,376552,11,797,2,36000,1.01380175659
375746,375760,376520,14,760,2,36000,1.01842105263
375747,375766,376541,19,775,2,36000,1.02451612903
375764,375772,376515,8,743,2,36000,1.01076716016
375765,375777,376451,12,674,2,36000,1.0178041543
375781,375788,376497,7,709,2,36000,1.00987306065
375783,375794,376509,11,715,2,36000,1.01538461538
375799,375804,376598,5,794,2,36000,1.00629722922
375814,375820,376522,6,702,2,36000,1.00854700855
375830,375836,376513,6,677,2,36000,1.00886262925
375831,375842,376583,11,741,2,36000,1.01484480432
375850,375856,376692,6,836,2,36000,1.00717703349
375883,375890,376645,7,755,2,36000,1.00927152318
375914,375921,376678,7,757,2,36000,1.00924702774
375930,375936,376668,6,732,2,36000,1.00819672131
375932,375942,376765,10,823,2,36000,1.01215066829
375954,375960,376641,6,681,2,36000,1.00881057269
375970,375976,376664,6,688,2,36000,1.00872093023
375971,375982,376620,11,638,2,36000,1.01724137931
375987,375993,376612,6,619,2,36000,1.00969305331
375988,375999,376649,11,650,2,36000,1.01692307692
376014,376818,431538,804,54720,8,172800,1.01469298246
376022,376028,376702,6,674,2,36000,1.00890207715
376045,376051,376704,6,653,2,36000,1.00918836141
376046,376057,376804,11,747,2,36000,1.01472556894
376062,376068,376773,6,705,2,36000,1.0085106383
376064,376075,376698,11,623,2,36000,1.0176565008
376065,376080,376803,15,723,2,36000,1.02074688797
376066,376085,376726,19,641,2,36000,1.02964118565
376082,376091,376807,9,716,2,36000,1.0125698324
376084,376097,376768,13,671,2,36000,1.01937406855
376099,376106,376807,7,701,2,36000,1.00998573466
376138,376144,376736,6,592,2,36000,1.01013513514
376139,376150,376807,11,657,2,36000,1.01674277017
376163,376169,376807,6,638,2,36000,1.00940438871
376164,376175,376807,11,632,2,36000,1.01740506329
376166,376180,376790,14,610,2,36000,1.02295081967
376185,376191,376807,6,616,2,36000,1.00974025974
376187,376198,376807,11,609,2,36000,1.01806239737
376205,376211,376807,6,596,2,36000,1.01006711409
376207,376217,376807,10,590,2,36000,1.01694915254
376223,376229,376807,6,578,2,36000,1.01038062284
376239,376245,376807,6,562,2,36000,1.01067615658
376241,376256,376807,15,551,2,36000,1.02722323049
376242,376262,376807,20,545,2,36000,1.03669724771
376243,376267,376807,24,540,2,36000,1.04444444444
376261,376273,376807,12,534,2,36000,1.02247191011
376315,376321,376807,6,486,2,36000,1.01234567901
376317,376327,376807,10,480,2,36000,1.02083333333
376341,376347,376807,6,460,2,36000,1.01304347826
376358,376364,376807,6,443,2,36000,1.01354401806
376375,376382,376807,7,425,2,36000,1.01647058824
376391,376398,376807,7,409,2,36000,1.01711491443
376393,376404,376807,11,403,2,36000,1.02729528536
376394,376409,376807,15,398,2,36000,1.03768844221
376412,376418,376807,6,389,2,36000,1.01542416452
376413,376424,376807,11,383,2,36000,1.02872062663
376414,376429,376807,15,378,2,36000,1.03968253968
376430,376437,376807,7,370,2,36000,1.01891891892
376446,376452,376809,6,357,2,36000,1.01680672269
376462,376468,376807,6,339,2,36000,1.01769911504
376487,376493,376807,6,314,2,36000,1.01910828025
376502,376509,376807,7,298,2,36000,1.02348993289
376518,376524,376807,6,283,2,36000,1.02120141343
376520,376531,376807,11,276,2,36000,1.03985507246
376521,376537,376807,16,270,2,36000,1.05925925926
376538,376544,376807,6,263,2,36000,1.02281368821
376539,376550,376807,11,257,2,36000,1.04280155642
376556,376563,376807,7,244,2,36000,1.02868852459
376558,376569,376807,11,238,2,36000,1.04621848739
376586,376592,376807,6,215,2,36000,1.02790697674
376602,376608,376807,6,199,2,36000,1.03015075377
376618,376623,376807,5,184,2,36000,1.02717391304
376633,376639,376807,6,168,2,36000,1.03571428571
376650,376656,376807,6,151,2,36000,1.03973509934
376651,376662,376807,11,145,2,36000,1.07586206897
376652,376668,376807,16,139,2,36000,1.11510791367
376669,376675,376807,6,132,2,36000,1.04545454545
376670,376681,376807,11,126,2,36000,1.0873015873
376686,376692,376807,6,115,2,36000,1.05217391304
376702,376708,376807,6,99,2,36000,1.06060606061
376703,376714,376807,11,93,2,36000,1.11827956989
376705,376719,376807,14,88,2,36000,1.15909090909
376721,376727,376807,6,80,2,36000,1.075
376739,376745,376807,6,62,2,36000,1.09677419355
376741,376751,376807,10,56,2,36000,1.17857142857
376776,376782,376807,6,25,2,36000,1.24
376777,376788,376808,11,20,2,36000,1.55
376779,376793,376807,14,14,2,36000,2.0
376969,376975,377715,6,740,2,36000,1.00810810811
376970,376981,377679,11,698,2,36000,1.01575931232
376972,376986,377589,14,603,2,36000,1.0232172471
376973,376991,377692,18,701,2,36000,1.02567760342
376974,376997,377725,23,728,2,36000,1.03159340659
376976,377002,377704,26,702,2,36000,1.03703703704
376978,377008,377659,30,651,2,36000,1.04608294931
376981,377013,377776,32,763,2,36000,1.04193971166
376982,377018,377694,36,676,2,36000,1.05325443787
376984,377023,377775,39,752,2,36000,1.05186170213
376986,377029,377722,43,693,2,36000,1.06204906205
376988,377034,377738,46,704,2,36000,1.06534090909
376989,377039,377684,50,645,2,36000,1.07751937984
376991,377044,377780,53,736,2,36000,1.07201086957
376993,377049,377741,56,692,2,36000,1.08092485549
376995,377055,377806,60,751,2,36000,1.07989347537
376997,377060,377749,63,689,2,36000,1.09143686502
376999,377066,377812,67,746,2,36000,1.08981233244
377001,377071,377894,70,823,2,36000,1.08505467801
377003,377077,377774,74,697,2,36000,1.10616929699
377005,377082,377862,77,780,2,36000,1.09871794872
377007,377087,377753,80,666,2,36000,1.12012012012
377009,377092,377740,83,648,2,36000,1.12808641975
377011,377097,377751,86,654,2,36000,1.13149847095
377013,377103,377810,90,707,2,36000,1.12729844413
377015,377108,377793,93,685,2,36000,1.13576642336
377017,377113,377772,96,659,2,36000,1.14567526555
377019,377118,378006,99,888,2,36000,1.11148648649
377021,377124,377939,103,815,2,36000,1.1263803681
377024,377129,377772,105,643,2,36000,1.1632970451
377026,377134,377791,108,657,2,36000,1.16438356164
377027,377139,377853,112,714,2,36000,1.1568627451
377029,377145,377769,116,624,2,36000,1.1858974359
377031,377150,377817,119,667,2,36000,1.1784107946
377032,377155,377831,123,676,2,36000,1.18195266272
377034,377160,377803,126,643,2,36000,1.19595645412
377036,377165,377781,129,616,2,36000,1.20941558442
377037,377171,377884,134,713,2,36000,1.18793828892
377039,377176,377987,137,811,2,36000,1.16892725031
377040,377181,377867,141,686,2,36000,1.2055393586
377041,377186,377814,145,628,2,36000,1.23089171975
377043,377192,377954,149,762,2,36000,1.19553805774
377045,377197,377843,152,646,2,36000,1.23529411765
377047,377202,377955,155,753,2,36000,1.20584329349
377049,377207,377904,158,697,2,36000,1.22668579627
377051,377212,377944,161,732,2,36000,1.21994535519
377053,377218,377908,165,690,2,36000,1.23913043478
377055,377223,378532,168,1309,2,36000,1.12834224599
377056,377228,377979,172,751,2,36000,1.22902796272
377058,377233,377929,175,696,2,36000,1.25143678161
377060,377239,377870,179,631,2,36000,1.28367670365
377063,377245,378026,182,781,2,36000,1.23303457106
377065,377250,377947,185,697,2,36000,1.26542324247
377068,377255,377962,187,707,2,36000,1.26449787836
377070,377261,377899,191,638,2,36000,1.29937304075
377073,377266,377943,193,677,2,36000,1.28508124077
377075,377271,378051,196,780,2,36000,1.25128205128
377078,377276,377940,198,664,2,36000,1.29819277108
377080,377282,378021,202,739,2,36000,1.27334235453
377083,377287,377888,204,601,2,36000,1.33943427621
377085,377292,377934,207,642,2,36000,1.32242990654
377087,377297,377966,210,669,2,36000,1.31390134529
377089,377302,378045,213,743,2,36000,1.2866756393
377091,377308,377914,217,606,2,36000,1.35808580858
377093,377313,378151,220,838,2,36000,1.26252983294
377095,377318,377961,223,643,2,36000,1.3468118196
377097,377323,377963,226,640,2,36000,1.353125
377099,377329,378039,230,710,2,36000,1.32394366197
377100,377602,378223,502,621,2,36000,1.80837359098
377103,377671,378389,568,718,2,36000,1.79108635097
377105,377690,378402,585,712,2,36000,1.82162921348
377106,377697,378328,591,631,2,36000,1.93660855784
377108,377704,378371,596,667,2,36000,1.89355322339
377109,377711,378410,602,699,2,36000,1.86123032904
377111,377717,378400,606,683,2,36000,1.88726207906
377113,377727,378394,614,667,2,36000,1.92053973013
377114,377733,378434,619,701,2,36000,1.88302425107
377116,377740,378480,624,740,2,36000,1.84324324324
377117,377746,378370,629,624,2,36000,2.00801282051
377119,377762,378488,643,726,2,36000,1.88567493113
377588,377770,378516,182,746,2,36000,1.24396782842
377624,377788,425402,164,47614,2,108000,1.0034443651
377661,377780,378604,119,824,2,36000,1.14441747573
377680,377793,378472,113,679,2,36000,1.16642120766
377696,377798,378422,102,624,2,36000,1.16346153846
377698,377803,378617,105,814,2,36000,1.12899262899
377699,377808,378479,109,671,2,36000,1.16244411326
377716,377815,378531,99,716,2,36000,1.13826815642
377717,377821,378545,104,724,2,36000,1.14364640884
377734,377826,378538,92,712,2,36000,1.12921348315
377736,377831,378608,95,777,2,36000,1.12226512227
377754,377836,378606,82,770,2,36000,1.10649350649
377755,377843,378634,88,791,2,36000,1.11125158028
377756,377848,378550,92,702,2,36000,1.13105413105
377758,377853,378510,95,657,2,36000,1.14459665145
377759,377858,378534,99,676,2,36000,1.14644970414
377760,377863,378556,103,693,2,36000,1.14862914863
377779,377869,378580,90,711,2,36000,1.12658227848
377780,377876,378541,96,665,2,36000,1.14436090226
377782,377881,378486,99,605,2,36000,1.16363636364
377783,377886,378601,103,715,2,36000,1.14405594406
377784,377892,378646,108,754,2,36000,1.14323607427
377786,377898,378509,112,611,2,36000,1.18330605565
377802,377904,378569,102,665,2,36000,1.15338345865
377803,377910,378707,107,797,2,36000,1.13425345044
377805,377917,378645,112,728,2,36000,1.15384615385
377806,377922,378614,116,692,2,36000,1.1676300578
377823,377927,378738,104,811,2,36000,1.12823674476
377825,377933,378570,108,637,2,36000,1.16954474097
377826,377938,378655,112,717,2,36000,1.15620641562
377827,377945,378630,118,685,2,36000,1.17226277372
377828,377950,378622,122,672,2,36000,1.18154761905
377830,377957,378753,127,796,2,36000,1.15954773869
377846,377963,378677,117,714,2,36000,1.16386554622
377847,377968,378773,121,805,2,36000,1.15031055901
377862,377973,378660,111,687,2,36000,1.1615720524
377864,377980,378840,116,860,2,36000,1.13488372093
377880,377985,378825,105,840,2,36000,1.125
377881,377990,378670,109,680,2,36000,1.16029411765
377901,377995,378666,94,671,2,36000,1.14008941878
377902,378000,378740,98,740,2,36000,1.13243243243
377903,378006,378640,103,634,2,36000,1.16246056782
377905,378011,378752,106,741,2,36000,1.14304993252
377932,378016,378743,84,727,2,36000,1.11554332875
377934,378021,378656,87,635,2,36000,1.13700787402
377935,378026,378777,91,751,2,36000,1.12117177097
377937,378032,378673,95,641,2,36000,1.14820592824
377958,378054,378690,96,636,2,36000,1.15094339623
377959,378059,378768,100,709,2,36000,1.14104372355
377960,378066,378713,106,647,2,36000,1.16383307573
377962,378071,378832,109,761,2,36000,1.1432325887
377963,378077,378808,114,731,2,36000,1.15595075239
377964,378162,378827,198,665,2,36000,1.2977443609
377966,378235,378912,269,677,2,36000,1.39734121123
377967,378339,379055,372,716,2,36000,1.51955307263
377987,378038,378714,51,676,2,36000,1.07544378698
377988,378043,378647,55,604,2,36000,1.09105960265
377989,378049,378646,60,597,2,36000,1.10050251256
377991,378382,379199,391,817,2,36000,1.47858017136
377992,378390,379047,398,657,2,36000,1.60578386606
377993,378401,379158,408,757,2,36000,1.53896961691
378020,378409,379059,389,650,2,36000,1.59846153846
378041,378416,379104,375,688,2,36000,1.54505813953
378043,378422,379173,379,751,2,36000,1.50466045273
378044,378429,379078,385,649,2,36000,1.59322033898
378061,378436,379123,375,687,2,36000,1.54585152838
378062,378447,379130,385,683,2,36000,1.56368960469
378151,378484,379107,333,623,2,36000,1.53451043339
378224,378492,379102,268,610,2,36000,1.4393442623
378324,387746,391494,9422,3748,32,7200,3.51387406617
378327,378497,379176,170,679,2,36000,1.25036818851
378328,391512,405924,13184,14412,64,14400,1.91479322787
378331,406002,420431,27671,14429,128,14400,2.91773511678
378333,398840,402566,20507,3726,32,7200,6.50375738057
378337,420442,434910,42105,14468,128,14400,3.91021564833
378370,378504,379175,134,671,2,36000,1.19970193741
378371,378510,379291,139,781,2,36000,1.17797695262
378390,378521,379106,131,585,2,36000,1.22393162393
378406,378528,379147,122,619,2,36000,1.19709208401
378408,378534,379249,126,715,2,36000,1.17622377622
378409,378544,379208,135,664,2,36000,1.20331325301
378424,378551,379240,127,689,2,36000,1.18432510885
378425,378557,379380,132,823,2,36000,1.16038882139
378441,378562,379189,121,627,2,36000,1.19298245614
378472,378570,379117,98,547,2,36000,1.17915904936
378488,378581,379167,93,586,2,36000,1.15870307167
378489,378588,379285,99,697,2,36000,1.14203730273
378491,378597,379277,106,680,2,36000,1.15588235294
378492,378613,379331,121,718,2,36000,1.16852367688
378511,378620,379335,109,715,2,36000,1.15244755245
378513,378626,379345,113,719,2,36000,1.15716272601
378532,378631,379210,99,579,2,36000,1.17098445596
378533,378638,379363,105,725,2,36000,1.14482758621
378535,378644,379328,109,684,2,36000,1.15935672515
378567,378652,379212,85,560,2,36000,1.15178571429
378569,378657,379317,88,660,2,36000,1.13333333333
378570,378665,379346,95,681,2,36000,1.13950073421
378571,378670,379343,99,673,2,36000,1.147102526
378573,378675,379368,102,693,2,36000,1.14718614719
378574,378680,379406,106,726,2,36000,1.14600550964
378593,378685,379377,92,692,2,36000,1.13294797688
378595,378694,379304,99,610,2,36000,1.16229508197
378596,378699,379367,103,668,2,36000,1.15419161677
378614,378704,379391,90,687,2,36000,1.13100436681
378616,378709,379353,93,644,2,36000,1.14440993789
378617,378715,379290,98,575,2,36000,1.17043478261
378618,378720,379540,102,820,2,36000,1.1243902439
378620,378725,379685,105,960,2,36000,1.109375
378639,378732,379429,93,697,2,36000,1.13342898135
378640,378738,379461,98,723,2,36000,1.13554633472
378642,378743,379402,101,659,2,36000,1.15326251897
378643,378748,379499,105,751,2,36000,1.13981358189
378669,378756,379507,87,751,2,36000,1.11584553928
378671,378761,379461,90,700,2,36000,1.12857142857
378672,378766,379507,94,741,2,36000,1.12685560054
378674,378774,379447,100,673,2,36000,1.1485884101
378675,378779,379516,104,737,2,36000,1.14111261872
378676,378787,379511,111,724,2,36000,1.15331491713
378678,378792,379550,114,758,2,36000,1.15039577836
378679,378799,379479,120,680,2,36000,1.17647058824
378681,378821,379492,140,671,2,36000,1.2086438152
378706,378837,379569,131,732,2,36000,1.17896174863
378708,378845,379568,137,723,2,36000,1.18948824343
378709,378850,379501,141,651,2,36000,1.21658986175
378710,378858,379590,148,732,2,36000,1.20218579235
378727,378925,379626,198,701,2,36000,1.28245363766
378728,379017,379690,289,673,2,36000,1.4294205052
378729,379060,379694,331,634,2,36000,1.52208201893
378748,379069,379797,321,728,2,36000,1.44093406593
378749,379077,379779,328,702,2,36000,1.46723646724
378750,379091,379823,341,732,2,36000,1.46584699454
378767,379115,379852,348,737,2,36000,1.47218453189
378768,379123,379783,355,660,2,36000,1.53787878788
378786,379128,379837,342,709,2,36000,1.48236953456
378787,379133,379947,346,814,2,36000,1.42506142506
378788,379141,379826,353,685,2,36000,1.51532846715
378810,379146,379838,336,692,2,36000,1.48554913295
378826,379153,379860,327,707,2,36000,1.46251768034
378841,379162,379853,321,691,2,36000,1.46454413893
378843,379170,379913,327,743,2,36000,1.4401076716
378844,379181,379804,337,623,2,36000,1.54093097913
378912,379188,379868,276,680,2,36000,1.40588235294
379048,379194,379921,146,727,2,36000,1.20082530949
379063,379199,379889,136,690,2,36000,1.19710144928
379064,379206,380072,142,866,2,36000,1.16397228637
379080,379214,379836,134,622,2,36000,1.2154340836
379103,379222,379862,119,640,2,36000,1.1859375
379128,379229,380017,101,788,2,36000,1.12817258883
379130,379234,379877,104,643,2,36000,1.16174183515
379131,379253,379916,122,663,2,36000,1.18401206637
379132,379262,379957,130,695,2,36000,1.18705035971
379134,379290,379969,156,679,2,36000,1.22974963181
379150,379299,380005,149,706,2,36000,1.21104815864
379151,379307,379966,156,659,2,36000,1.23672230653
379168,379312,380032,144,720,2,36000,1.2
379169,379320,379975,151,655,2,36000,1.23053435115
379186,379329,379966,143,637,2,36000,1.22448979592
379188,379341,380068,153,727,2,36000,1.21045392022
379189,379348,380139,159,791,2,36000,1.201011378
379190,379353,380058,163,705,2,36000,1.23120567376
379207,379361,380019,154,658,2,36000,1.23404255319
379222,379366,380041,144,675,2,36000,1.21333333333
379224,379371,380099,147,728,2,36000,1.20192307692
379225,379378,380146,153,768,2,36000,1.19921875
379240,379383,380168,143,785,2,36000,1.1821656051
379255,379392,380114,137,722,2,36000,1.18975069252
379280,379397,380157,117,760,2,36000,1.15394736842
379297,379402,380098,105,696,2,36000,1.15086206897
379298,379409,380098,111,689,2,36000,1.1611030479
379300,379414,380116,114,702,2,36000,1.16239316239
379315,379422,380095,107,673,2,36000,1.15898959881
379331,379427,380080,96,653,2,36000,1.14701378254
379333,379441,380078,108,637,2,36000,1.16954474097
379334,379459,380243,125,784,2,36000,1.15943877551
379351,379474,380165,123,691,2,36000,1.17800289436
379352,379480,380294,128,814,2,36000,1.15724815725
379354,379494,380224,140,730,2,36000,1.19178082192
379355,379504,380160,149,656,2,36000,1.22713414634
379371,379513,380218,142,705,2,36000,1.20141843972
379373,379521,380188,148,667,2,36000,1.22188905547
379374,379526,380249,152,723,2,36000,1.2102351314
379375,379531,380271,156,740,2,36000,1.21081081081
379391,379539,380273,148,734,2,36000,1.20163487738
379393,379544,380466,151,922,2,36000,1.16377440347
379394,379554,380217,160,663,2,36000,1.24132730015
379409,379564,380253,155,689,2,36000,1.22496371553
379411,379581,380252,170,671,2,36000,1.25335320417
379432,379589,380193,157,604,2,36000,1.25993377483
379448,379603,380316,155,713,2,36000,1.21739130435
379463,379638,380487,175,849,2,36000,1.20612485277
379464,379699,380425,235,726,2,36000,1.32369146006
379483,379706,380447,223,741,2,36000,1.30094466937
379501,379711,380415,210,704,2,36000,1.29829545455
379502,379792,380632,290,840,2,36000,1.34523809524
379503,379800,380501,297,701,2,36000,1.42368045649
379536,379809,380469,273,660,2,36000,1.41363636364
379537,379818,380647,281,829,2,36000,1.33896260555
379539,379835,380493,296,658,2,36000,1.44984802432
379540,379844,380443,304,599,2,36000,1.50751252087
379564,379852,380566,288,714,2,36000,1.40336134454
379565,379857,380481,292,624,2,36000,1.46794871795
379583,379862,380630,279,768,2,36000,1.36328125
379584,379870,380608,286,738,2,36000,1.38753387534
379600,379875,380548,275,673,2,36000,1.40861812779
379631,379883,380541,252,658,2,36000,1.3829787234
379687,379888,380559,201,671,2,36000,1.29955290611
379702,379893,380563,191,670,2,36000,1.28507462687
379704,379901,380687,197,786,2,36000,1.25063613232
379752,380096,610229,344,230133,2,345600,1.0014947878
379780,379908,380625,128,717,2,36000,1.17852161785
379795,379926,380626,131,700,2,36000,1.18714285714
379811,379934,380629,123,695,2,36000,1.17697841727
379812,379939,380696,127,757,2,36000,1.1677675033
379828,379960,380619,132,659,2,36000,1.20030349014
379829,379969,380628,140,659,2,36000,1.2124430956
379846,379979,380634,133,655,2,36000,1.20305343511
379847,379984,380614,137,630,2,36000,1.21746031746
379848,379993,380679,145,686,2,36000,1.21137026239
379865,379998,380656,133,658,2,36000,1.20212765957
379866,380017,380724,151,707,2,36000,1.21357850071
379868,380039,380784,171,745,2,36000,1.22953020134
379869,380046,380722,177,676,2,36000,1.26183431953
379885,380054,380872,169,818,2,36000,1.20660146699
379886,380072,380678,186,606,2,36000,1.30693069307
379898,380031,425834,133,45803,2,108000,1.00290373993
379901,380081,380705,180,624,2,36000,1.28846153846
379917,380088,380672,171,584,2,36000,1.29280821918
379918,380102,380776,184,674,2,36000,1.27299703264
379934,380109,380858,175,749,2,36000,1.23364485981
379949,380116,380766,167,650,2,36000,1.25692307692
379964,380121,380795,157,674,2,36000,1.23293768546
379980,380126,380854,146,728,2,36000,1.20054945055
379981,380133,380797,152,664,2,36000,1.22891566265
379982,380139,380928,157,789,2,36000,1.1989860583
379984,380151,380762,167,611,2,36000,1.27332242226
380005,380158,380832,153,674,2,36000,1.22700296736
380021,380169,380723,148,554,2,36000,1.26714801444
380022,380176,380938,154,762,2,36000,1.20209973753
380037,380184,380866,147,682,2,36000,1.21554252199
380053,380189,380987,136,798,2,36000,1.17042606516
380068,380201,380847,133,646,2,36000,1.20588235294
380070,380209,380920,139,711,2,36000,1.19549929677
380086,380230,380964,144,734,2,36000,1.1961852861
380087,380237,380904,150,667,2,36000,1.22488755622
380088,380242,380939,154,697,2,36000,1.22094691535
380105,380257,381021,152,764,2,36000,1.19895287958
380107,380264,381097,157,833,2,36000,1.18847539016
380108,380269,380917,161,648,2,36000,1.24845679012
380109,380276,380994,167,718,2,36000,1.23259052925
380130,380283,380977,153,694,2,36000,1.2204610951
380131,380292,380956,161,664,2,36000,1.24246987952
380148,380306,381042,158,736,2,36000,1.21467391304
380150,380329,381061,179,732,2,36000,1.24453551913
380168,380428,381043,260,615,2,36000,1.42276422764
380170,380437,381073,267,636,2,36000,1.41981132075
380171,380455,381142,284,687,2,36000,1.4133915575
380172,380462,381192,290,730,2,36000,1.39726027397
380191,380479,381139,288,660,2,36000,1.43636363636
380208,380486,381271,278,785,2,36000,1.35414012739
380224,380493,381221,269,728,2,36000,1.36950549451
380225,380501,381161,276,660,2,36000,1.41818181818
380227,380509,381150,282,641,2,36000,1.4399375975
380247,380516,381173,269,657,2,36000,1.40943683409
380275,380554,381275,279,721,2,36000,1.38696255201
380277,380561,381256,284,695,2,36000,1.40863309353
380278,380572,381276,294,704,2,36000,1.41761363636
380279,380580,381282,301,702,2,36000,1.42877492877
380281,380585,381389,304,804,2,36000,1.37810945274
380299,380620,381255,321,635,2,36000,1.50551181102
380318,380627,381323,309,696,2,36000,1.44396551724
380418,380635,381292,217,657,2,36000,1.3302891933
380434,380642,381232,208,590,2,36000,1.35254237288
380450,380648,381334,198,686,2,36000,1.28862973761
380451,380653,381359,202,706,2,36000,1.28611898017
380466,380658,381266,192,608,2,36000,1.31578947368
380481,380663,381323,182,660,2,36000,1.27575757576
380483,380670,381321,187,651,2,36000,1.28725038402
380499,380676,381439,177,763,2,36000,1.23197903014
380500,380681,381413,181,732,2,36000,1.24726775956
380516,380686,381412,170,726,2,36000,1.23415977961
380541,380694,381407,153,713,2,36000,1.21458625526
380563,380699,381453,136,754,2,36000,1.18037135279
380564,380704,381463,140,759,2,36000,1.18445322793
380566,380711,381352,145,641,2,36000,1.22620904836
380591,380716,381385,125,669,2,36000,1.18684603886
380610,380723,381430,113,707,2,36000,1.15983026874
380628,380734,381359,106,625,2,36000,1.1696
380629,380741,381512,112,771,2,36000,1.14526588846
380631,380746,381348,115,602,2,36000,1.19102990033
380632,380774,381447,142,673,2,36000,1.21099554235
380633,380783,381353,150,570,2,36000,1.26315789474
380635,380789,381515,154,726,2,36000,1.21212121212
380653,380797,381451,144,654,2,36000,1.22018348624
380654,380808,381507,154,699,2,36000,1.22031473534
380655,380815,381488,160,673,2,36000,1.23774145617
380657,380844,381619,187,775,2,36000,1.24129032258
380674,380860,381635,186,775,2,36000,1.24
380675,380868,381615,193,747,2,36000,1.25836680054
380692,380875,381524,183,649,2,36000,1.28197226502
380694,380883,381546,189,663,2,36000,1.2850678733
380695,380890,381530,195,640,2,36000,1.3046875
380722,380907,401478,185,20571,2,108000,1.00899324291
380724,380917,381551,193,634,2,36000,1.30441640379
380726,380929,381939,203,1010,2,36000,1.20099009901
380727,380936,381624,209,688,2,36000,1.30377906977
380728,380943,381701,215,758,2,36000,1.28364116095
380730,380951,381568,221,617,2,36000,1.35818476499
380766,380956,381609,190,653,2,36000,1.29096477795
380767,380970,381929,203,959,2,36000,1.21167883212
380783,380978,381707,195,729,2,36000,1.26748971193
380785,380989,381703,204,714,2,36000,1.28571428571
380801,380999,381622,198,623,2,36000,1.31781701445
380803,381007,381834,204,827,2,36000,1.24667472793
380834,381034,381610,200,576,2,36000,1.34722222222
380850,381054,381582,204,528,2,36000,1.38636363636
380867,381061,381810,194,749,2,36000,1.25901201602
380868,381074,381878,206,804,2,36000,1.25621890547
380869,381085,381767,216,682,2,36000,1.31671554252
380885,381109,381764,224,655,2,36000,1.34198473282
380906,381151,381814,245,663,2,36000,1.36953242836
380923,381159,381876,236,717,2,36000,1.32914923291
380924,381166,381813,242,647,2,36000,1.37403400309
380941,381173,381853,232,680,2,36000,1.34117647059
380942,381186,381758,244,572,2,36000,1.42657342657
380943,381204,381840,261,636,2,36000,1.41037735849
380964,381233,381903,269,670,2,36000,1.40149253731
380966,381244,381890,278,646,2,36000,1.43034055728
380984,381268,381940,284,672,2,36000,1.42261904762
381000,381273,381981,273,708,2,36000,1.38559322034
381001,381280,381914,279,634,2,36000,1.44006309148
381023,381287,382089,264,802,2,36000,1.32917705736
381038,381293,382086,255,793,2,36000,1.32156368222
381054,381300,381964,246,664,2,36000,1.37048192771
381070,381305,382017,235,712,2,36000,1.33005617978
381085,381313,381935,228,622,2,36000,1.36655948553
381100,381334,381880,234,546,2,36000,1.42857142857
381141,381341,381984,200,643,2,36000,1.31104199067
381142,381346,382018,204,672,2,36000,1.30357142857
381158,381353,381972,195,619,2,36000,1.31502423263
381174,381361,382043,187,682,2,36000,1.27419354839
381175,381369,382019,194,650,2,36000,1.29846153846
381194,381374,382094,180,720,2,36000,1.25
381222,381381,382075,159,694,2,36000,1.22910662824
381238,381386,382038,148,652,2,36000,1.22699386503
381257,381397,382033,140,636,2,36000,1.22012578616
381259,381405,382093,146,688,2,36000,1.21220930233
381277,381420,382106,143,686,2,36000,1.2084548105
381278,381427,382191,149,764,2,36000,1.19502617801
381280,381432,381974,152,542,2,36000,1.28044280443
381281,381443,382123,162,680,2,36000,1.23823529412
381307,381452,382105,145,653,2,36000,1.22205206738
381308,381460,382096,152,636,2,36000,1.23899371069
381331,381467,382205,136,738,2,36000,1.18428184282
381333,381472,382153,139,681,2,36000,1.20411160059
381334,381484,382062,150,578,2,36000,1.25951557093
381357,381500,382124,143,624,2,36000,1.22916666667
381359,381519,382278,160,759,2,36000,1.21080368906
381360,381527,382184,167,657,2,36000,1.25418569254
381362,381532,382243,170,711,2,36000,1.23909985935
381386,381539,382174,153,635,2,36000,1.24094488189
381387,381546,382246,159,700,2,36000,1.22714285714
381414,381558,382255,144,697,2,36000,1.20659971306
381415,381565,382308,150,743,2,36000,1.20188425303
381417,381581,382370,164,789,2,36000,1.20785804816
381418,381594,382232,176,638,2,36000,1.27586206897
381419,381621,382223,202,602,2,36000,1.33554817276
381450,381628,382357,178,729,2,36000,1.24417009602
381451,381634,382397,183,763,2,36000,1.23984272608
381453,381641,382279,188,638,2,36000,1.29467084639
381454,381646,382299,192,653,2,36000,1.29402756508
381473,381651,382283,178,632,2,36000,1.28164556962
381474,381658,382294,184,636,2,36000,1.2893081761
381490,381713,382450,223,737,2,36000,1.302578019
381510,381720,382256,210,536,2,36000,1.39179104478
381526,381726,382340,200,614,2,36000,1.32573289902
381527,381770,382418,243,648,2,36000,1.375
381528,381778,382469,250,691,2,36000,1.36179450072
381545,381785,382459,240,674,2,36000,1.35608308605
381561,381823,382480,262,657,2,36000,1.39878234399
381562,381830,382455,268,625,2,36000,1.4288
381578,381835,382474,257,639,2,36000,1.40219092332
381593,381846,382672,253,826,2,36000,1.30629539952
381613,381853,382525,240,672,2,36000,1.35714285714
381615,381865,382581,250,716,2,36000,1.34916201117
381622,382370,420618,748,38248,2,108000,1.01955657812
381632,381888,382881,256,993,2,36000,1.25780463243
381634,381896,382528,262,632,2,36000,1.41455696203
381635,381901,382682,266,781,2,36000,1.34058898848
381637,381908,382752,271,844,2,36000,1.32109004739
381652,381915,382631,263,716,2,36000,1.36731843575
381702,381926,382697,224,771,2,36000,1.29053177691
381719,381942,382607,223,665,2,36000,1.33533834586
381720,381949,382610,229,661,2,36000,1.34644478064
381760,381957,382582,197,625,2,36000,1.3152
381777,381963,382634,186,671,2,36000,1.27719821162
381778,381976,382657,198,681,2,36000,1.29074889868
381802,382378,980798,576,598420,4,604800,1.00096253467
381814,381984,382685,170,701,2,36000,1.242510699
381815,381991,382640,176,649,2,36000,1.27118644068
381817,381999,382692,182,693,2,36000,1.26262626263
381837,382005,382634,168,629,2,36000,1.26709062003
381853,382030,382668,177,638,2,36000,1.27742946708
381855,382036,382736,181,700,2,36000,1.25857142857
381881,382043,382801,162,758,2,36000,1.21372031662
381882,382050,382800,168,750,2,36000,1.224
381884,382056,382703,172,647,2,36000,1.2658423493
381909,382063,382816,154,753,2,36000,1.20451527224
381910,382074,382968,164,894,2,36000,1.18344519016
381925,382087,382714,162,627,2,36000,1.25837320574
381944,382099,382779,155,680,2,36000,1.22794117647
381945,382106,382767,161,661,2,36000,1.24357034796
381947,382111,382725,164,614,2,36000,1.2671009772
381948,382116,382768,168,652,2,36000,1.25766871166
381964,382123,382751,159,628,2,36000,1.25318471338
381981,382128,382780,147,652,2,36000,1.2254601227
381983,382133,382792,150,659,2,36000,1.22761760243
381984,382141,382812,157,671,2,36000,1.23397913562
382000,382146,382921,146,775,2,36000,1.18838709677
382026,382166,382873,140,707,2,36000,1.19801980198
382027,382187,382889,160,702,2,36000,1.22792022792
382029,382196,382892,167,696,2,36000,1.23994252874
382054,382205,382868,151,663,2,36000,1.22775263952
382055,382217,382895,162,678,2,36000,1.2389380531
382057,382235,382876,178,641,2,36000,1.27769110764
382072,382244,383178,172,934,2,36000,1.18415417559
382090,382256,383076,166,820,2,36000,1.20243902439
382091,382264,382936,173,672,2,36000,1.25744047619
382092,382272,382920,180,648,2,36000,1.27777777778
382110,382278,382931,168,653,2,36000,1.25727411945
382111,382291,383013,180,722,2,36000,1.24930747922
382113,382298,383076,185,778,2,36000,1.23778920308
382114,382303,383103,189,800,2,36000,1.23625
382115,382311,383012,196,701,2,36000,1.27960057061
382131,382316,383037,185,721,2,36000,1.25658807212
382133,382323,383205,190,882,2,36000,1.21541950113
382155,382353,382941,198,588,2,36000,1.33673469388
382176,382385,383127,209,742,2,36000,1.28167115903
382193,382409,383414,216,1005,2,36000,1.21492537313
382195,382430,383055,235,625,2,36000,1.376
382210,382462,383394,252,932,2,36000,1.27038626609
382226,382469,383146,243,677,2,36000,1.35893648449
382242,382476,383081,234,605,2,36000,1.3867768595
382258,382483,383238,225,755,2,36000,1.29801324503
382259,382491,383106,232,615,2,36000,1.37723577236
382260,382498,383201,238,703,2,36000,1.33854907539
382262,382537,383373,275,836,2,36000,1.32894736842
382281,382544,383233,263,689,2,36000,1.381712627
382283,382594,383444,311,850,2,36000,1.36588235294
382299,382600,383176,301,576,2,36000,1.52256944444
382300,382619,383277,319,658,2,36000,1.48480243161
382302,382626,383436,324,810,2,36000,1.4
382318,382643,383339,325,696,2,36000,1.46695402299
382348,382651,383347,303,696,2,36000,1.43534482759
382370,382656,383627,286,971,2,36000,1.29454170958
382389,382665,383327,276,662,2,36000,1.416918429
382404,382672,383364,268,692,2,36000,1.38728323699
382419,382680,383304,261,624,2,36000,1.41826923077
382455,382687,383310,232,623,2,36000,1.37239165329
382456,382695,383355,239,660,2,36000,1.36212121212
382476,393208,435513,10732,42305,2,108000,1.25368159792
382502,382703,383387,201,684,2,36000,1.29385964912
382504,382710,383469,206,759,2,36000,1.27140974967
382505,382716,383438,211,722,2,36000,1.29224376731
382506,382723,383382,217,659,2,36000,1.32928679818
382528,382730,383549,202,819,2,36000,1.24664224664
382529,382737,383497,208,760,2,36000,1.27368421053
382583,382749,383494,166,745,2,36000,1.22281879195
382585,382763,383517,178,754,2,36000,1.23607427056
382607,382771,383342,164,571,2,36000,1.28721541156
382622,382779,383475,157,696,2,36000,1.22557471264
382637,382786,383545,149,759,2,36000,1.19631093544
382639,382793,383543,154,750,2,36000,1.20533333333
382640,382798,383556,158,758,2,36000,1.20844327177
382657,382805,383506,148,701,2,36000,1.21112696148
382658,382812,383349,154,537,2,36000,1.28677839851
382674,382818,383532,144,714,2,36000,1.20168067227
382676,382824,383474,148,650,2,36000,1.22769230769
382691,382831,383528,140,697,2,36000,1.20086083214
382692,382881,383605,189,724,2,36000,1.26104972376
382708,382887,383609,179,722,2,36000,1.24792243767
382709,382895,383630,186,735,2,36000,1.25306122449
382710,382901,383501,191,600,2,36000,1.31833333333
382726,382908,383600,182,692,2,36000,1.26300578035
382727,382913,383577,186,664,2,36000,1.28012048193
382744,382918,383608,174,690,2,36000,1.25217391304
382759,382933,383669,174,736,2,36000,1.23641304348
382761,382938,383801,177,863,2,36000,1.20509849363
382777,382945,383568,168,623,2,36000,1.26966292135
382778,382953,383665,175,712,2,36000,1.24578651685
382795,382959,383677,164,718,2,36000,1.22841225627
382797,382980,383715,183,735,2,36000,1.24897959184
382798,383024,383782,226,758,2,36000,1.2981530343
382815,383032,383755,217,723,2,36000,1.30013831259
382817,383049,383804,232,755,2,36000,1.30728476821
382818,383067,383770,249,703,2,36000,1.35419630156
382835,383088,383807,253,719,2,36000,1.35187760779
382878,383094,383768,216,674,2,36000,1.32047477745
382879,383101,383874,222,773,2,36000,1.2871927555
382881,383115,383806,234,691,2,36000,1.33863965268
382902,383122,383805,220,683,2,36000,1.32210834553
382903,383139,383783,236,644,2,36000,1.36645962733
382905,383159,383898,254,739,2,36000,1.34370771313
382906,383188,383979,282,791,2,36000,1.35651074589
382922,383195,383830,273,635,2,36000,1.42992125984
382923,383213,383900,290,687,2,36000,1.42212518195
382947,383220,383925,273,705,2,36000,1.38723404255
382949,383245,383880,296,635,2,36000,1.46614173228
382950,383252,384066,302,814,2,36000,1.37100737101
382969,383290,383941,321,651,2,36000,1.4930875576
383013,383316,383957,303,641,2,36000,1.47269890796
383014,383323,383994,309,671,2,36000,1.46050670641
383040,383339,384229,299,890,2,36000,1.33595505618
383055,383352,383972,297,620,2,36000,1.47903225806
383078,383359,384128,281,769,2,36000,1.36540962289
383079,383365,383977,286,612,2,36000,1.46732026144
383095,383372,384048,277,676,2,36000,1.40976331361
383111,383377,384112,266,735,2,36000,1.3619047619
383113,383385,384070,272,685,2,36000,1.39708029197
383129,383390,383999,261,609,2,36000,1.42857142857
383148,383397,384043,249,646,2,36000,1.38544891641
383179,383404,384152,225,748,2,36000,1.30080213904
383181,383411,384052,230,641,2,36000,1.35881435257
383202,383426,384061,224,635,2,36000,1.35275590551
383218,383449,384118,231,669,2,36000,1.34529147982
383233,383457,384178,224,721,2,36000,1.31067961165
383248,383462,384207,214,745,2,36000,1.28724832215
383279,383482,384169,203,687,2,36000,1.29548762737
383290,396043,416697,12753,20654,2,108000,1.61745908783
383304,383489,384132,185,643,2,36000,1.28771384137
383319,383494,384152,175,658,2,36000,1.26595744681
383335,383506,384188,171,682,2,36000,1.25073313783
383350,383513,384201,163,688,2,36000,1.23691860465
383352,383518,384259,166,741,2,36000,1.22402159244
383353,383525,384282,172,757,2,36000,1.22721268164
383355,383532,384017,177,485,2,36000,1.36494845361
383380,383541,384309,161,768,2,36000,1.20963541667
383381,383548,384161,167,613,2,36000,1.27243066884
383383,383555,384192,172,637,2,36000,1.27001569859
383406,383563,384331,157,768,2,36000,1.20442708333
383407,383568,384294,161,726,2,36000,1.2217630854
383408,383576,384202,168,626,2,36000,1.26837060703
383424,383583,384179,159,596,2,36000,1.26677852349
383453,383590,384314,137,724,2,36000,1.18922651934
383454,383612,384397,158,785,2,36000,1.20127388535
383456,383619,384231,163,612,2,36000,1.26633986928
383473,383626,384384,153,758,2,36000,1.2018469657
383492,383631,384306,139,675,2,36000,1.20592592593
383493,383640,384332,147,692,2,36000,1.21242774566
383510,383647,384247,137,600,2,36000,1.22833333333
383511,383678,384462,167,784,2,36000,1.21301020408
383512,383686,384357,174,671,2,36000,1.25931445604
383514,383693,384360,179,667,2,36000,1.26836581709
383530,383727,384377,197,650,2,36000,1.30307692308
383531,383768,384379,237,611,2,36000,1.38788870704
383547,383781,384451,234,670,2,36000,1.34925373134
383548,383788,384524,240,736,2,36000,1.32608695652
383550,383795,384508,245,713,2,36000,1.34361851332
383567,383800,384506,233,706,2,36000,1.33002832861
383568,383815,384481,247,666,2,36000,1.37087087087
383584,383823,384561,239,738,2,36000,1.32384823848
383585,383828,384463,243,635,2,36000,1.38267716535
383601,383833,384535,232,702,2,36000,1.33048433048
383616,383838,384505,222,667,2,36000,1.33283358321
383618,383845,384581,227,736,2,36000,1.30842391304
383619,383887,384508,268,621,2,36000,1.43156199678
383635,383895,384612,260,717,2,36000,1.36262203626
383636,383911,384528,275,617,2,36000,1.44570502431
383665,386358,403676,2693,17318,1,90000,1.15550294491
383669,383918,384712,249,794,2,36000,1.31360201511
383695,383937,384913,242,976,2,36000,1.24795081967
383696,383953,384776,257,823,2,36000,1.31227217497
383717,383970,384558,253,588,2,36000,1.43027210884
383759,383984,384672,225,688,2,36000,1.32703488372
383764,386376,403339,2612,16963,1,90000,1.15398219655
383782,383993,384629,211,636,2,36000,1.33176100629
383784,383998,384614,214,616,2,36000,1.3474025974
383785,384007,384930,222,923,2,36000,1.24052004334
383786,384015,384767,229,752,2,36000,1.3045212766
383803,384031,384779,228,748,2,36000,1.30481283422
383804,384055,384794,251,739,2,36000,1.33964817321
383822,384062,384797,240,735,2,36000,1.32653061224
383823,384069,384778,246,709,2,36000,1.34696755994
383824,384076,384812,252,736,2,36000,1.34239130435
383840,384084,384893,244,809,2,36000,1.30160692213
383874,384089,384805,215,716,2,36000,1.30027932961
383890,384124,384782,234,658,2,36000,1.3556231003
383905,384132,384846,227,714,2,36000,1.31792717087
383906,384140,384793,234,653,2,36000,1.35834609495
383926,384148,384829,222,681,2,36000,1.32599118943
383941,384164,384986,223,822,2,36000,1.27128953771
383960,384169,384839,209,670,2,36000,1.31194029851
383975,384176,384863,201,687,2,36000,1.29257641921
383991,384183,384946,192,763,2,36000,1.25163826999
383993,384190,385017,197,827,2,36000,1.23821039903
384008,384197,384978,189,781,2,36000,1.24199743918
384010,384205,385023,195,818,2,36000,1.23838630807
384025,384210,384882,185,672,2,36000,1.27529761905
384047,384217,384999,170,782,2,36000,1.21739130435
384049,384222,384966,173,744,2,36000,1.23252688172
384065,384230,384860,165,630,2,36000,1.2619047619
384067,384241,384979,174,738,2,36000,1.23577235772
384068,384249,384911,181,662,2,36000,1.27341389728
384084,384259,385043,175,784,2,36000,1.22321428571
384112,384271,385020,159,749,2,36000,1.21228304406
384129,384294,384971,165,677,2,36000,1.24372230428
384130,384306,384956,176,650,2,36000,1.27076923077
384134,458799,496603,74665,37804,10,43200,2.97505554968
384145,384318,385024,173,706,2,36000,1.24504249292
384163,384326,385030,163,704,2,36000,1.23153409091
384164,384331,385166,167,835,2,36000,1.2
384165,384343,385049,178,706,2,36000,1.25212464589
384183,384350,385116,167,766,2,36000,1.2180156658
384184,384369,385100,185,731,2,36000,1.25307797538
384186,384377,385109,191,732,2,36000,1.26092896175
384214,384389,385110,175,721,2,36000,1.2427184466
384215,384396,385131,181,735,2,36000,1.2462585034
384216,384401,385145,185,744,2,36000,1.24865591398
384218,384410,385070,192,660,2,36000,1.29090909091
384219,384463,385075,244,612,2,36000,1.39869281046
384242,384474,385151,232,677,2,36000,1.34268833087
384244,384481,385288,237,807,2,36000,1.2936802974
384266,384493,385082,227,589,2,36000,1.38539898132
384267,384517,385151,250,634,2,36000,1.39432176656
384286,384525,385286,239,761,2,36000,1.31406044678
384306,384531,385213,225,682,2,36000,1.32991202346
384307,384536,385239,229,703,2,36000,1.32574679943
384328,384543,385212,215,669,2,36000,1.32137518685
384329,384548,385222,219,674,2,36000,1.32492581602
384346,384557,385452,211,895,2,36000,1.23575418994
384347,384570,385234,223,664,2,36000,1.33584337349
384363,384577,385235,214,658,2,36000,1.32522796353
384365,384594,385259,229,665,2,36000,1.34436090226
384382,384625,385402,243,777,2,36000,1.31274131274
384383,384632,385347,249,715,2,36000,1.34825174825
384399,384641,385373,242,732,2,36000,1.3306010929
384400,384647,385353,247,706,2,36000,1.34985835694
384455,384653,385335,198,682,2,36000,1.29032258065
384470,384658,385416,188,758,2,36000,1.24802110818
384472,384663,385406,191,743,2,36000,1.25706594886
384487,384684,385393,197,709,2,36000,1.2778561354
384507,384726,385462,219,736,2,36000,1.29755434783
384508,384780,385463,272,683,2,36000,1.39824304539
384525,384789,385517,264,728,2,36000,1.36263736264
384527,384796,386137,269,1341,2,36000,1.20059656972
384528,384801,385502,273,701,2,36000,1.38944365193
384543,384806,385545,263,739,2,36000,1.35588633288
384545,384814,385432,269,618,2,36000,1.43527508091
384563,384819,385602,256,783,2,36000,1.32694763729
384564,384824,385554,260,730,2,36000,1.35616438356
384585,384831,385531,246,700,2,36000,1.35142857143
384614,384836,385522,222,686,2,36000,1.32361516035
384615,384843,385586,228,743,2,36000,1.3068640646
384632,384851,385451,219,600,2,36000,1.365
384638,405937,405954,21299,17,128,30,1253.88235294
384659,457926,515562,73267,57636,12,57600,2.27120202651
384673,384858,385939,185,1081,2,36000,1.17113783534
384713,384872,385697,159,825,2,36000,1.19272727273
384774,384879,385483,105,604,2,36000,1.1738410596
384801,384894,385560,93,666,2,36000,1.13963963964
384802,384905,385485,103,580,2,36000,1.1775862069
384804,384922,385514,118,592,2,36000,1.19932432432
384805,384929,385650,124,721,2,36000,1.17198335645
384806,384942,385629,136,687,2,36000,1.19796215429
384808,384958,385765,150,807,2,36000,1.18587360595
384809,384968,385615,159,647,2,36000,1.2457496136
384839,384978,385705,139,727,2,36000,1.19119669876
384840,384986,385682,146,696,2,36000,1.20977011494
384842,384993,385913,151,920,2,36000,1.16413043478
384843,384998,385691,155,693,2,36000,1.22366522367
384862,385005,385631,143,626,2,36000,1.22843450479
384863,385012,385632,149,620,2,36000,1.24032258065
384880,385029,385779,149,750,2,36000,1.19866666667
384898,385035,385722,137,687,2,36000,1.19941775837
384900,385041,385690,141,649,2,36000,1.21725731895
384916,385046,385746,130,700,2,36000,1.18571428571
384917,385053,385854,136,801,2,36000,1.16978776529
384935,385060,385772,125,712,2,36000,1.17556179775
384951,385067,385773,116,706,2,36000,1.16430594901
384968,385082,385991,114,909,2,36000,1.12541254125
384969,385089,385782,120,693,2,36000,1.17316017316
384995,385096,385821,101,725,2,36000,1.13931034483
384996,385113,385904,117,791,2,36000,1.14791403287
384997,385121,385996,124,875,2,36000,1.14171428571
384999,385128,385825,129,697,2,36000,1.18507890961
385025,385133,385926,108,793,2,36000,1.13619167718
385027,385143,385840,116,697,2,36000,1.16642754663
385028,385158,385916,130,758,2,36000,1.17150395778
385029,385165,385771,136,606,2,36000,1.22442244224
385031,385170,385914,139,744,2,36000,1.18682795699
385055,385178,385896,123,718,2,36000,1.1713091922
385057,385220,385916,163,696,2,36000,1.2341954023
385058,385227,386299,169,1072,2,36000,1.15764925373
385077,385232,385904,155,672,2,36000,1.2306547619
385079,385239,386006,160,767,2,36000,1.20860495437
385101,385246,386208,145,962,2,36000,1.15072765073
385102,385253,385948,151,695,2,36000,1.21726618705
385128,385258,385947,130,689,2,36000,1.18867924528
385129,385271,386033,142,762,2,36000,1.18635170604
385131,385299,386001,168,702,2,36000,1.23931623932
385153,385306,386009,153,703,2,36000,1.21763869132
385154,385348,386061,194,713,2,36000,1.27208976157
385155,385359,386011,204,652,2,36000,1.31288343558
385156,385366,386124,210,758,2,36000,1.27704485488
385182,385385,386075,203,690,2,36000,1.29420289855
385222,385405,386108,183,703,2,36000,1.26031294452
385223,385414,386092,191,678,2,36000,1.28171091445
385225,385421,386045,196,624,2,36000,1.3141025641
385244,385427,386142,183,715,2,36000,1.25594405594
385245,385444,386226,199,782,2,36000,1.25447570332
385247,385464,386176,217,712,2,36000,1.3047752809
385263,385471,386181,208,710,2,36000,1.29295774648
385292,385478,386225,186,747,2,36000,1.24899598394
385294,385483,386164,189,681,2,36000,1.27753303965
385339,385496,386289,157,793,2,36000,1.19798234552
385357,385502,386246,145,744,2,36000,1.19489247312
385358,385514,386325,156,811,2,36000,1.19235511714
385374,385526,386322,152,796,2,36000,1.19095477387
385396,385533,386266,137,733,2,36000,1.18690313779
385419,385540,386225,121,685,2,36000,1.17664233577
385420,385546,386378,126,832,2,36000,1.15144230769
385422,385557,386357,135,800,2,36000,1.16875
385439,385566,386254,127,688,2,36000,1.18459302326
385460,385573,386301,113,728,2,36000,1.15521978022
385462,385598,386291,136,693,2,36000,1.19624819625
385480,385615,386431,135,816,2,36000,1.16544117647
385481,385628,386330,147,702,2,36000,1.2094017094
385500,385641,386465,141,824,2,36000,1.17111650485
385501,385648,386323,147,675,2,36000,1.21777777778
385520,385653,386454,133,801,2,36000,1.16604244694
385521,385662,386673,141,1011,2,36000,1.13946587537
385522,385694,386435,172,741,2,36000,1.23211875843
385540,385703,386425,163,722,2,36000,1.22576177285
385542,385708,386420,166,712,2,36000,1.23314606742
385560,385715,386486,155,771,2,36000,1.20103761349
385561,385722,386467,161,745,2,36000,1.21610738255
385563,385734,386485,171,751,2,36000,1.22769640479
385588,385758,386455,170,697,2,36000,1.24390243902
385606,385777,386536,171,759,2,36000,1.22529644269
385630,385784,386534,154,750,2,36000,1.20533333333
385632,385789,386521,157,732,2,36000,1.21448087432
385651,385796,386619,145,823,2,36000,1.17618469016
385652,385801,386503,149,702,2,36000,1.21225071225
385654,385806,386437,152,631,2,36000,1.24088748019
385692,385833,386996,141,1163,2,36000,1.12123817713
385693,385840,386603,147,763,2,36000,1.19266055046
385695,385853,386573,158,720,2,36000,1.21944444444
385725,385866,386560,141,694,2,36000,1.20317002882
385726,385908,386527,182,619,2,36000,1.29402261712
385727,385916,386612,189,696,2,36000,1.27155172414
385747,385921,386661,174,740,2,36000,1.23513513514
385768,385928,386655,160,727,2,36000,1.22008253095
385790,385933,386754,143,821,2,36000,1.17417783191
385791,385938,386668,147,730,2,36000,1.20136986301
385792,385944,386651,152,707,2,36000,1.21499292786
385794,385951,386653,157,702,2,36000,1.22364672365
385795,385956,386712,161,756,2,36000,1.21296296296
385824,385963,386658,139,695,2,36000,1.2
385851,385968,386719,117,751,2,36000,1.15579227696
385852,386003,386697,151,694,2,36000,1.21757925072
385873,386325,386345,452,20,1,60,23.6
385875,386010,386694,135,684,2,36000,1.19736842105
385897,386017,386682,120,665,2,36000,1.18045112782
385915,386024,386734,109,710,2,36000,1.15352112676
385916,386029,386672,113,643,2,36000,1.17573872473
385917,386034,386663,117,629,2,36000,1.18600953895
385919,386046,386826,127,780,2,36000,1.16282051282
385937,386057,386789,120,732,2,36000,1.16393442623
385938,386073,386833,135,760,2,36000,1.17763157895
385939,386087,386849,148,762,2,36000,1.19422572178
385955,386104,386799,149,695,2,36000,1.21438848921
385956,386121,386709,165,588,2,36000,1.2806122449
385958,386136,386882,178,746,2,36000,1.23860589812
385993,386149,386792,156,643,2,36000,1.24261275272
386011,386157,386803,146,646,2,36000,1.22600619195
386012,386176,386816,164,640,2,36000,1.25625
386013,386188,386994,175,806,2,36000,1.21712158809
386015,386194,387056,179,862,2,36000,1.20765661253
386016,386220,386914,204,694,2,36000,1.2939481268
386038,386236,386965,198,729,2,36000,1.27160493827
386055,386242,386880,187,638,2,36000,1.29310344828
386070,386249,387406,179,1157,2,36000,1.15471045808
386090,386258,387083,168,825,2,36000,1.20363636364
386106,386267,387027,161,760,2,36000,1.21184210526
386120,386278,387360,158,1082,2,36000,1.146025878
386136,386301,386935,165,634,2,36000,1.26025236593
386137,386308,387057,171,749,2,36000,1.22830440587
386153,386315,387020,162,705,2,36000,1.22978723404
386169,386320,387090,151,770,2,36000,1.1961038961
386181,386457,393707,276,7250,1,7200,1.03806896552
386185,386334,387034,149,700,2,36000,1.21285714286
386186,386341,387072,155,731,2,36000,1.21203830369
386208,386346,387005,138,659,2,36000,1.20940819423
386228,386353,387115,125,762,2,36000,1.16404199475
386229,386369,387151,140,782,2,36000,1.17902813299
386231,386390,387098,159,708,2,36000,1.22457627119
386247,386433,387249,186,816,2,36000,1.22794117647
386266,386440,387261,174,821,2,36000,1.21193666261
386267,386447,387244,180,797,2,36000,1.22584692597
386290,386452,387260,162,808,2,36000,1.2004950495
386306,386464,387147,158,683,2,36000,1.23133235725
386307,386471,387439,164,968,2,36000,1.1694214876
386308,387603,474038,1295,86435,1,86400,1.01498235668
386308,386476,387281,168,805,2,36000,1.20869565217
386331,386483,387329,152,846,2,36000,1.17966903073
386332,386488,387301,156,813,2,36000,1.19188191882
386333,386497,387236,164,739,2,36000,1.22192151556
386335,386504,387288,169,784,2,36000,1.21556122449
386365,386516,387318,151,802,2,36000,1.18827930175
386382,386534,387193,152,659,2,36000,1.23065250379
386432,386541,387232,109,691,2,36000,1.15774240232
386433,386547,387385,114,838,2,36000,1.13603818616
386452,386553,387336,101,783,2,36000,1.12899106003
386453,386572,387270,119,698,2,36000,1.17048710602
386454,386585,387424,131,839,2,36000,1.15613825983
386478,386615,387335,137,720,2,36000,1.19027777778
386480,386624,387371,144,747,2,36000,1.19277108434
386481,386631,387428,150,797,2,36000,1.18820577164
386482,386663,387342,181,679,2,36000,1.26656848306
386498,386669,387485,171,816,2,36000,1.20955882353
386499,386675,387459,176,784,2,36000,1.22448979592
386514,386680,387426,166,746,2,36000,1.22252010724
386530,386687,387429,157,742,2,36000,1.2115902965
386532,386693,387455,161,762,2,36000,1.21128608924
386548,386698,387522,150,824,2,36000,1.18203883495
386549,386703,387499,154,796,2,36000,1.19346733668
386564,386708,387464,144,756,2,36000,1.19047619048
386580,386715,387546,135,831,2,36000,1.16245487365
386605,386720,387480,115,760,2,36000,1.15131578947
386621,386725,387526,104,801,2,36000,1.12983770287
386622,386732,387525,110,793,2,36000,1.13871374527
386657,386737,387474,80,737,2,36000,1.10854816825
386659,386742,387481,83,739,2,36000,1.11231393775
386661,386749,387541,88,792,2,36000,1.11111111111
386682,386766,387529,84,763,2,36000,1.11009174312
386683,386802,387537,119,735,2,36000,1.1619047619
386685,386809,387609,124,800,2,36000,1.155
386686,386816,387606,130,790,2,36000,1.16455696203
386688,386821,387590,133,769,2,36000,1.17295188557
386689,386829,387596,140,767,2,36000,1.18252933507
386690,386839,387596,149,757,2,36000,1.19682959049
386716,386846,387586,130,740,2,36000,1.17567567568
386718,386861,387630,143,769,2,36000,1.18595578674
386719,386892,387652,173,760,2,36000,1.22763157895
386720,386899,387780,179,881,2,36000,1.20317820658
386737,386926,387676,189,750,2,36000,1.252
386738,386947,387725,209,778,2,36000,1.26863753213
386757,386977,387783,220,806,2,36000,1.2729528536
386790,387006,387708,216,702,2,36000,1.30769230769
386813,387013,387766,200,753,2,36000,1.26560424967
386814,387020,387814,206,794,2,36000,1.25944584383
386816,387032,387784,216,752,2,36000,1.28723404255
386851,387039,387845,188,806,2,36000,1.23325062035
386852,387046,387904,194,858,2,36000,1.22610722611
386854,387068,388127,214,1059,2,36000,1.20207743154
386855,387075,387846,220,771,2,36000,1.28534370947
386881,387084,388210,203,1126,2,36000,1.18028419183
386883,387095,387944,212,849,2,36000,1.24970553592
386914,387102,387806,188,704,2,36000,1.26704545455
386935,387111,387917,176,806,2,36000,1.21836228288
386966,387127,387934,161,807,2,36000,1.19950433705
386995,387160,387836,165,676,2,36000,1.24408284024
386996,387167,387958,171,791,2,36000,1.21618204804
387013,387205,387943,192,738,2,36000,1.26016260163
387029,387244,388044,215,800,2,36000,1.26875
387030,387251,388050,221,799,2,36000,1.27659574468
387046,387258,387977,212,719,2,36000,1.29485396384
387061,387265,388107,204,842,2,36000,1.24228028504
387063,387272,388052,209,780,2,36000,1.26794871795
387078,387279,388044,201,765,2,36000,1.26274509804
387094,387286,388404,192,1118,2,36000,1.1717352415
387095,387293,388086,198,793,2,36000,1.24968474149
387111,387300,388100,189,800,2,36000,1.23625
387126,387312,388115,186,803,2,36000,1.23163138232
387150,387330,388065,180,735,2,36000,1.24489795918
387165,387341,388064,176,723,2,36000,1.24343015214
387193,387348,388148,155,800,2,36000,1.19375
387195,387493,387593,298,100,1,60,3.98
387234,387353,388061,119,708,2,36000,1.16807909605
387238,458805,498670,71567,39865,10,57600,2.79523391446
387256,387360,388151,104,791,2,36000,1.13147914033
387257,387371,388106,114,735,2,36000,1.15510204082
387258,387383,388153,125,770,2,36000,1.16233766234
387276,387397,388228,121,831,2,36000,1.14560770156
387277,387418,388232,141,814,2,36000,1.17321867322
387278,387436,388259,158,823,2,36000,1.19198055893
387295,387443,388254,148,811,2,36000,1.18249075216
387296,387448,388255,152,807,2,36000,1.18835192069
387319,387453,388295,134,842,2,36000,1.15914489311
387321,387460,388227,139,767,2,36000,1.18122555411
387345,434926,465550,47581,30624,12,43200,2.55371603971
387352,387467,388305,115,838,2,36000,1.13723150358
387354,387474,388264,120,790,2,36000,1.15189873418
387355,387481,388289,126,808,2,36000,1.15594059406
387356,387488,388273,132,785,2,36000,1.16815286624
387373,387500,388285,127,785,2,36000,1.16178343949
387374,387505,388244,131,739,2,36000,1.17726657645
387392,387511,388287,119,776,2,36000,1.15335051546
387411,387518,388175,107,657,2,36000,1.16286149163
387436,387534,388224,98,690,2,36000,1.14202898551
387438,387541,388361,103,820,2,36000,1.1256097561
387439,387546,388336,107,790,2,36000,1.13544303797
387440,387610,388393,170,783,2,36000,1.21711366539
387460,405182,577990,17722,172808,4,172800,1.10255312254
387469,387664,388490,195,826,2,36000,1.23607748184
387470,387737,388455,267,718,2,36000,1.37186629526
387472,387778,388545,306,767,2,36000,1.39895697523
387473,387819,388663,346,844,2,36000,1.40995260664
387496,387826,388549,330,723,2,36000,1.45643153527
387497,387848,388703,351,855,2,36000,1.41052631579
387498,387857,388596,359,739,2,36000,1.48579161028
387500,387916,388603,416,687,2,36000,1.60553129549
387518,387930,388737,412,807,2,36000,1.51053283767
387523,420448,593288,32925,172840,4,172800,1.19049409859
387535,387947,388698,412,751,2,36000,1.54860186418
387537,387955,388681,418,726,2,36000,1.57575757576
387538,387971,388819,433,848,2,36000,1.51061320755
387539,387988,388757,449,769,2,36000,1.58387516255
387555,388057,388914,502,857,2,36000,1.58576429405
387557,388062,388933,505,871,2,36000,1.57979334099
387558,388069,388817,511,748,2,36000,1.68315508021
387586,388076,388770,490,694,2,36000,1.7060518732
387603,388081,388831,478,750,2,36000,1.63733333333
387604,388099,388877,495,778,2,36000,1.63624678663
387605,388117,388929,512,812,2,36000,1.63054187192
387621,388124,388919,503,795,2,36000,1.63270440252
387622,388131,388888,509,757,2,36000,1.67239101717
387637,388140,388895,503,755,2,36000,1.66622516556
387654,388160,388973,506,813,2,36000,1.62238622386
387675,388167,388949,492,782,2,36000,1.62915601023
387709,388172,388869,463,697,2,36000,1.66427546628
387727,388187,388961,460,774,2,36000,1.59431524548
387767,388236,388963,469,727,2,36000,1.64511691884
387768,406847,561722,19079,154875,2,172800,1.12318966909
387784,388257,389024,473,767,2,36000,1.61668839635
387785,388267,389103,482,836,2,36000,1.57655502392
387787,388274,388987,487,713,2,36000,1.68302945302
387808,388281,389089,473,808,2,36000,1.5853960396
387823,388288,389079,465,791,2,36000,1.58786346397
387842,388300,388896,458,596,2,36000,1.76845637584
387883,388307,389093,424,786,2,36000,1.53944020356
387884,388312,389062,428,750,2,36000,1.57066666667
387904,388319,389131,415,812,2,36000,1.51108374384
387919,388349,389182,430,833,2,36000,1.51620648259
387938,388373,389140,435,767,2,36000,1.56714471969
387962,388404,389237,442,833,2,36000,1.5306122449
387963,388416,389107,453,691,2,36000,1.65557163531
387964,388467,389219,503,752,2,36000,1.66888297872
387980,388502,389344,522,842,2,36000,1.61995249406
388047,388557,389308,510,751,2,36000,1.67909454061
388049,388564,389354,515,790,2,36000,1.65189873418
388066,388608,389367,542,759,2,36000,1.71409749671
388067,388616,389346,549,730,2,36000,1.75205479452
388069,388676,389520,607,844,2,36000,1.7191943128
388070,388693,389499,623,806,2,36000,1.7729528536
388071,388711,389505,640,794,2,36000,1.80604534005
388091,388718,389525,627,807,2,36000,1.77695167286
388108,388749,389579,641,830,2,36000,1.77228915663
388109,388769,389546,660,777,2,36000,1.84942084942
388111,388782,389547,671,765,2,36000,1.87712418301
388127,388830,389631,703,801,2,36000,1.87765293383
388129,388837,389554,708,717,2,36000,1.98744769874
388148,388844,389669,696,825,2,36000,1.84363636364
388164,388882,389742,718,860,2,36000,1.83488372093
388165,388889,389728,724,839,2,36000,1.86293206198
388176,393685,398706,5509,5021,16,7200,2.09719179446
388181,388900,389714,719,814,2,36000,1.88329238329
388212,388907,389716,695,809,2,36000,1.85908529048
388236,388914,389643,678,729,2,36000,1.93004115226
388238,388927,389740,689,813,2,36000,1.84747847478
388239,388934,389736,695,802,2,36000,1.86658354115
388241,388941,389771,700,830,2,36000,1.84337349398
388272,388948,389675,676,727,2,36000,1.92984869326
388273,388962,389778,689,816,2,36000,1.8443627451
388275,388973,389732,698,759,2,36000,1.91963109354
388276,388980,389761,704,781,2,36000,1.9014084507
388277,388987,389789,710,802,2,36000,1.88528678304
388297,388999,389797,702,798,2,36000,1.87969924812
388298,389037,389808,739,771,2,36000,1.95849546044
388299,389073,389889,774,816,2,36000,1.94852941176
388301,389091,389891,790,800,2,36000,1.9875
388302,389101,389910,799,809,2,36000,1.98763906057
388318,389108,389832,790,724,2,36000,2.09116022099
388336,389115,389901,779,786,2,36000,1.99109414758
388362,389122,389916,760,794,2,36000,1.95717884131
388394,389144,389940,750,796,2,36000,1.94221105528
388398,398718,404027,10320,5309,16,7200,2.94386890186
388415,389152,389815,737,663,2,36000,2.11161387632
388457,389194,389991,737,797,2,36000,1.92471769134
388491,389231,390071,740,840,2,36000,1.88095238095
388536,389131,389446,595,315,4,108000,2.88888888889
388546,389250,389989,704,739,2,36000,1.95263870095
388561,389321,390114,760,793,2,36000,1.95838587642
388598,389356,390186,758,830,2,36000,1.91325301205
388613,389363,390158,750,795,2,36000,1.94339622642
388638,395318,398823,6680,3505,32,7200,2.90584878745
388665,389370,390134,705,764,2,36000,1.92277486911
388680,389379,390191,699,812,2,36000,1.86083743842
388699,389511,390321,812,810,2,36000,2.0024691358
388713,389518,390275,805,757,2,36000,2.06340819022
388738,389533,390524,795,991,2,36000,1.80221997982
388756,389540,390333,784,793,2,36000,1.98865069357
388773,389558,390256,785,698,2,36000,2.12464183381
388777,390359,390365,1582,6,4,108000,158.8
388819,389565,390269,746,704,2,36000,2.05965909091
388820,389571,390196,751,625,2,36000,2.2016
388837,389591,390332,754,741,2,36000,2.01754385965
388873,389643,390434,770,791,2,36000,1.97345132743
388893,389655,390432,762,777,2,36000,1.98069498069
388894,389681,390503,787,822,2,36000,1.95742092457
388918,389688,390440,770,752,2,36000,2.02393617021
388919,389726,390529,807,803,2,36000,2.00498132005
388920,389733,390519,813,786,2,36000,2.03435114504
388939,389741,390496,802,755,2,36000,2.06225165563
388940,389748,390492,808,744,2,36000,2.08602150538
388941,389753,390511,812,758,2,36000,2.07124010554
388953,390377,392772,1424,2395,4,108000,1.59457202505
388963,389760,390512,797,752,2,36000,2.05984042553
388964,389765,390542,801,777,2,36000,2.03088803089
388966,389774,390534,808,760,2,36000,2.06315789474
388984,389783,390796,799,1013,2,36000,1.78874629812
389000,389790,390599,790,809,2,36000,1.97651421508
389025,389801,390574,776,773,2,36000,2.00388098318
389065,389809,390545,744,736,2,36000,2.01086956522
389080,389820,390560,740,740,2,36000,2.0
389095,389827,390605,732,778,2,36000,1.94087403599
389096,389844,390705,748,861,2,36000,1.868757259
389112,389901,390620,789,719,2,36000,2.09735744089
389113,389908,390772,795,864,2,36000,1.92013888889
389132,389915,390628,783,713,2,36000,2.09817671809
389147,389922,390548,775,626,2,36000,2.23801916933
389184,389929,390787,745,858,2,36000,1.8682983683
389219,389952,390710,733,758,2,36000,1.96701846966
389240,390002,390784,762,782,2,36000,1.97442455243
389310,390009,390755,699,746,2,36000,1.93699731903
389354,390083,390731,729,648,2,36000,2.125
389355,390126,390905,771,779,2,36000,1.98973042362
389356,390146,390932,790,786,2,36000,2.00508905852
389376,390170,390876,794,706,2,36000,2.12464589235
389469,447426,465459,57957,18033,17,18000,4.21394110797
389499,390198,391001,699,803,2,36000,1.8704856787
389515,458794,476819,69279,18025,17,18000,4.84349514563
389515,390205,391076,690,871,2,36000,1.79219288175
389530,390212,390995,682,783,2,36000,1.87100893997
389532,390268,391078,736,810,2,36000,1.90864197531
389547,390282,391165,735,883,2,36000,1.83238958097
389548,390289,391087,741,798,2,36000,1.92857142857
389564,390333,391079,769,746,2,36000,2.0308310992
389583,390344,390963,761,619,2,36000,2.22940226171
389633,390351,391124,718,773,2,36000,1.92884864166
389649,390444,391245,795,801,2,36000,1.9925093633
389671,390451,391186,780,735,2,36000,2.0612244898
389688,390458,391216,770,758,2,36000,2.01583113456
389714,390504,391126,790,622,2,36000,2.27009646302
389740,390511,391286,771,775,2,36000,1.99483870968
389741,390518,391337,777,819,2,36000,1.94871794872
389743,390525,391243,782,718,2,36000,2.08913649025
389744,390530,391377,786,847,2,36000,1.9279811098
389772,390537,391993,765,1456,2,36000,1.52541208791
389773,390542,391232,769,690,2,36000,2.11449275362
389774,390549,391306,775,757,2,36000,2.02377807133
389776,390554,391331,778,777,2,36000,2.00128700129
389791,390561,391345,770,784,2,36000,1.98214285714
389793,390566,391348,773,782,2,36000,1.98849104859
389809,390571,391383,762,812,2,36000,1.93842364532
389810,390579,391340,769,761,2,36000,2.01051248357
389827,390586,391511,759,925,2,36000,1.82054054054
389842,390610,391264,768,654,2,36000,2.17431192661
389892,390618,391397,726,779,2,36000,1.93196405648
389893,390632,391401,739,769,2,36000,1.96098829649
389909,390641,391363,732,722,2,36000,2.01385041551
389924,390718,391494,794,776,2,36000,2.02319587629
389925,390725,391510,800,785,2,36000,2.01910828025
389940,390744,391493,804,749,2,36000,2.07343124166
389993,390768,391522,775,754,2,36000,2.02785145889
389994,390785,391713,791,928,2,36000,1.85237068966
390072,390796,391460,724,664,2,36000,2.09036144578
390113,390803,391640,690,837,2,36000,1.82437275986
390135,390810,391591,675,781,2,36000,1.8642765685
390160,390889,391686,729,797,2,36000,1.91468005019
390188,390917,391721,729,804,2,36000,1.90671641791
390204,390943,391634,739,691,2,36000,2.06946454414
390205,390975,391698,770,723,2,36000,2.06500691563
390258,391008,391856,750,848,2,36000,1.88443396226
390273,391015,391992,742,977,2,36000,1.75946775844
390288,391088,391816,800,728,2,36000,2.0989010989
390323,391095,391960,772,865,2,36000,1.89248554913
390339,391100,391882,761,782,2,36000,1.97314578005
390340,391107,391831,767,724,2,36000,2.05939226519
390429,391136,391962,707,826,2,36000,1.85593220339
390445,391143,391972,698,829,2,36000,1.84197828709
390446,391177,391981,731,804,2,36000,1.9092039801
390500,391197,392012,697,815,2,36000,1.85521472393
390502,391228,391975,726,747,2,36000,1.9718875502
390521,391244,392003,723,759,2,36000,1.95256916996
390523,391255,391874,732,619,2,36000,2.18255250404
390524,391262,392077,738,815,2,36000,1.90552147239
390525,391276,391995,751,719,2,36000,2.04450625869
390542,391299,392087,757,788,2,36000,1.96065989848
390543,391318,392065,775,747,2,36000,2.0374832664
390545,391343,392081,798,738,2,36000,2.08130081301
390546,391350,392123,804,773,2,36000,2.04010349288
390573,391357,392123,784,766,2,36000,2.02349869452
390575,391362,392149,787,787,2,36000,2.0
390576,391369,392176,793,807,2,36000,1.98265179678
390577,391376,392150,799,774,2,36000,2.0322997416
390606,391390,392056,784,666,2,36000,2.17717717718
390608,391397,392026,789,629,2,36000,2.25437201908
390630,391409,392207,779,798,2,36000,1.97619047619
390632,391416,392125,784,709,2,36000,2.10578279267
390712,391473,392358,761,885,2,36000,1.85988700565
390714,391505,392279,791,774,2,36000,2.02196382429
390739,391517,392305,778,788,2,36000,1.98730964467
390762,391524,392348,762,824,2,36000,1.92475728155
390784,391529,392307,745,778,2,36000,1.95758354756
390785,391541,392309,756,768,2,36000,1.984375
390829,391603,392405,774,802,2,36000,1.9650872818
390830,391646,392379,816,733,2,36000,2.11323328786
390887,391653,392365,766,712,2,36000,2.07584269663
390909,391698,392523,789,825,2,36000,1.95636363636
390937,391710,392464,773,754,2,36000,2.02519893899
390965,391725,392478,760,753,2,36000,2.00929614874
390996,391733,392525,737,792,2,36000,1.93055555556
391011,391829,392668,818,839,2,36000,1.97497020262
391077,391844,392613,767,769,2,36000,1.99739921977
391078,391869,392628,791,759,2,36000,2.04216073781
391094,391886,392711,792,825,2,36000,1.96
391096,391894,392683,798,789,2,36000,2.01140684411
391124,391973,392932,849,959,2,36000,1.88529718457
391140,391980,392813,840,833,2,36000,2.00840336134
391165,391986,392796,821,810,2,36000,2.01358024691
391186,391992,392806,806,814,2,36000,1.99017199017
391217,391999,392791,782,792,2,36000,1.98737373737
391233,392011,392847,778,836,2,36000,1.93062200957
391249,392016,392743,767,727,2,36000,2.05502063274
391250,392023,392705,773,682,2,36000,2.13343108504
391265,392028,392882,763,854,2,36000,1.89344262295
391287,392035,392802,748,767,2,36000,1.97522816167
391308,392042,392769,734,727,2,36000,2.00962861073
391330,392068,392863,738,795,2,36000,1.92830188679
391345,392077,392804,732,727,2,36000,2.00687757909
391346,392089,392871,743,782,2,36000,1.95012787724
391348,392096,392824,748,728,2,36000,2.02747252747
391364,392103,392988,739,885,2,36000,1.83502824859
391365,392135,392964,770,829,2,36000,1.92882991556
391380,392140,392837,760,697,2,36000,2.09038737446
391396,392147,392931,751,784,2,36000,1.95790816327
391398,392161,392879,763,718,2,36000,2.06267409471
391415,392168,392975,753,807,2,36000,1.93308550186
391464,392188,393046,724,858,2,36000,1.84382284382
391501,392219,393004,718,785,2,36000,1.91464968153
391502,392292,393043,790,751,2,36000,2.05193075899
391528,392317,393101,789,784,2,36000,2.00637755102
391529,392329,393079,800,750,2,36000,2.06666666667
391529,391536,391539,7,3,1,300,1.0
391530,392334,393083,804,749,2,36000,2.07343124166
391593,392361,393122,768,761,2,36000,2.00919842313
391634,392370,393072,736,702,2,36000,2.04843304843
391649,392377,393253,728,876,2,36000,1.83105022831
391689,392391,393214,702,823,2,36000,1.85297691373
391704,392417,393093,713,676,2,36000,2.05473372781
391719,392476,393255,757,779,2,36000,1.97175866496
391734,392491,393318,757,827,2,36000,1.915356711
391820,392535,393354,715,819,2,36000,1.87301587302
391839,392542,393290,703,748,2,36000,1.93983957219
391857,392625,393414,768,789,2,36000,1.97338403042
391877,392641,393525,764,884,2,36000,1.86425339367
391895,392680,393517,785,837,2,36000,1.93787335723
391957,392696,393428,739,732,2,36000,2.00956284153
391973,392717,393402,744,685,2,36000,2.08613138686
391974,392724,393512,750,788,2,36000,1.95177664975
391990,392755,393539,765,784,2,36000,1.97576530612
391991,392781,393605,790,824,2,36000,1.95873786408
391994,392006,392101,12,95,1,60,1.12631578947
392008,392804,393606,796,802,2,36000,1.99251870324
392009,392811,393527,802,716,2,36000,2.12011173184
392011,392817,393639,806,822,2,36000,1.98053527981
392012,392822,393589,810,767,2,36000,2.05606258149
392027,392828,393635,801,807,2,36000,1.99256505576
392029,392835,393623,806,788,2,36000,2.02284263959
392046,401490,401505,9444,15,2,108000,630.6
392057,392842,393661,785,819,2,36000,1.95848595849
392072,392849,393553,777,704,2,36000,2.10369318182
392087,392859,393690,772,831,2,36000,1.92900120337
392089,392875,393707,786,832,2,36000,1.94471153846
392090,392884,393688,794,804,2,36000,1.98756218905
392124,392890,393602,766,712,2,36000,2.07584269663
392126,392897,393723,771,826,2,36000,1.93341404358
392141,392943,393686,802,743,2,36000,2.07940780619
392156,392949,393708,793,759,2,36000,2.04479578393
392158,392976,393762,818,786,2,36000,2.04071246819
392179,392987,393772,808,785,2,36000,2.02929936306
392207,392999,393777,792,778,2,36000,2.01799485861
392281,393016,393801,735,785,2,36000,1.93630573248
392306,393054,393854,748,800,2,36000,1.935
392312,392324,392400,12,76,1,600,1.15789473684
392321,393062,393856,741,794,2,36000,1.93324937028
392322,393083,393825,761,742,2,36000,2.025606469
392356,393091,393874,735,783,2,36000,1.93869731801
392381,393097,393831,716,734,2,36000,1.97547683924
392382,393105,393867,723,762,2,36000,1.94881889764
392383,393113,393949,730,836,2,36000,1.87320574163
392406,393134,393918,728,784,2,36000,1.92857142857
392465,393226,393981,761,755,2,36000,2.00794701987
392484,393265,394053,781,788,2,36000,1.99111675127
392525,393272,394053,747,781,2,36000,1.95646606914
392527,393303,394128,776,825,2,36000,1.94060606061
392615,393330,394139,715,809,2,36000,1.88380716934
392630,393366,394092,736,726,2,36000,2.01377410468
392670,393414,394050,744,636,2,36000,2.16981132075
392682,392689,392691,7,2,1,1800,1.0
392685,393426,394216,741,790,2,36000,1.93797468354
392706,393441,394132,735,691,2,36000,2.06367583213
392707,401670,423962,8963,22292,4,360000,1.40207249237
392714,404039,404102,11325,63,4,360000,180.761904762
392720,404106,419099,11386,14993,4,360000,1.75942106316
392722,393524,394272,802,748,2,36000,2.07219251337
392743,393531,394360,788,829,2,36000,1.95054282268
392754,401523,509541,8769,108018,2,108000,1.08118091429
392771,393538,394344,767,806,2,36000,1.95161290323
392792,393545,394245,753,700,2,36000,2.07571428571
392810,393552,394339,742,787,2,36000,1.94282083863
392811,393564,394331,753,767,2,36000,1.98174706649
392813,393602,394337,789,735,2,36000,2.07346938776
392814,393615,394413,801,798,2,36000,2.0037593985
392833,393621,394520,788,899,2,36000,1.8765294772
392834,393626,394363,792,737,2,36000,2.07462686567
392850,393636,394451,786,815,2,36000,1.96441717791
392851,393648,394462,797,814,2,36000,1.97911547912
392867,393655,394542,788,887,2,36000,1.88838782413
392883,393673,394457,790,784,2,36000,2.00765306122
392884,393698,394452,814,754,2,36000,2.07957559682
392885,393705,394486,820,781,2,36000,2.04993597951
392931,393710,394508,779,798,2,36000,1.97619047619
392933,393719,394527,786,808,2,36000,1.97277227723
392964,393725,394455,761,730,2,36000,2.04246575342
392979,393738,394497,759,759,2,36000,2.0
392994,393775,394560,781,785,2,36000,1.9949044586
393009,393784,394617,775,833,2,36000,1.93037214886
393046,393791,394572,745,781,2,36000,1.95390524968
393047,393813,394522,766,709,2,36000,2.08039492243
393072,393837,394631,765,794,2,36000,1.96347607053
393090,393844,394634,754,790,2,36000,1.95443037975
393092,393867,394602,775,735,2,36000,2.05442176871
393112,393874,394644,762,770,2,36000,1.98961038961
393113,393881,394805,768,924,2,36000,1.83116883117
393129,393888,394658,759,770,2,36000,1.98571428571
393144,393151,393215,7,64,1,600,1.109375
393216,393930,394727,714,797,2,36000,1.89585947302
393230,393237,393239,7,2,1,1800,1.0
393253,393961,394790,708,829,2,36000,1.85404101327
393268,393993,394771,725,778,2,36000,1.93187660668
393292,394062,394831,770,769,2,36000,2.00130039012
393320,394069,394863,749,794,2,36000,1.94332493703
393356,394074,394827,718,753,2,36000,1.95351925631
393402,394105,394799,703,694,2,36000,2.01296829971
393417,394139,394998,722,859,2,36000,1.84051222352
393432,394147,394955,715,808,2,36000,1.8849009901
393520,394154,394962,634,808,2,36000,1.78465346535
393522,394227,395012,705,785,2,36000,1.89808917197
393538,394257,395186,719,929,2,36000,1.77395048439
393539,394283,395077,744,794,2,36000,1.93702770781
393556,394343,395130,787,787,2,36000,2.0
393557,394350,395145,793,795,2,36000,1.99748427673
393593,394356,395135,763,779,2,36000,1.97946084724
393612,394362,395148,750,786,2,36000,1.95419847328
393614,394372,395107,758,735,2,36000,2.03129251701
393615,394384,395190,769,806,2,36000,1.9540942928
393631,394425,395228,794,803,2,36000,1.98879202989
393646,394464,395344,818,880,2,36000,1.92954545455
393647,394469,395291,822,822,2,36000,2.0
393663,394476,395256,813,780,2,36000,2.04230769231
393691,394481,395140,790,659,2,36000,2.19878603945
393693,394486,395180,793,694,2,36000,2.14265129683
393694,394498,395277,804,779,2,36000,2.03209242619
393713,394509,395343,796,834,2,36000,1.95443645084
393714,394520,395294,806,774,2,36000,2.04134366925
393715,393732,394063,17,331,1,300,1.05135951662
393730,394531,395302,801,771,2,36000,2.03891050584
393763,394538,395321,775,783,2,36000,1.98978288633
393779,394545,395465,766,920,2,36000,1.83260869565
393781,394554,395370,773,816,2,36000,1.94730392157
393803,394573,395362,770,789,2,36000,1.97591888466
393819,393825,397177,6,3352,1,7200,1.00178997613
393826,394584,395396,758,812,2,36000,1.93349753695
393841,394614,395375,773,761,2,36000,2.01576872536
393843,394081,496919,238,102838,1,576000,1.00231431961
393856,394629,395382,773,753,2,36000,2.02656042497
393857,394643,395388,786,745,2,36000,2.05503355705
393873,394650,395459,777,809,2,36000,1.96044499382
393889,394657,395424,768,767,2,36000,2.00130378096
393919,394671,395458,752,787,2,36000,1.95552731893
393950,394739,395625,789,886,2,36000,1.89051918736
393983,394782,395436,799,654,2,36000,2.22171253823
394052,394801,395709,749,908,2,36000,1.82488986784
394068,394811,395564,743,753,2,36000,1.98671978752
394069,394818,395676,749,858,2,36000,1.87296037296
394096,394839,395654,743,815,2,36000,1.91165644172
394129,394846,395650,717,804,2,36000,1.89179104478
394148,394874,395626,726,752,2,36000,1.96542553191
394150,394967,395761,817,794,2,36000,2.02896725441
394215,394974,395756,759,782,2,36000,1.97058823529
394246,395011,395884,765,873,2,36000,1.87628865979
394273,395025,395885,752,860,2,36000,1.87441860465
394332,395089,395853,757,764,2,36000,1.99083769634
394348,395119,396187,771,1068,2,36000,1.72191011236
394349,395142,395877,793,735,2,36000,2.07891156463
394350,395149,395969,799,820,2,36000,1.9743902439
394365,395156,395939,791,783,2,36000,2.01021711367
394367,395163,395917,796,754,2,36000,2.05570291777
394416,395168,396130,752,962,2,36000,1.7817047817
394454,395192,395956,738,764,2,36000,1.96596858639
394455,395198,395966,743,768,2,36000,1.96744791667
394471,395206,395953,735,747,2,36000,1.98393574297
394473,395241,396017,768,776,2,36000,1.98969072165
394474,395268,396074,794,806,2,36000,1.98511166253
394490,395290,396136,800,846,2,36000,1.94562647754
394505,395304,396081,799,777,2,36000,2.02831402831
394523,395311,396109,788,798,2,36000,1.98746867168
394524,395323,396147,799,824,2,36000,1.96966019417
394526,395333,396117,807,784,2,36000,2.02933673469
394542,395356,396175,814,819,2,36000,1.99389499389
394544,395361,396089,817,728,2,36000,2.12225274725
394562,395374,396116,812,742,2,36000,2.09433962264
394578,395382,396136,804,754,2,36000,2.06631299735
394604,395389,396191,785,802,2,36000,1.97880299252
394622,395396,396124,774,728,2,36000,2.06318681319
394638,395403,396134,765,731,2,36000,2.04651162791
394640,395410,396133,770,723,2,36000,2.06500691563
394660,395442,396128,782,686,2,36000,2.13994169096
394661,395449,396292,788,843,2,36000,1.93475682088
394729,395469,396306,740,837,2,36000,1.88410991637
394772,395476,396210,704,734,2,36000,1.9591280654
394777,394789,394798,12,9,1,7260,2.1
394790,395483,396287,693,804,2,36000,1.86194029851
394806,395577,396350,771,773,2,36000,1.99741267788
394807,395637,396464,830,827,2,36000,2.00362756953
394829,395643,396385,814,742,2,36000,2.09703504043
394844,395661,396552,817,891,2,36000,1.91694725028
394865,395668,396480,803,812,2,36000,1.98891625616
394958,395688,396494,730,806,2,36000,1.90570719603
394975,401675,401696,6700,21,2,108000,320.047619048
394976,395722,396384,746,662,2,36000,2.12688821752
394999,395768,396491,769,723,2,36000,2.06362378976
395008,404111,405169,9103,1058,4,432000,9.60396975425
395020,395775,396617,755,842,2,36000,1.89667458432
395078,395865,396612,787,747,2,36000,2.05354752343
395109,395890,396715,781,825,2,36000,1.94666666667
395130,395896,396711,766,815,2,36000,1.93987730061
395146,395901,396630,755,729,2,36000,2.03566529492
395147,395929,396764,782,835,2,36000,1.93652694611
395149,395951,396771,802,820,2,36000,1.97804878049
395164,395966,396876,802,910,2,36000,1.88131868132
395183,395973,396772,790,799,2,36000,1.9887359199
395198,395984,396895,786,911,2,36000,1.8627881449
395199,395991,396746,792,755,2,36000,2.04900662252
395230,396029,396847,799,818,2,36000,1.97677261614
395257,396086,396814,829,728,2,36000,2.13873626374
395278,396093,396911,815,818,2,36000,1.99633251834
395298,396101,396938,803,837,2,36000,1.95937873357
395299,396121,396920,822,799,2,36000,2.02878598248
395314,396132,396933,818,801,2,36000,2.02122347066
395330,396139,396865,809,726,2,36000,2.11432506887
395345,396144,396949,799,805,2,36000,1.99254658385
395346,396151,396934,805,783,2,36000,2.02809706258
395365,396156,397067,791,911,2,36000,1.8682766191
395387,396161,396931,774,770,2,36000,2.00519480519
395388,396166,396939,778,773,2,36000,2.0064683053
395390,396172,397033,782,861,2,36000,1.90824622532
395391,396177,396857,786,680,2,36000,2.15588235294
395407,396184,397060,777,876,2,36000,1.88698630137
395433,396191,396904,758,713,2,36000,2.06311360449
395450,396199,396900,749,701,2,36000,2.06847360913
395469,396206,397047,737,841,2,36000,1.87633769322
395470,396221,397118,751,897,2,36000,1.83723522854
395471,396300,396937,829,637,2,36000,2.30141287284
395566,396307,397065,741,758,2,36000,1.97757255937
395624,396318,397105,694,787,2,36000,1.88182973316
395639,396362,396988,723,626,2,36000,2.15495207668
395654,396396,397095,742,699,2,36000,2.06151645207
395656,396403,397150,747,747,2,36000,2.0
395677,396475,397250,798,775,2,36000,2.02967741935
395711,396493,397204,782,711,2,36000,2.09985935302
395757,396503,397342,746,839,2,36000,1.88915375447
395772,396510,397417,738,907,2,36000,1.81367144432
395854,396563,397368,709,805,2,36000,1.88074534161
395879,396625,397429,746,804,2,36000,1.92786069652
395881,396631,397383,750,752,2,36000,1.99734042553
395895,396643,397487,748,844,2,36000,1.88625592417
395916,396724,397507,808,783,2,36000,2.0319284802
395939,396731,397555,792,824,2,36000,1.96116504854
395955,396757,397555,802,798,2,36000,2.00501253133
395956,396776,397511,820,735,2,36000,2.1156462585
395972,395979,396111,7,132,1,60,1.05303030303
395973,396784,397503,811,719,2,36000,2.12795549374
395974,396789,397492,815,703,2,36000,2.15931721195
396018,396826,397565,808,739,2,36000,2.09336941813
396074,396858,397700,784,842,2,36000,1.93111638955
396090,396870,397651,780,781,2,36000,1.99871959027
396091,396877,397719,786,842,2,36000,1.93349168646
396109,396888,397648,779,760,2,36000,2.025
396117,396127,396301,10,174,1,60,1.05747126437
396125,396907,397728,782,821,2,36000,1.95249695493
396126,396914,397710,788,796,2,36000,1.98994974874
396128,396921,397725,793,804,2,36000,1.98631840796
396145,396928,397695,783,767,2,36000,2.02086049544
396146,396935,397690,789,755,2,36000,2.04503311258
396147,396943,397656,796,713,2,36000,2.11640953717
396149,396949,397720,800,771,2,36000,2.03761348898
396150,396955,397717,805,762,2,36000,2.05643044619
396151,396960,397705,809,745,2,36000,2.08590604027
396166,396965,397745,799,780,2,36000,2.02435897436
396182,396972,397687,790,715,2,36000,2.1048951049
396198,396977,397742,779,765,2,36000,2.01830065359
396199,397001,397767,802,766,2,36000,2.04699738903
396214,397046,397896,832,850,2,36000,1.97882352941
396289,397059,397804,770,745,2,36000,2.03355704698
396313,397072,397869,759,797,2,36000,1.95232120452
396314,397079,397850,765,771,2,36000,1.99221789883
396352,397084,397880,732,796,2,36000,1.91959798995
396383,397107,397924,724,817,2,36000,1.88616891065
396398,397117,397889,719,772,2,36000,1.93134715026
396469,397130,397921,661,791,2,36000,1.83565107459
396492,397161,397840,669,679,2,36000,1.9852724595
396494,397217,397997,723,780,2,36000,1.92692307692
396510,397262,397959,752,697,2,36000,2.07890961263
396545,396551,396570,6,19,1,60,1.31578947368
396554,397354,398118,800,764,2,36000,2.04712041885
396613,397380,398161,767,781,2,36000,1.98207426376
396628,397395,398212,767,817,2,36000,1.9388004896
396643,397429,398245,786,816,2,36000,1.96323529412
396713,397441,398240,728,799,2,36000,1.91113892365
396728,397499,398250,771,751,2,36000,2.02663115846
396746,397506,398241,760,735,2,36000,2.03401360544
396765,397516,398246,751,730,2,36000,2.02876712329
396781,397522,398330,741,808,2,36000,1.91707920792
396782,397527,398290,745,763,2,36000,1.97640891219
396815,397567,398311,752,744,2,36000,2.01075268817
396846,397572,398331,726,759,2,36000,1.95652173913
396861,397579,398396,718,817,2,36000,1.8788249694
396877,397661,398323,784,662,2,36000,2.18429003021
396878,397667,398389,789,722,2,36000,2.09279778393
396897,397673,398378,776,705,2,36000,2.10070921986
396933,397699,398472,766,773,2,36000,1.99094437257
396934,397706,398489,772,783,2,36000,1.98595146871
396935,397713,398516,778,803,2,36000,1.96886674969
396937,397718,398581,781,863,2,36000,1.90498261877
396938,397725,398519,787,794,2,36000,1.99118387909
396959,397730,398507,771,777,2,36000,1.99227799228
396961,397742,398503,781,761,2,36000,2.02628120894
396962,397747,398576,785,829,2,36000,1.94692400483
396963,397753,398503,790,750,2,36000,2.05333333333
396965,397758,398536,793,778,2,36000,2.01928020566
396966,397765,398578,799,813,2,36000,1.9827798278
396989,397770,398448,781,678,2,36000,2.15191740413
397037,397775,398597,738,822,2,36000,1.89781021898
397053,397782,398582,729,800,2,36000,1.91125
397069,397816,398623,747,807,2,36000,1.92565055762
397070,397852,398582,782,730,2,36000,2.07123287671
397071,397862,398649,791,787,2,36000,2.00508259212
397096,397881,398672,785,791,2,36000,1.99241466498
397112,397891,399138,779,1247,2,36000,1.62469927827
397127,397902,398638,775,736,2,36000,2.05298913043
397151,397908,398821,757,913,2,36000,1.8291347207
397206,397933,398696,727,763,2,36000,1.95281782438
397252,397939,398715,687,776,2,36000,1.88530927835
397328,397335,397444,7,109,1,60,1.06422018349
397343,397971,398796,628,825,2,36000,1.76121212121
397367,398009,398615,642,606,2,36000,2.05940594059
397383,398130,398902,747,772,2,36000,1.96761658031
397409,457915,538909,60506,80994,32,86400,1.74704299084
397419,398173,398917,754,744,2,36000,2.01344086022
397438,398224,398904,786,680,2,36000,2.15588235294
397463,447318,447414,49855,96,14,7980,520.322916667
397488,398251,399028,763,777,2,36000,1.98198198198
397504,398258,398951,754,693,2,36000,2.08802308802
397505,398263,399065,758,802,2,36000,1.94513715711
397505,436278,444522,38773,8244,64,18000,5.7031780689
397511,436283,437929,38772,1646,64,18000,24.5552855407
397525,398268,399092,743,824,2,36000,1.90169902913
397526,398275,398994,749,719,2,36000,2.04172461752
397540,397547,397758,7,211,1,180,1.03317535545
397563,398302,399046,739,744,2,36000,1.99327956989
397564,398324,399020,760,696,2,36000,2.09195402299
397580,398335,399055,755,720,2,36000,2.04861111111
397651,398342,399149,691,807,2,36000,1.85625774473
397652,398349,399159,697,810,2,36000,1.86049382716
397667,398390,399163,723,773,2,36000,1.93531694696
397689,398401,399173,712,772,2,36000,1.92227979275
397704,398408,399133,704,725,2,36000,1.97103448276
397705,398460,399160,755,700,2,36000,2.07857142857
397707,398484,399244,777,760,2,36000,2.02236842105
397724,398501,399194,777,693,2,36000,2.12121212121
397726,398516,399297,790,781,2,36000,2.01152368758
397727,398521,399279,794,758,2,36000,2.04749340369
397728,398527,399367,799,840,2,36000,1.95119047619
397728,397737,397831,9,94,1,3600,1.09574468085
397730,398533,399278,803,745,2,36000,2.07785234899
397731,398539,399243,808,704,2,36000,2.14772727273
397747,398547,399350,800,803,2,36000,1.99626400996
397748,398588,399311,840,723,2,36000,2.16182572614
397750,398595,399354,845,759,2,36000,2.11330698287
397768,398600,399340,832,740,2,36000,2.12432432432
397808,398605,399290,797,685,2,36000,2.16350364964
397836,397842,398028,6,186,1,180,1.03225806452
397847,398610,399398,763,788,2,36000,1.96827411168
397862,398617,399431,755,814,2,36000,1.92751842752
397878,398628,399378,750,750,2,36000,2.0
397902,398635,399361,733,726,2,36000,2.00964187328
397903,398650,399467,747,817,2,36000,1.91432068543
397905,398660,399406,755,746,2,36000,2.01206434316
397928,398684,399603,756,919,2,36000,1.82263329706
397929,398708,399509,779,801,2,36000,1.97253433208
397960,398727,399450,767,723,2,36000,2.06085753804
397996,398808,399631,812,823,2,36000,1.98663426488
398119,398833,399622,714,789,2,36000,1.90494296578
398161,398915,399626,754,711,2,36000,2.06047819972
398214,398922,399649,708,727,2,36000,1.97386519945
398242,398928,399652,686,724,2,36000,1.94751381215
398244,398963,399704,719,741,2,36000,1.97031039136
398261,399005,399794,744,789,2,36000,1.94296577947
398262,399032,399790,770,758,2,36000,2.01583113456
398263,399040,399836,777,796,2,36000,1.97613065327
398291,399058,399847,767,789,2,36000,1.9721166033
398315,399067,399946,752,879,2,36000,1.85551763367
398365,399077,399904,712,827,2,36000,1.86094316808
398367,399104,399868,737,764,2,36000,1.96465968586
398368,399145,399939,777,794,2,36000,1.97858942065
398384,399152,399942,768,790,2,36000,1.97215189873
398401,399161,399946,760,785,2,36000,1.96815286624
398402,399170,399997,768,827,2,36000,1.92865779927
398449,399177,399898,728,721,2,36000,2.00970873786
398471,399182,399978,711,796,2,36000,1.8932160804
398490,399188,399972,698,784,2,36000,1.89030612245
398505,399207,400065,702,858,2,36000,1.81818181818
398506,399256,400021,750,765,2,36000,1.98039215686
398523,399261,400092,738,831,2,36000,1.8880866426
398524,399290,399970,766,680,2,36000,2.12647058824
398525,399297,400163,772,866,2,36000,1.89145496536
398541,399303,400085,762,782,2,36000,1.97442455243
398578,399310,400102,732,792,2,36000,1.92424242424
398580,399323,399996,743,673,2,36000,2.10401188707
398595,399353,400164,758,811,2,36000,1.934648582
398597,399362,400169,765,807,2,36000,1.94795539033
398598,399369,400211,771,842,2,36000,1.91567695962
398613,399375,400185,762,810,2,36000,1.94074074074
398629,399383,400228,754,845,2,36000,1.89230769231
398630,399390,400109,760,719,2,36000,2.05702364395
398646,399409,400191,763,782,2,36000,1.97570332481
398661,399417,400217,756,800,2,36000,1.945
398676,399443,400261,767,818,2,36000,1.93765281174
398698,399463,400191,765,728,2,36000,2.05082417582
398716,399479,400236,763,757,2,36000,2.00792602378
398796,399521,400306,725,785,2,36000,1.92356687898
398802,398815,406224,13,7409,1,7380,1.00175462276
398825,399615,400408,790,793,2,36000,1.99621689786
398905,399633,400484,728,851,2,36000,1.85546415981
398906,399641,400426,735,785,2,36000,1.93630573248
398909,407447,413056,8538,5609,2,43200,2.52219646996
398921,399648,400370,727,722,2,36000,2.00692520776
398955,399661,400451,706,790,2,36000,1.89367088608
398994,399668,400481,674,813,2,36000,1.82902829028
399022,399715,400468,693,753,2,36000,1.9203187251
399037,399802,400549,765,747,2,36000,2.02409638554
399053,399809,401101,756,1292,2,36000,1.58513931889
399069,399849,400565,780,716,2,36000,2.08938547486
399070,399859,400580,789,721,2,36000,2.09431345354
399092,399879,400636,787,757,2,36000,2.03963011889
399136,399911,400728,775,817,2,36000,1.94859241126
399152,399918,400594,766,676,2,36000,2.13313609467
399153,399951,400705,798,754,2,36000,2.05835543767
399170,399959,400724,789,765,2,36000,2.03137254902
399171,399964,400705,793,741,2,36000,2.0701754386
399172,399969,400730,797,761,2,36000,2.04730617608
399189,399982,400778,793,796,2,36000,1.99623115578
399206,399989,401030,783,1041,2,36000,1.75216138329
399245,399996,400779,751,783,2,36000,1.95913154534
399247,400008,400800,761,792,2,36000,1.96085858586
399278,400014,400672,736,658,2,36000,2.11854103343
399279,400032,400833,753,801,2,36000,1.94007490637
399297,400077,400864,780,787,2,36000,1.99110546379
399298,400097,400907,799,810,2,36000,1.98641975309
399314,400104,400881,790,777,2,36000,2.01673101673
399347,400114,400875,767,761,2,36000,2.00788436268
399370,400120,400918,750,798,2,36000,1.93984962406
399372,400175,400934,803,759,2,36000,2.05797101449
399373,400181,400929,808,748,2,36000,2.08021390374
399374,400187,400897,813,710,2,36000,2.14507042254
399390,400196,401075,806,879,2,36000,1.91695108077
399406,400204,400980,798,776,2,36000,2.02835051546
399407,400223,400993,816,770,2,36000,2.05974025974
399431,400229,400979,798,750,2,36000,2.064
399453,400240,401034,787,794,2,36000,1.99118387909
399468,400248,401013,780,765,2,36000,2.01960784314
399471,400279,403254,808,2975,1,7200,1.27159663866
399508,400274,401105,766,831,2,36000,1.92178098676
399604,400317,401070,713,753,2,36000,1.94687915007
399623,400381,401233,758,852,2,36000,1.8896713615
399638,400419,401194,781,775,2,36000,2.00774193548
399639,400437,401186,798,749,2,36000,2.06542056075
399655,400463,401186,808,723,2,36000,2.11756569848
399656,400481,401452,825,971,2,36000,1.84963954686
399705,400493,401211,788,718,2,36000,2.09749303621
399793,400499,401296,706,797,2,36000,1.88582183187
399812,400562,401394,750,832,2,36000,1.90144230769
399843,400577,401288,734,711,2,36000,2.0323488045
399862,400593,401397,731,804,2,36000,1.9092039801
399878,400605,401294,727,689,2,36000,2.05515239478
399900,400647,401463,747,816,2,36000,1.91544117647
399915,400684,401498,769,814,2,36000,1.94471744472
399940,400716,401535,776,819,2,36000,1.9474969475
399956,400721,401608,765,887,2,36000,1.86245772266
399957,400735,401496,778,761,2,36000,2.0223390276
399958,400742,401534,784,792,2,36000,1.9898989899
399974,400747,401545,773,798,2,36000,1.9686716792
399975,400790,401636,815,846,2,36000,1.963356974
399991,400797,401466,806,669,2,36000,2.20478325859
400007,400812,401635,805,823,2,36000,1.97812879708
400008,400845,401582,837,737,2,36000,2.13568521031
400023,400876,401670,853,794,2,36000,2.07430730479
400064,400887,401729,823,842,2,36000,1.97743467933
400086,400893,401580,807,687,2,36000,2.17467248908
400103,400908,401756,805,848,2,36000,1.94929245283
400104,400919,401677,815,758,2,36000,2.07519788918
400121,400931,401685,810,754,2,36000,2.07427055703
400165,400940,401815,775,875,2,36000,1.88571428571
400166,400948,401750,782,802,2,36000,1.97506234414
400182,400990,401787,808,797,2,36000,2.01380175659
400198,400998,401774,800,776,2,36000,2.03092783505
400200,401005,401772,805,767,2,36000,2.04954367666
400201,401025,401818,824,793,2,36000,2.03909205549
400216,401046,401839,830,793,2,36000,2.04665825977
400218,401051,401801,833,750,2,36000,2.11066666667
400233,401082,401956,849,874,2,36000,1.97139588101
400253,401088,401975,835,887,2,36000,1.94137542277
400270,401113,401866,843,753,2,36000,2.11952191235
400307,401120,401973,813,853,2,36000,1.9531066823
400371,401197,402415,826,1218,2,36000,1.67816091954
400402,400408,400442,6,34,1,600,1.17647058824
400408,401202,402001,794,799,2,36000,1.99374217772
400427,401208,401899,781,691,2,36000,2.13024602026
400452,401224,402013,772,789,2,36000,1.97845373891
400470,401245,401978,775,733,2,36000,2.05729877217
400485,401300,402091,815,791,2,36000,2.03034134008
400487,401306,402135,819,829,2,36000,1.98793727382
400552,401313,402105,761,792,2,36000,1.96085858586
400567,401405,402309,838,904,2,36000,1.92699115044
400588,401413,402168,825,755,2,36000,2.09271523179
400604,401464,402288,860,824,2,36000,2.04368932039
400633,400639,400642,6,3,4,3600,1.0
400640,401474,402259,834,785,2,36000,2.06242038217
400675,401481,402236,806,755,2,36000,2.06754966887
400707,401508,402181,801,673,2,36000,2.19019316493
400708,401516,402287,808,771,2,36000,2.04798962387
400727,401546,402355,819,809,2,36000,2.01236093943
400743,401552,402350,809,798,2,36000,2.01378446115
400744,401559,402338,815,779,2,36000,2.04621309371
400778,401592,402363,814,771,2,36000,2.05577172503
400780,401598,402375,818,777,2,36000,2.05276705277
400801,401620,402396,819,776,2,36000,2.05541237113
400835,401647,402397,812,750,2,36000,2.08266666667
400863,401652,402293,789,641,2,36000,2.23088923557
400879,401683,402474,804,791,2,36000,2.01643489254
400881,404118,414084,3237,9966,4,144000,1.32480433474
400894,401690,402480,796,790,2,36000,2.00759493671
400910,401697,402499,787,802,2,36000,1.9812967581
400911,401708,402401,797,693,2,36000,2.15007215007
400926,401741,402563,815,822,2,36000,1.99148418491
400942,401762,402590,820,828,2,36000,1.99033816425
400943,401769,402565,826,796,2,36000,2.03768844221
400980,401784,402622,804,838,2,36000,1.95942720764
400981,401791,402539,810,748,2,36000,2.08288770053
400996,401799,402503,803,704,2,36000,2.140625
401015,401813,402602,798,789,2,36000,2.01140684411
401030,401827,402590,797,763,2,36000,2.04456094364
401045,401834,402582,789,748,2,36000,2.05481283422
401073,401851,402719,778,868,2,36000,1.89631336406
401074,401878,402637,804,759,2,36000,2.05928853755
401105,401911,402651,806,740,2,36000,2.08918918919
401106,401969,402754,863,785,2,36000,2.09936305732
401191,401986,402769,795,783,2,36000,2.0153256705
401192,401991,402741,799,750,2,36000,2.06533333333
401211,401998,402722,787,724,2,36000,2.08701657459
401235,402014,402791,779,777,2,36000,2.00257400257
401236,402024,402830,788,806,2,36000,1.9776674938
401291,402104,402843,813,739,2,36000,2.100135318
401307,402117,402916,810,799,2,36000,2.01376720901
401308,402147,402919,839,772,2,36000,2.08678756477
401394,402181,402886,787,705,2,36000,2.11631205674
401410,402193,403008,783,815,2,36000,1.96073619632
401453,402248,402985,795,737,2,36000,2.07869742198
401469,402271,403084,802,813,2,36000,1.9864698647
401470,402299,403055,829,756,2,36000,2.09656084656
401498,402305,403098,807,793,2,36000,2.01765447667
401500,402311,403095,811,784,2,36000,2.03443877551
401534,402321,403086,787,765,2,36000,2.02875816993
401535,402351,403179,816,828,2,36000,1.98550724638
401551,402365,403258,814,893,2,36000,1.91153415454
401582,402371,403146,789,775,2,36000,2.01806451613
401583,402378,403123,795,745,2,36000,2.06711409396
401599,401606,402596,7,990,1,1800,1.00707070707
401612,402392,403228,780,836,2,36000,1.93301435407
401619,401627,403166,8,1539,1,3600,1.00519818064
401637,402407,403194,770,787,2,36000,1.97839898348
401639,402414,403151,775,737,2,36000,2.05156037992
401681,402419,403118,738,699,2,36000,2.05579399142
401682,402427,403267,745,840,2,36000,1.8869047619
401738,402486,403249,748,763,2,36000,1.98034076016
401740,402493,403189,753,696,2,36000,2.08189655172
401758,402512,403276,754,764,2,36000,1.98691099476
401759,402518,403355,759,837,2,36000,1.90681003584
401779,402551,403431,772,880,2,36000,1.87727272727
401780,402576,403332,796,756,2,36000,2.05291005291
401797,402583,403296,786,713,2,36000,2.10238429173
401813,402593,403353,780,760,2,36000,2.02631578947
401829,402602,403448,773,846,2,36000,1.91371158392
401830,402608,403311,778,703,2,36000,2.106685633
401846,402614,403342,768,728,2,36000,2.05494505495
401868,402634,403418,766,784,2,36000,1.97704081633
401902,402650,403415,748,765,2,36000,1.97777777778
401958,402663,403441,705,778,2,36000,1.90616966581
401975,402731,403503,756,772,2,36000,1.9792746114
401977,402738,403511,761,773,2,36000,1.98447606727
401994,402752,403468,758,716,2,36000,2.05865921788
402010,402766,404027,756,1261,2,36000,1.59952418715
402027,402781,403836,754,1055,2,36000,1.71469194313
402094,402803,403625,709,822,2,36000,1.86253041363
402111,402843,403612,732,769,2,36000,1.95188556567
402138,402855,403628,717,773,2,36000,1.9275549806
402172,402898,403636,726,738,2,36000,1.9837398374
402189,402928,403706,739,778,2,36000,1.9498714653
402235,402935,403620,700,685,2,36000,2.02189781022
402261,402997,403875,736,878,2,36000,1.83826879271
402268,402278,402287,10,9,1,600,1.9
402287,403020,403801,733,781,2,36000,1.93854033291
402288,403066,403806,778,740,2,36000,2.05135135135
402310,403096,403853,786,757,2,36000,2.03830911493
402311,403102,403844,791,742,2,36000,2.06603773585
402342,403109,403907,767,798,2,36000,1.96115288221
402349,402358,402367,9,9,8,900,1.8
402359,403114,403957,755,843,2,36000,1.8956109134
402361,403130,403927,769,797,2,36000,1.96486825596
402376,403137,403944,761,807,2,36000,1.94299876084
402376,402385,402409,9,24,2,1800,1.375
402378,403158,403984,780,826,2,36000,1.94430992736
402396,437940,446748,35544,8808,64,18000,5.03542234332
402398,403165,403897,767,732,2,36000,2.04781420765
402400,403191,404005,791,814,2,36000,1.97174447174
402401,403201,404019,800,818,2,36000,1.97799511002
402421,403208,404054,787,846,2,36000,1.93026004728
402474,403241,404045,767,804,2,36000,1.9539800995
402493,403261,404056,768,795,2,36000,1.96603773585
402512,403267,403994,755,727,2,36000,2.03851444292
402513,403275,404032,762,757,2,36000,2.00660501982
402541,403282,404084,741,802,2,36000,1.92394014963
402545,402557,402565,12,8,8,900,2.0
402565,403289,404067,724,778,2,36000,1.93059125964
402566,403308,404115,742,807,2,36000,1.91945477076
402587,403323,404135,736,812,2,36000,1.90640394089
402603,403344,404223,741,879,2,36000,1.84300341297
402604,403359,404130,755,771,2,36000,1.97924773022
402606,403365,404159,759,794,2,36000,1.95591939547
402624,403372,404193,748,821,2,36000,1.91108404385
402639,403428,404101,789,673,2,36000,2.17236255572
402654,403435,404289,781,854,2,36000,1.91451990632
402719,403443,404123,724,680,2,36000,2.06470588235
402734,403453,404287,719,834,2,36000,1.86211031175
402749,403461,404258,712,797,2,36000,1.89335006274
402764,403481,404213,717,732,2,36000,1.97950819672
402779,403515,404269,736,754,2,36000,1.97612732095
402786,402792,402828,6,36,1,600,1.16666666667
402795,403523,404269,728,746,2,36000,1.97587131367
402832,403623,404390,791,767,2,36000,2.03129074316
402847,403632,404298,785,666,2,36000,2.17867867868
402887,403639,404403,752,764,2,36000,1.98429319372
402918,403646,404422,728,776,2,36000,1.9381443299
402933,403652,404497,719,845,2,36000,1.85088757396
402985,403718,404453,733,735,2,36000,1.99727891156
403010,403812,404519,802,707,2,36000,2.13437057992
403057,403820,404560,763,740,2,36000,2.03108108108
403097,403849,404559,752,710,2,36000,2.05915492958
403098,403856,404620,758,764,2,36000,1.99214659686
403100,403866,404674,766,808,2,36000,1.94801980198
403101,403887,404659,786,772,2,36000,2.01813471503
403121,403909,404682,788,773,2,36000,2.01940491591
403139,403920,404649,781,729,2,36000,2.07133058985
403178,403939,404807,761,868,2,36000,1.8767281106
403180,403956,404747,776,791,2,36000,1.98103666245
403197,403968,404728,771,760,2,36000,2.01447368421
403198,403996,404696,798,700,2,36000,2.14
403199,404007,404642,808,635,2,36000,2.27244094488
403227,404017,404705,790,688,2,36000,2.14825581395
403243,403352,406994,109,3642,1,3600,1.02992861065
403249,404031,404707,782,676,2,36000,2.15680473373
403265,404044,404796,779,752,2,36000,2.03590425532
403280,404050,405896,770,1846,2,36000,1.41711809317
403281,404057,405926,776,1869,2,36000,1.4151952916
403296,404065,405285,769,1220,2,36000,1.63032786885
403311,404072,405934,761,1862,2,36000,1.40870032223
403333,404079,405941,746,1862,2,36000,1.40064446831
403349,404096,405946,747,1850,2,36000,1.40378378378
403365,404123,405949,758,1826,2,36000,1.41511500548
403367,404130,405917,763,1787,2,36000,1.42697257974
403417,404136,405910,719,1774,2,36000,1.40529875986
403435,404142,405950,707,1808,2,36000,1.39103982301
403437,404149,405929,712,1780,2,36000,1.4
403452,404173,405951,721,1778,2,36000,1.40551181102
403453,404206,405934,753,1728,2,36000,1.43576388889
403468,404225,405939,757,1714,2,36000,1.44165694282
403505,404235,405937,730,1702,2,36000,1.42890716804
403521,404270,405925,749,1655,2,36000,1.45256797583
403617,404281,405913,664,1632,2,36000,1.4068627451
403643,404288,405935,645,1647,2,36000,1.39162112933
403644,404300,405929,656,1629,2,36000,1.40270104359
403646,404307,405939,661,1632,2,36000,1.4050245098
403647,404313,405712,666,1399,2,36000,1.47605432452
403708,404402,405916,694,1514,2,36000,1.45838837517
403802,404414,405908,612,1494,2,36000,1.40963855422
403818,404434,405943,616,1509,2,36000,1.40821736249
403837,404465,405920,628,1455,2,36000,1.43161512027
403854,404508,405913,654,1405,2,36000,1.46548042705
403855,404532,405944,677,1412,2,36000,1.47946175637
403877,404570,405897,693,1327,2,36000,1.52223059533
403898,404577,405908,679,1331,2,36000,1.51014274981
403914,404632,405948,718,1316,2,36000,1.54559270517
403929,404654,405902,725,1248,2,36000,1.58092948718
403945,404666,405954,721,1288,2,36000,1.5597826087
403966,404673,405926,707,1253,2,36000,1.56424581006
403988,404687,405945,699,1258,2,36000,1.55564387917
404004,404693,405947,689,1254,2,36000,1.54944178628
404021,404707,405928,686,1221,2,36000,1.56183456183
404022,404716,405916,694,1200,2,36000,1.57833333333
404049,404729,405954,680,1225,2,36000,1.55510204082
404051,404740,405952,689,1212,2,36000,1.56848184818
404052,404759,405933,707,1174,2,36000,1.60221465077
404073,404808,405908,735,1100,2,36000,1.66818181818
404074,404819,405901,745,1082,2,36000,1.68853974122
404077,404085,404108,8,23,1,1800,1.34782608696
404124,405338,406740,1214,1402,2,36000,1.86590584879
404142,405736,405737,1594,1,2,36000,159.5
404234,405796,405797,1562,1,2,36000,156.3
404301,423973,434282,19672,10309,4,21600,2.90823552236
404310,405844,405845,1534,1,2,36000,153.5
404462,405908,406736,1446,828,2,36000,2.74637681159
404464,405915,406660,1451,745,2,36000,2.94765100671
404502,405920,406638,1418,718,2,36000,2.97493036212
404524,405925,406729,1401,804,2,36000,2.74253731343
404525,407006,408178,2481,1172,1,1800,3.11689419795
404563,405930,406645,1367,715,2,36000,2.91188811189
404565,405942,406689,1377,747,2,36000,2.84337349398
404586,406872,406963,2286,91,1,7200,26.1208791209
404622,405948,406776,1326,828,2,36000,2.60144927536
404645,405953,406780,1308,827,2,36000,2.58162031439
404653,404661,404683,8,22,1,600,1.36363636364
404662,405958,406663,1296,705,2,36000,2.83829787234
404663,406975,408715,2312,1740,1,1800,2.32873563218
404664,405963,406794,1299,831,2,36000,2.56317689531
404687,405968,406620,1281,652,2,36000,2.96472392638
404689,405974,406750,1285,776,2,36000,2.65592783505
404709,405979,406765,1270,786,2,36000,2.61577608142
404710,405984,406738,1274,754,2,36000,2.68965517241
404711,405989,406788,1278,799,2,36000,2.59949937422
404716,404723,409524,7,4801,1,600,1.00145802958
404730,405994,406697,1264,703,2,36000,2.79800853485
404749,406007,406834,1258,827,2,36000,2.52116082225
404798,406013,406721,1215,708,2,36000,2.71610169492
404814,406018,406748,1204,730,2,36000,2.64931506849
404822,404833,404903,11,70,1,600,1.15714285714
404839,406023,406805,1184,782,2,36000,2.51406649616
404855,406028,406781,1173,753,2,36000,2.5577689243
404856,406033,406805,1177,772,2,36000,2.52461139896
404881,406038,406889,1157,851,2,36000,2.35957696827
404900,406044,406818,1144,774,2,36000,2.47803617571
404901,406049,406868,1148,819,2,36000,2.40170940171
404926,406054,406756,1128,702,2,36000,2.60683760684
404942,406059,406832,1117,773,2,36000,2.44501940492
404943,406064,406821,1121,757,2,36000,2.48084544254
404944,406070,406847,1126,777,2,36000,2.44916344916
404962,404969,405212,7,243,1,120,1.02880658436
404967,404975,404983,8,8,8,900,1.6
404969,406075,406825,1106,750,2,36000,2.47466666667
404984,406080,406860,1096,780,2,36000,2.40512820513
404991,404997,405608,6,611,1,600,1.00981996727
405000,406085,406936,1085,851,2,36000,2.2749706228
405016,406090,406890,1074,800,2,36000,2.3425
405017,406096,406880,1079,784,2,36000,2.3762755102
405033,406101,406854,1068,753,2,36000,2.41832669323
405034,406106,406933,1072,827,2,36000,2.29625151149
405076,406111,406973,1035,862,2,36000,2.20069605568
405122,406116,406894,994,778,2,36000,2.27763496144
405148,406121,406892,973,771,2,36000,2.26199740597
405165,406127,406914,962,787,2,36000,2.22236340534
405197,406132,406904,935,772,2,36000,2.21113989637
405226,406235,407013,1009,778,2,36000,2.2969151671
405291,406632,407522,1341,890,2,36000,2.50674157303
405307,406650,407451,1343,801,2,36000,2.67665418227
405309,406657,407423,1348,766,2,36000,2.75979112272
405332,406673,407435,1341,762,2,36000,2.75984251969
405360,406680,407424,1320,744,2,36000,2.77419354839
405398,406701,407473,1303,772,2,36000,2.6878238342
405415,406710,407454,1295,744,2,36000,2.74059139785
405433,406733,407559,1300,826,2,36000,2.57384987893
405434,406741,407524,1307,783,2,36000,2.66922094508
405484,406748,407540,1264,792,2,36000,2.59595959596
405486,406755,407545,1269,790,2,36000,2.60632911392
405502,406760,407553,1258,793,2,36000,2.58638083228
405503,406767,407599,1264,832,2,36000,2.51923076923
405522,406772,407459,1250,687,2,36000,2.81950509461
405561,406779,407607,1218,828,2,36000,2.47101449275
405579,406784,407507,1205,723,2,36000,2.66666666667
405581,406791,407575,1210,784,2,36000,2.54336734694
405602,406798,407597,1196,799,2,36000,2.49687108886
405708,407024,408442,1316,1418,1,1800,1.92806770099
406324,458810,496908,52486,38098,10,57600,2.37765761982
407436,458815,492463,51379,33648,10,43200,2.52695553971
407473,407485,420019,12,12534,1,21600,1.00095739588
408220,408226,409869,6,1643,1,1800,1.00365185636
408252,414095,433256,5843,19161,4,432000,1.30494233078
408327,408335,409142,8,807,2,36000,1.00991325898
408329,408340,409173,11,833,2,36000,1.01320528211
408330,408347,409196,17,849,2,36000,1.02002355713
408331,408352,409074,21,722,2,36000,1.02908587258
408333,408357,409279,24,922,2,36000,1.02603036876
408334,408362,409168,28,806,2,36000,1.03473945409
408335,408367,409192,32,825,2,36000,1.03878787879
408336,408372,409137,36,765,2,36000,1.04705882353
408338,408378,409133,40,755,2,36000,1.05298013245
408339,408383,409166,44,783,2,36000,1.05619412516
408340,408388,409151,48,763,2,36000,1.0629095675
408342,408395,409054,53,659,2,36000,1.08042488619
408343,408400,409235,57,835,2,36000,1.06826347305
408344,408405,409162,61,757,2,36000,1.08058124174
408346,408410,409139,64,729,2,36000,1.0877914952
408347,408415,409274,68,859,2,36000,1.07916181607
408348,408421,409244,73,823,2,36000,1.08869987849
408350,408426,409141,76,715,2,36000,1.10629370629
408351,408432,409248,81,816,2,36000,1.09926470588
408352,408437,409237,85,800,2,36000,1.10625
408354,408442,409222,88,780,2,36000,1.11282051282
408355,408447,409286,92,839,2,36000,1.10965435042
408356,408453,409177,97,724,2,36000,1.13397790055
408358,408458,409225,100,767,2,36000,1.13037809648
408359,408463,409200,104,737,2,36000,1.14111261872
408360,408468,409176,108,708,2,36000,1.15254237288
408362,408473,409278,111,805,2,36000,1.13788819876
408363,408478,409319,115,841,2,36000,1.13674197384
408364,408484,409217,120,733,2,36000,1.16371077763
408366,408489,409274,123,785,2,36000,1.15668789809
408367,408494,409226,127,732,2,36000,1.17349726776
408368,408499,409228,131,729,2,36000,1.17969821674
408370,408504,409338,134,834,2,36000,1.16067146283
408371,408510,409279,139,769,2,36000,1.18075422627
408372,408515,409287,143,772,2,36000,1.18523316062
408374,408520,409295,146,775,2,36000,1.18838709677
408375,408525,409155,150,630,2,36000,1.2380952381
408376,408530,409324,154,794,2,36000,1.19395465995
408377,408536,409325,159,789,2,36000,1.20152091255
408379,408541,409365,162,824,2,36000,1.19660194175
408380,409066,409843,686,777,2,36000,1.88288288288
408381,409086,409814,705,728,2,36000,1.96840659341
408383,409144,409954,761,810,2,36000,1.93950617284
408384,409152,409968,768,816,2,36000,1.94117647059
408385,409157,409943,772,786,2,36000,1.98218829517
408386,409164,409985,778,821,2,36000,1.94762484775
408388,409169,409952,781,783,2,36000,1.99744572158
408389,409174,409979,785,805,2,36000,1.9751552795
408391,409181,409974,790,793,2,36000,1.99621689786
408392,409186,410044,794,858,2,36000,1.92540792541
408393,409191,409861,798,670,2,36000,2.19104477612
408394,409196,409998,802,802,2,36000,2.0
408396,409204,410026,808,822,2,36000,1.98296836983
408397,409209,410011,812,802,2,36000,2.01246882793
408398,409214,410036,816,822,2,36000,1.99270072993
408400,409219,409977,819,758,2,36000,2.08047493404
408401,409226,410070,825,844,2,36000,1.97748815166
408402,409231,410081,829,850,2,36000,1.97529411765
408404,409237,410030,833,793,2,36000,2.05044136192
408405,409242,409879,837,637,2,36000,2.31397174254
408406,409248,410040,842,792,2,36000,2.06313131313
408408,409254,410010,846,756,2,36000,2.11904761905
408558,419111,436852,10553,17741,4,432000,1.59483681867
408575,408581,410168,6,1587,1,1800,1.00378071834
408727,408734,408761,7,27,1,3600,1.25925925926
409053,409259,410041,206,782,2,36000,1.26342710997
409076,409265,410048,189,783,2,36000,1.24137931034
409135,409271,410000,136,729,2,36000,1.1865569273
409155,409278,410075,123,797,2,36000,1.15432873275
409157,409283,410015,126,732,2,36000,1.17213114754
409158,409290,410073,132,783,2,36000,1.16858237548
409159,409295,409895,136,600,2,36000,1.22666666667
409161,409300,410110,139,810,2,36000,1.17160493827
409162,409307,410077,145,770,2,36000,1.18831168831
409180,457920,459986,48740,2066,32,356400,24.5914811229
409181,409312,410162,131,850,2,36000,1.15411764706
409183,409317,409967,134,650,2,36000,1.20615384615
409184,409322,410082,138,760,2,36000,1.18157894737
409185,409328,410089,143,761,2,36000,1.18791064389
409186,409335,410123,149,788,2,36000,1.18908629442
409188,409341,410087,153,746,2,36000,1.20509383378
409207,409347,410065,140,718,2,36000,1.19498607242
409208,409354,410080,146,726,2,36000,1.20110192837
409210,409378,410315,168,937,2,36000,1.17929562433
409241,409826,410686,585,860,2,36000,1.68023255814
409242,409856,410654,614,798,2,36000,1.7694235589
409244,409873,410704,629,831,2,36000,1.75691937425
409245,409890,410755,645,865,2,36000,1.74566473988
409246,409908,410716,662,808,2,36000,1.81930693069
409248,409955,410692,707,737,2,36000,1.95929443691
409249,409964,410750,715,786,2,36000,1.9096692112
409288,409971,410772,683,801,2,36000,1.85268414482
409289,409979,410776,690,797,2,36000,1.86574654956
409291,409986,410754,695,768,2,36000,1.90494791667
409293,409991,410807,698,816,2,36000,1.85539215686
409294,409998,410766,704,768,2,36000,1.91666666667
409296,410003,410912,707,909,2,36000,1.77777777778
409297,410008,410795,711,787,2,36000,1.90343074968
409298,410015,410787,717,772,2,36000,1.92875647668
409300,410020,410838,720,818,2,36000,1.88019559902
409337,410027,410802,690,775,2,36000,1.89032258065
409338,410032,410623,694,591,2,36000,2.17428087986
409339,410037,410816,698,779,2,36000,1.89602053915
409341,410044,410798,703,754,2,36000,1.93236074271
409342,410049,410849,707,800,2,36000,1.88375
409365,410061,410918,696,857,2,36000,1.81213535589
409778,409784,409820,6,36,1,3600,1.16666666667
409816,410066,410826,250,760,2,36000,1.32894736842
409847,410071,410911,224,840,2,36000,1.26666666667
409863,410076,410748,213,672,2,36000,1.31696428571
409879,410083,410817,204,734,2,36000,1.27792915531
409897,410088,410840,191,752,2,36000,1.2539893617
409944,410093,410870,149,777,2,36000,1.19176319176
409961,410100,410885,139,785,2,36000,1.17707006369
409962,410105,410900,143,795,2,36000,1.17987421384
409981,410110,410844,129,734,2,36000,1.1757493188
409982,410116,410907,134,791,2,36000,1.16940581542
409983,410121,411385,138,1264,2,36000,1.10917721519
409985,410126,410938,141,812,2,36000,1.1736453202
409986,410131,410962,145,831,2,36000,1.17448856799
410002,410138,410958,136,820,2,36000,1.16585365854
410004,410143,410971,139,828,2,36000,1.16787439614
410005,410148,410939,143,791,2,36000,1.18078381795
410023,410174,410982,151,808,2,36000,1.18688118812
410024,410181,410948,157,767,2,36000,1.20469361147
410025,410327,411064,302,737,2,36000,1.40976933514
410044,410635,411303,591,668,2,36000,1.88473053892
410045,410666,411468,621,802,2,36000,1.77431421446
410045,410055,410165,10,110,1,3600,1.09090909091
410047,410698,411491,651,793,2,36000,1.8209331652
410048,410704,411561,656,857,2,36000,1.76546091015
410049,410715,411507,666,792,2,36000,1.84090909091
410051,410728,411411,677,683,2,36000,1.99121522694
410074,410760,411531,686,771,2,36000,1.8897535668
410075,410766,411607,691,841,2,36000,1.82164090369
410077,410771,411558,694,787,2,36000,1.88182973316
410078,410779,411502,701,723,2,36000,1.96957123098
410079,410784,411591,705,807,2,36000,1.87360594796
410114,410790,411588,676,798,2,36000,1.84711779449
410115,410795,411531,680,736,2,36000,1.92391304348
410116,410802,411644,686,842,2,36000,1.81472684086
410118,410809,411529,691,720,2,36000,1.95972222222
410119,410816,411519,697,703,2,36000,1.99146514936
410120,410821,411805,701,984,2,36000,1.71239837398
410122,410827,411604,705,777,2,36000,1.90733590734
410139,410832,411655,693,823,2,36000,1.84204131227
410151,410158,410767,7,609,1,3600,1.01149425287
410169,410840,411749,671,909,2,36000,1.73817381738
410314,410845,411636,531,791,2,36000,1.67130214918
410625,410852,411537,227,685,2,36000,1.33138686131
410661,410857,411672,196,815,2,36000,1.24049079755
410691,410864,411778,173,914,2,36000,1.18927789934
410707,410869,411653,162,784,2,36000,1.20663265306
410708,410882,411668,174,786,2,36000,1.2213740458
410725,410898,411640,173,742,2,36000,1.23315363881
410760,410912,411696,152,784,2,36000,1.19387755102
410761,410920,411741,159,821,2,36000,1.19366626066
410763,410926,411789,163,863,2,36000,1.1888760139
410764,410931,411709,167,778,2,36000,1.2146529563
410792,410938,411731,146,793,2,36000,1.184110971
410793,410950,411744,157,794,2,36000,1.19773299748
410794,410955,411716,161,761,2,36000,1.21156373193
410796,410962,411876,166,914,2,36000,1.18161925602
410813,410970,411766,157,796,2,36000,1.1972361809
410815,410977,411819,162,842,2,36000,1.19239904988
410816,410984,411863,168,879,2,36000,1.19112627986
410817,410994,411757,177,763,2,36000,1.23197903014
410834,411077,411817,243,740,2,36000,1.32837837838
410836,411315,412065,479,750,2,36000,1.63866666667
410837,411396,412243,559,847,2,36000,1.65997638725
410854,411423,412233,569,810,2,36000,1.7024691358
410855,411480,412200,625,720,2,36000,1.86805555556
410857,411504,412190,647,686,2,36000,1.94314868805
410858,411513,412272,655,759,2,36000,1.86297760211
410873,411520,412282,647,762,2,36000,1.84908136483
410889,411532,412343,643,811,2,36000,1.79284833539
410904,411540,412290,636,750,2,36000,1.848
410920,411552,412323,632,771,2,36000,1.81971465629
410921,411557,412434,636,877,2,36000,1.7251995439
410923,411564,412279,641,715,2,36000,1.8965034965
410924,411570,412298,646,728,2,36000,1.88736263736
410940,411577,412316,637,739,2,36000,1.86197564276
410941,411601,412416,660,815,2,36000,1.80981595092
410957,411608,412375,651,767,2,36000,1.84876140808
410959,411616,412432,657,816,2,36000,1.80514705882
410974,411623,412404,649,781,2,36000,1.83098591549
410976,411647,412426,671,779,2,36000,1.86136071887
410991,411655,412468,664,813,2,36000,1.81672816728
411036,411042,411147,6,105,1,3600,1.05714285714
411068,411662,412411,594,749,2,36000,1.79305740988
411304,411669,412383,365,714,2,36000,1.51120448179
411386,411674,412518,288,844,2,36000,1.34123222749
411414,411681,412459,267,778,2,36000,1.34318766067
411470,411688,412424,218,736,2,36000,1.29619565217
411492,411707,412516,215,809,2,36000,1.26576019778
411508,411721,412464,213,743,2,36000,1.2866756393
411510,411728,412512,218,784,2,36000,1.27806122449
411532,411743,412652,211,909,2,36000,1.23212321232
411534,411752,412451,218,699,2,36000,1.31187410587
411535,411760,412600,225,840,2,36000,1.26785714286
411536,411766,412994,230,1228,2,36000,1.18729641694
411539,411547,411657,8,110,1,3600,1.07272727273
411561,411774,412578,213,804,2,36000,1.26492537313
411562,411781,412522,219,741,2,36000,1.2955465587
411564,411791,412528,227,737,2,36000,1.30800542741
411575,417435,417440,5860,5,2,86400,586.5
411589,411801,412605,212,804,2,36000,1.26368159204
411605,411817,412591,212,774,2,36000,1.27390180879
411606,411829,412630,223,801,2,36000,1.2784019975
411622,411836,412639,214,803,2,36000,1.26650062267
411637,411875,412775,238,900,2,36000,1.26444444444
411653,411889,412670,236,781,2,36000,1.30217669654
411655,412077,412900,422,823,2,36000,1.5127582017
411656,412203,412979,547,776,2,36000,1.70489690722
411672,412212,413037,540,825,2,36000,1.65454545455
411673,412245,413075,572,830,2,36000,1.68915662651
411675,412255,413052,580,797,2,36000,1.72772898369
411696,412284,413006,588,722,2,36000,1.81440443213
411712,412292,413059,580,767,2,36000,1.75619295958
411728,412298,412981,570,683,2,36000,1.8345534407
411744,412306,413088,562,782,2,36000,1.71867007673
411745,412312,413109,567,797,2,36000,1.71141781681
411746,412328,413047,582,719,2,36000,1.80945757997
411763,412335,413073,572,738,2,36000,1.77506775068
411765,412355,413003,590,648,2,36000,1.91049382716
411781,412387,413238,606,851,2,36000,1.71210340776
411782,412396,413164,614,768,2,36000,1.79947916667
411798,412416,413174,618,758,2,36000,1.81530343008
411813,412423,413253,610,830,2,36000,1.73493975904
411829,412429,413232,600,803,2,36000,1.74719800747
411830,412435,413284,605,849,2,36000,1.71260306243
411864,412443,413225,579,782,2,36000,1.74040920716
411879,412450,413265,571,815,2,36000,1.70061349693
412067,412455,413205,388,750,2,36000,1.51733333333
412191,412464,413261,273,797,2,36000,1.34253450439
412207,412472,413313,265,841,2,36000,1.31510107015
412234,412479,413191,245,712,2,36000,1.3441011236
412249,412485,413371,236,886,2,36000,1.26636568849
412272,412524,413774,252,1250,2,36000,1.2016
412287,412532,413430,245,898,2,36000,1.2728285078
412289,412537,413309,248,772,2,36000,1.32124352332
412305,412543,413258,238,715,2,36000,1.33286713287
412306,412548,413358,242,810,2,36000,1.2987654321
412321,412589,413343,268,754,2,36000,1.35543766578
412336,412602,413455,266,853,2,36000,1.31184056272
412351,412612,413338,261,726,2,36000,1.35950413223
412376,412618,413443,242,825,2,36000,1.29333333333
412391,412642,413444,251,802,2,36000,1.31296758105
412407,412651,413373,244,722,2,36000,1.3379501385
412423,412664,413473,241,809,2,36000,1.2978986403
412424,412682,413370,258,688,2,36000,1.375
412447,412787,413495,340,708,2,36000,1.4802259887
412449,412912,413746,463,834,2,36000,1.5551558753
412450,412991,413736,541,745,2,36000,1.72617449664
412451,412998,413830,547,832,2,36000,1.65745192308
412479,413006,413848,527,842,2,36000,1.62589073634
412481,413014,413835,533,821,2,36000,1.64920828258
412482,413021,413875,539,854,2,36000,1.63114754098
412483,413049,413828,566,779,2,36000,1.72657252888
412537,413059,413810,522,751,2,36000,1.69507323569
412538,413065,413791,527,726,2,36000,1.7258953168
412539,413073,413835,534,762,2,36000,1.70078740157
412541,413078,413763,537,685,2,36000,1.78394160584
412542,413086,413756,544,670,2,36000,1.81194029851
412582,413093,413882,511,789,2,36000,1.64765525982
412598,413099,413914,501,815,2,36000,1.61472392638
412614,413120,413892,506,772,2,36000,1.65544041451
412616,413176,413971,560,795,2,36000,1.70440251572
412631,413185,413927,554,742,2,36000,1.74663072776
412646,413204,413939,558,735,2,36000,1.75918367347
412661,413216,414026,555,810,2,36000,1.68518518519
412677,413237,413944,560,707,2,36000,1.79207920792
412774,413244,413977,470,733,2,36000,1.6412005457
412902,413251,414040,349,789,2,36000,1.44233206591
412983,413265,414149,282,884,2,36000,1.31900452489
412985,413272,413951,287,679,2,36000,1.42268041237
413000,413279,414067,279,788,2,36000,1.35406091371
413016,413284,414036,268,752,2,36000,1.35638297872
413017,413295,414084,278,789,2,36000,1.35234474018
413039,413322,414119,283,797,2,36000,1.35508155583
413054,413329,414021,275,692,2,36000,1.39739884393
413056,413350,414051,294,701,2,36000,1.41940085592
413072,413356,414158,284,802,2,36000,1.35411471322
413088,413370,414069,282,699,2,36000,1.40343347639
413089,413382,414218,293,836,2,36000,1.3504784689
413090,413389,414287,299,898,2,36000,1.33296213808
413109,413394,414227,285,833,2,36000,1.34213685474
413165,413441,414208,276,767,2,36000,1.35984354628
413180,413454,414195,274,741,2,36000,1.3697705803
413195,413462,414305,267,843,2,36000,1.31672597865
413211,413469,414298,258,829,2,36000,1.31121833534
413226,413485,414241,259,756,2,36000,1.34259259259
413241,413507,414389,266,882,2,36000,1.30158730159
413243,413748,414572,505,824,2,36000,1.61286407767
413259,413758,414550,499,792,2,36000,1.63005050505
413260,413768,414567,508,799,2,36000,1.63579474343
413276,413775,414577,499,802,2,36000,1.62219451372
413277,413786,414582,509,796,2,36000,1.63944723618
413292,413802,414571,510,769,2,36000,1.66319895969
413310,413822,414681,512,859,2,36000,1.5960419092
413325,413840,414629,515,789,2,36000,1.65272496831
413341,413847,414626,506,779,2,36000,1.64955070603
413357,413852,414669,495,817,2,36000,1.605875153
413378,413857,414603,479,746,2,36000,1.64209115282
413380,413863,414584,483,721,2,36000,1.66990291262
413381,413888,414625,507,737,2,36000,1.68792401628
413382,413895,414624,513,729,2,36000,1.7037037037
413433,413905,414633,472,728,2,36000,1.64835164835
413449,413926,414721,477,795,2,36000,1.6
413450,413938,414897,488,959,2,36000,1.50886339937
413470,413951,414670,481,719,2,36000,1.66898470097
413492,413958,414666,466,708,2,36000,1.6581920904
413513,413964,414757,451,793,2,36000,1.56872635561
413738,413983,414790,245,807,2,36000,1.30359355638
413754,413990,414762,236,772,2,36000,1.30569948187
413769,414032,414872,263,840,2,36000,1.3130952381
413771,414039,414826,268,787,2,36000,1.34053367217
413786,414047,414863,261,816,2,36000,1.31985294118
413801,414054,414853,253,799,2,36000,1.31664580726
413817,414063,414838,246,775,2,36000,1.31741935484
413832,414079,414883,247,804,2,36000,1.30721393035
413834,414086,414847,252,761,2,36000,1.33114323259
413850,414101,414884,251,783,2,36000,1.32056194125
413851,414132,414870,281,738,2,36000,1.38075880759
413852,414161,415120,309,959,2,36000,1.32221063608
413881,414170,414898,289,728,2,36000,1.39697802198
413906,414207,414975,301,768,2,36000,1.39192708333
413908,414219,415084,311,865,2,36000,1.35953757225
413926,414230,415022,304,792,2,36000,1.38383838384
413927,414239,414963,312,724,2,36000,1.43093922652
413946,414253,415045,307,792,2,36000,1.38762626263
413947,414299,415105,352,806,2,36000,1.43672456576
413963,414309,415130,346,821,2,36000,1.42143727162
413978,414316,415077,338,761,2,36000,1.44415243101
413979,414400,415172,421,772,2,36000,1.54533678756
414023,414562,415332,539,770,2,36000,1.7
414040,414579,415346,539,767,2,36000,1.70273794003
414042,414586,415382,544,796,2,36000,1.68341708543
414043,414591,415371,548,780,2,36000,1.70256410256
414060,414598,415331,538,733,2,36000,1.73396998636
414080,414603,415361,523,758,2,36000,1.68997361478
414081,414608,415386,527,778,2,36000,1.67737789203
414098,414615,415413,517,798,2,36000,1.64786967419
414120,414636,415455,516,819,2,36000,1.63003663004
414152,414643,415505,491,862,2,36000,1.56960556845
414171,414648,415381,477,733,2,36000,1.65075034106
414199,414653,415456,454,803,2,36000,1.56537982565
414214,414660,415374,446,714,2,36000,1.62464985994
414230,414678,415823,448,1145,2,36000,1.39126637555
414231,414685,415410,454,725,2,36000,1.62620689655
414247,414690,415429,443,739,2,36000,1.59945872801
414290,414697,415409,407,712,2,36000,1.57162921348
414305,414732,415613,427,881,2,36000,1.48467650397
414307,414768,415435,461,667,2,36000,1.69115442279
414392,414775,415496,383,721,2,36000,1.53120665742
414551,414801,415605,250,804,2,36000,1.31094527363
414567,414839,415495,272,656,2,36000,1.41463414634
414583,414849,415547,266,698,2,36000,1.38108882521
414585,414858,415663,273,805,2,36000,1.33913043478
414586,414864,415651,278,787,2,36000,1.35324015248
414587,414876,415563,289,687,2,36000,1.42066957787
414589,414882,415624,293,742,2,36000,1.3948787062
414605,414888,415626,283,738,2,36000,1.38346883469
414624,414895,415610,271,715,2,36000,1.37902097902
414641,414900,415738,259,838,2,36000,1.30906921241
414642,414909,415742,267,833,2,36000,1.32052821128
414644,414915,415648,271,733,2,36000,1.36971350614
414645,414975,415781,330,806,2,36000,1.4094292804
414667,414987,415725,320,738,2,36000,1.43360433604
414668,415034,415778,366,744,2,36000,1.49193548387
414684,415057,415868,373,811,2,36000,1.45992601726
414685,415089,415796,404,707,2,36000,1.57142857143
414722,415096,415888,374,792,2,36000,1.47222222222
414762,415116,415910,354,794,2,36000,1.44584382872
414763,415132,415914,369,782,2,36000,1.47186700767
414793,415143,415922,350,779,2,36000,1.44929396662
414827,415184,415960,357,776,2,36000,1.46005154639
414843,415342,416172,499,830,2,36000,1.60120481928
414860,415349,416077,489,728,2,36000,1.6717032967
414861,415356,416204,495,848,2,36000,1.58372641509
414878,415373,416177,495,804,2,36000,1.61567164179
414879,415383,416196,504,813,2,36000,1.61992619926
414881,415389,416167,508,778,2,36000,1.6529562982
414905,415397,416188,492,791,2,36000,1.62199747155
414906,415402,416179,496,777,2,36000,1.63835263835
414908,415409,416230,501,821,2,36000,1.61023142509
414909,415421,416241,512,820,2,36000,1.6243902439
414966,415428,416201,462,773,2,36000,1.59767141009
414981,415433,416163,452,730,2,36000,1.61917808219
415024,415442,416259,418,817,2,36000,1.51162790698
415045,415449,416189,404,740,2,36000,1.54594594595
415079,415466,416271,387,805,2,36000,1.48074534161
415094,415474,416233,380,759,2,36000,1.50065876153
415109,415507,416247,398,740,2,36000,1.53783783784
415125,415513,416300,388,787,2,36000,1.49301143583
415140,415521,416397,381,876,2,36000,1.43493150685
415173,415560,416325,387,765,2,36000,1.50588235294
415331,415574,416346,243,772,2,36000,1.31476683938
415333,415616,416437,283,821,2,36000,1.34470158343
415348,415623,416378,275,755,2,36000,1.3642384106
415363,415630,416406,267,776,2,36000,1.34407216495
415379,415637,416367,258,730,2,36000,1.35342465753
415381,415644,416487,263,843,2,36000,1.31198102017
415397,415660,416473,263,813,2,36000,1.32349323493
415398,415667,416412,269,745,2,36000,1.3610738255
415399,415675,416483,276,808,2,36000,1.34158415842
415416,415736,416483,320,747,2,36000,1.42838018742
415417,415750,416588,333,838,2,36000,1.39737470167
415419,415756,416517,337,761,2,36000,1.44283837057
415436,415790,416626,354,836,2,36000,1.42344497608
415437,415797,416670,360,873,2,36000,1.41237113402
415464,415807,416529,343,722,2,36000,1.47506925208
415465,415836,416677,371,841,2,36000,1.44114149822
415496,415881,417170,385,1289,2,36000,1.29868114818
415497,415900,416563,403,663,2,36000,1.60784313725
415513,415923,416705,410,782,2,36000,1.52429667519
415550,415930,416763,380,833,2,36000,1.45618247299
415566,415937,416728,371,791,2,36000,1.46902654867
415607,415972,416702,365,730,2,36000,1.5
415635,416089,416936,454,847,2,36000,1.5360094451
415636,416174,416990,538,816,2,36000,1.65931372549
415638,416182,416967,544,785,2,36000,1.69299363057
415639,416188,417462,549,1274,2,36000,1.43092621664
415659,416193,416928,534,735,2,36000,1.72653061224
415661,416201,416948,540,747,2,36000,1.72289156627
415677,416206,417030,529,824,2,36000,1.64199029126
416198,416213,417009,15,796,2,36000,1.01884422111
416200,416218,416987,18,769,2,36000,1.02340702211
416215,416224,416952,9,728,2,36000,1.01236263736
416216,416230,417057,14,827,2,36000,1.0169286578
416232,416243,417021,11,778,2,36000,1.01413881748
416248,416254,417012,6,758,2,36000,1.00791556728
416249,416260,417024,11,764,2,36000,1.01439790576
416250,416265,417120,15,855,2,36000,1.01754385965
416266,416272,417041,6,769,2,36000,1.0078023407
416281,416287,417069,6,782,2,36000,1.00767263427
416302,416312,417074,10,762,2,36000,1.01312335958
416327,416336,417147,9,811,2,36000,1.0110974106
416349,416359,417168,10,809,2,36000,1.01236093943
416367,416379,417156,12,777,2,36000,1.01544401544
416382,416390,417208,8,818,2,36000,1.0097799511
416397,416410,417239,13,829,2,36000,1.01568154403
416413,416420,417210,7,790,2,36000,1.00886075949
416414,416426,417286,12,860,2,36000,1.01395348837
416439,416448,417198,9,750,2,36000,1.012
416473,416485,417197,12,712,2,36000,1.01685393258
416489,416496,417320,7,824,2,36000,1.00849514563
416490,416503,417283,13,780,2,36000,1.01666666667
416491,416508,417402,17,894,2,36000,1.01901565996
416519,416530,417312,11,782,2,36000,1.01406649616
416534,416540,417318,6,778,2,36000,1.00771208226
416565,416574,417387,9,813,2,36000,1.0110701107
416589,416599,417401,10,802,2,36000,1.01246882793
416626,416638,417421,12,783,2,36000,1.0153256705
416670,416682,417501,12,819,2,36000,1.01465201465
416687,416694,417468,7,774,2,36000,1.00904392765
416703,416709,417530,6,821,2,36000,1.00730816078
416704,416716,417436,12,720,2,36000,1.01666666667
416729,416736,417464,7,728,2,36000,1.00961538462
416766,416772,417630,6,858,2,36000,1.00699300699
416931,416937,417763,6,826,2,36000,1.00726392252
416946,416953,417679,7,726,2,36000,1.00964187328
416962,416968,417700,6,732,2,36000,1.00819672131
416963,416975,417812,12,837,2,36000,1.01433691756
416978,416986,417769,8,783,2,36000,1.01021711367
416994,417000,417824,6,824,2,36000,1.0072815534
416995,417008,417927,13,919,2,36000,1.01414581066
417011,417017,417757,6,740,2,36000,1.00810810811
417028,417034,417867,6,833,2,36000,1.00720288115
417029,417041,417895,12,854,2,36000,1.01405152225
417030,417046,417857,16,811,2,36000,1.01972872996
417046,417052,417756,6,704,2,36000,1.00852272727
417048,417060,417835,12,775,2,36000,1.01548387097
417063,417071,417781,8,710,2,36000,1.01126760563
417079,417085,417869,6,784,2,36000,1.00765306122
417080,417092,417934,12,842,2,36000,1.01425178147
417120,417127,417910,7,783,2,36000,1.00893997446
417148,417155,417945,7,790,2,36000,1.00886075949
417163,417169,417915,6,746,2,36000,1.00804289544
417178,417185,417976,7,791,2,36000,1.00884955752
417180,417192,417949,12,757,2,36000,1.01585204756
417199,417205,418015,6,810,2,36000,1.00740740741
417200,417212,418031,12,819,2,36000,1.01465201465
417216,417223,418016,7,793,2,36000,1.00882723834
417218,417229,418024,11,795,2,36000,1.01383647799
417241,417248,418175,7,927,2,36000,1.00755124056
417287,417294,417999,7,705,2,36000,1.00992907801
417288,417301,418068,13,767,2,36000,1.01694915254
417315,417322,418126,7,804,2,36000,1.00870646766
417331,417337,418136,6,799,2,36000,1.00750938673
417332,417344,418106,12,762,2,36000,1.0157480315
417388,417394,418111,6,717,2,36000,1.00836820084
417404,417411,418221,7,810,2,36000,1.00864197531
417406,417419,418184,13,765,2,36000,1.01699346405
417422,417428,418205,6,777,2,36000,1.00772200772
417437,417448,418204,11,756,2,36000,1.01455026455
417463,417469,418280,6,811,2,36000,1.00739827374
417478,417484,418294,6,810,2,36000,1.00740740741
417479,417490,418281,11,791,2,36000,1.01390644753
417501,417507,418272,6,765,2,36000,1.00784313725
417528,417535,418371,7,836,2,36000,1.00837320574
417632,417639,418432,7,793,2,36000,1.00882723834
417681,417688,418511,7,823,2,36000,1.0085054678
417703,417710,418512,7,802,2,36000,1.00872817955
417758,417764,418482,6,718,2,36000,1.00835654596
417759,417770,418866,11,1096,2,36000,1.01003649635
417775,417782,418599,7,817,2,36000,1.00856793146
417776,417789,418644,13,855,2,36000,1.01520467836
417792,417799,418561,7,762,2,36000,1.00918635171
417813,417819,418601,6,782,2,36000,1.00767263427
417828,417835,418606,7,771,2,36000,1.00907911803
417843,417850,418593,7,743,2,36000,1.00942126514
417859,417866,418640,7,774,2,36000,1.00904392765
417875,417882,418727,7,845,2,36000,1.00828402367
417876,417889,418684,13,795,2,36000,1.01635220126
417895,417901,418603,6,702,2,36000,1.00854700855
417913,417919,418666,6,747,2,36000,1.00803212851
417933,417939,418677,6,738,2,36000,1.0081300813
417934,417945,418994,11,1049,2,36000,1.01048617731
417951,417957,418732,6,775,2,36000,1.00774193548
417952,417964,418722,12,758,2,36000,1.01583113456
417953,417969,418732,16,763,2,36000,1.02096985583
417979,417986,418756,7,770,2,36000,1.00909090909
418004,418011,418774,7,763,2,36000,1.00917431193
418024,418031,418779,7,748,2,36000,1.00935828877
418026,418037,418886,11,849,2,36000,1.01295641932
418027,418043,418808,16,765,2,36000,1.02091503268
418044,418051,418811,7,760,2,36000,1.00921052632
418068,418075,418891,7,816,2,36000,1.00857843137
418108,418115,418809,7,694,2,36000,1.01008645533
418123,418130,418984,7,854,2,36000,1.00819672131
418139,418146,418874,7,728,2,36000,1.00961538462
418140,418152,418993,12,841,2,36000,1.01426872771
418177,418183,419002,6,819,2,36000,1.00732600733
418192,418198,419004,6,806,2,36000,1.00744416873
418207,418214,418922,7,708,2,36000,1.00988700565
418209,418221,419054,12,833,2,36000,1.0144057623
418224,418230,419018,6,788,2,36000,1.0076142132
418270,418277,419051,7,774,2,36000,1.00904392765
418286,418293,419094,7,801,2,36000,1.00873907615
418287,418300,419115,13,815,2,36000,1.01595092025
418303,418309,419110,6,801,2,36000,1.0074906367
418373,418380,419174,7,794,2,36000,1.00881612091
418434,418441,419252,7,811,2,36000,1.00863131936
418483,418489,419288,6,799,2,36000,1.00750938673
418512,418519,419338,7,819,2,36000,1.00854700855
418513,418526,419421,13,895,2,36000,1.01452513966
418561,418568,419380,7,812,2,36000,1.00862068966
418596,418602,419433,6,831,2,36000,1.00722021661
418613,418619,419347,6,728,2,36000,1.00824175824
418614,418625,419312,11,687,2,36000,1.01601164483
418616,418630,419353,14,723,2,36000,1.0193637621
418617,418635,419446,18,811,2,36000,1.02219482121
418651,418658,419432,7,774,2,36000,1.00904392765
418653,418665,419473,12,808,2,36000,1.01485148515
418669,418675,419449,6,774,2,36000,1.00775193798
418685,418691,419442,6,751,2,36000,1.00798934754
418686,418697,419525,11,828,2,36000,1.01328502415
418723,418730,419609,7,879,2,36000,1.00796359499
418739,418744,419543,5,799,2,36000,1.00625782228
418740,418751,419499,11,748,2,36000,1.01470588235
418741,418757,419568,16,811,2,36000,1.01972872996
418757,418763,419627,6,864,2,36000,1.00694444444
418775,418783,419659,8,876,2,36000,1.00913242009
418791,418798,419588,7,790,2,36000,1.00886075949
418810,418816,419644,6,828,2,36000,1.00724637681
418811,418823,419617,12,794,2,36000,1.01511335013
418827,418834,419553,7,719,2,36000,1.00973574409
418866,418874,419636,8,762,2,36000,1.01049868766
418882,418888,419619,6,731,2,36000,1.00820793434
418898,418904,419735,6,831,2,36000,1.00722021661
418899,418910,419877,11,967,2,36000,1.0113753878
418924,418930,419661,6,731,2,36000,1.00820793434
418985,418992,419667,7,675,2,36000,1.01037037037
419001,419008,419807,7,799,2,36000,1.00876095119
419002,419015,419744,13,729,2,36000,1.01783264746
419018,419025,419780,7,755,2,36000,1.00927152318
419019,419032,419767,13,735,2,36000,1.01768707483
419021,419037,419787,16,750,2,36000,1.02133333333
419052,419059,419895,7,836,2,36000,1.00837320574
419066,419074,419855,8,781,2,36000,1.01024327785
419094,419100,419854,6,754,2,36000,1.00795755968
419111,419117,419982,6,865,2,36000,1.00693641618
419126,419133,419912,7,779,2,36000,1.00898587933
419177,419184,420000,7,816,2,36000,1.00857843137
419257,419264,420107,7,843,2,36000,1.00830367734
419288,419295,420097,7,802,2,36000,1.00872817955
419315,419321,420058,6,737,2,36000,1.00814111262
419339,419345,420095,6,750,2,36000,1.008
419355,419361,420154,6,793,2,36000,1.00756620429
419356,419368,420111,12,743,2,36000,1.01615074024
419381,419388,420212,7,824,2,36000,1.00849514563
419424,419430,420209,6,779,2,36000,1.00770218228
419440,419446,420166,6,720,2,36000,1.00833333333
419441,419452,420260,11,808,2,36000,1.01361386139
419456,419462,420258,6,796,2,36000,1.00753768844
419458,419468,420303,10,835,2,36000,1.0119760479
419459,419473,420278,14,805,2,36000,1.01739130435
419474,419482,420210,8,728,2,36000,1.01098901099
419499,419506,420215,7,709,2,36000,1.00987306065
419526,419533,420280,7,747,2,36000,1.0093708166
419544,419550,420329,6,779,2,36000,1.00770218228
419559,419567,420507,8,940,2,36000,1.0085106383
419574,419582,420385,8,803,2,36000,1.0099626401
419589,419596,420425,7,829,2,36000,1.00844390832
419611,419617,420418,6,801,2,36000,1.0074906367
419626,419634,420399,8,765,2,36000,1.01045751634
419628,419639,420359,11,720,2,36000,1.01527777778
419643,419649,420435,6,786,2,36000,1.00763358779
419645,419655,420442,10,787,2,36000,1.0127064803
419646,419661,420461,15,800,2,36000,1.01875
419662,419668,420398,6,730,2,36000,1.00821917808
419664,419674,420480,10,806,2,36000,1.01240694789
419680,419686,420480,6,794,2,36000,1.00755667506
419686,420075,420076,389,1,2,3540,39.0
419738,419744,420528,6,784,2,36000,1.00765306122
419754,419760,420595,6,835,2,36000,1.00718562874
419769,419775,420580,6,805,2,36000,1.00745341615
419791,419798,420550,7,752,2,36000,1.00930851064
419792,419805,420561,13,756,2,36000,1.0171957672
419814,419820,420568,6,748,2,36000,1.00802139037
419854,419860,420621,6,761,2,36000,1.00788436268
419869,419875,420669,6,794,2,36000,1.00755667506
419884,419891,420702,7,811,2,36000,1.00863131936
419899,419906,420678,7,772,2,36000,1.00906735751
419915,419921,420817,6,896,2,36000,1.00669642857
419982,419988,420821,6,833,2,36000,1.00720288115
420000,420006,420775,6,769,2,36000,1.0078023407
420061,420068,420785,7,717,2,36000,1.00976290098
420097,420105,420909,8,804,2,36000,1.00995024876
420099,420112,420879,13,767,2,36000,1.01694915254
420114,420120,421044,6,924,2,36000,1.00649350649
420116,420128,420890,12,762,2,36000,1.0157480315
420156,420163,420923,7,760,2,36000,1.00921052632
420171,420177,420882,6,705,2,36000,1.0085106383
420212,420219,420998,7,779,2,36000,1.00898587933
420214,420226,420989,12,763,2,36000,1.01572739187
420215,420231,420990,16,759,2,36000,1.02108036891
420230,420237,421160,7,923,2,36000,1.00758396533
420258,420265,420999,7,734,2,36000,1.00953678474
420273,420279,420981,6,702,2,36000,1.00854700855
420288,420295,421045,7,750,2,36000,1.00933333333
420289,420302,421069,13,767,2,36000,1.01694915254
420305,420312,421217,7,905,2,36000,1.00773480663
420331,420337,421143,6,806,2,36000,1.00744416873
420361,420368,421135,7,767,2,36000,1.00912646675
420386,420393,421057,7,664,2,36000,1.01054216867
420402,420408,421247,6,839,2,36000,1.00715137068
420403,420415,421157,12,742,2,36000,1.01617250674
420419,420425,421613,6,1188,2,36000,1.00505050505
420435,420453,421215,18,762,2,36000,1.02362204724
420437,420460,421178,23,718,2,36000,1.03203342618
420452,420465,421317,13,852,2,36000,1.01525821596
420473,420481,421297,8,816,2,36000,1.00980392157
420495,420501,421219,6,718,2,36000,1.00835654596
420496,420508,421246,12,738,2,36000,1.0162601626
420512,420518,421264,6,746,2,36000,1.00804289544
420528,420540,421380,12,840,2,36000,1.01428571429
420552,420563,421383,11,820,2,36000,1.01341463415
420567,420574,421463,7,889,2,36000,1.00787401575
420583,420589,421423,6,834,2,36000,1.0071942446
420584,420596,421354,12,758,2,36000,1.01583113456
420600,420606,421438,6,832,2,36000,1.00721153846
420624,420630,421374,6,744,2,36000,1.00806451613
420669,420676,421437,7,761,2,36000,1.00919842313
420684,420691,421522,7,831,2,36000,1.00842358604
420703,420709,421459,6,750,2,36000,1.008
420776,420782,421679,6,897,2,36000,1.00668896321
420791,420797,421639,6,842,2,36000,1.00712589074
420819,420825,421577,6,752,2,36000,1.0079787234
420834,420840,421722,6,882,2,36000,1.00680272109
420879,420886,421612,7,726,2,36000,1.00964187328
420894,420901,421778,7,877,2,36000,1.00798175599
420896,420907,421711,11,804,2,36000,1.01368159204
420911,420917,421650,6,733,2,36000,1.00818553888
420926,420932,421909,6,977,2,36000,1.00614124872
420982,420989,421756,7,767,2,36000,1.00912646675
421004,421010,421800,6,790,2,36000,1.00759493671
421005,421016,421830,11,814,2,36000,1.01351351351
421007,421021,421856,14,835,2,36000,1.01676646707
421008,421026,421649,18,623,2,36000,1.02889245586
421045,421051,421789,6,738,2,36000,1.0081300813
421047,421058,421832,11,774,2,36000,1.0142118863
421065,421071,421813,6,742,2,36000,1.00808625337
421080,421086,421758,6,672,2,36000,1.00892857143
421136,421143,421976,7,833,2,36000,1.00840336134
421152,421159,421887,7,728,2,36000,1.00961538462
421168,421174,421975,6,801,2,36000,1.0074906367
421169,421180,421995,11,815,2,36000,1.01349693252
421185,421191,421865,6,674,2,36000,1.00890207715
421215,421222,422016,7,794,2,36000,1.00881612091
421230,421237,422039,7,802,2,36000,1.00872817955
421232,421243,421958,11,715,2,36000,1.01538461538
421248,421254,421977,6,723,2,36000,1.00829875519
421249,421261,422045,12,784,2,36000,1.01530612245
421264,421270,422100,6,830,2,36000,1.00722891566
421298,421304,422294,6,990,2,36000,1.00606060606
421316,421322,422118,6,796,2,36000,1.00753768844
421355,421362,422216,7,854,2,36000,1.00819672131
421374,421380,422109,6,729,2,36000,1.00823045267
421389,421396,422147,7,751,2,36000,1.00932090546
421390,421402,422188,12,786,2,36000,1.01526717557
421421,421427,422239,6,812,2,36000,1.00738916256
421440,421446,422244,6,798,2,36000,1.00751879699
421441,421453,422323,12,870,2,36000,1.01379310345
421459,421466,422263,7,797,2,36000,1.00878293601
421476,421482,422315,6,833,2,36000,1.00720288115
421526,421532,422286,6,754,2,36000,1.00795755968
421578,421584,422394,6,810,2,36000,1.00740740741
421614,421620,422405,6,785,2,36000,1.0076433121
421615,421627,422359,12,732,2,36000,1.01639344262
421640,421646,422393,6,747,2,36000,1.00803212851
421656,421663,422455,7,792,2,36000,1.00883838384
421657,421669,422402,12,733,2,36000,1.01637107776
421679,421686,422466,7,780,2,36000,1.00897435897
421713,421719,422587,6,868,2,36000,1.0069124424
421728,421734,422441,6,707,2,36000,1.00848656294
421756,421762,422644,6,882,2,36000,1.00680272109
421771,421777,422604,6,827,2,36000,1.00725513906
421786,421793,422492,7,699,2,36000,1.01001430615
421802,421808,422523,6,715,2,36000,1.00839160839
421803,421815,422637,12,822,2,36000,1.01459854015
421818,421825,422648,7,823,2,36000,1.0085054678
421833,421840,422721,7,881,2,36000,1.00794551646
421835,421847,422680,12,833,2,36000,1.0144057623
421856,421863,422634,7,771,2,36000,1.00907911803
421872,421878,422769,6,891,2,36000,1.00673400673
421887,421894,422698,7,804,2,36000,1.00870646766
421911,421918,422688,7,770,2,36000,1.00909090909
421960,421966,422702,6,736,2,36000,1.00815217391
421979,421985,422834,6,849,2,36000,1.00706713781
421980,421993,422719,13,726,2,36000,1.01790633609
421982,421998,422810,16,812,2,36000,1.0197044335
421997,422005,422766,8,761,2,36000,1.01051248357
422015,422023,422807,8,784,2,36000,1.01020408163
422040,422047,422840,7,793,2,36000,1.00882723834
422055,422062,422837,7,775,2,36000,1.00903225806
422109,422115,422982,6,867,2,36000,1.00692041522
422110,422122,422889,12,767,2,36000,1.01564537158
422129,422135,422900,6,765,2,36000,1.00784313725
422148,422154,422979,6,825,2,36000,1.00727272727
422191,422198,422971,7,773,2,36000,1.00905562743
422217,422223,422957,6,734,2,36000,1.00817438692
422241,422249,423066,8,817,2,36000,1.00979192166
422259,422266,423051,7,785,2,36000,1.00891719745
422275,422281,422946,6,665,2,36000,1.00902255639
422290,422296,423077,6,781,2,36000,1.00768245839
422305,422311,423311,6,1000,2,36000,1.006
422320,422326,423079,6,753,2,36000,1.00796812749
422336,422342,423119,6,777,2,36000,1.00772200772
422360,422367,423158,7,791,2,36000,1.00884955752
422394,422401,423199,7,798,2,36000,1.00877192982
422395,422407,423142,12,735,2,36000,1.01632653061
422411,422417,423143,6,726,2,36000,1.00826446281
422413,422423,423170,10,747,2,36000,1.01338688086
422443,422450,423263,7,813,2,36000,1.0086100861
422459,422465,423358,6,893,2,36000,1.00671892497
422474,422480,423202,6,722,2,36000,1.00831024931
422492,422498,423335,6,837,2,36000,1.00716845878
422525,422532,423333,7,801,2,36000,1.00873907615
422589,422595,423385,6,790,2,36000,1.00759493671
422605,422611,423487,6,876,2,36000,1.00684931507
422635,422641,423445,6,804,2,36000,1.00746268657
422651,422658,423463,7,805,2,36000,1.00869565217
422652,422664,423339,12,675,2,36000,1.01777777778
422653,422670,423419,17,749,2,36000,1.02269692924
422682,422688,423442,6,754,2,36000,1.00795755968
422697,422703,423592,6,889,2,36000,1.00674915636
422698,422709,423505,11,796,2,36000,1.01381909548
422714,422721,423548,7,827,2,36000,1.0084643289
422730,422736,423576,6,840,2,36000,1.00714285714
422731,422742,423478,11,736,2,36000,1.01494565217
422768,422774,423556,6,782,2,36000,1.00767263427
422783,422789,423520,6,731,2,36000,1.00820793434
422810,422816,423770,6,954,2,36000,1.00628930818
422811,422823,423605,12,782,2,36000,1.01534526854
422842,422848,423653,6,805,2,36000,1.00745341615
422843,422854,423682,11,828,2,36000,1.01328502415
422845,422860,423591,15,731,2,36000,1.02051983584
422892,422898,423660,6,762,2,36000,1.00787401575
422908,422914,423687,6,773,2,36000,1.00776196636
422946,422952,423827,6,875,2,36000,1.00685714286
422978,422986,423790,8,804,2,36000,1.00995024876
422980,422993,423887,13,894,2,36000,1.01454138702
422981,422998,423843,17,845,2,36000,1.0201183432
422983,423003,423769,20,766,2,36000,1.02610966057
422998,423009,425537,11,2528,1,18000,1.00435126582
423054,423060,423835,6,775,2,36000,1.00774193548
423069,423076,423901,7,825,2,36000,1.00848484848
423084,423091,423951,7,860,2,36000,1.00813953488
423086,423097,423875,11,778,2,36000,1.01413881748
423099,423214,458719,115,35505,1,439200,1.00323898043
423119,423127,423907,8,780,2,36000,1.01025641026
423144,423151,423912,7,761,2,36000,1.00919842313
423146,423158,423969,12,811,2,36000,1.01479654747
423161,423167,423972,6,805,2,36000,1.00745341615
423176,423183,423916,7,733,2,36000,1.00954979536
423201,423207,423971,6,764,2,36000,1.00785340314
423216,423223,424036,7,813,2,36000,1.0086100861
423266,423274,424208,8,934,2,36000,1.00856531049
423311,423322,424127,11,805,2,36000,1.01366459627
423334,423345,424093,11,748,2,36000,1.01470588235
423349,423355,424125,6,770,2,36000,1.00779220779
423350,423361,424147,11,786,2,36000,1.01399491094
423365,423373,424219,8,846,2,36000,1.00945626478
423387,423396,424200,9,804,2,36000,1.01119402985
423424,423430,424178,6,748,2,36000,1.00802139037
423446,423455,424167,9,712,2,36000,1.01264044944
423448,423461,424222,13,761,2,36000,1.01708278581
423469,423476,424240,7,764,2,36000,1.00916230366
423485,423491,424297,6,806,2,36000,1.00744416873
423501,423508,424275,7,767,2,36000,1.00912646675
423517,423523,424303,6,780,2,36000,1.00769230769
423532,423538,424356,6,818,2,36000,1.00733496333
423552,423560,424335,8,775,2,36000,1.01032258065
423570,423577,424313,7,736,2,36000,1.00951086957
423587,423594,424301,7,707,2,36000,1.0099009901
423602,423608,424478,6,870,2,36000,1.00689655172
423604,423614,424358,10,744,2,36000,1.01344086022
423619,423626,424441,7,815,2,36000,1.00858895706
423654,423664,424395,10,731,2,36000,1.01367989056
423669,423676,424401,7,725,2,36000,1.00965517241
423685,423694,424521,9,827,2,36000,1.01088270859
423701,423707,424486,6,779,2,36000,1.00770218228
423769,423780,424452,11,672,2,36000,1.01636904762
423784,423791,424571,7,780,2,36000,1.00897435897
423799,423805,424571,6,766,2,36000,1.00783289817
423824,423839,424591,15,752,2,36000,1.01994680851
423839,423846,424563,7,717,2,36000,1.00976290098
423854,423861,424608,7,747,2,36000,1.0093708166
423876,423886,424713,10,827,2,36000,1.01209189843
423892,423898,424718,6,820,2,36000,1.00731707317
423908,423915,424768,7,853,2,36000,1.0082063306
423910,423922,424687,12,765,2,36000,1.01568627451
423926,423932,424684,6,752,2,36000,1.0079787234
423928,423938,424754,10,816,2,36000,1.01225490196
423949,423963,424805,14,842,2,36000,1.01662707838
423971,423980,424758,9,778,2,36000,1.01156812339
423972,423986,424743,14,757,2,36000,1.01849405548
423973,423992,424787,19,795,2,36000,1.02389937107
424035,424049,424863,14,814,2,36000,1.0171990172
424093,424105,424944,12,839,2,36000,1.01430274136
424131,424138,424873,7,735,2,36000,1.00952380952
424133,424145,425435,12,1290,2,36000,1.00930232558
424153,424159,424964,6,805,2,36000,1.00745341615
424168,424180,424984,12,804,2,36000,1.01492537313
424184,424192,424951,8,759,2,36000,1.01054018445
424201,424211,425049,10,838,2,36000,1.01193317422
424218,424224,425081,6,857,2,36000,1.00700116686
424238,424244,425149,6,905,2,36000,1.00662983425
424239,424250,424995,11,745,2,36000,1.01476510067
424257,424264,425065,7,801,2,36000,1.00873907615
424279,424287,424994,8,707,2,36000,1.01131541726
424298,424308,425100,10,792,2,36000,1.01262626263
424315,424322,425183,7,861,2,36000,1.0081300813
424316,424328,425212,12,884,2,36000,1.01357466063
424317,424334,425145,17,811,2,36000,1.02096177559
424336,424346,425154,10,808,2,36000,1.01237623762
424358,424369,425266,11,897,2,36000,1.01226309922
424359,424376,425160,17,784,2,36000,1.02168367347
424396,424407,425266,11,859,2,36000,1.01280558789
424411,424417,425105,6,688,2,36000,1.00872093023
424443,424452,425281,9,829,2,36000,1.01085645356
424459,424466,425259,7,793,2,36000,1.00882723834
424477,424490,425375,13,885,2,36000,1.01468926554
424493,424500,425325,7,825,2,36000,1.00848484848
424521,424534,425230,13,696,2,36000,1.01867816092
424567,424576,425360,9,784,2,36000,1.01147959184
424582,424588,425693,6,1105,2,36000,1.00542986425
424584,424594,425303,10,709,2,36000,1.01410437236
424599,424605,425400,6,795,2,36000,1.00754716981
424615,424621,425312,6,691,2,36000,1.00868306802
424685,424696,425445,11,749,2,36000,1.01468624833
424700,424706,425725,6,1019,2,36000,1.00588812561
424715,424725,425540,10,815,2,36000,1.01226993865
424731,424737,425486,6,749,2,36000,1.00801068091
424746,424755,425571,9,816,2,36000,1.01102941176
424762,424768,425517,6,749,2,36000,1.00801068091
424763,424774,425520,11,746,2,36000,1.01474530831
424779,424785,425543,6,758,2,36000,1.00791556728
424795,424802,425586,7,784,2,36000,1.00892857143
424811,424817,425713,6,896,2,36000,1.00669642857
424864,424874,425648,10,774,2,36000,1.01291989664
424882,424888,425615,6,727,2,36000,1.00825309491
424947,424955,425775,8,820,2,36000,1.00975609756
424967,424975,425780,8,805,2,36000,1.0099378882
424969,424981,425792,12,811,2,36000,1.01479654747
424987,424995,425753,8,758,2,36000,1.01055408971
425003,425010,425756,7,746,2,36000,1.00938337802
425004,425017,425845,13,828,2,36000,1.01570048309
425051,425061,425897,10,836,2,36000,1.01196172249
425067,425077,425846,10,769,2,36000,1.01300390117
425082,425093,425963,11,870,2,36000,1.01264367816
425101,425112,425951,11,839,2,36000,1.01311084625
425117,425123,425944,6,821,2,36000,1.00730816078
425145,425157,425924,12,767,2,36000,1.01564537158
425161,425167,425953,6,786,2,36000,1.00763358779
425162,425173,425948,11,775,2,36000,1.01419354839
425163,425178,425983,15,805,2,36000,1.01863354037
425186,425194,426067,8,873,2,36000,1.00916380298
425214,425224,426067,10,843,2,36000,1.0118623962
425232,425242,425966,10,724,2,36000,1.0138121547
425260,425271,426038,11,767,2,36000,1.01434159061
425276,425283,426113,7,830,2,36000,1.00843373494
425278,425290,426101,12,811,2,36000,1.01479654747
425293,425299,426074,6,775,2,36000,1.00774193548
425309,425315,426116,6,801,2,36000,1.0074906367
425325,425331,426094,6,763,2,36000,1.00786369594
425326,425338,425969,12,631,2,36000,1.01901743265
425360,425372,426113,12,741,2,36000,1.01619433198
425376,425386,426222,10,836,2,36000,1.01196172249
425400,425411,426231,11,820,2,36000,1.01341463415
425441,425447,426239,6,792,2,36000,1.00757575758
425458,425465,426190,7,725,2,36000,1.00965517241
425488,425496,426289,8,793,2,36000,1.01008827238
425525,425532,426473,7,941,2,36000,1.00743889479
425527,425538,426227,11,689,2,36000,1.01596516691
425546,425551,426359,5,808,2,36000,1.00618811881
425547,425558,426366,11,808,2,36000,1.01361386139
425575,425581,426414,6,833,2,36000,1.00720288115
425590,425596,426325,6,729,2,36000,1.00823045267
425618,425624,426435,6,811,2,36000,1.00739827374
425648,425655,426405,7,750,2,36000,1.00933333333
425694,425702,426521,8,819,2,36000,1.00976800977
425716,425722,426556,6,834,2,36000,1.0071942446
425732,425738,426457,6,719,2,36000,1.0083449235
425754,425760,426533,6,773,2,36000,1.00776196636
425769,425776,426569,7,793,2,36000,1.00882723834
425785,425791,426574,6,783,2,36000,1.00766283525
425786,425797,426643,11,846,2,36000,1.01300236407
425802,425809,426475,7,666,2,36000,1.01051051051
425845,425851,426748,6,897,2,36000,1.00668896321
425846,425857,426598,11,741,2,36000,1.01484480432
425899,425906,426602,7,696,2,36000,1.01005747126
425927,425933,426718,6,785,2,36000,1.0076433121
425946,425953,426752,7,799,2,36000,1.00876095119
425962,425968,426800,6,832,2,36000,1.00721153846
425963,425975,426766,12,791,2,36000,1.01517067004
425965,425980,426826,15,846,2,36000,1.01773049645
425982,425989,426775,7,786,2,36000,1.00890585242
425984,425996,426833,12,837,2,36000,1.01433691756
425985,426001,426762,16,761,2,36000,1.02102496715
426001,426007,426812,6,805,2,36000,1.00745341615
426053,426059,426867,6,808,2,36000,1.00742574257
426087,426093,426856,6,763,2,36000,1.00786369594
426089,426100,426919,11,819,2,36000,1.01343101343
426090,426106,426936,16,830,2,36000,1.01927710843
426113,426120,426893,7,773,2,36000,1.00905562743
426115,426127,426937,12,810,2,36000,1.01481481481
426116,426132,426877,16,745,2,36000,1.02147651007
426117,426137,426832,20,695,2,36000,1.02877697842
426146,426153,426957,7,804,2,36000,1.00870646766
426194,426200,426988,6,788,2,36000,1.0076142132
426225,426231,426991,6,760,2,36000,1.00789473684
426242,426248,427015,6,767,2,36000,1.00782268579
426243,426254,427065,11,811,2,36000,1.01356350185
426244,426260,427095,16,835,2,36000,1.01916167665
426293,426300,427053,7,753,2,36000,1.00929614874
426331,426338,427009,7,671,2,36000,1.01043219076
426364,426371,427130,7,759,2,36000,1.0092226614
426380,426386,427127,6,741,2,36000,1.00809716599
426404,426411,427175,7,764,2,36000,1.00916230366
426420,426426,427237,6,811,2,36000,1.00739827374
426436,426443,427204,7,761,2,36000,1.00919842313
426457,426464,427237,7,773,2,36000,1.00905562743
426476,426483,427332,7,849,2,36000,1.00824499411
426477,426489,427253,12,764,2,36000,1.01570680628
426524,426530,427335,6,805,2,36000,1.00745341615
426539,426545,427299,6,754,2,36000,1.00795755968
426557,426563,427398,6,835,2,36000,1.00718562874
426573,426579,427279,6,700,2,36000,1.00857142857
426574,426585,427257,11,672,2,36000,1.01636904762
426599,426605,427384,6,779,2,36000,1.00770218228
426614,426621,427344,7,723,2,36000,1.00968188105
426645,426651,427451,6,800,2,36000,1.0075
426719,426725,427518,6,793,2,36000,1.00756620429
426750,426756,427805,6,1049,2,36000,1.00571973308
426765,426771,427538,6,767,2,36000,1.00782268579
426767,426778,427507,11,729,2,36000,1.01508916324
426768,426783,427497,15,714,2,36000,1.02100840336
426784,426791,427556,7,765,2,36000,1.0091503268
426802,426809,427543,7,734,2,36000,1.00953678474
426818,426825,427704,7,879,2,36000,1.00796359499
426833,426840,427621,7,781,2,36000,1.00896286812
426835,426847,427689,12,842,2,36000,1.01425178147
426836,426852,427635,16,783,2,36000,1.02043422733
426858,426865,427679,7,814,2,36000,1.0085995086
426874,426880,427709,6,829,2,36000,1.00723763571
426890,426897,427682,7,785,2,36000,1.00891719745
426908,426914,427724,6,810,2,36000,1.00740740741
426933,426939,427701,6,762,2,36000,1.00787401575
426954,426960,428359,6,1399,2,36000,1.0042887777
426956,426967,427655,11,688,2,36000,1.01598837209
426971,426977,427767,6,790,2,36000,1.00759493671
426991,426998,427787,7,789,2,36000,1.00887198986
426993,427004,427862,11,858,2,36000,1.01282051282
427018,427024,427812,6,788,2,36000,1.0076142132
427019,427030,427832,11,802,2,36000,1.01371571072
427060,427066,427704,6,638,2,36000,1.00940438871
427076,427082,427828,6,746,2,36000,1.00804289544
427097,427104,427853,7,749,2,36000,1.00934579439
427127,427134,427989,7,855,2,36000,1.0081871345
427143,427149,427884,6,735,2,36000,1.00816326531
427176,427182,427961,6,779,2,36000,1.00770218228
427204,427211,428026,7,815,2,36000,1.00858895706
427238,427245,428019,7,774,2,36000,1.00904392765
427240,427252,428045,12,793,2,36000,1.01513240858
427255,427262,427942,7,680,2,36000,1.01029411765
427270,427277,428124,7,847,2,36000,1.00826446281
427285,427291,428068,6,777,2,36000,1.00772200772
427300,427307,428138,7,831,2,36000,1.00842358604
427334,427340,428112,6,772,2,36000,1.00777202073
427336,427346,428090,10,744,2,36000,1.01344086022
427351,427357,428161,6,804,2,36000,1.00746268657
427385,427391,428140,6,749,2,36000,1.00801068091
427400,427406,428137,6,731,2,36000,1.00820793434
427458,427464,428253,6,789,2,36000,1.00760456274
427498,427506,428321,8,815,2,36000,1.00981595092
427514,427521,428289,7,768,2,36000,1.00911458333
427530,427537,428284,7,747,2,36000,1.0093708166
427551,427557,428343,6,786,2,36000,1.00763358779
427552,427563,428301,11,738,2,36000,1.01490514905
427568,427574,428268,6,694,2,36000,1.00864553314
427623,427629,428443,6,814,2,36000,1.00737100737
427639,427646,428361,7,715,2,36000,1.00979020979
427657,427663,428411,6,748,2,36000,1.00802139037
427683,427689,428418,6,729,2,36000,1.00823045267
427684,427696,428478,12,782,2,36000,1.01534526854
427701,427707,428463,6,756,2,36000,1.00793650794
427702,427714,428474,12,760,2,36000,1.01578947368
427718,427725,428536,7,811,2,36000,1.00863131936
427720,427732,428484,12,752,2,36000,1.01595744681
427721,427737,428449,16,712,2,36000,1.02247191011
427736,427743,428432,7,689,2,36000,1.01015965167
427770,427777,428518,7,741,2,36000,1.00944669366
427788,427794,428517,6,723,2,36000,1.00829875519
427807,427813,428573,6,760,2,36000,1.00789473684
427822,427828,428688,6,860,2,36000,1.00697674419
427838,427845,428556,7,711,2,36000,1.00984528833
427839,427850,428679,11,829,2,36000,1.01326899879
427855,427861,428639,6,778,2,36000,1.00771208226
427870,427876,428618,6,742,2,36000,1.00808625337
427885,427892,428651,7,759,2,36000,1.0092226614
427944,427950,428714,6,764,2,36000,1.00785340314
427962,427968,428785,6,817,2,36000,1.00734394125
427990,427996,428686,6,690,2,36000,1.00869565217
428020,428027,428853,7,826,2,36000,1.00847457627
428036,428043,428789,7,746,2,36000,1.00938337802
428051,428058,428851,7,793,2,36000,1.00882723834
428069,428076,428949,7,873,2,36000,1.00801832761
428091,428097,428876,6,779,2,36000,1.00770218228
428112,428118,428875,6,757,2,36000,1.00792602378
428127,428134,428952,7,818,2,36000,1.00855745721
428143,428150,429009,7,859,2,36000,1.00814901048
428144,428156,428927,12,771,2,36000,1.01556420233
428146,428162,428892,16,730,2,36000,1.02191780822
428161,428168,428944,7,776,2,36000,1.00902061856
428255,428262,429179,7,917,2,36000,1.00763358779
428274,428281,429055,7,774,2,36000,1.00904392765
428291,428298,429068,7,770,2,36000,1.00909090909
428292,428305,429116,13,811,2,36000,1.01602959309
428308,428315,429189,7,874,2,36000,1.00800915332
428327,428333,429132,6,799,2,36000,1.00750938673
428344,428351,429088,7,737,2,36000,1.00949796472
428360,428367,429168,7,801,2,36000,1.00873907615
428362,428374,429165,12,791,2,36000,1.01517067004
428412,428419,429226,7,807,2,36000,1.00867410161
428428,428435,429204,7,769,2,36000,1.00910273082
428443,428451,429251,8,800,2,36000,1.01
428445,428456,429760,11,1304,2,36000,1.00843558282
428460,428466,429256,6,790,2,36000,1.00759493671
428476,428482,429228,6,746,2,36000,1.00804289544
428477,428489,429239,12,750,2,36000,1.016
428493,428499,429336,6,837,2,36000,1.00716845878
428494,428505,429323,11,818,2,36000,1.01344743276
428517,428524,429349,7,825,2,36000,1.00848484848
428519,428532,429309,13,777,2,36000,1.01673101673
428539,428546,429273,7,727,2,36000,1.00962861073
428558,428565,429281,7,716,2,36000,1.00977653631
428573,428579,429370,6,791,2,36000,1.00758533502
428620,428627,429384,7,757,2,36000,1.00924702774
428639,428645,429352,6,707,2,36000,1.00848656294
428655,428661,429414,6,753,2,36000,1.00796812749
428680,428686,429530,6,844,2,36000,1.00710900474
428696,428702,429413,6,711,2,36000,1.00843881857
428697,428708,429494,11,786,2,36000,1.01399491094
428716,428723,429458,7,735,2,36000,1.00952380952
428787,428793,429603,6,810,2,36000,1.00740740741
428802,428808,429513,6,705,2,36000,1.0085106383
428852,428858,429743,6,885,2,36000,1.00677966102
428853,428865,429646,12,781,2,36000,1.01536491677
428883,428890,429612,7,722,2,36000,1.00969529086
428885,428896,429707,11,811,2,36000,1.01356350185
428901,428907,429689,6,782,2,36000,1.00767263427
428928,428935,429754,7,819,2,36000,1.00854700855
428944,428950,429818,6,868,2,36000,1.0069124424
428964,428970,429725,6,755,2,36000,1.00794701987
428966,428976,429698,10,722,2,36000,1.01385041551
429011,429018,429829,7,811,2,36000,1.00863131936
429055,429063,429870,8,807,2,36000,1.00991325898
429071,429078,429826,7,748,2,36000,1.00935828877
429090,429096,429884,6,788,2,36000,1.0076142132
429118,429124,429916,6,792,2,36000,1.00757575758
429134,429140,429953,6,813,2,36000,1.0073800738
429166,429172,429957,6,785,2,36000,1.0076433121
429168,429178,429958,10,780,2,36000,1.01282051282
429183,429190,429944,7,754,2,36000,1.00928381963
429199,429205,429970,6,765,2,36000,1.00784313725
429215,429221,429979,6,758,2,36000,1.00791556728
429231,429237,429972,6,735,2,36000,1.00816326531
429232,429243,430022,11,779,2,36000,1.01412066752
429248,429255,430171,7,916,2,36000,1.0076419214
429263,429271,430112,8,841,2,36000,1.00951248514
429265,429276,429993,11,717,2,36000,1.01534170153
429281,429287,430174,6,887,2,36000,1.0067643743
429283,429294,430066,11,772,2,36000,1.01424870466
429310,429317,430132,7,815,2,36000,1.00858895706
429326,429332,430198,6,866,2,36000,1.00692840647
429342,429348,430060,6,712,2,36000,1.00842696629
429359,429365,430228,6,863,2,36000,1.00695249131
429361,429372,430104,11,732,2,36000,1.0150273224
429378,429384,430644,6,1260,2,36000,1.00476190476
429395,429401,430076,6,675,2,36000,1.00888888889
429422,429428,430158,6,730,2,36000,1.00821917808
429423,429434,430164,11,730,2,36000,1.01506849315
429457,429463,430236,6,773,2,36000,1.00776196636
429495,429501,430232,6,731,2,36000,1.00820793434
429514,429520,430233,6,713,2,36000,1.00841514727
429529,429535,430303,6,768,2,36000,1.0078125
429539,429624,429625,85,1,2,3540,8.6
429605,429612,430475,7,863,2,36000,1.00811123986
429621,429631,430414,10,783,2,36000,1.01277139208
429650,429656,430598,6,942,2,36000,1.00636942675
429691,429697,430480,6,783,2,36000,1.00766283525
429707,429714,430484,7,770,2,36000,1.00909090909
429708,429721,430514,13,793,2,36000,1.01639344262
429730,429737,430612,7,875,2,36000,1.008
429750,429757,430483,7,726,2,36000,1.00964187328
429766,429773,430555,7,782,2,36000,1.00895140665
429767,429779,430659,12,880,2,36000,1.01363636364
429821,429827,430532,6,705,2,36000,1.0085106383
429839,429845,430658,6,813,2,36000,1.0073800738
429840,429851,430648,11,797,2,36000,1.01380175659
429874,429880,430643,6,763,2,36000,1.00786369594
429889,429895,430614,6,719,2,36000,1.0083449235
429917,429923,430732,6,809,2,36000,1.00741656366
429944,429950,430817,6,867,2,36000,1.00692041522
429960,429966,430860,6,894,2,36000,1.0067114094
429961,429973,430779,12,806,2,36000,1.01488833747
429963,429978,430695,15,717,2,36000,1.02092050209
429979,429986,430795,7,809,2,36000,1.0086526576
429980,429993,430693,13,700,2,36000,1.01857142857
429982,429998,430797,16,799,2,36000,1.02002503129
429997,430005,430797,8,792,2,36000,1.0101010101
430025,430031,430823,6,792,2,36000,1.00757575758
430062,430068,430882,6,814,2,36000,1.00737100737
430077,430083,430883,6,800,2,36000,1.0075
430078,430090,430867,12,777,2,36000,1.01544401544
430106,430112,430959,6,847,2,36000,1.00708382527
430121,430127,430955,6,828,2,36000,1.00724637681
430137,430143,430947,6,804,2,36000,1.00746268657
430160,430167,430928,7,761,2,36000,1.00919842313
430176,430182,430997,6,815,2,36000,1.00736196319
430177,430189,431019,12,830,2,36000,1.01445783133
430179,430194,430991,15,797,2,36000,1.01882057716
430201,430207,430998,6,791,2,36000,1.00758533502
430229,430236,430977,7,741,2,36000,1.00944669366
430245,430252,431243,7,991,2,36000,1.00706357215
430246,430258,431054,12,796,2,36000,1.01507537688
430247,430263,431024,16,761,2,36000,1.02102496715
430302,430309,431139,7,830,2,36000,1.00843373494
430419,430425,431209,6,784,2,36000,1.00765306122
430477,430484,431213,7,729,2,36000,1.00960219479
430493,430499,431232,6,733,2,36000,1.00818553888
430494,430506,431288,12,782,2,36000,1.01534526854
430495,430511,431332,16,821,2,36000,1.01948842875
430514,430520,431294,6,774,2,36000,1.00775193798
430533,430539,431284,6,745,2,36000,1.00805369128
430557,430563,431347,6,784,2,36000,1.00765306122
430598,430604,431381,6,777,2,36000,1.00772200772
430613,430620,431397,7,777,2,36000,1.00900900901
430615,430627,431428,12,801,2,36000,1.01498127341
430643,430650,431452,7,802,2,36000,1.00872817955
430644,430656,431432,12,776,2,36000,1.01546391753
430666,430673,431500,7,827,2,36000,1.0084643289
430668,430679,431489,11,810,2,36000,1.01358024691
430669,430684,431474,15,790,2,36000,1.01898734177
430694,430700,431482,6,782,2,36000,1.00767263427
430696,430708,431473,12,765,2,36000,1.01568627451
430732,430739,431485,7,746,2,36000,1.00938337802
430781,430787,431468,6,681,2,36000,1.00881057269
430797,430803,431566,6,763,2,36000,1.00786369594
430798,430811,431640,13,829,2,36000,1.01568154403
430814,430820,431643,6,823,2,36000,1.00729040097
430829,430835,431645,6,810,2,36000,1.00740740741
430831,430842,431710,11,868,2,36000,1.01267281106
430862,430868,431651,6,783,2,36000,1.00766283525
430877,430883,431642,6,759,2,36000,1.00790513834
430894,430900,431646,6,746,2,36000,1.00804289544
430895,430908,431655,13,747,2,36000,1.01740294511
430929,430935,431713,6,778,2,36000,1.00771208226
430948,430955,431743,7,788,2,36000,1.00888324873
430967,430974,431846,7,872,2,36000,1.00802752294
430969,430980,431736,11,756,2,36000,1.01455026455
430993,431000,431769,7,769,2,36000,1.00910273082
430995,431006,431798,11,792,2,36000,1.01388888889
431017,431023,431866,6,843,2,36000,1.00711743772
431019,431029,431873,10,844,2,36000,1.01184834123
431037,431043,431770,6,727,2,36000,1.00825309491
431039,431049,431846,10,797,2,36000,1.01254705144
431058,431065,431835,7,770,2,36000,1.00909090909
431138,431144,431955,6,811,2,36000,1.00739827374
431212,431220,431999,8,779,2,36000,1.01026957638
431214,431225,431952,11,727,2,36000,1.015130674
431232,431238,432006,6,768,2,36000,1.0078125
431247,431254,431997,7,743,2,36000,1.00942126514
431284,431291,432274,7,983,2,36000,1.00712105799
431300,431306,432165,6,859,2,36000,1.00698486612
431301,431313,432085,12,772,2,36000,1.01554404145
431332,431339,431998,7,659,2,36000,1.01062215478
431347,431354,432152,7,798,2,36000,1.00877192982
431381,431387,432117,6,730,2,36000,1.00821917808
431399,431406,432161,7,755,2,36000,1.00927152318
431415,431421,431427,6,6,2,1200,1.2
431430,431436,432217,6,781,2,36000,1.00768245839
431445,431452,432185,7,733,2,36000,1.00954979536
431460,431466,432229,6,763,2,36000,1.00786369594
431477,431484,432230,7,746,2,36000,1.00938337802
431478,431490,432218,12,728,2,36000,1.01648351648
431479,431496,432319,17,823,2,36000,1.02065613609
431496,431502,432308,6,806,2,36000,1.00744416873
431497,431509,432277,12,768,2,36000,1.015625
431498,431514,432284,16,770,2,36000,1.02077922078
431514,431520,432252,6,732,2,36000,1.00819672131
431566,431572,432371,6,799,2,36000,1.00750938673
431640,431647,432465,7,818,2,36000,1.00855745721
431657,431663,432500,6,837,2,36000,1.00716845878
431658,431669,432410,11,741,2,36000,1.01484480432
431659,431674,432374,15,700,2,36000,1.02142857143
431661,431679,432467,18,788,2,36000,1.02284263959
431662,431685,432448,23,763,2,36000,1.03014416776
431663,431690,432473,27,783,2,36000,1.03448275862
431709,431716,432476,7,760,2,36000,1.00921052632
431724,431731,432467,7,736,2,36000,1.00951086957
431740,431747,432487,7,740,2,36000,1.00945945946
431755,431761,432555,6,794,2,36000,1.00755667506
431770,431776,432552,6,776,2,36000,1.00773195876
431772,431783,432591,11,808,2,36000,1.01361386139
431801,431808,432557,7,749,2,36000,1.00934579439
431841,431848,432630,7,782,2,36000,1.00895140665
431860,431867,432743,7,876,2,36000,1.00799086758
431862,431874,432645,12,771,2,36000,1.01556420233
431878,431884,432627,6,743,2,36000,1.00807537012
431879,431891,432739,12,848,2,36000,1.0141509434
431957,431963,432734,6,771,2,36000,1.00778210117
431958,431970,432744,12,774,2,36000,1.01550387597
431983,444537,445629,12554,1092,64,7200,12.4963369963
431985,445640,446731,13655,1091,64,7200,13.51604033
431998,432005,432807,7,802,2,36000,1.00872817955
432000,432011,432807,11,796,2,36000,1.01381909548
432001,432017,432786,16,769,2,36000,1.02080624187
432018,432023,432896,5,873,2,36000,1.00572737686
432087,432094,432821,7,727,2,36000,1.00962861073
432118,432124,432885,6,761,2,36000,1.00788436268
432152,432158,432961,6,803,2,36000,1.00747198007
432167,432175,433015,8,840,2,36000,1.00952380952
432169,432180,432982,11,802,2,36000,1.01371571072
432187,432194,432973,7,779,2,36000,1.00898587933
432218,432225,433065,7,840,2,36000,1.00833333333
432219,432232,433016,13,784,2,36000,1.01658163265
432235,432241,433090,6,849,2,36000,1.00706713781
432236,432248,433001,12,753,2,36000,1.01593625498
432254,432261,433077,7,816,2,36000,1.00857843137
432276,432282,433128,6,846,2,36000,1.00709219858
432291,432298,433076,7,778,2,36000,1.00899742931
432293,432304,433139,11,835,2,36000,1.01317365269
432311,432317,433059,6,742,2,36000,1.00808625337
432327,432333,433109,6,776,2,36000,1.00773195876
432372,432379,433141,7,762,2,36000,1.00918635171
432387,432394,433149,7,755,2,36000,1.00927152318
432412,432419,433194,7,775,2,36000,1.00903225806
432422,446742,447846,14320,1104,64,7200,13.9710144928
432426,434921,435593,2495,672,128,7200,4.71279761905
432448,432455,433211,7,756,2,36000,1.00925925926
432467,432473,433174,6,701,2,36000,1.00855920114
432468,432480,433282,12,802,2,36000,1.01496259352
432470,432485,433340,15,855,2,36000,1.01754385965
432488,432496,433278,8,782,2,36000,1.01023017903
432490,432503,433306,13,803,2,36000,1.01618929016
432491,432508,433234,17,726,2,36000,1.02341597796
432512,432518,433396,6,878,2,36000,1.00683371298
432523,435603,436267,3080,664,128,7200,5.63855421687
432554,432560,433420,6,860,2,36000,1.00697674419
432572,432579,433359,7,780,2,36000,1.00897435897
432574,432586,433306,12,720,2,36000,1.01666666667
432596,432603,433358,7,755,2,36000,1.00927152318
432628,432634,433453,6,819,2,36000,1.00732600733
432643,432649,433466,6,817,2,36000,1.00734394125
432658,432666,433406,8,740,2,36000,1.01081081081
432734,432740,433547,6,807,2,36000,1.00743494424
432750,432756,433499,6,743,2,36000,1.00807537012
432751,432763,433559,12,796,2,36000,1.01507537688
432752,432768,433615,16,847,2,36000,1.01889020071
432786,432792,433564,6,772,2,36000,1.00777202073
432808,432814,433644,6,830,2,36000,1.00722891566
432809,432821,433579,12,758,2,36000,1.01583113456
432825,432832,433607,7,775,2,36000,1.00903225806
432886,432892,433655,6,763,2,36000,1.00786369594
432901,432908,433687,7,779,2,36000,1.00898587933
432963,432970,433689,7,719,2,36000,1.00973574409
432978,432984,433793,6,809,2,36000,1.00741656366
432994,433000,433761,6,761,2,36000,1.00788436268
433009,433015,433835,6,820,2,36000,1.00731707317
433024,433030,433882,6,852,2,36000,1.00704225352
433025,433036,433844,11,808,2,36000,1.01361386139
433060,433067,433812,7,745,2,36000,1.00939597315
433076,433082,433947,6,865,2,36000,1.00693641618
433077,433088,433858,11,770,2,36000,1.01428571429
433093,433099,433816,6,717,2,36000,1.00836820084
433094,433107,433934,13,827,2,36000,1.01571946796
433111,433117,434006,6,889,2,36000,1.00674915636
433129,433135,433925,6,790,2,36000,1.00759493671
433153,433160,433897,7,737,2,36000,1.00949796472
433155,433167,433980,12,813,2,36000,1.0147601476
433156,433172,433989,16,817,2,36000,1.01958384333
433184,433190,433986,6,796,2,36000,1.00753768844
433200,433208,433963,8,755,2,36000,1.01059602649
433220,433228,434012,8,784,2,36000,1.01020408163
433237,433243,434041,6,798,2,36000,1.00751879699
433284,433291,434114,7,823,2,36000,1.0085054678
433285,433296,434116,11,820,2,36000,1.01341463415
433309,433315,434165,6,850,2,36000,1.00705882353
433311,433322,434136,11,814,2,36000,1.01351351351
433341,433348,434136,7,788,2,36000,1.00888324873
433360,433366,434127,6,761,2,36000,1.00788436268
433361,433373,434181,12,808,2,36000,1.01485148515
433398,433405,434267,7,862,2,36000,1.00812064965
433413,433421,434209,8,788,2,36000,1.01015228426
433429,433435,434229,6,794,2,36000,1.00755667506
433453,433459,434187,6,728,2,36000,1.00824175824
433468,433475,434237,7,762,2,36000,1.00918635171
433502,433509,434268,7,759,2,36000,1.0092226614
433548,433555,434292,7,737,2,36000,1.00949796472
433563,433570,434440,7,870,2,36000,1.00804597701
433578,433585,434266,7,681,2,36000,1.01027900147
433593,433599,434506,6,907,2,36000,1.00661521499
433609,433616,434421,7,805,2,36000,1.00869565217
433624,433630,434384,6,754,2,36000,1.00795755968
433645,433652,434543,7,891,2,36000,1.00785634119
433661,433668,434365,7,697,2,36000,1.01004304161
433688,433695,434422,7,727,2,36000,1.00962861073
433690,433702,434442,12,740,2,36000,1.01621621622
433761,433767,434557,6,790,2,36000,1.00759493671
433794,433801,434650,7,849,2,36000,1.00824499411
433813,433819,434626,6,807,2,36000,1.00743494424
433828,433835,434506,7,671,2,36000,1.01043219076
433843,433850,434703,7,853,2,36000,1.0082063306
433845,433856,434587,11,731,2,36000,1.01504787962
433861,433867,434634,6,767,2,36000,1.00782268579
433882,433889,434604,7,715,2,36000,1.00979020979
433897,433904,434680,7,776,2,36000,1.00902061856
433925,433931,434777,6,846,2,36000,1.00709219858
433940,433947,434873,7,926,2,36000,1.00755939525
433955,433962,434923,7,961,2,36000,1.00728407908
433971,433977,434803,6,826,2,36000,1.00726392252
433988,433995,434787,7,792,2,36000,1.00883838384
433989,434002,434760,13,758,2,36000,1.01715039578
434015,434021,434785,6,764,2,36000,1.00785340314
434016,434027,434754,11,727,2,36000,1.015130674
434018,434032,434839,14,807,2,36000,1.01734820322
434042,434048,434852,6,804,2,36000,1.00746268657
434114,434120,434969,6,849,2,36000,1.00706713781
434131,434137,434899,6,762,2,36000,1.00787401575
434132,434143,434974,11,831,2,36000,1.01323706378
434153,434160,435073,7,913,2,36000,1.00766703176
434154,434166,435008,12,842,2,36000,1.01425178147
434174,434180,434973,6,793,2,36000,1.00756620429
434189,434196,435005,7,809,2,36000,1.0086526576
434190,434202,435021,12,819,2,36000,1.01465201465
434209,434215,435158,6,943,2,36000,1.00636267232
434230,434237,435029,7,792,2,36000,1.00883838384
434245,434253,435067,8,814,2,36000,1.00982800983
434267,434274,435121,7,847,2,36000,1.00826446281
434269,434281,435239,12,958,2,36000,1.01252609603
434270,434286,435084,16,798,2,36000,1.02005012531
434292,434299,435127,7,828,2,36000,1.00845410628
434365,434372,435148,7,776,2,36000,1.00902061856
434383,434391,435212,8,821,2,36000,1.00974421437
434420,434427,435243,7,816,2,36000,1.00857843137
434436,434443,435209,7,766,2,36000,1.0091383812
434451,434457,435228,6,771,2,36000,1.00778210117
434453,434463,435256,10,793,2,36000,1.01261034048
434507,434515,435321,8,806,2,36000,1.00992555831
434509,434522,435328,13,806,2,36000,1.01612903226
434545,434552,435530,7,978,2,36000,1.00715746421
434560,434568,435310,8,742,2,36000,1.01078167116
434588,434594,435352,6,758,2,36000,1.00791556728
434606,434613,435396,7,783,2,36000,1.00893997446
434628,434634,435391,6,757,2,36000,1.00792602378
434643,434650,435460,7,810,2,36000,1.00864197531
434658,434664,435351,6,687,2,36000,1.00873362445
434681,434688,435409,7,721,2,36000,1.00970873786
434705,434712,435526,7,814,2,36000,1.0085995086
434756,434763,435594,7,831,2,36000,1.00842358604
434773,434780,435566,7,786,2,36000,1.00890585242
434797,434803,435626,6,823,2,36000,1.00729040097
434798,434809,435627,11,818,2,36000,1.01344743276
434800,434814,435560,14,746,2,36000,1.01876675603
434819,434826,435616,7,790,2,36000,1.00886075949
434841,434847,435632,6,785,2,36000,1.0076433121
434857,434863,435601,6,738,2,36000,1.0081300813
434875,434882,435644,7,762,2,36000,1.00918635171
434900,434907,435710,7,803,2,36000,1.00871731009
434924,434934,435774,10,840,2,36000,1.0119047619
434971,434977,435780,6,803,2,36000,1.00747198007
434972,434983,435785,11,802,2,36000,1.01371571072
434988,434994,435734,6,740,2,36000,1.00810810811
435007,435013,435825,6,812,2,36000,1.00738916256
435022,435028,435873,6,845,2,36000,1.00710059172
435024,435034,435738,10,704,2,36000,1.01420454545
435039,435045,435809,6,764,2,36000,1.00785340314
435070,435076,435875,6,799,2,36000,1.00750938673
435085,435091,435887,6,796,2,36000,1.00753768844
435087,435097,435872,10,775,2,36000,1.01290322581
435123,435130,436220,7,1090,2,36000,1.00642201835
435138,435144,435890,6,746,2,36000,1.00804289544
435154,435160,435902,6,742,2,36000,1.00808625337
435169,435175,435886,6,711,2,36000,1.00843881857
435209,435215,436085,6,870,2,36000,1.00689655172
435224,435231,436074,7,843,2,36000,1.00830367734
435240,435246,435984,6,738,2,36000,1.0081300813
435241,435252,436045,11,793,2,36000,1.01387137453
435257,435264,436056,7,792,2,36000,1.00883838384
435258,435270,435948,12,678,2,36000,1.01769911504
435310,435316,436091,6,775,2,36000,1.00774193548
435326,435332,436159,6,827,2,36000,1.00725513906
435342,435348,436179,6,831,2,36000,1.00722021661
435362,435368,436123,6,755,2,36000,1.00794701987
435363,435375,436195,12,820,2,36000,1.01463414634
435394,435401,436184,7,783,2,36000,1.00893997446
435412,435418,436209,6,791,2,36000,1.00758533502
435413,435425,436212,12,787,2,36000,1.01524777637
435461,435468,436280,7,812,2,36000,1.00862068966
435528,435534,436347,6,813,2,36000,1.0073800738
435529,435540,436347,11,807,2,36000,1.0136307311
435560,435566,436401,6,835,2,36000,1.00718562874
435575,435582,436403,7,821,2,36000,1.00852618758
435597,435609,436358,12,749,2,36000,1.01602136182
435613,435619,436385,6,766,2,36000,1.00783289817
435629,435635,436388,6,753,2,36000,1.00796812749
435630,435642,436444,12,802,2,36000,1.01496259352
435632,435647,436470,15,823,2,36000,1.01822600243
435647,435653,436465,6,812,2,36000,1.00738916256
435648,435659,436436,11,777,2,36000,1.01415701416
435712,435718,436468,6,750,2,36000,1.008
435734,435741,436556,7,815,2,36000,1.00858895706
435749,435755,436802,6,1047,2,36000,1.00573065903
435773,435780,436529,7,749,2,36000,1.00934579439
435789,435795,436497,6,702,2,36000,1.00854700855
435790,435801,436525,11,724,2,36000,1.01519337017
435809,435815,436598,6,783,2,36000,1.00766283525
435827,435834,436571,7,737,2,36000,1.00949796472
435873,435880,436696,7,816,2,36000,1.00857843137
435875,435887,436716,12,829,2,36000,1.01447527141
435891,435897,436667,6,770,2,36000,1.00779220779
435892,435904,436669,12,765,2,36000,1.01568627451
435893,435909,436708,16,799,2,36000,1.02002503129
435895,435914,436642,19,728,2,36000,1.0260989011
435910,435921,436740,11,819,2,36000,1.01343101343
435950,435956,436701,6,745,2,36000,1.00805369128
435984,435990,436734,6,744,2,36000,1.00806451613
436045,436051,436902,6,851,2,36000,1.00705052879
436060,436067,436800,7,733,2,36000,1.00954979536
436076,436082,436834,6,752,2,36000,1.0079787234
436091,436097,436865,6,768,2,36000,1.0078125
436093,436105,436840,12,735,2,36000,1.01632653061
436123,436130,436969,7,839,2,36000,1.00834326579
436160,436167,436950,7,783,2,36000,1.00893997446
436179,436185,436962,6,777,2,36000,1.00772200772
436194,436200,436961,6,761,2,36000,1.00788436268
436196,436206,436990,10,784,2,36000,1.01275510204
436211,436217,437053,6,836,2,36000,1.00717703349
436213,436223,436972,10,749,2,36000,1.01335113485
436228,436234,436992,6,758,2,36000,1.00791556728
436280,436290,437051,10,761,2,36000,1.01314060447
436348,436354,437168,6,814,2,36000,1.00737100737
436349,436361,437140,12,779,2,36000,1.01540436457
436364,436371,437153,7,782,2,36000,1.00895140665
436386,436392,437224,6,832,2,36000,1.00721153846
436402,436409,437171,7,762,2,36000,1.00918635171
436403,436415,437168,12,753,2,36000,1.01593625498
436404,436421,437203,17,782,2,36000,1.02173913043
436438,436445,437243,7,798,2,36000,1.00877192982
436461,436468,437207,7,739,2,36000,1.00947225981
436476,436484,437324,8,840,2,36000,1.00952380952
436478,436489,437273,11,784,2,36000,1.01403061224
436479,436495,437326,16,831,2,36000,1.01925391095
436498,436504,437292,6,788,2,36000,1.0076142132
436526,436533,437324,7,791,2,36000,1.00884955752
436541,436547,437299,6,752,2,36000,1.0079787234
436556,436562,437289,6,727,2,36000,1.00825309491
436571,436577,437319,6,742,2,36000,1.00808625337
436599,436606,437486,7,880,2,36000,1.00795454545
436641,436647,437483,6,836,2,36000,1.00717703349
436669,436675,437487,6,812,2,36000,1.00738916256
436670,436681,437397,11,716,2,36000,1.01536312849
436699,436706,437677,7,971,2,36000,1.00720906282
436714,436720,437509,6,789,2,36000,1.00760456274
436716,436728,437489,12,761,2,36000,1.01576872536
436731,436737,437575,6,838,2,36000,1.00715990453
436747,436752,437594,5,842,2,36000,1.00593824228
436748,436759,437517,11,758,2,36000,1.01451187335
436800,436806,437590,6,784,2,36000,1.00765306122
436815,436821,437624,6,803,2,36000,1.00747198007
436837,436844,437638,7,794,2,36000,1.00881612091
436852,436859,437666,7,807,2,36000,1.00867410161
436868,436874,437619,6,745,2,36000,1.00805369128
436901,436909,437686,8,777,2,36000,1.0102960103
436950,436957,437750,7,793,2,36000,1.00882723834
436966,436972,437734,6,762,2,36000,1.00787401575
436967,436979,437726,12,747,2,36000,1.01606425703
436983,436989,437753,6,764,2,36000,1.00785340314
436984,436996,437874,12,878,2,36000,1.01366742597
437000,437006,437723,6,717,2,36000,1.00836820084
437001,437013,437825,12,812,2,36000,1.01477832512
437054,437060,437737,6,677,2,36000,1.00886262925
437055,437068,437780,13,712,2,36000,1.01825842697
437144,437150,438025,6,875,2,36000,1.00685714286
437159,437165,438028,6,863,2,36000,1.00695249131
437175,437182,438070,7,888,2,36000,1.00788288288
437176,437188,437999,12,811,2,36000,1.01479654747
437177,437194,438023,17,829,2,36000,1.0205066345
437205,437211,437999,6,788,2,36000,1.0076142132
437220,437228,438001,8,773,2,36000,1.01034928849
437236,437242,438008,6,766,2,36000,1.00783289817
437251,437259,438089,8,830,2,36000,1.00963855422
437273,437279,438088,6,809,2,36000,1.00741656366
437291,437297,438062,6,765,2,36000,1.00784313725
437293,437304,438108,11,804,2,36000,1.01368159204
437308,437314,438083,6,769,2,36000,1.0078023407
437324,437330,438176,6,846,2,36000,1.00709219858
437325,437337,438126,12,789,2,36000,1.01520912548
437327,437342,438113,15,771,2,36000,1.01945525292
437343,437350,438071,7,721,2,36000,1.00970873786
437398,437405,438112,7,707,2,36000,1.0099009901
437486,437493,438278,7,785,2,36000,1.00891719745
437487,437500,438315,13,815,2,36000,1.01595092025
437489,437505,438390,16,885,2,36000,1.01807909605
437504,437511,438308,7,797,2,36000,1.00878293601
437519,437526,438278,7,752,2,36000,1.00930851064
437521,437534,438431,13,897,2,36000,1.01449275362
437577,437584,438358,7,774,2,36000,1.00904392765
437592,437599,438386,7,787,2,36000,1.00889453621
437607,437614,438435,7,821,2,36000,1.00852618758
437623,437629,438368,6,739,2,36000,1.00811907984
437638,437644,438456,6,812,2,36000,1.00738916256
437653,437659,438413,6,754,2,36000,1.00795755968
437669,437675,439220,6,1545,2,36000,1.00388349515
437684,437690,438535,6,845,2,36000,1.00710059172
437699,437705,438446,6,741,2,36000,1.00809716599
437727,437733,438549,6,816,2,36000,1.00735294118
437728,437741,438515,13,774,2,36000,1.01679586563
437744,437751,438468,7,717,2,36000,1.00976290098
437745,437757,438531,12,774,2,36000,1.01550387597
437761,437768,438498,7,730,2,36000,1.0095890411
437763,437774,438563,11,789,2,36000,1.01394169835
437781,437788,438548,7,760,2,36000,1.00921052632
437827,437833,438600,6,767,2,36000,1.00782268579
437876,437882,438668,6,786,2,36000,1.00763358779
438002,438008,438820,6,812,2,36000,1.00738916256
438004,438015,438819,11,804,2,36000,1.01368159204
438005,438020,438771,15,751,2,36000,1.01997336884
438021,438027,438762,6,735,2,36000,1.00816326531
438037,438043,438846,6,803,2,36000,1.00747198007
438038,438049,438865,11,816,2,36000,1.01348039216
438040,438055,438868,15,813,2,36000,1.0184501845
438064,438070,438920,6,850,2,36000,1.00705882353
438080,438087,439011,7,924,2,36000,1.00757575758
438081,438093,438862,12,769,2,36000,1.0156046814
438097,438103,438804,6,701,2,36000,1.00855920114
438098,438109,438898,11,789,2,36000,1.01394169835
438100,438114,438869,14,755,2,36000,1.01854304636
438116,438122,439094,6,972,2,36000,1.00617283951
438117,438129,438919,12,790,2,36000,1.01518987342
438118,438135,438921,17,786,2,36000,1.02162849873
438134,438141,439015,7,874,2,36000,1.00800915332
438176,438182,438897,6,715,2,36000,1.00839160839
438280,438288,439097,8,809,2,36000,1.00988875155
438282,438294,439100,12,806,2,36000,1.01488833747
438310,438316,439143,6,827,2,36000,1.00725513906
438326,438333,439087,7,754,2,36000,1.00928381963
438359,438365,439155,6,790,2,36000,1.00759493671
438374,438380,439272,6,892,2,36000,1.0067264574
438390,438396,439062,6,666,2,36000,1.00900900901
438391,438404,439241,13,837,2,36000,1.01553166069
438413,438419,439128,6,709,2,36000,1.00846262341
438432,438438,439173,6,735,2,36000,1.00816326531
438447,438453,439191,6,738,2,36000,1.0081300813
438448,438459,439202,11,743,2,36000,1.01480484522
438464,438470,439487,6,1017,2,36000,1.00589970501
438479,438485,439304,6,819,2,36000,1.00732600733
438500,438506,439308,6,802,2,36000,1.00748129676
438515,438522,439320,7,798,2,36000,1.00877192982
438534,438540,439336,6,796,2,36000,1.00753768844
438550,438556,439331,6,775,2,36000,1.00774193548
438551,438563,439437,12,874,2,36000,1.01372997712
438553,438568,439332,15,764,2,36000,1.01963350785
438568,438575,439317,7,742,2,36000,1.00943396226
438602,438608,439456,6,848,2,36000,1.0070754717
438669,438675,439395,6,720,2,36000,1.00833333333
438764,438770,439484,6,714,2,36000,1.00840336134
438779,438786,439613,7,827,2,36000,1.0084643289
438806,438813,439594,7,781,2,36000,1.00896286812
438822,438829,439596,7,767,2,36000,1.00912646675
438823,438836,439600,13,764,2,36000,1.01701570681
438848,438855,439659,7,804,2,36000,1.00870646766
438863,438869,439701,6,832,2,36000,1.00721153846
438879,438885,439731,6,846,2,36000,1.00709219858
438880,438891,439827,11,936,2,36000,1.01175213675
438881,438897,439694,16,797,2,36000,1.02007528231
438897,438903,439678,6,775,2,36000,1.00774193548
438899,438910,439737,11,827,2,36000,1.01330108827
438921,438927,439774,6,847,2,36000,1.00708382527
438923,438934,439699,11,765,2,36000,1.01437908497
438924,438939,439772,15,833,2,36000,1.01800720288
439013,439020,439839,7,819,2,36000,1.00854700855
439028,439034,439776,6,742,2,36000,1.00808625337
439061,439067,439840,6,773,2,36000,1.00776196636
439093,439099,439841,6,742,2,36000,1.00808625337
439094,439105,439855,11,750,2,36000,1.01466666667
439110,439116,439913,6,797,2,36000,1.00752823087
439111,439123,439939,12,816,2,36000,1.01470588235
439130,439136,439914,6,778,2,36000,1.00771208226
439145,439152,439896,7,744,2,36000,1.00940860215
439160,439166,439926,6,760,2,36000,1.00789473684
439175,439181,439934,6,753,2,36000,1.00796812749
439193,439200,439891,7,691,2,36000,1.01013024602
439209,439215,439995,6,780,2,36000,1.00769230769
439224,439231,439998,7,767,2,36000,1.00912646675
439242,439248,440067,6,819,2,36000,1.00732600733
439273,439279,440098,6,819,2,36000,1.00732600733
439303,439309,440057,6,748,2,36000,1.00802139037
439319,439325,440139,6,814,2,36000,1.00737100737
439320,439331,440104,11,773,2,36000,1.01423027167
439322,439337,440069,15,732,2,36000,1.02049180328
439339,439345,440132,6,787,2,36000,1.00762388818
439341,439352,440061,11,709,2,36000,1.01551480959
439342,439357,440298,15,941,2,36000,1.01594048884
439397,439404,440174,7,770,2,36000,1.00909090909
439434,439440,440173,6,733,2,36000,1.00818553888
439458,439464,440299,6,835,2,36000,1.00718562874
439485,439493,440267,8,774,2,36000,1.01033591731
439501,439507,440300,6,793,2,36000,1.00756620429
439595,439601,440414,6,813,2,36000,1.0073800738
439610,439616,440424,6,808,2,36000,1.00742574257
439611,439623,440408,12,785,2,36000,1.0152866242
439626,439634,440459,8,825,2,36000,1.0096969697
439660,439666,440488,6,822,2,36000,1.00729927007
439678,439685,440415,7,730,2,36000,1.0095890411
439694,439700,440412,6,712,2,36000,1.00842696629
439709,439715,440524,6,809,2,36000,1.00741656366
439711,439721,440585,10,864,2,36000,1.01157407407
439732,439739,440613,7,874,2,36000,1.00800915332
439747,439754,440488,7,734,2,36000,1.00953678474
439773,439779,440597,6,818,2,36000,1.00733496333
439774,439786,440637,12,851,2,36000,1.01410105758
439789,439796,440645,7,849,2,36000,1.00824499411
439829,439836,440569,7,733,2,36000,1.00954979536
439846,439852,440528,6,676,2,36000,1.00887573964
439847,439858,440648,11,790,2,36000,1.01392405063
439848,439864,440699,16,835,2,36000,1.01916167665
439864,439870,440630,6,760,2,36000,1.00789473684
439891,439897,440691,6,794,2,36000,1.00755667506
439907,439913,440718,6,805,2,36000,1.00745341615
439922,439929,440649,7,720,2,36000,1.00972222222
439924,439935,440773,11,838,2,36000,1.01312649165
439940,439947,440634,7,687,2,36000,1.01018922853
439941,439953,440762,12,809,2,36000,1.01483312732
439943,439959,440784,16,825,2,36000,1.01939393939
439995,440001,440736,6,735,2,36000,1.00816326531
440010,440017,440888,7,871,2,36000,1.00803673938
440059,440066,440766,7,700,2,36000,1.01
440075,440081,440865,6,784,2,36000,1.00765306122
440076,440087,440845,11,758,2,36000,1.01451187335
440077,440092,440904,15,812,2,36000,1.0184729064
440100,440106,440930,6,824,2,36000,1.0072815534
440115,440121,440884,6,763,2,36000,1.00786369594
440133,440139,441075,6,936,2,36000,1.00641025641
440148,440155,440933,7,778,2,36000,1.00899742931
440173,440181,441018,8,837,2,36000,1.00955794504
440175,440186,440926,11,740,2,36000,1.01486486486
440267,440273,441006,6,733,2,36000,1.00818553888
440301,440307,441099,6,792,2,36000,1.00757575758
440302,440314,441109,12,795,2,36000,1.01509433962
440304,440319,441155,15,836,2,36000,1.01794258373
440352,440358,440360,6,2,2,3540,1.0
440407,440414,441233,7,819,2,36000,1.00854700855
440423,440429,441186,6,757,2,36000,1.00792602378
440424,440436,441180,12,744,2,36000,1.01612903226
440426,440441,441208,15,767,2,36000,1.01955671447
440441,440448,441178,7,730,2,36000,1.0095890411
440459,440466,441247,7,781,2,36000,1.00896286812
440488,440494,441324,6,830,2,36000,1.00722891566
440489,440500,441240,11,740,2,36000,1.01486486486
440526,440532,441327,6,795,2,36000,1.00754716981
440541,440547,441250,6,703,2,36000,1.00853485064
440568,440574,441313,6,739,2,36000,1.00811907984
440587,440594,441398,7,804,2,36000,1.00870646766
440602,440608,441406,6,798,2,36000,1.00751879699
440618,440625,441381,7,756,2,36000,1.00925925926
440633,440640,441401,7,761,2,36000,1.00919842313
440635,440647,441409,12,762,2,36000,1.0157480315
440652,440658,441471,6,813,2,36000,1.0073800738
440653,440665,441414,12,749,2,36000,1.01602136182
440655,440670,441522,15,852,2,36000,1.0176056338
440656,440675,441429,19,754,2,36000,1.02519893899
440693,440700,441412,7,712,2,36000,1.00983146067
440708,440715,441540,7,825,2,36000,1.00848484848
440723,440730,441444,7,714,2,36000,1.00980392157
440739,440746,441580,7,834,2,36000,1.00839328537
440763,440770,441546,7,776,2,36000,1.00902061856
440779,440786,441625,7,839,2,36000,1.00834326579
440780,440793,441627,13,834,2,36000,1.01558752998
440795,440802,441480,7,678,2,36000,1.01032448378
440848,440854,441693,6,839,2,36000,1.00715137068
440866,440872,441660,6,788,2,36000,1.0076142132
440885,440891,441711,6,820,2,36000,1.00731707317
440900,440906,441609,6,703,2,36000,1.00853485064
440916,440922,441708,6,786,2,36000,1.00763358779
440932,440939,441657,7,718,2,36000,1.00974930362
440933,440946,441836,13,890,2,36000,1.01460674157
440949,440955,441760,6,805,2,36000,1.00745341615
441008,441015,441787,7,772,2,36000,1.00906735751
441024,441030,441798,6,768,2,36000,1.0078125
441076,441083,441872,7,789,2,36000,1.00887198986
441100,441106,441842,6,736,2,36000,1.00815217391
441115,441123,441905,8,782,2,36000,1.01023017903
441155,441161,442012,6,851,2,36000,1.00705052879
441180,441186,442073,6,887,2,36000,1.0067643743
441181,441193,442056,12,863,2,36000,1.01390498262
441197,441203,442027,6,824,2,36000,1.0072815534
441212,441218,441931,6,713,2,36000,1.00841514727
441233,441240,442011,7,771,2,36000,1.00907911803
441249,441255,442080,6,825,2,36000,1.00727272727
441250,441262,442048,12,786,2,36000,1.01526717557
441266,441272,442078,6,806,2,36000,1.00744416873
441277,441283,441450,6,167,1,3600,1.03592814371
441314,441321,442015,7,694,2,36000,1.01008645533
441330,441337,442131,7,794,2,36000,1.00881612091
441331,441343,442134,12,791,2,36000,1.01517067004
441383,441389,442177,6,788,2,36000,1.0076142132
441398,441405,442109,7,704,2,36000,1.00994318182
441415,441422,442164,7,742,2,36000,1.00943396226
441417,441429,442202,12,773,2,36000,1.01552393273
441418,441434,442189,16,755,2,36000,1.02119205298
441419,441439,442249,20,810,2,36000,1.02469135802
441421,441444,442230,23,786,2,36000,1.02926208651
441437,441451,442203,14,752,2,36000,1.01861702128
441452,441458,442271,6,813,2,36000,1.0073800738
441474,441480,442246,6,766,2,36000,1.00783289817
441489,441495,442243,6,748,2,36000,1.00802139037
441522,441529,442227,7,698,2,36000,1.0100286533
441541,441547,442331,6,784,2,36000,1.00765306122
441556,441562,442367,6,805,2,36000,1.00745341615
441581,441587,442359,6,772,2,36000,1.00777202073
441609,441615,442452,6,837,2,36000,1.00716845878
441621,441628,441963,7,335,1,3600,1.02089552239
441628,441635,442408,7,773,2,36000,1.00905562743
441629,441642,442496,13,854,2,36000,1.01522248244
441657,441663,442454,6,791,2,36000,1.00758533502
441672,441678,442421,6,743,2,36000,1.00807537012
441694,441701,442473,7,772,2,36000,1.00906735751
441709,441716,442523,7,807,2,36000,1.00867410161
441724,441731,442549,7,818,2,36000,1.00855745721
441761,441768,442578,7,810,2,36000,1.00864197531
441788,441796,442611,8,815,2,36000,1.00981595092
441804,441810,442590,6,780,2,36000,1.00769230769
441838,441845,442683,7,838,2,36000,1.00835322196
441853,441860,442639,7,779,2,36000,1.00898587933
441874,441882,442670,8,788,2,36000,1.01015228426
441905,441911,442693,6,782,2,36000,1.00767263427
441933,441940,442690,7,750,2,36000,1.00933333333
442012,442020,442814,8,794,2,36000,1.01007556675
442014,442026,442825,12,799,2,36000,1.01501877347
442030,442036,442852,6,816,2,36000,1.00735294118
442031,442042,442988,11,946,2,36000,1.01162790698
442046,442052,442931,6,879,2,36000,1.00682593857
442062,442068,442898,6,830,2,36000,1.00722891566
442077,442085,442879,8,794,2,36000,1.01007556675
442079,442090,442873,11,783,2,36000,1.01404853129
442094,442100,442926,6,826,2,36000,1.00726392252
442109,442115,442867,6,752,2,36000,1.0079787234
442131,442137,442932,6,795,2,36000,1.00754716981
442133,442144,442995,11,851,2,36000,1.01292596945
442166,442173,442966,7,793,2,36000,1.00882723834
442182,442188,443043,6,855,2,36000,1.00701754386
442198,442204,442925,6,721,2,36000,1.00832177531
442213,442219,443002,6,783,2,36000,1.00766283525
442214,442225,443054,11,829,2,36000,1.01326899879
442230,442236,443061,6,825,2,36000,1.00727272727
442232,442242,443062,10,820,2,36000,1.01219512195
442248,442255,443023,7,768,2,36000,1.00911458333
442249,442262,442950,13,688,2,36000,1.01889534884
442265,442271,442946,6,675,2,36000,1.00888888889
442280,442286,443110,6,824,2,36000,1.0072815534
442301,442308,443140,7,832,1,3600,1.00841346154
442332,442338,443048,6,710,2,36000,1.00845070423
442360,442367,443103,7,736,2,36000,1.00951086957
442376,442383,443130,7,747,2,36000,1.0093708166
442409,442415,443168,6,753,2,36000,1.00796812749
442424,442431,443231,7,800,2,36000,1.00875
442452,442458,443183,6,725,2,36000,1.00827586207
442467,442475,443272,8,797,2,36000,1.01003764115
442483,442489,443295,6,806,2,36000,1.00744416873
442498,442504,443347,6,843,2,36000,1.00711743772
442523,442529,443326,6,797,2,36000,1.00752823087
442550,442557,443424,7,867,2,36000,1.00807381776
442578,442584,443412,6,828,2,36000,1.00724637681
442594,442600,443427,6,827,2,36000,1.00725513906
442612,442619,443348,7,729,2,36000,1.00960219479
442640,442646,443429,6,783,2,36000,1.00766283525
442673,442679,443512,6,833,2,36000,1.00720288115
442689,442696,443471,7,775,2,36000,1.00903225806
442704,442710,443505,6,795,2,36000,1.00754716981
442705,442716,443439,11,723,2,36000,1.01521438451
442813,442820,443556,7,736,2,36000,1.00951086957
442828,442836,443657,8,821,2,36000,1.00974421437
442853,442859,443660,6,801,2,36000,1.0074906367
442868,442875,443674,7,799,2,36000,1.00876095119
442885,442892,443618,7,726,2,36000,1.00964187328
442886,442898,443728,12,830,2,36000,1.01445783133
442902,442909,443752,7,843,2,36000,1.00830367734
442926,442932,443890,6,958,2,36000,1.00626304802
442927,442939,443931,12,992,2,36000,1.01209677419
442943,442949,443646,6,697,2,36000,1.00860832138
442944,442956,443806,12,850,2,36000,1.01411764706
442960,442967,443625,7,658,2,36000,1.01063829787
442962,442973,443762,11,789,2,36000,1.01394169835
442977,442983,443777,6,794,2,36000,1.00755667506
442992,442999,443838,7,839,2,36000,1.00834326579
443008,443015,444063,7,1048,2,36000,1.00667938931
443009,443020,443939,11,919,2,36000,1.0119695321
443025,443031,443722,6,691,2,36000,1.00868306802
443043,443049,443793,6,744,2,36000,1.00806451613
443059,443065,443845,6,780,2,36000,1.00769230769
443060,443071,443846,11,775,2,36000,1.01419354839
443076,443082,443847,6,765,2,36000,1.00784313725
443077,443088,443930,11,842,2,36000,1.01306413302
443105,443111,443931,6,820,2,36000,1.00731707317
443120,443127,443941,7,814,2,36000,1.0085995086
443135,443141,443977,6,836,2,36000,1.00717703349
443166,443172,443895,6,723,2,36000,1.00829875519
443184,443190,444021,6,831,2,36000,1.00722021661
443233,443239,444050,6,811,2,36000,1.00739827374
443272,443279,444104,7,825,2,36000,1.00848484848
443297,443303,444139,6,836,2,36000,1.00717703349
443328,443334,444137,6,803,2,36000,1.00747198007
443350,443357,444068,7,711,2,36000,1.00984528833
443351,443363,444168,12,805,2,36000,1.0149068323
443412,443418,444260,6,842,2,36000,1.00712589074
443428,443434,444197,6,763,2,36000,1.00786369594
443429,443441,444312,12,871,2,36000,1.01377726751
443431,443446,444269,15,823,2,36000,1.01822600243
443446,443452,444207,6,755,2,36000,1.00794701987
443471,443477,444280,6,803,2,36000,1.00747198007
443507,443513,444322,6,809,2,36000,1.00741656366
443522,443529,444295,7,766,2,36000,1.0091383812
443556,443562,444396,6,834,2,36000,1.0071942446
443620,443628,444487,8,859,2,36000,1.00931315483
443636,443643,444405,7,762,2,36000,1.00918635171
443651,443657,444508,6,851,2,36000,1.00705052879
443667,443674,444467,7,793,2,36000,1.00882723834
443668,443680,444395,12,715,2,36000,1.01678321678
443683,443689,444525,6,836,2,36000,1.00717703349
443723,443729,444494,6,765,2,36000,1.00784313725
443738,443744,444546,6,802,2,36000,1.00748129676
443754,443760,444527,6,767,2,36000,1.00782268579
443769,443775,444514,6,739,2,36000,1.00811907984
443785,443791,444542,6,751,2,36000,1.00798934754
443800,443807,444591,7,784,2,36000,1.00892857143
443816,443823,444617,7,794,2,36000,1.00881612091
443841,443847,444626,6,779,2,36000,1.00770218228
443857,443864,444550,7,686,2,36000,1.01020408163
443858,443870,444663,12,793,2,36000,1.01513240858
443859,443876,444711,17,835,2,36000,1.02035928144
443893,443899,444739,6,840,2,36000,1.00714285714
443908,443914,444620,6,706,2,36000,1.00849858357
443935,443941,444750,6,809,2,36000,1.00741656366
443936,443948,444703,12,755,2,36000,1.01589403974
443937,443953,444778,16,825,2,36000,1.01939393939
443953,443960,444664,7,704,2,36000,1.00994318182
443954,443966,444734,12,768,2,36000,1.015625
443979,443986,444748,7,762,2,36000,1.00918635171
444022,444028,444855,6,827,2,36000,1.00725513906
444039,444047,502425,8,58378,1,90000,1.00013703793
444053,444059,444795,6,736,2,36000,1.00815217391
444069,444076,444838,7,762,2,36000,1.00918635171
444070,444082,444868,12,786,2,36000,1.01526717557
444105,444111,444905,6,794,2,36000,1.00755667506
444139,444146,444910,7,764,2,36000,1.00916230366
444141,444153,444950,12,797,2,36000,1.01505646173
444151,444160,517133,9,72973,1,90000,1.00012333329
444168,444175,444903,7,728,2,36000,1.00961538462
444199,444205,444952,6,747,2,36000,1.00803212851
444214,444220,444975,6,755,2,36000,1.00794701987
444260,444266,445090,6,824,2,36000,1.0072815534
444276,444282,445309,6,1027,2,36000,1.00584225901
444291,444297,445118,6,821,2,36000,1.00730816078
444306,444313,445254,7,941,2,36000,1.00743889479
444322,444328,445205,6,877,2,36000,1.00684150513
444323,444334,445022,11,688,2,36000,1.01598837209
444346,444352,444463,6,111,1,3600,1.05405405405
444347,444407,496063,60,51656,1,90000,1.00116153012
444394,444400,445208,6,808,2,36000,1.00742574257
444409,444416,445198,7,782,2,36000,1.00895140665
444410,444423,445202,13,779,2,36000,1.01668806162
444468,444475,445227,7,752,2,36000,1.00930851064
444487,444493,445232,6,739,2,36000,1.00811907984
444503,444509,445277,6,768,2,36000,1.0078125
444518,444525,445345,7,820,2,36000,1.00853658537
444520,444531,445385,11,854,2,36000,1.01288056206
444535,444543,445338,8,795,2,36000,1.01006289308
444537,444549,445373,12,824,2,36000,1.0145631068
444553,444559,445356,6,797,2,36000,1.00752823087
444554,444565,445359,11,794,2,36000,1.01385390428
444555,444570,445369,15,799,2,36000,1.01877346683
444594,444601,445332,7,731,2,36000,1.00957592339
444616,444622,445397,6,775,2,36000,1.00774193548
444628,444634,444952,6,318,1,3600,1.01886792453
444632,444641,445436,9,795,2,36000,1.01132075472
444633,444646,445456,13,810,2,36000,1.01604938272
444664,444671,445500,7,829,2,36000,1.00844390832
444666,444678,445438,12,760,2,36000,1.01578947368
444706,444712,445587,6,875,2,36000,1.00685714286
444721,444727,445509,6,782,2,36000,1.00767263427
444736,444743,445599,7,856,2,36000,1.00817757009
444752,444759,445592,7,833,2,36000,1.00840336134
444754,444765,445475,11,710,2,36000,1.01549295775
444755,444771,445538,16,767,2,36000,1.02086049544
444780,444786,445588,6,802,2,36000,1.00748129676
444796,444802,445722,6,920,2,36000,1.00652173913
444839,444845,445677,6,832,2,36000,1.00721153846
444841,444852,445014,11,162,1,3600,1.06790123457
444854,444861,445621,7,760,2,36000,1.00921052632
444870,444876,445646,6,770,2,36000,1.00779220779
444904,444910,445702,6,792,2,36000,1.00757575758
444919,444926,445766,7,840,2,36000,1.00833333333
444921,444933,445744,12,811,2,36000,1.01479654747
444952,444962,445808,10,846,2,36000,1.01182033097
444954,444968,445767,14,799,2,36000,1.01752190238
444975,444982,445752,7,770,2,36000,1.00909090909
445024,445030,445846,6,816,2,36000,1.00735294118
445091,445097,445892,6,795,2,36000,1.00754716981
445119,445125,445895,6,770,2,36000,1.00779220779
445178,445184,445531,6,347,1,3600,1.01729106628
445199,445205,446045,6,840,2,36000,1.00714285714
445214,445220,446066,6,846,2,36000,1.00709219858
445215,445226,445979,11,753,2,36000,1.01460823373
445217,445232,445985,15,753,2,36000,1.01992031873
445233,445240,446011,7,771,2,36000,1.00907911803
445235,445247,446041,12,794,2,36000,1.01511335013
445256,445263,446049,7,786,2,36000,1.00890585242
445278,445285,446060,7,775,2,36000,1.00903225806
445311,445318,446047,7,729,2,36000,1.00960219479
445333,445340,446179,7,839,2,36000,1.00834326579
445348,445355,446048,7,693,2,36000,1.0101010101
445350,445361,446154,11,793,2,36000,1.01387137453
445366,445372,446127,6,755,2,36000,1.00794701987
445367,445378,446164,11,786,2,36000,1.01399491094
445384,445390,446195,6,805,2,36000,1.00745341615
445386,445398,446128,12,730,2,36000,1.01643835616
445401,445407,446160,6,753,2,36000,1.00796812749
445402,445414,446171,12,757,2,36000,1.01585204756
445414,445456,446061,42,605,1,3600,1.0694214876
445436,445443,446198,7,755,2,36000,1.00927152318
445438,445449,446324,11,875,2,36000,1.01257142857
445456,445463,446191,7,728,2,36000,1.00961538462
445474,445481,446257,7,776,2,36000,1.00902061856
445502,445508,446315,6,807,2,36000,1.00743494424
445518,445524,446313,6,789,2,36000,1.00760456274
445539,445545,446334,6,789,2,36000,1.00760456274
445589,445596,446421,7,825,2,36000,1.00848484848
445591,445602,446358,11,756,2,36000,1.01455026455
445592,445608,446447,16,839,2,36000,1.01907032181
445607,445615,446433,8,818,2,36000,1.0097799511
445622,445630,446447,8,817,2,36000,1.00979192166
445647,445653,446417,6,764,2,36000,1.00785340314
445678,445684,446490,6,806,2,36000,1.00744416873
445702,445708,446469,6,761,2,36000,1.00788436268
445724,445731,446483,7,752,2,36000,1.00930851064
445746,445753,446539,7,786,2,36000,1.00890585242
445761,445768,446634,7,866,2,36000,1.00808314088
445776,445782,446639,6,857,2,36000,1.00700116686
445777,445789,446604,12,815,2,36000,1.01472392638
445808,445815,446547,7,732,2,36000,1.00956284153
445848,445854,446637,6,783,2,36000,1.00766283525
445893,445900,446748,7,848,2,36000,1.00825471698
445901,445908,446720,7,812,1,3600,1.00862068966
445909,445919,446622,10,703,2,36000,1.01422475107
445979,445985,446785,6,800,2,36000,1.0075
445994,446001,446710,7,709,2,36000,1.00987306065
446013,446019,446721,6,702,2,36000,1.00854700855
446040,446046,446800,6,754,2,36000,1.00795755968
446056,446062,446881,6,819,2,36000,1.00732600733
446058,446071,446847,13,776,2,36000,1.01675257732
446059,446076,446825,17,749,2,36000,1.02269692924
446060,446082,446836,22,754,2,36000,1.02917771883
446076,446089,446844,13,755,2,36000,1.01721854305
446078,446094,446953,16,859,2,36000,1.01862630966
446127,446134,446921,7,787,2,36000,1.00889453621
446128,446141,446861,13,720,2,36000,1.01805555556
446153,446159,447005,6,846,2,36000,1.00709219858
446169,446175,446973,6,798,2,36000,1.00751879699
446170,446182,446954,12,772,2,36000,1.01554404145
446186,446192,446933,6,741,2,36000,1.00809716599
446187,446198,446907,11,709,2,36000,1.01551480959
446203,446209,446925,6,716,2,36000,1.00837988827
446205,446216,446966,11,750,2,36000,1.01466666667
446206,446221,447035,15,814,2,36000,1.01842751843
446259,446265,447111,6,846,2,36000,1.00709219858
446314,446321,447139,7,818,2,36000,1.00855745721
446316,446327,447108,11,781,2,36000,1.01408450704
446331,446337,447112,6,775,2,36000,1.00774193548
446346,446352,447227,6,875,2,36000,1.00685714286
446361,446367,447096,6,729,2,36000,1.00823045267
446420,446427,447237,7,810,2,36000,1.00864197531
446422,446433,447171,11,738,2,36000,1.01490514905
446437,446444,447155,7,711,2,36000,1.00984528833
446453,446459,447221,6,762,2,36000,1.00787401575
446454,446465,447301,11,836,2,36000,1.01315789474
446469,446476,447241,7,765,2,36000,1.0091503268
446485,446491,447164,6,673,2,36000,1.00891530461
446500,446506,447307,6,801,2,36000,1.0074906367
446540,446548,447323,8,775,2,36000,1.01032258065
446556,446562,447371,6,809,2,36000,1.00741656366
446605,446611,447360,6,749,2,36000,1.00801068091
446624,446630,447353,6,723,2,36000,1.00829875519
446640,446646,447385,6,739,2,36000,1.00811907984
446641,446653,447419,12,766,2,36000,1.01566579634
446643,446658,447479,15,821,2,36000,1.01827040195
446711,446717,447444,6,727,2,36000,1.00825309491
446725,446761,458783,36,12022,64,18000,1.00299451006
446727,446733,447416,6,683,2,36000,1.00878477306
446748,446755,447571,7,816,2,36000,1.00857843137
446786,446793,447529,7,736,2,36000,1.00951086957
446801,446807,447540,6,733,2,36000,1.00818553888
446826,446832,447557,6,725,2,36000,1.00827586207
446843,446848,447653,5,805,2,36000,1.00621118012
446858,446865,447646,7,781,2,36000,1.00896286812
446859,446871,447705,12,834,2,36000,1.01438848921
446871,447857,457904,986,10047,64,36000,1.09813874788
446875,446882,447654,7,772,2,36000,1.00906735751
446890,446897,447704,7,807,2,36000,1.00867410161
446909,446915,447685,6,770,2,36000,1.00779220779
446925,446932,447762,7,830,2,36000,1.00843373494
446926,446939,447677,13,738,2,36000,1.01761517615
446942,446949,447788,7,839,2,36000,1.00834326579
446958,446964,447715,6,751,2,36000,1.00798934754
446959,446971,447789,12,818,2,36000,1.01466992665
446975,446982,447805,7,823,2,36000,1.0085054678
446976,446989,447676,13,687,2,36000,1.01892285298
447008,447014,447880,6,866,2,36000,1.00692840647
447036,447042,447932,6,890,2,36000,1.00674157303
447097,447104,448617,7,1513,2,36000,1.00462656973
447113,447119,447891,6,772,2,36000,1.00777202073
447115,447127,447893,12,766,2,36000,1.01566579634
447116,447132,447885,16,753,2,36000,1.02124833997
447141,447148,447949,7,801,2,36000,1.00873907615
447157,447163,447908,6,745,2,36000,1.00805369128
447172,447180,447934,8,754,2,36000,1.01061007958
447174,447185,447959,11,774,2,36000,1.0142118863
447221,447227,448013,6,786,2,36000,1.00763358779
447236,447243,447990,7,747,2,36000,1.0093708166
447238,447249,448041,11,792,2,36000,1.01388888889
447253,447259,448063,6,804,2,36000,1.00746268657
447303,447309,448099,6,790,2,36000,1.00759493671
447319,447325,448066,6,741,2,36000,1.00809716599
447335,447341,448085,6,744,2,36000,1.00806451613
447353,447359,448143,6,784,2,36000,1.00765306122
447369,447375,448081,6,706,2,36000,1.00849858357
447386,447392,448151,6,759,2,36000,1.00790513834
447387,447398,448185,11,787,2,36000,1.01397712834
447412,447420,447427,8,7,1,900,1.5
447419,447431,448232,12,801,2,36000,1.01498127341
447420,447437,448139,17,702,2,36000,1.02421652422
447425,459998,460085,12573,87,14,7980,145.517241379
447446,447453,448212,7,759,2,36000,1.0092226614
447480,447486,448238,6,752,2,36000,1.0079787234
447530,447536,448314,6,778,2,36000,1.00771208226
447545,447551,448377,6,826,2,36000,1.00726392252
447560,447570,448343,10,773,2,36000,1.01293661061
447576,447582,448280,6,698,2,36000,1.00859598854
447647,447658,448581,11,923,2,36000,1.0119176598
447663,447669,448415,6,746,2,36000,1.00804289544
447664,447675,448506,11,831,2,36000,1.01323706378
447681,447687,448527,6,840,2,36000,1.00714285714
447682,447693,448514,11,821,2,36000,1.01339829476
447698,447705,448476,7,771,2,36000,1.00907911803
447714,447721,448514,7,793,2,36000,1.00882723834
447716,447728,448447,12,719,2,36000,1.01668984701
447717,447734,448486,17,752,2,36000,1.02260638298
447764,447774,448498,10,724,2,36000,1.0138121547
447789,447799,448591,10,792,2,36000,1.01262626263
447790,447806,448483,16,677,2,36000,1.02363367799
447806,447817,448569,11,752,2,36000,1.01462765957
447880,447891,448687,11,796,2,36000,1.01381909548
447897,447903,448626,6,723,2,36000,1.00829875519
447898,447909,448701,11,792,2,36000,1.01388888889
447900,447914,448732,14,818,2,36000,1.01711491443
447916,447921,448669,5,748,2,36000,1.00668449198
447935,447943,448717,8,774,2,36000,1.01033591731
447936,447956,448733,20,777,2,36000,1.02574002574
447942,447950,448062,8,112,1,3600,1.07142857143
447952,447962,448852,10,890,2,36000,1.01123595506
447968,447974,448825,6,851,2,36000,1.00705052879
447990,448002,448836,12,834,2,36000,1.01438848921
448015,448025,448813,10,788,2,36000,1.01269035533
448044,448052,448811,8,759,2,36000,1.01054018445
448066,448074,448900,8,826,2,36000,1.00968523002
448068,448080,448877,12,797,2,36000,1.01505646173
448083,448093,448771,10,678,2,36000,1.01474926254
448085,448100,448803,15,703,2,36000,1.0213371266
448100,448112,448997,12,885,2,36000,1.01355932203
448139,448151,448896,12,745,2,36000,1.01610738255
448140,448158,448859,18,701,2,36000,1.02567760342
448156,448164,448937,8,773,2,36000,1.01034928849
448185,448197,448968,12,771,2,36000,1.01556420233
448211,448245,449039,34,794,2,36000,1.04282115869
448230,448238,448545,8,307,1,3600,1.02605863192
448233,448251,449033,18,782,2,36000,1.02301790281
448249,448291,448986,42,695,2,36000,1.06043165468
448281,448325,449127,44,802,2,36000,1.05486284289
448315,448355,449224,40,869,2,36000,1.04602991945
448343,448389,449116,46,727,2,36000,1.06327372765
448378,448426,449253,48,827,2,36000,1.05804111245
448416,448459,449242,43,783,2,36000,1.05491698595
448447,448488,449263,41,775,2,36000,1.05290322581
448478,448494,449237,16,743,2,36000,1.02153432032
448495,448501,449240,6,739,2,36000,1.00811907984
448496,448510,449216,14,706,2,36000,1.01983002833
448514,448520,449372,6,852,2,36000,1.00704225352
448515,448526,449303,11,777,2,36000,1.01415701416
448517,448532,449285,15,753,2,36000,1.01992031873
448518,448538,449261,20,723,2,36000,1.02766251729
448534,448581,449383,47,802,2,36000,1.05860349127
448553,448559,448684,6,125,1,1800,1.048
448571,448603,449348,32,745,2,36000,1.04295302013
448588,448628,449444,40,816,2,36000,1.04901960784
448603,448638,449419,35,781,2,36000,1.04481434059
448619,448681,449516,62,835,2,36000,1.07425149701
448634,448699,449438,65,739,2,36000,1.08795669824
448669,448713,449469,44,756,2,36000,1.0582010582
448687,448728,449368,41,640,2,36000,1.0640625
448703,448743,449580,40,837,2,36000,1.04778972521
448718,448749,449568,31,819,2,36000,1.03785103785
448735,448782,449603,47,821,2,36000,1.05724725944
448736,448814,449614,78,800,2,36000,1.0975
448771,448822,449592,51,770,2,36000,1.06623376623
448802,448829,449571,27,742,2,36000,1.03638814016
448818,448837,449625,19,788,2,36000,1.02411167513
448820,448847,449617,27,770,2,36000,1.03506493506
448836,448865,449591,29,726,2,36000,1.03994490358
448838,448871,449787,33,916,2,36000,1.03602620087
448855,448888,449707,33,819,2,36000,1.04029304029
448871,448907,449745,36,838,2,36000,1.04295942721
448886,448914,449663,28,749,2,36000,1.03738317757
448902,448950,449622,48,672,2,36000,1.07142857143
448904,448979,449902,75,923,2,36000,1.0812567714
448939,449001,449756,62,755,2,36000,1.0821192053
448970,449009,449717,39,708,2,36000,1.05508474576
448981,448987,449085,6,98,1,1800,1.0612244898
448985,448994,449589,9,595,1,3600,1.01512605042
448990,449045,449876,55,831,2,36000,1.06618531889
449006,449052,449767,46,715,2,36000,1.06433566434
449035,449128,449861,93,733,2,36000,1.12687585266
449051,449138,449941,87,803,2,36000,1.10834371108
449117,449228,450054,111,826,2,36000,1.13438256659
449132,449236,450045,104,809,2,36000,1.12855377009
449214,449248,450085,34,837,2,36000,1.04062126643
449230,449255,449988,25,733,2,36000,1.03410641201
449247,449260,450107,13,847,2,36000,1.01534828808
449248,449266,449982,18,716,2,36000,1.0251396648
449249,449273,450070,24,797,2,36000,1.03011292346
449265,449280,450095,15,815,2,36000,1.01840490798
449267,449298,450087,31,789,2,36000,1.03929024081
449268,449314,450086,46,772,2,36000,1.05958549223
449287,449359,450211,72,852,2,36000,1.08450704225
449303,449379,450201,76,822,2,36000,1.09245742092
449350,449387,450071,37,684,2,36000,1.05409356725
449369,449394,450249,25,855,2,36000,1.02923976608
449384,449431,450171,47,740,2,36000,1.06351351351
449386,449450,450229,64,779,2,36000,1.08215661104
449421,449456,450256,35,800,2,36000,1.04375
449439,449481,450211,42,730,2,36000,1.05753424658
449454,449528,450294,74,766,2,36000,1.09660574413
449470,449580,450294,110,714,2,36000,1.15406162465
449517,449587,450321,70,734,2,36000,1.09536784741
449570,449593,450372,23,779,2,36000,1.02952503209
449586,449603,450391,17,788,2,36000,1.02157360406
449588,449609,450357,21,748,2,36000,1.02807486631
449604,449615,450465,11,850,2,36000,1.01294117647
449606,449626,450510,20,884,2,36000,1.02262443439
449607,449632,450437,25,805,2,36000,1.03105590062
449624,449638,450392,14,754,2,36000,1.01856763926
449625,449644,450404,19,760,2,36000,1.025
449627,449674,450490,47,816,2,36000,1.05759803922
449628,449719,450468,91,749,2,36000,1.1214953271
449663,449729,450466,66,737,2,36000,1.08955223881
449709,449756,450486,47,730,2,36000,1.06438356164
449725,449767,450480,42,713,2,36000,1.05890603086
449748,449780,450557,32,777,2,36000,1.04118404118
449763,449773,450344,10,571,1,1800,1.01751313485
449765,449798,450609,33,811,2,36000,1.04069050555
449780,449873,450652,93,779,2,36000,1.11938382542
449795,449887,450704,92,817,2,36000,1.11260709914
449861,449913,450673,52,760,2,36000,1.06842105263
449878,449953,450874,75,921,2,36000,1.08143322476
449903,449994,450733,91,739,2,36000,1.12313937754
449943,450001,450822,58,821,2,36000,1.0706455542
449984,450057,450869,73,812,2,36000,1.08990147783
450000,450065,450888,65,823,2,36000,1.07897934386
450044,450081,450872,37,791,2,36000,1.04677623262
450060,450090,450899,30,809,2,36000,1.03708281829
450077,450097,450917,20,820,2,36000,1.0243902439
450078,450103,450958,25,855,2,36000,1.02923976608
450095,450109,450863,14,754,2,36000,1.01856763926
450096,450116,450883,20,767,2,36000,1.0260756193
450097,450123,450872,26,749,2,36000,1.0347129506
450099,450183,450907,84,724,2,36000,1.11602209945
450115,450212,450992,97,780,2,36000,1.12435897436
450172,450223,451004,51,781,2,36000,1.06530089629
450209,450228,451026,19,798,2,36000,1.02380952381
450224,450240,451010,16,770,2,36000,1.02077922078
450226,450260,451131,34,871,2,36000,1.03903559127
450242,450267,451003,25,736,2,36000,1.0339673913
450257,450305,451054,48,749,2,36000,1.06408544726
450259,450311,451054,52,743,2,36000,1.06998654105
450294,450333,451163,39,830,2,36000,1.04698795181
450295,450368,451212,73,844,2,36000,1.086492891
450321,450383,451221,62,838,2,36000,1.07398568019
450359,450403,451165,44,762,2,36000,1.05774278215
450375,450410,451263,35,853,2,36000,1.04103165299
450391,450416,451188,25,772,2,36000,1.03238341969
450393,450448,451250,55,802,2,36000,1.06857855362
450410,450476,451250,66,774,2,36000,1.08527131783
450438,450484,451326,46,842,2,36000,1.05463182898
450467,450489,451291,22,802,2,36000,1.02743142145
450468,450496,451342,28,846,2,36000,1.03309692671
450485,450503,451276,18,773,2,36000,1.02328589909
450487,450508,451356,21,848,2,36000,1.02476415094
450488,450522,451328,34,806,2,36000,1.04218362283
450505,450568,451444,63,876,2,36000,1.07191780822
450506,450620,451459,114,839,2,36000,1.13587604291
450557,450663,451415,106,752,2,36000,1.14095744681
450604,450684,451457,80,773,2,36000,1.10349288486
450655,450715,451533,60,818,2,36000,1.07334963325
450674,450744,451493,70,749,2,36000,1.09345794393
450705,450834,451645,129,811,2,36000,1.15906288533
450737,450875,451704,138,829,2,36000,1.16646562123
450824,450881,451709,57,828,2,36000,1.06884057971
450866,450889,451688,23,799,2,36000,1.02878598248
450883,450896,451668,13,772,2,36000,1.01683937824
450884,450901,451714,17,813,2,36000,1.0209102091
450886,450906,451684,20,778,2,36000,1.02570694087
450887,450912,451763,25,851,2,36000,1.02937720329
450888,450918,451828,30,910,2,36000,1.03296703297
450905,450931,451698,26,767,2,36000,1.03389830508
450906,450925,451653,19,728,2,36000,1.0260989011
450922,450969,451722,47,753,2,36000,1.06241699867
450924,451003,451786,79,783,2,36000,1.10089399745
450961,451014,451777,53,763,2,36000,1.06946264744
450992,451020,451825,28,805,2,36000,1.0347826087
451008,451027,451755,19,728,2,36000,1.0260989011
451010,451037,451800,27,763,2,36000,1.03538663172
451026,451066,451818,40,752,2,36000,1.05319148936
451027,451072,451802,45,730,2,36000,1.06164383562
451056,451143,451932,87,789,2,36000,1.1102661597
451057,451174,451968,117,794,2,36000,1.14735516373
451132,451181,451935,49,754,2,36000,1.0649867374
451163,451199,452075,36,876,2,36000,1.04109589041
451180,451223,452069,43,846,2,36000,1.05082742317
451195,451233,451969,38,736,2,36000,1.05163043478
451214,451262,452072,48,810,2,36000,1.05925925926
451230,451267,452039,37,772,2,36000,1.04792746114
451252,451275,452068,23,793,2,36000,1.0290037831
451253,451288,452050,35,762,2,36000,1.04593175853
451270,451303,452133,33,830,2,36000,1.03975903614
451285,451338,452152,53,814,2,36000,1.06511056511
451301,451344,452120,43,776,2,36000,1.05541237113
451329,451353,452119,24,766,2,36000,1.03133159269
451330,451368,452209,38,841,2,36000,1.0451843044
451349,451426,452257,77,831,2,36000,1.09265944645
451364,451455,452328,91,873,2,36000,1.10423825888
451417,451468,452284,51,816,2,36000,1.0625
451445,451474,452227,29,753,2,36000,1.0385126162
451460,451506,452286,46,780,2,36000,1.05897435897
451462,451545,452348,83,803,2,36000,1.10336239103
451496,451657,452505,161,848,2,36000,1.18985849057
451536,451665,452458,129,793,2,36000,1.16267339218
451651,451679,452456,28,777,2,36000,1.03603603604
451655,460003,496035,8348,36032,9,36000,1.23168294849
451667,451695,452445,28,750,2,36000,1.03733333333
451691,451702,452504,11,802,2,36000,1.01371571072
451692,451710,452508,18,798,2,36000,1.02255639098
451693,451717,452447,24,730,2,36000,1.03287671233
451720,451726,452486,6,760,2,36000,1.00789473684
451722,451732,452523,10,791,2,36000,1.01264222503
451723,451738,452511,15,773,2,36000,1.01940491591
451724,451766,452538,42,772,2,36000,1.05440414508
451740,451775,452524,35,749,2,36000,1.04672897196
451756,451788,452539,32,751,2,36000,1.04260985353
451771,451798,452603,27,805,2,36000,1.03354037267
451787,451813,452579,26,766,2,36000,1.03394255875
451789,451819,452692,30,873,2,36000,1.03436426117
451805,451829,452634,24,805,2,36000,1.0298136646
451807,451836,452670,29,834,2,36000,1.03477218225
451824,451842,452619,18,777,2,36000,1.02316602317
451839,451944,452763,105,819,2,36000,1.12820512821
451841,451951,452705,110,754,2,36000,1.14588859416
451931,451979,452788,48,809,2,36000,1.05933250927
451947,451987,452808,40,821,2,36000,1.04872107186
451969,452055,452924,86,869,2,36000,1.09896432681
451970,452061,452842,91,781,2,36000,1.11651728553
452041,452079,452843,38,764,2,36000,1.0497382199
452043,452050,452106,7,56,1,1800,1.125
452060,452085,452845,25,760,2,36000,1.03289473684
452076,452091,452925,15,834,2,36000,1.01798561151
452078,452097,452834,19,737,2,36000,1.02578018996
452079,452130,452931,51,801,2,36000,1.06367041199
452080,452137,452906,57,769,2,36000,1.07412223667
452122,452149,452947,27,798,2,36000,1.03383458647
452123,452164,452844,41,680,2,36000,1.06029411765
452143,452220,452966,77,746,2,36000,1.10321715818
452158,452240,452998,82,758,2,36000,1.10817941953
452207,452213,452336,6,123,1,1800,1.0487804878
452211,452269,452985,58,716,2,36000,1.08100558659
452227,452295,453054,68,759,2,36000,1.08959156785
452258,452302,453015,44,713,2,36000,1.06171107994
452283,452339,453115,56,776,2,36000,1.07216494845
452299,452359,453233,60,874,2,36000,1.06864988558
452329,452456,453287,127,831,2,36000,1.15282791817
452348,452463,453485,115,1022,2,36000,1.11252446184
452417,452423,452500,6,77,1,1800,1.07792207792
452445,452469,453218,24,749,2,36000,1.03204272363
452462,452474,453304,12,830,2,36000,1.01445783133
452463,452498,453269,35,771,2,36000,1.04539559014
452464,452515,453271,51,756,2,36000,1.06746031746
452489,452521,453330,32,809,2,36000,1.03955500618
452506,452527,453325,21,798,2,36000,1.02631578947
452507,452533,453272,26,739,2,36000,1.0351826793
452524,452539,453327,15,788,2,36000,1.01903553299
452525,452545,453356,20,811,2,36000,1.02466091245
452527,452551,453357,24,806,2,36000,1.02977667494
452528,452556,453312,28,756,2,36000,1.03703703704
452545,452590,453382,45,792,2,36000,1.05681818182
452546,452614,453342,68,728,2,36000,1.09340659341
452580,452630,453360,50,730,2,36000,1.06849315068
452605,452646,453491,41,845,2,36000,1.04852071006
452621,452681,453418,60,737,2,36000,1.08141112619
452636,452704,453526,68,822,2,36000,1.08272506083
452658,452664,452767,6,103,1,1800,1.05825242718
452670,452717,453530,47,813,2,36000,1.05781057811
452692,452775,453519,83,744,2,36000,1.11155913978
452707,452800,453583,93,783,2,36000,1.11877394636
452766,452821,453544,55,723,2,36000,1.07607192254
452790,452845,453653,55,808,2,36000,1.06806930693
452809,452854,453648,45,794,2,36000,1.05667506297
452834,452860,453643,26,783,2,36000,1.03320561941
452850,452866,453699,16,833,2,36000,1.01920768307
452852,452871,453723,19,852,2,36000,1.02230046948
452853,452917,453688,64,771,2,36000,1.08300907912
452854,452935,453727,81,792,2,36000,1.10227272727
452907,452941,453757,34,816,2,36000,1.04166666667
452926,452948,453858,22,910,2,36000,1.02417582418
452927,452958,453662,31,704,2,36000,1.04403409091
452943,452977,453761,34,784,2,36000,1.04336734694
452958,452997,453795,39,798,2,36000,1.04887218045
452973,453009,453766,36,757,2,36000,1.04755614267
452989,453026,453744,37,718,2,36000,1.05153203343
453004,453065,453794,61,729,2,36000,1.08367626886
453019,453126,453940,107,814,2,36000,1.13144963145
453056,453229,454021,173,792,2,36000,1.21843434343
453115,453245,454046,130,801,2,36000,1.16229712859
453219,453280,453988,61,708,2,36000,1.08615819209
453236,453287,454065,51,778,2,36000,1.06555269923
453271,453292,454059,21,767,2,36000,1.02737940026
453272,453298,454082,26,784,2,36000,1.03316326531
453273,453315,454121,42,806,2,36000,1.05210918114
453290,453324,454132,34,808,2,36000,1.04207920792
453306,453336,454157,30,821,2,36000,1.0365408039
453322,453342,454125,20,783,2,36000,1.02554278416
453338,453353,454213,15,860,2,36000,1.01744186047
453339,453359,454193,20,834,2,36000,1.02398081535
453339,453348,453634,9,286,1,1800,1.03146853147
453340,453367,454189,27,822,2,36000,1.03284671533
453357,453374,454367,17,993,2,36000,1.01711983887
453358,453379,454228,21,849,2,36000,1.02473498233
453359,453394,454211,35,817,2,36000,1.04283965728
453375,453430,454105,55,675,2,36000,1.08148148148
453390,453496,454263,106,767,2,36000,1.13820078227
453421,453504,454364,83,860,2,36000,1.09651162791
453451,453457,453966,6,509,1,1800,1.01178781925
453486,453530,454256,44,726,2,36000,1.06060606061
453502,453538,454365,36,827,2,36000,1.04353083434
453521,453544,454330,23,786,2,36000,1.02926208651
453537,453555,454311,18,756,2,36000,1.02380952381
453538,453595,454392,57,797,2,36000,1.07151819322
453554,453656,454464,102,808,2,36000,1.12623762376
453585,453662,454475,77,813,2,36000,1.09471094711
453644,453669,454493,25,824,2,36000,1.03033980583
453659,453675,454522,16,847,2,36000,1.01889020071
453661,453699,454497,38,798,2,36000,1.04761904762
453682,453710,454418,28,708,2,36000,1.0395480226
453698,453735,454562,37,827,2,36000,1.04474002418
453713,453742,454507,29,765,2,36000,1.03790849673
453729,453755,454592,26,837,2,36000,1.03106332139
453730,453768,454548,38,780,2,36000,1.04871794872
453746,453775,454568,29,793,2,36000,1.03656998739
453762,453782,454537,20,755,2,36000,1.02649006623
453763,453805,454566,42,761,2,36000,1.05519053876
453779,453812,454633,33,821,2,36000,1.04019488429
453795,453870,454621,75,751,2,36000,1.09986684421
453796,453952,454783,156,831,2,36000,1.18772563177
453861,453999,454827,138,828,2,36000,1.16666666667
453941,454033,454788,92,755,2,36000,1.12185430464
453991,454058,454878,67,820,2,36000,1.08170731707
454021,454070,454864,49,794,2,36000,1.06171284635
454046,454076,454811,30,735,2,36000,1.04081632653
454062,454094,454935,32,841,2,36000,1.03804994055
454078,454117,454867,39,750,2,36000,1.052
454093,454133,454883,40,750,2,36000,1.05333333333
454108,454139,454883,31,744,2,36000,1.04166666667
454124,454146,454891,22,745,2,36000,1.02953020134
454140,454168,454986,28,818,2,36000,1.03422982885
454141,454201,454989,60,788,2,36000,1.07614213198
454157,454207,454956,50,749,2,36000,1.06675567423
454192,454222,454974,30,752,2,36000,1.03989361702
454208,454230,455082,22,852,2,36000,1.02582159624
454224,454240,454987,16,747,2,36000,1.02141900937
454225,454267,455182,42,915,2,36000,1.04590163934
454241,454275,455092,34,817,2,36000,1.04161566707
454256,454323,455219,67,896,2,36000,1.07477678571
454271,454342,455103,71,761,2,36000,1.09329829172
454312,454376,455175,64,799,2,36000,1.08010012516
454334,454381,455177,47,796,2,36000,1.05904522613
454365,454387,455122,22,735,2,36000,1.02993197279
454366,454404,455203,38,799,2,36000,1.04755944931
454382,454430,455124,48,694,2,36000,1.06916426513
454397,454475,455243,78,768,2,36000,1.1015625
454419,454487,455267,68,780,2,36000,1.08717948718
454465,454504,455193,39,689,2,36000,1.05660377358
454481,454510,455264,29,754,2,36000,1.03846153846
454497,454518,455243,21,725,2,36000,1.02896551724
454498,454534,455290,36,756,2,36000,1.04761904762
454514,454549,455333,35,784,2,36000,1.04464285714
454529,454559,455343,30,784,2,36000,1.03826530612
454545,454573,455300,28,727,2,36000,1.03851444292
454561,454580,455370,19,790,2,36000,1.02405063291
454577,454585,455445,8,860,2,36000,1.00930232558
454578,454604,455425,26,821,2,36000,1.03166869671
454580,454633,455437,53,804,2,36000,1.06592039801
454595,454645,455539,50,894,2,36000,1.05592841163
454620,454794,455571,174,777,2,36000,1.22393822394
454635,454801,455626,166,825,2,36000,1.20121212121
454788,454823,455610,35,787,2,36000,1.04447268107
454789,454838,455693,49,855,2,36000,1.05730994152
454811,454875,455669,64,794,2,36000,1.08060453401
454827,454882,455565,55,683,2,36000,1.08052708638
454868,454890,455688,22,798,2,36000,1.02756892231
454869,454897,455639,28,742,2,36000,1.03773584906
454886,454902,455599,16,697,2,36000,1.02295552367
454887,454908,455627,21,719,2,36000,1.02920723227
454888,454947,455665,59,718,2,36000,1.08217270195
454904,454967,455759,63,792,2,36000,1.07954545455
454937,454986,455731,49,745,2,36000,1.06577181208
454956,454999,455767,43,768,2,36000,1.05598958333
454975,455004,455726,29,722,2,36000,1.04016620499
454991,455010,455816,19,806,2,36000,1.02357320099
454993,455093,455846,100,753,2,36000,1.13280212483
454994,455104,455885,110,781,2,36000,1.14084507042
455083,455114,455867,31,753,2,36000,1.0411686587
455099,455133,455866,34,733,2,36000,1.04638472033
455114,455139,455911,25,772,2,36000,1.03238341969
455129,455186,456089,57,903,2,36000,1.06312292359
455131,455192,455963,61,771,2,36000,1.07911802853
455177,455199,456017,22,818,2,36000,1.02689486553
455179,455206,456011,27,805,2,36000,1.03354037267
455195,455214,455982,19,768,2,36000,1.02473958333
455196,455230,456022,34,792,2,36000,1.04292929293
455212,455254,455985,42,731,2,36000,1.05745554036
455228,455260,456437,32,1177,2,36000,1.02718776551
455244,455275,456026,31,751,2,36000,1.04127829561
455245,455282,456041,37,759,2,36000,1.0487483531
455267,455301,456123,34,822,2,36000,1.04136253041
455282,455311,456038,29,727,2,36000,1.03988995873
455298,455345,456082,47,737,2,36000,1.06377204885
455314,455354,456149,40,795,2,36000,1.05031446541
455335,455381,456147,46,766,2,36000,1.06005221932
455351,455437,456205,86,768,2,36000,1.11197916667
455372,455448,456441,76,993,2,36000,1.07653575025
455428,455457,456196,29,739,2,36000,1.03924221922
455444,455551,456381,107,830,2,36000,1.12891566265
455445,455576,456434,131,858,2,36000,1.15268065268
455541,455583,456417,42,834,2,36000,1.05035971223
455566,455610,456372,44,762,2,36000,1.05774278215
455582,455621,456616,39,995,2,36000,1.0391959799
455600,455639,456355,39,716,2,36000,1.05446927374
455617,455644,456418,27,774,2,36000,1.03488372093
455633,455650,456447,17,797,2,36000,1.02132998745
455634,455676,456636,42,960,2,36000,1.04375
455650,455682,456424,32,742,2,36000,1.04312668464
455665,455700,456488,35,788,2,36000,1.04441624365
455681,455707,456491,26,784,2,36000,1.03316326531
455696,455737,456545,41,808,2,36000,1.05074257426
455697,455744,456516,47,772,2,36000,1.06088082902
455728,455770,456565,42,795,2,36000,1.05283018868
455744,455778,456508,34,730,2,36000,1.04657534247
455762,455827,456692,65,865,2,36000,1.07514450867
455777,455857,456575,80,718,2,36000,1.11142061281
455818,455879,456621,61,742,2,36000,1.08221024259
455848,455884,456634,36,750,2,36000,1.048
455867,455897,456631,30,734,2,36000,1.0408719346
455868,455922,456889,54,967,2,36000,1.05584281282
455877,455890,455939,13,49,1,1800,1.26530612245
455884,455974,456733,90,759,2,36000,1.1185770751
455912,455994,456801,82,807,2,36000,1.10161090458
455962,456001,456821,39,820,2,36000,1.04756097561
455984,456022,456828,38,806,2,36000,1.04714640199
455985,456030,456786,45,756,2,36000,1.05952380952
456014,456036,456753,22,717,2,36000,1.03068340307
456030,456043,457317,13,1274,2,36000,1.01020408163
456031,456050,456848,19,798,2,36000,1.02380952381
456033,456057,456869,24,812,2,36000,1.02955665025
456049,456095,456880,46,785,2,36000,1.05859872611
456050,456101,456998,51,897,2,36000,1.05685618729
456084,456134,456833,50,699,2,36000,1.07153075823
456099,456158,456896,59,738,2,36000,1.07994579946
456124,456164,456904,40,740,2,36000,1.05405405405
456149,456207,456969,58,762,2,36000,1.07611548556
456150,456216,456972,66,756,2,36000,1.0873015873
456197,456366,457219,169,853,2,36000,1.19812426729
456212,456383,457145,171,762,2,36000,1.22440944882
456275,456281,456351,6,70,1,1800,1.08571428571
456357,456393,457108,36,715,2,36000,1.05034965035
456374,456428,457278,54,850,2,36000,1.06352941176
456389,456434,457259,45,825,2,36000,1.05454545455
456418,456441,457233,23,792,2,36000,1.02904040404
456419,456447,457310,28,863,2,36000,1.03244495944
456435,456453,457263,18,810,2,36000,1.02222222222
456436,456458,457231,22,773,2,36000,1.02846054334
456452,456465,457268,13,803,2,36000,1.01618929016
456454,456499,457323,45,824,2,36000,1.05461165049
456455,456506,457207,51,701,2,36000,1.0727532097
456489,456520,457308,31,788,2,36000,1.03934010152
456504,456552,457344,48,792,2,36000,1.06060606061
456520,456559,457358,39,799,2,36000,1.04881101377
456521,456578,457336,57,758,2,36000,1.07519788918
456546,456587,457364,41,777,2,36000,1.05276705277
456568,456628,457487,60,859,2,36000,1.06984866123
456584,456634,457427,50,793,2,36000,1.0630517024
456615,456642,457501,27,859,2,36000,1.03143189756
456631,456649,457447,18,798,2,36000,1.02255639098
456633,456655,457467,22,812,2,36000,1.02709359606
456648,456704,457527,56,823,2,36000,1.06804374241
456650,456744,457640,94,896,2,36000,1.10491071429
456693,456764,457512,71,748,2,36000,1.0949197861
456733,456797,457616,64,819,2,36000,1.07814407814
456759,456812,457525,53,713,2,36000,1.07433380084
456787,456833,457778,46,945,2,36000,1.04867724868
456803,456839,457538,36,699,2,36000,1.05150214592
456822,456845,457582,23,737,2,36000,1.03120759837
456838,456860,457608,22,748,2,36000,1.02941176471
456839,456881,457582,42,701,2,36000,1.05991440799
456855,456892,457701,37,809,2,36000,1.0457354759
456870,456900,457761,30,861,2,36000,1.03484320557
456886,456908,457753,22,845,2,36000,1.02603550296
456902,456915,457686,13,771,2,36000,1.0168612192
456903,456980,457766,77,786,2,36000,1.09796437659
456919,456986,457762,67,776,2,36000,1.08634020619
456971,457009,457854,38,845,2,36000,1.0449704142
456986,457119,457908,133,789,2,36000,1.16856780735
457002,457157,457977,155,820,2,36000,1.18902439024
457109,457220,458038,111,818,2,36000,1.13569682152
457146,457230,458067,84,837,2,36000,1.10035842294
457208,457242,458038,34,796,2,36000,1.04271356784
457224,457248,458094,24,846,2,36000,1.02836879433
457239,457271,458021,32,750,2,36000,1.04266666667
457240,457278,458066,38,788,2,36000,1.04822335025
457259,457284,458051,25,767,2,36000,1.03259452412
457275,457291,458097,16,806,2,36000,1.01985111663
457276,457321,458069,45,748,2,36000,1.06016042781
457292,457327,458074,35,747,2,36000,1.046854083
457308,457334,458203,26,869,2,36000,1.02991944764
457309,457340,458121,31,781,2,36000,1.03969270166
457325,457347,458005,22,658,2,36000,1.03343465046
457326,457356,458103,30,747,2,36000,1.04016064257
457342,457369,458165,27,796,2,36000,1.03391959799
457358,457380,458137,22,757,2,36000,1.02906208719
457359,457439,458274,80,835,2,36000,1.09580838323
457364,457375,457651,11,276,1,1800,1.03985507246
457374,457458,458258,84,800,2,36000,1.105
457429,457478,458255,49,777,2,36000,1.06306306306
457448,457499,458265,51,766,2,36000,1.06657963446
457469,457512,458345,43,833,2,36000,1.05162064826
457488,457523,458263,35,740,2,36000,1.0472972973
457504,457537,458308,33,771,2,36000,1.04280155642
457520,457543,458345,23,802,2,36000,1.02867830424
457537,457551,458348,14,797,2,36000,1.01756587202
457539,457593,458398,54,805,2,36000,1.06708074534
457540,457598,458376,58,778,2,36000,1.07455012853
457587,457619,458426,32,807,2,36000,1.03965303594
457588,457628,458419,40,791,2,36000,1.05056890013
457612,457651,458409,39,758,2,36000,1.05145118734
457630,457698,458452,68,754,2,36000,1.09018567639
457647,457712,458515,65,803,2,36000,1.08094645081
457689,457772,458582,83,810,2,36000,1.1024691358
457706,457764,458495,58,731,2,36000,1.07934336525
457757,457779,458814,22,1035,2,36000,1.02125603865
457775,457785,458618,10,833,2,36000,1.01200480192
457776,457791,458609,15,818,2,36000,1.01833740831
457778,457865,458715,87,850,2,36000,1.10235294118
457794,457932,458730,138,798,2,36000,1.17293233083
457858,457988,458789,130,801,2,36000,1.16229712859
457913,458017,458805,104,788,2,36000,1.13197969543
457982,458033,458847,51,814,2,36000,1.06265356265
458009,458050,458819,41,769,2,36000,1.0533159948
458026,458055,458831,29,776,2,36000,1.03737113402
458043,458063,458888,20,825,2,36000,1.02424242424
458045,458079,458861,34,782,2,36000,1.04347826087
458062,458084,459004,22,920,2,36000,1.02391304348
458081,458090,458931,9,841,2,36000,1.01070154578
458083,458095,458939,12,844,2,36000,1.01421800948
458084,458107,458956,23,849,2,36000,1.02709069494
458085,458113,459151,28,1038,2,36000,1.02697495183
458104,458119,459138,15,1019,2,36000,1.01472031403
458105,458133,458916,28,783,2,36000,1.03575989783
458107,458148,459014,41,866,2,36000,1.04734411085
458125,458176,458912,51,736,2,36000,1.06929347826
458142,458215,459075,73,860,2,36000,1.08488372093
458169,458266,459026,97,760,2,36000,1.12763157895
458206,458272,459065,66,793,2,36000,1.08322824716
458255,458280,458994,25,714,2,36000,1.0350140056
458274,458286,458988,12,702,2,36000,1.01709401709
458275,458292,459123,17,831,2,36000,1.02045728039
458277,458319,459108,42,789,2,36000,1.05323193916
458295,458357,459118,62,761,2,36000,1.0814717477
458311,458363,459206,52,843,2,36000,1.06168446026
458348,458369,459168,21,799,2,36000,1.02628285357
458350,458387,459104,37,717,2,36000,1.05160390516
458351,458409,459255,58,846,2,36000,1.06855791962
458379,458420,459346,41,926,2,36000,1.04427645788
458403,458431,459258,28,827,2,36000,1.0338573156
458420,458438,459134,18,696,2,36000,1.02586206897
458422,458463,459290,41,827,2,36000,1.04957678356
458440,458506,459196,66,690,2,36000,1.09565217391
458456,458526,459232,70,706,2,36000,1.09915014164
458499,458594,459373,95,779,2,36000,1.12195121951
458519,458621,459366,102,745,2,36000,1.13691275168
458586,458629,459393,43,764,2,36000,1.05628272251
458612,458727,459490,115,763,2,36000,1.15072083879
458628,458741,459477,113,736,2,36000,1.1535326087
458719,458821,459552,102,731,2,36000,1.13953488372
458735,458827,459635,92,808,2,36000,1.11386138614
458793,458833,459685,40,852,2,36000,1.04694835681
458809,458839,459517,30,678,2,36000,1.04424778761
458825,458845,459661,20,816,2,36000,1.02450980392
458827,458858,459641,31,783,2,36000,1.03959131545
458842,458872,459689,30,817,2,36000,1.03671970624
458857,458899,459734,42,835,2,36000,1.0502994012
458873,458923,459733,50,810,2,36000,1.06172839506
458889,458929,459730,40,801,2,36000,1.04993757803
458914,458942,459775,28,833,2,36000,1.03361344538
458930,458950,459726,20,776,2,36000,1.02577319588
458946,458967,459781,21,814,2,36000,1.0257985258
458947,458999,459720,52,721,2,36000,1.0721220527
458963,459006,459787,43,781,2,36000,1.05505761844
458990,459016,459851,26,835,2,36000,1.03113772455
459006,459026,459766,20,740,2,36000,1.02702702703
459008,459037,459822,29,785,2,36000,1.03694267516
459023,459077,459823,54,746,2,36000,1.07238605898
459039,459086,459927,47,841,2,36000,1.05588585018
459067,459115,459915,48,800,2,36000,1.06
459082,459121,459867,39,746,2,36000,1.05227882038
459104,459129,459865,25,736,2,36000,1.0339673913
459120,459135,459835,15,700,2,36000,1.02142857143
459121,459145,459947,24,802,2,36000,1.02992518703
459138,459151,459857,13,706,2,36000,1.01841359773
459139,459162,460326,23,1164,2,36000,1.01975945017
459140,459179,459961,39,782,2,36000,1.04987212276
459156,459207,460001,51,794,2,36000,1.06423173804
459171,459217,459973,46,756,2,36000,1.06084656085
459196,459243,460012,47,769,2,36000,1.0611183355
459211,459266,460044,55,778,2,36000,1.0706940874
459233,459273,460058,40,785,2,36000,1.05095541401
459258,459301,460061,43,760,2,36000,1.05657894737
459260,459357,460176,97,819,2,36000,1.11843711844
459291,459377,460124,86,747,2,36000,1.11512717537
459346,459385,460220,39,835,2,36000,1.04670658683
459369,459404,460185,35,781,2,36000,1.04481434059
459384,459488,460224,104,736,2,36000,1.14130434783
459400,459501,460309,101,808,2,36000,1.125
459479,459528,460167,49,639,2,36000,1.07668231612
459495,459564,460415,69,851,2,36000,1.08108108108
459517,459646,460371,129,725,2,36000,1.17793103448
459554,459653,460417,99,764,2,36000,1.12958115183
459635,459672,460501,37,829,2,36000,1.04463208685
459651,459696,460477,45,781,2,36000,1.0576184379
459666,459702,460515,36,813,2,36000,1.0442804428
459688,459731,460514,43,783,2,36000,1.05491698595
459703,459737,460467,34,730,2,36000,1.04657534247
459722,459744,460555,22,811,2,36000,1.0271270037
459739,459751,460706,12,955,2,36000,1.01256544503
459740,459756,460534,16,778,2,36000,1.0205655527
459742,459777,460783,35,1006,2,36000,1.03479125249
459743,459786,460672,43,886,2,36000,1.04853273138
459768,459792,460576,24,784,2,36000,1.0306122449
459784,459799,460559,15,760,2,36000,1.01973684211
459786,459840,460720,54,880,2,36000,1.06136363636
459801,459846,460590,45,744,2,36000,1.06048387097
459820,459852,460650,32,798,2,36000,1.04010025063
459822,459862,460647,40,785,2,36000,1.05095541401
459837,459869,460590,32,721,2,36000,1.04438280166
459853,459876,460700,23,824,2,36000,1.02791262136
459870,459882,460640,12,758,2,36000,1.01583113456
459871,459926,460652,55,726,2,36000,1.07575757576
459872,459938,460650,66,712,2,36000,1.09269662921
459916,459958,460753,42,795,2,36000,1.05283018868
459932,459972,460784,40,812,2,36000,1.04926108374
459947,459984,460797,37,813,2,36000,1.0455104551
459963,460008,460809,45,801,2,36000,1.05617977528
459978,460014,460863,36,849,2,36000,1.04240282686
460003,460025,460766,22,741,2,36000,1.02968960864
460019,460030,460768,11,738,2,36000,1.01490514905
460044,460050,460778,6,728,2,36000,1.00824175824
460059,460066,460904,7,838,2,36000,1.00835322196
460061,460072,460879,11,807,2,36000,1.0136307311
460084,460090,460096,6,6,1,900,1.2
460095,460101,460191,6,90,14,7980,1.06666666667
460126,460133,460886,7,753,2,36000,1.00929614874
460170,460176,460958,6,782,2,36000,1.00767263427
460186,460192,461096,6,904,2,36000,1.00663716814
460187,460198,460910,11,712,2,36000,1.0154494382
460189,460781,460787,592,6,1,900,59.8
460195,460204,460283,9,79,14,7980,1.11392405063
460222,460228,460984,6,756,2,36000,1.00793650794
460237,460243,461031,6,788,2,36000,1.0076142132
460282,460787,460791,505,4,1,900,50.9
460289,460295,460378,6,83,14,7980,1.07228915663
460312,460318,461077,6,759,2,36000,1.00790513834
460327,460333,461166,6,833,2,36000,1.00720288115
460374,460380,461909,6,1529,2,36000,1.00392413342
460375,460792,460795,417,3,1,900,42.0
460381,460389,460479,8,90,14,7980,1.08888888889
460418,460424,461212,6,788,2,36000,1.0076142132
460419,460430,461215,11,785,2,36000,1.01401273885
460469,460475,461211,6,736,2,36000,1.00815217391
460477,460797,460803,320,6,1,900,32.6
460484,460496,461224,12,728,2,36000,1.01648351648
460484,460490,460583,6,93,14,7980,1.06451612903
460503,460509,461402,6,893,2,36000,1.00671892497
460519,460525,461321,6,796,2,36000,1.00753768844
460520,460531,461377,11,846,2,36000,1.01300236407
460535,460542,461311,7,769,2,36000,1.00910273082
460555,460561,461361,6,800,2,36000,1.0075
460571,460577,461339,6,762,2,36000,1.00787401575
460578,460814,460818,236,4,1,900,24.0
460585,460598,460686,13,88,14,7980,1.14772727273
460586,460592,461357,6,765,2,36000,1.00784313725
460602,460608,461448,6,840,2,36000,1.00714285714
460603,460614,461400,11,786,2,36000,1.01399491094
460641,460647,461447,6,800,2,36000,1.0075
460657,460663,461471,6,808,2,36000,1.00742574257
460658,460670,461380,12,710,2,36000,1.01690140845
460660,460675,461453,15,778,2,36000,1.01928020566
460661,460680,461451,19,771,2,36000,1.02464332036
460677,460686,461441,9,755,2,36000,1.0119205298
460684,460820,460824,136,4,1,900,14.0
460691,460697,460784,6,87,14,7980,1.06896551724
460702,460708,461475,6,767,2,36000,1.00782268579
460717,460724,461565,7,841,2,36000,1.00832342449
460719,460730,461525,11,795,2,36000,1.01383647799
460753,460760,461547,7,787,2,36000,1.00889453621
460769,460775,461615,6,840,2,36000,1.00714285714
460770,460802,461575,32,773,2,36000,1.04139715395
460782,460826,460829,44,3,1,900,4.7
460786,460831,461668,45,837,2,36000,1.05376344086
460787,460836,461609,49,773,2,36000,1.06338939198
460788,460808,460891,20,83,14,7980,1.24096385542
460789,460842,461600,53,758,2,36000,1.06992084433
460805,460848,461585,43,737,2,36000,1.05834464043
460821,460854,461669,33,815,2,36000,1.04049079755
460864,460870,461704,6,834,2,36000,1.0071942446
460880,460886,461629,6,743,2,36000,1.00807537012
460890,460896,460900,6,4,1,900,1.0
460895,460902,461588,7,686,2,36000,1.01020408163
460896,460908,460989,12,81,14,7980,1.14814814815
460911,460917,461665,6,748,2,36000,1.00802139037
460913,460923,461695,10,772,2,36000,1.01295336788
460959,460965,461682,6,717,2,36000,1.00836820084
460984,460990,461807,6,817,2,36000,1.00734394125
460987,461094,461099,107,5,1,900,11.2
460994,461000,461083,6,83,14,7980,1.07228915663
461030,461036,462126,6,1090,2,36000,1.00550458716
461077,461083,461784,6,701,2,36000,1.00855920114
461081,461099,461104,18,5,1,900,2.3
461089,461115,461202,26,87,14,7980,1.29885057471
461099,461105,461810,6,705,2,36000,1.0085106383
461167,461174,461953,7,779,2,36000,1.00898587933
461200,461612,461617,412,5,1,900,41.7
461207,461213,461300,6,87,14,7980,1.06896551724
461211,461219,462048,8,829,2,36000,1.00965018094
461212,461224,462083,12,859,2,36000,1.01396973225
461228,461235,462074,7,839,2,36000,1.00834326579
461230,461241,462019,11,778,2,36000,1.01413881748
461298,461618,461622,320,4,1,900,32.4
461305,461311,461403,6,92,14,7980,1.0652173913
461311,461317,462109,6,792,2,36000,1.00757575758
461326,461332,462113,6,781,2,36000,1.00768245839
461341,461348,462126,7,778,2,36000,1.00899742931
461357,461364,462090,7,726,2,36000,1.00964187328
461373,461380,462126,7,746,2,36000,1.00938337802
461389,461395,462126,6,731,2,36000,1.00820793434
461390,461401,462126,11,725,2,36000,1.01517241379
461400,461623,461627,223,4,1,900,22.7
461406,461412,462126,6,714,2,36000,1.00840336134
461408,461424,462126,16,702,2,36000,1.02279202279
461408,461418,461504,10,86,14,7980,1.11627906977
461443,461449,462126,6,677,2,36000,1.00886262925
461444,461455,462126,11,671,2,36000,1.01639344262
461446,461461,462126,15,665,2,36000,1.02255639098
461463,461469,462126,6,657,2,36000,1.00913242009
461465,461476,462126,11,650,2,36000,1.01692307692
461481,461487,462126,6,639,2,36000,1.00938967136
461482,461493,462126,11,633,2,36000,1.01737756714
461502,461628,461633,126,5,1,900,13.1
461508,461515,461596,7,81,14,7980,1.08641975309
461526,461532,462126,6,594,2,36000,1.0101010101
461548,461554,462126,6,572,2,36000,1.01048951049
461567,461573,462126,6,553,2,36000,1.01084990958
461583,461589,462126,6,537,2,36000,1.01117318436
461584,461595,462126,11,531,2,36000,1.02071563089
461585,461601,462126,16,525,2,36000,1.03047619048
461595,461640,461643,45,3,1,900,4.8
461601,461633,462126,32,493,2,36000,1.06490872211
461602,461607,461696,5,89,14,7980,1.05617977528
461617,461645,462126,28,481,2,36000,1.05821205821
461618,461650,462126,32,476,2,36000,1.06722689076
461634,461655,462126,21,471,2,36000,1.04458598726
461666,461672,462126,6,454,2,36000,1.01321585903
461681,461687,462126,6,439,2,36000,1.01366742597
461683,461693,462126,10,433,2,36000,1.02309468822
461694,461700,461707,6,7,1,900,1.3
461698,461706,462126,8,420,2,36000,1.01904761905
461700,461711,462126,11,415,2,36000,1.0265060241
461703,461718,461810,15,92,14,7980,1.16304347826
461715,461724,462126,9,402,2,36000,1.0223880597
461786,461793,462126,7,333,2,36000,1.02102102102
461808,461814,462126,6,312,2,36000,1.01923076923
461808,462141,462145,333,4,1,900,33.7
461814,461821,461904,7,83,14,7980,1.0843373494
461823,461830,462126,7,296,2,36000,1.02364864865
461902,462146,462151,244,5,1,900,24.9
461909,461915,462001,6,86,14,7980,1.06976744186
461911,461921,462126,10,205,2,36000,1.0487804878
461955,461961,462126,6,165,2,36000,1.03636363636
461999,462151,462157,152,6,1,900,15.8
462006,462012,462090,6,78,14,7980,1.07692307692
462021,462027,462126,6,99,2,36000,1.06060606061
462049,462055,462126,6,71,2,36000,1.08450704225
462078,462084,462126,6,42,2,36000,1.14285714286
462089,462156,462161,67,5,1,900,7.2
462094,462100,462126,6,26,2,36000,1.23076923077
462095,462112,462126,17,14,2,36000,2.21428571429
462096,462106,462195,10,89,14,7980,1.11235955056
462111,462118,462128,7,10,2,36000,1.7
462194,462200,462205,6,5,1,900,1.1
462201,462207,462297,6,90,14,7980,1.06666666667
462296,462302,462308,6,6,1,900,1.2
462302,462308,462399,6,91,14,7980,1.06593406593
462397,462403,462408,6,5,1,900,1.1
462409,462415,462503,6,88,14,7980,1.06818181818
462431,462437,464529,6,2092,2,36000,1.00286806883
462433,462443,464255,10,1812,2,36000,1.0055187638
462434,462448,464152,14,1704,2,36000,1.00821596244
462435,462453,464436,18,1983,2,36000,1.00907715582
462436,462459,463316,23,857,2,36000,1.0268378063
462438,462465,463875,27,1410,2,36000,1.01914893617
462439,462470,464521,31,2051,2,36000,1.01511457825
462440,462475,464144,35,1669,2,36000,1.0209706411
462442,462480,464241,38,1761,2,36000,1.0215786485
462443,462485,464406,42,1921,2,36000,1.0218636127
462444,462491,464106,47,1615,2,36000,1.02910216718
462446,462496,464088,50,1592,2,36000,1.03140703518
462447,462501,463281,54,780,2,36000,1.06923076923
462448,462506,464331,58,1825,2,36000,1.03178082192
462450,462512,464261,62,1749,2,36000,1.0354488279
462451,462517,463728,66,1211,2,36000,1.05450041288
462452,462522,463448,70,926,2,36000,1.07559395248
462454,462528,463880,74,1352,2,36000,1.05473372781
462455,462533,464940,78,2407,2,36000,1.032405484
462456,462538,464291,82,1753,2,36000,1.04677695379
462458,462544,463803,86,1259,2,36000,1.0683081811
462459,462549,464693,90,2144,2,36000,1.04197761194
462460,462560,464481,100,1921,2,36000,1.05205622072
462462,462565,464187,103,1622,2,36000,1.06350184957
462463,462571,464184,108,1613,2,36000,1.06695598264
462464,462576,463745,112,1169,2,36000,1.09580838323
462465,462581,464213,116,1632,2,36000,1.07107843137
462467,462586,464231,119,1645,2,36000,1.07234042553
462468,462592,464253,124,1661,2,36000,1.074653823
462469,462597,464126,128,1529,2,36000,1.0837148463
462471,462602,463794,131,1192,2,36000,1.10989932886
462472,462607,464641,135,2034,2,36000,1.06637168142
462473,462612,464290,139,1678,2,36000,1.08283671037
462475,462618,464259,143,1641,2,36000,1.08714198659
462476,462623,464052,147,1429,2,36000,1.10286913926
462477,462628,464532,151,1904,2,36000,1.07930672269
462479,462633,464267,154,1634,2,36000,1.09424724602
462480,462639,464565,159,1926,2,36000,1.08255451713
462481,462644,464276,163,1632,2,36000,1.09987745098
462483,462649,464610,166,1961,2,36000,1.08465068842
462484,462654,464346,170,1692,2,36000,1.10047281324
462485,462659,464428,174,1769,2,36000,1.09836065574
462487,462665,464381,178,1716,2,36000,1.10372960373
462488,462670,464455,182,1785,2,36000,1.10196078431
462489,462675,464045,186,1370,2,36000,1.13576642336
462491,462680,464017,189,1337,2,36000,1.14136125654
462492,462685,464334,193,1649,2,36000,1.11704063069
462493,463294,464998,801,1704,2,36000,1.47007042254
462495,463409,465452,914,2043,2,36000,1.44738130201
462496,463459,465396,963,1937,2,36000,1.49716055756
462498,463710,465266,1212,1556,2,36000,1.77892030848
462499,463715,465663,1216,1948,2,36000,1.62422997947
462500,463720,465422,1220,1702,2,36000,1.71680376028
462501,463328,463334,827,6,1,900,83.3
462502,463726,465658,1224,1932,2,36000,1.63354037267
462503,463731,465410,1228,1679,2,36000,1.73138773079
462504,463736,465583,1232,1847,2,36000,1.66702761234
462506,463743,465446,1237,1703,2,36000,1.72636523782
462507,463757,465758,1250,2001,2,36000,1.62468765617
462508,463805,465573,1297,1768,2,36000,1.73359728507
462509,462555,462645,46,90,14,7980,1.51111111111
462509,463814,465856,1305,2042,2,36000,1.63907933399
462511,463891,465781,1380,1890,2,36000,1.73015873016
462512,464028,465868,1516,1840,2,36000,1.82391304348
462513,464056,465055,1543,999,2,36000,2.54454454454
462515,464063,465884,1548,1821,2,36000,1.85008237232
462516,464100,466118,1584,2018,2,36000,1.78493557978
462517,464117,465894,1600,1777,2,36000,1.90039392234
462519,464137,465937,1618,1800,2,36000,1.89888888889
462520,464195,466037,1675,1842,2,36000,1.90933767644
462522,464201,466021,1679,1820,2,36000,1.92252747253
462523,464224,466247,1701,2023,2,36000,1.84083044983
462643,463333,463339,690,6,1,900,69.6
462652,462692,462776,40,84,14,7980,1.47619047619
462774,463345,463352,571,7,1,900,57.8
462781,462787,462878,6,91,14,7980,1.06593406593
462876,463352,463358,476,6,1,900,48.2
462883,462889,462973,6,84,14,7980,1.07142857143
462971,463363,463370,392,7,1,900,39.9
462978,462983,463071,5,88,14,7980,1.05681818182
463070,463369,463374,299,5,1,900,30.4
463076,463082,463175,6,93,14,7980,1.06451612903
463173,463381,463386,208,5,1,900,21.3
463180,463186,463286,6,100,14,7980,1.06
463284,463388,463393,104,5,1,900,10.9
463291,463300,463384,9,84,14,7980,1.10714285714
463383,463402,463407,19,5,1,900,2.4
463389,463396,463484,7,88,14,7980,1.07954545455
463482,463694,463700,212,6,1,900,21.8
463490,463495,463584,5,89,14,7980,1.05617977528
463582,463700,463704,118,4,1,900,12.2
463589,463595,463683,6,88,14,7980,1.06818181818
463681,463705,463710,24,5,1,900,2.9
463690,464535,464625,845,90,14,7980,10.3888888889
463865,465476,555623,1611,90147,2,108000,1.01787081101
464266,464272,465640,6,1368,2,36000,1.00438596491
464280,464287,465675,7,1388,2,36000,1.00504322767
464282,464293,466104,11,1811,2,36000,1.00607399227
464297,464303,465575,6,1272,2,36000,1.00471698113
464298,464309,466124,11,1815,2,36000,1.00606060606
464331,464337,465842,6,1505,2,36000,1.00398671096
464346,464352,466359,6,2007,2,36000,1.00298953662
464347,464359,465636,12,1277,2,36000,1.00939702428
464383,464389,466100,6,1711,2,36000,1.00350672122
464391,465470,471621,1079,6151,32,356400,1.17541863112
464407,464413,466241,6,1828,2,36000,1.00328227571
464431,464437,466911,6,2474,2,36000,1.00242522231
464445,464452,465313,7,861,2,36000,1.0081300813
464460,464466,466408,6,1942,2,36000,1.00308959835
464481,464487,466417,6,1930,2,36000,1.00310880829
464522,464529,466386,7,1857,2,36000,1.00376952073
464538,464544,466632,6,2088,2,36000,1.00287356322
464539,464550,466511,11,1961,2,36000,1.00560938297
464563,464569,466032,6,1463,2,36000,1.004101162
464611,464617,466475,6,1858,2,36000,1.00322927879
464624,464630,464637,6,7,1,900,1.3
464634,465594,465686,960,92,14,7980,11.4347826087
464644,464650,465769,6,1119,2,36000,1.00536193029
464695,464701,466762,6,2061,2,36000,1.00291120815
464939,464945,466815,6,1870,2,36000,1.00320855615
465000,465006,466910,6,1904,2,36000,1.0031512605
465057,465063,466423,6,1360,2,36000,1.00441176471
465268,465274,467188,6,1914,2,36000,1.00313479624
465313,465324,466582,11,1258,2,36000,1.00874403816
465397,465407,466661,10,1254,2,36000,1.00797448166
465412,465457,467259,45,1802,2,36000,1.02497225305
465426,465481,466262,55,781,2,36000,1.07042253521
465447,465486,467545,39,2059,2,36000,1.01894123361
465462,465491,466830,29,1339,2,36000,1.0216579537
465573,465585,466385,12,800,2,36000,1.015
465588,465599,467516,11,1917,2,36000,1.0057381325
465590,465605,467713,15,2108,2,36000,1.00711574953
465638,465648,466689,10,1041,2,36000,1.00960614793
465652,465658,466889,6,1231,2,36000,1.00487408611
465667,465673,467043,6,1370,2,36000,1.00437956204
465668,465679,466583,11,904,2,36000,1.01216814159
465683,465689,466755,6,1066,2,36000,1.00562851782
465683,465697,465703,14,6,1,900,2.0
465694,465714,465777,20,63,14,7980,1.31746031746
465758,465769,467692,11,1923,2,36000,1.00572022881
465773,465780,467694,7,1914,2,36000,1.00365726228
465775,465889,465893,114,4,1,900,11.8
465782,465788,465878,6,90,14,7980,1.06666666667
465787,465794,467627,7,1833,2,36000,1.00381887616
465843,465853,466934,10,1081,2,36000,1.0092506938
465858,465868,467186,10,1318,2,36000,1.00758725341
465873,465879,467657,6,1778,2,36000,1.00337457818
465876,465894,465899,18,5,1,900,2.3
465884,465914,466003,30,89,14,7980,1.33707865169
465887,465900,467840,13,1940,2,36000,1.00670103093
465902,465908,467377,6,1469,2,36000,1.00408441116
465938,465948,467084,10,1136,2,36000,1.0088028169
466001,466273,466278,272,5,1,900,27.7
466007,466014,466105,7,91,14,7980,1.07692307692
466022,466032,467961,10,1929,2,36000,1.00518403318
466037,466043,467818,6,1775,2,36000,1.00338028169
466039,466049,467832,10,1783,2,36000,1.00560852496
466099,466111,466944,12,833,2,36000,1.0144057623
466103,466278,466283,175,5,1,900,18.0
466110,466117,466208,7,91,14,7980,1.07692307692
466114,466123,467586,9,1463,2,36000,1.00615174299
466128,466134,467350,6,1216,2,36000,1.00493421053
466130,466140,467783,10,1643,2,36000,1.00608642727
466205,466290,466295,85,5,1,900,9.0
466212,467125,467216,913,91,14,7980,11.032967033
466241,466253,468056,12,1803,2,36000,1.00665557404
466255,466262,468363,7,2101,2,36000,1.00333174679
466270,466370,468132,100,1762,2,36000,1.05675368899
466362,466396,469047,34,2651,2,36000,1.01282534892
466387,466402,468208,15,1806,2,36000,1.00830564784
466388,466419,467804,31,1385,2,36000,1.02238267148
466410,466428,468275,18,1847,2,36000,1.0097455333
466425,466434,467242,9,808,2,36000,1.01113861386
466427,466485,468236,58,1751,2,36000,1.03312392918
466480,466522,467413,42,891,2,36000,1.04713804714
466514,466593,468591,79,1998,2,36000,1.03953953954
466585,466599,467825,14,1226,2,36000,1.01141924959
466586,466643,468700,57,2057,2,36000,1.02771025766
466634,466673,467904,39,1231,2,36000,1.03168155971
466661,466700,468222,39,1522,2,36000,1.02562417871
466691,466766,468125,75,1359,2,36000,1.05518763797
466757,466773,467724,16,951,2,36000,1.01682439537
466771,466827,468249,56,1422,2,36000,1.03938115331
466817,466841,468766,24,1925,2,36000,1.01246753247
466833,466900,468202,67,1302,2,36000,1.05145929339
466890,466922,468751,32,1829,2,36000,1.0174958994
466911,466927,468799,16,1872,2,36000,1.00854700855
466926,466945,467975,19,1030,2,36000,1.01844660194
466941,466955,468389,14,1434,2,36000,1.00976290098
466955,467095,468540,140,1445,2,36000,1.09688581315
467044,467130,468926,86,1796,2,36000,1.04788418708
467085,467135,468277,50,1142,2,36000,1.04378283713
467123,467227,481765,104,14538,1,14580,1.00715366625
467189,467197,468417,8,1220,2,36000,1.00655737705
467191,467203,468432,12,1229,2,36000,1.0097640358
467213,467232,467238,19,6,1,900,2.5
467222,467557,467794,335,237,14,7980,2.4135021097
467243,467253,469074,10,1821,2,36000,1.00549148819
467260,467270,468500,10,1230,2,36000,1.0081300813
467350,467361,469253,11,1892,2,36000,1.00581395349
467377,467388,468367,11,979,2,36000,1.01123595506
467407,467424,468878,17,1454,2,36000,1.01169188446
467513,467527,469202,14,1675,2,36000,1.00835820896
467546,467597,468489,51,892,2,36000,1.05717488789
467587,467638,469207,51,1569,2,36000,1.03250478011
467630,467668,469011,38,1343,2,36000,1.02829486225
467657,467704,469658,47,1954,2,36000,1.02405322416
467693,467710,469597,17,1887,2,36000,1.00900900901
467708,467724,469544,16,1820,2,36000,1.00879120879
467709,467735,469297,26,1562,2,36000,1.0166453265
467724,467795,469049,71,1254,2,36000,1.05661881978
467784,467815,469320,31,1505,2,36000,1.02059800664
467787,467836,467840,49,4,1,900,5.3
467793,467805,468036,12,231,14,7980,1.05194805195
467804,467830,468729,26,899,2,36000,1.02892102336
467819,467841,469479,22,1638,2,36000,1.01343101343
467834,467847,469643,13,1796,2,36000,1.00723830735
467835,467853,469576,18,1723,2,36000,1.01044689495
467850,467915,469148,65,1233,2,36000,1.05271695053
467904,467972,469248,68,1276,2,36000,1.05329153605
467961,467986,469894,25,1908,2,36000,1.01310272537
467973,468292,534874,319,66582,2,108000,1.00479108468
467976,468067,469844,91,1777,2,36000,1.05120990433
468032,468143,468150,111,7,1,900,11.8
468039,468047,468269,8,222,14,7980,1.03603603604
468057,468136,470107,79,1971,2,36000,1.04008117707
468126,468149,469552,23,1403,2,36000,1.01639344262
468140,468213,469839,73,1626,2,36000,1.04489544895
468203,468219,469221,16,1002,2,36000,1.01596806387
468218,468234,470050,16,1816,2,36000,1.00881057269
468233,468247,470256,14,2009,2,36000,1.00696864111
468248,468260,469075,12,815,2,36000,1.01472392638
468262,468286,469528,24,1242,2,36000,1.0193236715
468266,468272,468278,6,6,1,900,1.2
468273,468280,468517,7,237,14,7980,1.02953586498
468277,468375,469200,98,825,2,36000,1.11878787879
468278,468381,469837,103,1456,2,36000,1.07074175824
468366,468400,469763,34,1363,2,36000,1.02494497432
468367,468429,470067,62,1638,2,36000,1.03785103785
468391,468443,469875,52,1432,2,36000,1.03631284916
468418,468500,469997,82,1497,2,36000,1.0547762191
468433,468511,469568,78,1057,2,36000,1.07379375591
468487,468552,470316,65,1764,2,36000,1.03684807256
468502,468602,470557,100,1955,2,36000,1.05115089514
468514,468520,468530,6,10,1,900,1.6
468522,468528,468791,6,263,14,7980,1.02281368821
468541,468712,469546,171,834,2,36000,1.20503597122
468592,468740,469525,148,785,2,36000,1.18853503185
468683,468813,469977,130,1164,2,86400,1.1116838488
468700,468762,470654,62,1892,2,36000,1.03276955603
468730,468778,470196,48,1418,2,36000,1.03385049365
468751,468802,470638,51,1836,2,36000,1.02777777778
468765,468807,470644,42,1837,2,36000,1.02286336418
468790,468796,468803,6,7,1,900,1.3
468798,471632,471881,2834,249,14,7980,12.3815261044
468801,468819,470599,18,1780,2,36000,1.01011235955
468880,468886,470686,6,1800,2,36000,1.00333333333
468925,468931,470770,6,1839,2,36000,1.00326264274
469013,469020,470865,7,1845,2,36000,1.00379403794
469046,469052,471185,6,2133,2,36000,1.00281293952
469061,469067,470724,6,1657,2,36000,1.00362100181
469076,469082,470689,6,1607,2,36000,1.00373366521
469078,469088,470572,10,1484,2,36000,1.00673854447
469150,469156,470292,6,1136,2,36000,1.00528169014
469201,469208,470919,7,1711,2,36000,1.00409117475
469203,469213,470647,10,1434,2,36000,1.0069735007
469218,469224,471054,6,1830,2,36000,1.00327868852
469232,469238,471143,6,1905,2,36000,1.0031496063
469250,469256,470593,6,1337,2,36000,1.00448765894
469265,469271,470772,6,1501,2,36000,1.00399733511
469298,469304,471164,6,1860,2,36000,1.00322580645
469311,469988,494262,677,24274,4,108000,1.02788992337
469319,469325,470687,6,1362,2,36000,1.00440528634
469482,469488,471294,6,1806,2,36000,1.00332225914
469527,469533,471276,6,1743,2,36000,1.00344234079
469529,469539,471167,10,1628,2,36000,1.00614250614
469544,469550,471430,6,1880,2,36000,1.00319148936
469559,469565,471336,6,1771,2,36000,1.00338791643
469560,469571,471419,11,1848,2,36000,1.00595238095
469575,469581,471307,6,1726,2,36000,1.00347624565
469589,469595,470937,6,1342,2,36000,1.0044709389
469605,469611,471105,6,1494,2,36000,1.00401606426
469616,485688,491230,16072,5542,4,432000,3.90003608805
469644,469651,471558,7,1907,2,36000,1.00367068694
469659,469665,470771,6,1106,2,36000,1.00542495479
469765,469771,471638,6,1867,2,36000,1.00321371184
469837,469843,471687,6,1844,2,36000,1.0032537961
469852,469858,471812,6,1954,2,36000,1.00307062436
469853,469864,471609,11,1745,2,36000,1.00630372493
469877,469883,471713,6,1830,2,36000,1.00327868852
469895,469901,471661,6,1760,2,36000,1.00340909091
469998,470004,471467,6,1463,2,36000,1.004101162
470051,470057,471139,6,1082,2,36000,1.00554528651
470070,470076,471787,6,1711,2,36000,1.00350672122
470110,470116,472057,6,1941,2,36000,1.00309119011
470203,470209,471357,6,1148,2,36000,1.00522648084
470218,485693,500819,15475,15126,4,432000,2.02307285469
470223,470611,477926,388,7315,4,14400,1.05304169515
470259,470265,471929,6,1664,2,36000,1.00360576923
470293,470299,471462,6,1163,2,36000,1.00515907137
470319,470326,470336,7,10,1,300,1.7
470321,470332,471349,11,1017,2,36000,1.01081612586
470386,470392,470404,6,12,1,300,1.5
470421,481771,483711,11350,1940,64,36000,6.85051546392
470426,483722,485656,13296,1934,64,36000,7.87487073423
470467,470474,470478,7,4,1,900,1.1
470560,470566,472522,6,1956,2,36000,1.00306748466
470576,470583,472559,7,1976,2,36000,1.00354251012
470596,470604,472452,8,1848,2,36000,1.00432900433
470616,470622,472509,6,1887,2,36000,1.00317965024
470640,470647,472646,7,1999,2,36000,1.00350175088
470657,470664,472399,7,1735,2,36000,1.00403458213
470659,470671,472495,12,1824,2,36000,1.00657894737
470660,470699,472557,39,1858,2,36000,1.02099031216
470689,470782,484444,93,13662,4,21600,1.00680720246
470691,470706,471785,15,1079,2,36000,1.01390176089
470693,470735,472697,42,1962,2,36000,1.02140672783
470694,470788,472612,94,1824,2,36000,1.05153508772
470727,470794,472617,67,1823,2,36000,1.0367526056
470772,470930,472126,158,1196,2,36000,1.13210702341
470773,470949,472649,176,1700,2,36000,1.10352941176
470791,471066,473019,275,1953,2,36000,1.14080901178
470871,471116,472378,245,1262,2,36000,1.1941362916
470924,471152,472860,228,1708,2,36000,1.13348946136
470941,471159,473074,218,1915,2,36000,1.1138381201
471056,471176,472915,120,1739,2,36000,1.06900517539
471107,471183,472496,76,1313,2,36000,1.05788271135
471140,471288,472520,148,1232,2,36000,1.12012987013
471155,471306,472895,151,1589,2,36000,1.0950283197
471171,471318,473296,147,1978,2,36000,1.07431749242
471172,471348,472238,176,890,2,36000,1.19775280899
471188,471361,472874,173,1513,2,36000,1.11434236616
471278,471369,472626,91,1257,2,36000,1.07239459029
471297,471431,473367,134,1936,2,36000,1.06921487603
471311,471443,473129,132,1686,2,36000,1.07829181495
471335,471474,473363,139,1889,2,36000,1.07358390683
471350,471481,473763,131,2282,2,36000,1.0574057844
471365,471570,473331,205,1761,2,36000,1.11641113004
471423,471621,472845,198,1224,2,36000,1.16176470588
471438,471650,472962,212,1312,2,36000,1.16158536585
471462,471673,473245,211,1572,2,36000,1.13422391858
471477,471698,472812,221,1114,2,36000,1.19838420108
471560,471725,473200,165,1475,2,36000,1.11186440678
471611,471797,473298,186,1501,2,36000,1.12391738841
471638,471803,473510,165,1707,2,36000,1.09666080844
471662,471824,473704,162,1880,2,36000,1.08617021277
471689,471941,473195,252,1254,2,36000,1.2009569378
471713,472068,472905,355,837,2,36000,1.42413381123
471785,472138,474053,353,1915,2,36000,1.18433420366
471801,472250,473421,449,1171,2,36000,1.38343296328
471816,472390,473441,574,1051,2,36000,1.54614652712
471835,485698,593732,13863,108034,2,108000,1.12832071385
471878,471886,471899,8,13,1,900,1.61538461538
471890,471897,471988,7,91,14,7980,1.07692307692
471930,472411,474227,481,1816,2,36000,1.26486784141
471987,471993,471994,6,1,1,900,1.0
472058,472464,474579,406,2115,2,36000,1.19196217494
472128,472507,473638,379,1131,2,36000,1.33510167993
472240,472512,474370,272,1858,2,36000,1.14639397201
472379,472521,474583,142,2062,2,36000,1.06886517944
472400,472532,474502,132,1970,2,36000,1.06700507614
472454,472540,474368,86,1828,2,36000,1.04704595186
472496,472569,473577,73,1008,2,36000,1.07242063492
472497,472576,474413,79,1837,2,36000,1.04300489929
472512,472623,473461,111,838,2,36000,1.13245823389
472528,472631,474475,103,1844,2,36000,1.05585683297
472529,472637,474417,108,1780,2,36000,1.0606741573
472559,472658,474646,99,1988,2,36000,1.04979879276
472560,472666,474073,106,1407,2,36000,1.07533759773
472615,472710,473649,95,939,2,36000,1.101171459
472616,472824,474744,208,1920,2,36000,1.10833333333
472631,472857,474595,226,1738,2,36000,1.13003452244
472646,472872,474597,226,1725,2,36000,1.13101449275
472661,472885,474336,224,1451,2,36000,1.15437629221
472697,472908,474331,211,1423,2,36000,1.14827828531
472815,472917,474889,102,1972,2,36000,1.05172413793
472845,472928,473797,83,869,2,36000,1.09551208285
472860,472974,474763,114,1789,2,36000,1.06372275014
472878,473031,474551,153,1520,2,36000,1.10065789474
472899,473086,474781,187,1695,2,36000,1.11032448378
472913,473141,474906,228,1765,2,36000,1.12917847025
472928,473208,475015,280,1807,2,36000,1.15495296071
472964,473215,474679,251,1464,2,36000,1.17144808743
473021,473256,474266,235,1010,2,36000,1.23267326733
473077,473309,474922,232,1613,2,36000,1.14383137012
473133,473316,474193,183,877,2,36000,1.2086659065
473197,473343,474472,146,1129,2,36000,1.12931798051
473211,473375,475313,164,1938,2,36000,1.08462332301
473247,473382,474930,135,1548,2,36000,1.08720930233
473298,473434,474822,136,1388,2,36000,1.09798270893
473300,473452,475294,152,1842,2,36000,1.08251900109
473330,473473,475314,143,1841,2,36000,1.07767517653
473366,473523,475383,157,1860,2,36000,1.08440860215
473380,473589,475226,209,1637,2,36000,1.12767257178
473422,473650,475740,228,2090,2,36000,1.10909090909
473444,473660,474589,216,929,2,36000,1.2325080732
473462,473716,475749,254,2033,2,36000,1.12493851451
473513,473776,475703,263,1927,2,36000,1.13648157758
473580,473809,474639,229,830,2,36000,1.27590361446
473640,474064,475065,424,1001,2,36000,1.42357642358
473655,474085,475870,430,1785,2,36000,1.24089635854
473706,474205,475333,499,1128,2,36000,1.44237588652
473764,474239,475645,475,1406,2,36000,1.33783783784
473800,474277,476147,477,1870,2,36000,1.2550802139
474053,474343,476359,290,2016,2,36000,1.14384920635
474074,474349,476140,275,1791,2,36000,1.1535455053
474191,474381,475449,190,1068,2,36000,1.17790262172
474227,474387,476086,160,1699,2,36000,1.09417304297
474266,474424,476344,158,1920,2,36000,1.08229166667
474332,474431,475540,99,1109,2,36000,1.08926961226
474347,474484,476012,137,1528,2,36000,1.08965968586
474368,474490,476380,122,1890,2,36000,1.06455026455
474383,474514,476068,131,1554,2,36000,1.0842985843
474413,474563,476435,150,1872,2,36000,1.08012820513
474427,474591,476306,164,1715,2,36000,1.09562682216
474472,474597,476664,125,2067,2,36000,1.06047411708
474487,474605,476094,118,1489,2,36000,1.07924781733
474502,474612,476144,110,1532,2,36000,1.07180156658
474553,474617,476616,64,1999,2,36000,1.032016008
474580,474652,476139,72,1487,2,36000,1.04841963685
474595,474658,476751,63,2093,2,36000,1.03010033445
474596,474691,476574,95,1883,2,36000,1.05045140733
474611,474756,476463,145,1707,2,36000,1.08494434681
474612,474776,476138,164,1362,2,36000,1.12041116006
474639,474792,476850,153,2058,2,36000,1.07434402332
474654,474834,476495,180,1661,2,36000,1.10836845274
474681,474901,476741,220,1840,2,36000,1.11956521739
474744,474918,476214,174,1296,2,36000,1.13425925926
474765,474934,476678,169,1744,2,36000,1.09690366972
474783,474942,476821,159,1879,2,36000,1.08461947845
474822,475026,476122,204,1096,2,36000,1.18613138686
474884,474890,475476,6,586,12,3600,1.01023890785
474891,475077,476878,186,1801,2,36000,1.1032759578
474909,475238,476535,329,1297,2,36000,1.25366229761
474923,475306,477133,383,1827,2,36000,1.2096332786
474938,475326,477383,388,2057,2,36000,1.18862421001
475017,475332,477374,315,2042,2,36000,1.15426052889
475065,475345,477229,280,1884,2,36000,1.14861995754
475227,475394,477154,167,1760,2,36000,1.09488636364
475294,475460,476893,166,1433,2,36000,1.11584089323
475315,475552,477388,237,1836,2,36000,1.12908496732
475316,475662,477476,346,1814,2,36000,1.19073869901
475334,475715,477335,381,1620,2,36000,1.23518518519
475382,475752,477550,370,1798,2,36000,1.20578420467
475451,475760,477552,309,1792,2,36000,1.17243303571
475490,485667,489904,10177,4237,12,32400,3.4019353316
475542,475882,477698,340,1816,2,36000,1.1872246696
475647,476023,477838,376,1815,2,36000,1.20716253444
475650,475656,477485,6,1829,12,1800,1.00328048114
475704,476080,478076,376,1996,2,36000,1.18837675351
475741,476098,477246,357,1148,2,36000,1.31097560976
475756,476105,478054,349,1949,2,36000,1.17906618779
475874,476134,476959,260,825,2,36000,1.31515151515
476014,476150,477363,136,1213,2,36000,1.11211871393
476070,476156,477948,86,1792,2,36000,1.04799107143
476089,476163,477893,74,1730,2,36000,1.04277456647
476106,476168,478025,62,1857,2,36000,1.03338718363
476123,476173,477918,50,1745,2,36000,1.02865329513
476140,476226,477922,86,1696,2,36000,1.05070754717
476141,476317,478249,176,1932,2,36000,1.09109730849
476159,476356,477146,197,790,2,36000,1.24936708861
476160,476372,478324,212,1952,2,36000,1.10860655738
476161,476392,478307,231,1915,2,36000,1.12062663185
476217,476447,477803,230,1356,2,36000,1.16961651917
476307,476475,478291,168,1816,2,36000,1.09251101322
476343,476508,478480,165,1972,2,36000,1.08367139959
476361,476547,478132,186,1585,2,36000,1.11735015773
476379,476585,477663,206,1078,2,36000,1.19109461967
476437,476628,479075,191,2447,2,36000,1.07805476093
476464,476677,478745,213,2068,2,36000,1.10299806576
476497,476689,478036,192,1347,2,36000,1.1425389755
476536,476754,478479,218,1725,2,36000,1.12637681159
476575,476763,477991,188,1228,2,36000,1.15309446254
476617,476834,478682,217,1848,2,36000,1.11742424242
476665,476862,477812,197,950,2,36000,1.20736842105
476680,476890,477844,210,954,2,36000,1.22012578616
476743,476905,477845,162,940,2,36000,1.17234042553
476757,476970,477946,213,976,2,36000,1.21823770492
476823,477144,478823,321,1679,2,36000,1.1911852293
476850,477158,478896,308,1738,2,36000,1.17721518987
476880,477166,478641,286,1475,2,36000,1.19389830508
476895,477242,478879,347,1637,2,36000,1.21197312156
476962,477259,478747,297,1488,2,36000,1.19959677419
477134,477348,478980,214,1632,2,36000,1.13112745098
477149,477375,478229,226,854,2,36000,1.26463700234
477163,477386,478252,223,866,2,36000,1.25750577367
477230,477395,478571,165,1176,2,36000,1.14030612245
477248,477402,479153,154,1751,2,36000,1.087949743
477311,485683,490209,8372,4526,17,18000,2.84975695979
477335,477488,479216,153,1728,2,36000,1.08854166667
477365,477562,479438,197,1876,2,36000,1.10501066098
477380,477569,479677,189,2108,2,36000,1.08965844402
477395,477674,479216,279,1542,2,36000,1.18093385214
477396,477710,478891,314,1181,2,36000,1.26587637595
477478,477814,479199,336,1385,2,36000,1.24259927798
477550,477824,478631,274,807,2,36000,1.3395291202
477564,477850,479673,286,1823,2,36000,1.15688425672
477664,477857,479432,193,1575,2,36000,1.12253968254
477700,477862,479557,162,1695,2,36000,1.09557522124
477805,477906,479710,101,1804,2,36000,1.05598669623
477820,477930,479959,110,2029,2,36000,1.05421389847
477838,477936,479716,98,1780,2,36000,1.05505617978
477853,477958,479111,105,1153,2,36000,1.09106678231
477854,477966,479096,112,1130,2,36000,1.09911504425
477893,478003,479498,110,1495,2,36000,1.07357859532
477920,478036,480160,116,2124,2,36000,1.05461393597
477935,478048,479565,113,1517,2,36000,1.07448912327
477950,478065,479789,115,1724,2,36000,1.06670533643
477951,478087,479349,136,1262,2,36000,1.10776545166
477990,478144,479483,154,1339,2,36000,1.11501120239
478027,478240,480011,213,1771,2,36000,1.12027103331
478041,478261,479099,220,838,2,36000,1.26252983294
478056,478267,479869,211,1602,2,36000,1.13171036205
478077,478302,479778,225,1476,2,36000,1.15243902439
478134,478318,480122,184,1804,2,36000,1.10199556541
478230,478337,480354,107,2017,2,36000,1.0530490828
478248,478491,479833,243,1342,2,36000,1.18107302534
478263,478498,480352,235,1854,2,36000,1.12675296656
478293,478583,480409,290,1826,2,36000,1.15881708653
478308,478643,479610,335,967,2,36000,1.34643226474
478326,478652,480300,326,1648,2,36000,1.19781553398
478480,478694,480516,214,1822,2,36000,1.11745334797
478481,478757,480649,276,1892,2,36000,1.14587737844
478571,478764,479583,193,819,2,36000,1.23565323565
478623,486308,486318,7685,10,4,21600,769.5
478631,478835,480593,204,1758,2,36000,1.11604095563
478646,478891,480719,245,1828,2,36000,1.13402625821
478682,478903,479732,221,829,2,36000,1.26658624849
478745,478910,479774,165,864,2,36000,1.19097222222
478747,478993,480952,246,1959,2,36000,1.12557427259
478825,479087,480156,262,1069,2,36000,1.2450888681
478879,479108,480846,229,1738,2,36000,1.13176064442
478894,479115,480999,221,1884,2,36000,1.11730360934
478909,479123,480922,214,1799,2,36000,1.11895497499
478981,479166,480589,185,1423,2,36000,1.13000702741
479077,479211,481064,134,1853,2,36000,1.0723151646
479098,479228,480963,130,1735,2,36000,1.07492795389
479099,479233,481052,134,1819,2,36000,1.07366684992
479114,479361,480686,247,1325,2,36000,1.18641509434
479153,479444,481472,291,2028,2,36000,1.14349112426
479201,479451,480550,250,1099,2,36000,1.22747952684
479216,479494,481483,278,1989,2,36000,1.139768728
479217,479511,481122,294,1611,2,36000,1.18249534451
479350,479568,481259,218,1691,2,36000,1.12891780012
479435,479577,481354,142,1777,2,36000,1.07990996061
479449,479595,481417,146,1822,2,36000,1.08013172338
479482,479622,481901,140,2279,2,36000,1.06143045195
479500,479685,481399,185,1714,2,36000,1.10793465578
479560,479692,481522,132,1830,2,36000,1.07213114754
479575,479722,481351,147,1629,2,36000,1.09023941068
479589,479729,481701,140,1972,2,36000,1.07099391481
479610,479745,481350,135,1605,2,36000,1.08411214953
479674,479787,481575,113,1788,2,36000,1.06319910515
479688,479793,481678,105,1885,2,36000,1.05570291777
479709,479802,481848,93,2046,2,36000,1.04545454545
479724,479845,481079,121,1234,2,36000,1.09805510535
479739,479880,481812,141,1932,2,36000,1.07298136646
479775,479971,481838,196,1867,2,36000,1.10498125335
479793,480024,481906,231,1882,2,36000,1.12274176408
479794,480133,481956,339,1823,2,36000,1.18595721338
479833,480168,481035,335,867,2,36000,1.38638985006
479869,480175,481477,306,1302,2,36000,1.23502304147
479960,480311,482191,351,1880,2,36000,1.18670212766
480011,480364,482417,353,2053,2,36000,1.17194349732
480123,480371,482414,248,2043,2,36000,1.12139011258
480156,480422,482310,266,1888,2,36000,1.14088983051
480171,480529,482488,358,1959,2,36000,1.18274629913
480301,480563,482363,262,1800,2,36000,1.14555555556
480352,480600,482742,248,2142,2,36000,1.11577964519
480367,480607,482000,240,1393,2,36000,1.17229002154
480412,480661,482450,249,1789,2,36000,1.13918390162
480517,480698,481894,181,1196,2,36000,1.15133779264
480550,480730,482694,180,1964,2,36000,1.0916496945
480589,480859,482165,270,1306,2,36000,1.2067381317
480604,480934,482589,330,1655,2,36000,1.19939577039
480652,480964,482924,312,1960,2,36000,1.15918367347
480685,480975,482086,290,1111,2,36000,1.26102610261
480720,481011,482833,291,1822,2,36000,1.15971459934
480729,480737,480953,8,216,1,180,1.03703703704
480849,481046,482233,197,1187,2,36000,1.16596461668
480922,481064,482841,142,1777,2,36000,1.07990996061
480951,481081,482920,130,1839,2,36000,1.07069059271
480966,481092,483050,126,1958,2,36000,1.06435137896
480999,481134,482387,135,1253,2,36000,1.10774142059
481035,481270,483119,235,1849,2,36000,1.12709572742
481053,481362,483073,309,1711,2,36000,1.18059614261
481068,481367,483110,299,1743,2,36000,1.17154331612
481069,481075,481268,6,193,1,180,1.0310880829
481083,481374,483371,291,1997,2,36000,1.14571857787
481122,481410,482675,288,1265,2,36000,1.22766798419
481258,481429,483292,171,1863,2,36000,1.09178743961
481352,481484,483113,132,1629,2,36000,1.08103130755
481353,481491,483066,138,1575,2,36000,1.08761904762
481368,481497,483347,129,1850,2,36000,1.06972972973
481401,481534,482568,133,1034,2,36000,1.12862669246
481418,481587,483692,169,2105,2,36000,1.08028503563
481472,481691,483214,219,1523,2,36000,1.14379514117
481487,481713,482830,226,1117,2,36000,1.20232766338
481488,481823,483144,335,1321,2,36000,1.25359576079
481524,481850,483496,326,1646,2,36000,1.19805589307
481575,481859,483651,284,1792,2,36000,1.15848214286
481681,481906,483526,225,1620,2,36000,1.13888888889
481703,481913,483720,210,1807,2,36000,1.11621472053
481812,481921,483893,109,1972,2,36000,1.05527383367
481839,481967,484042,128,2075,2,36000,1.06168674699
481854,482012,483751,158,1739,2,36000,1.09085681426
481896,482097,483796,201,1699,2,36000,1.11830488523
481911,482178,483393,267,1215,2,36000,1.21975308642
481912,482203,483929,291,1726,2,36000,1.16859791425
481957,482244,484102,287,1858,2,36000,1.154467169
481970,485678,488160,3708,2482,12,3600,2.4939564867
481989,485709,485710,3720,1,1,21600,372.1
481999,482322,484184,323,1862,2,36000,1.17346938776
482086,482376,484133,290,1757,2,36000,1.16505406944
482167,482399,484306,232,1907,2,36000,1.12165705296
482191,482426,483855,235,1429,2,36000,1.1644506648
482233,482433,483839,200,1406,2,36000,1.14224751067
482311,482461,484222,150,1761,2,36000,1.08517887564
482325,489093,595559,6768,106466,2,432000,1.06356959029
482365,482500,484037,135,1537,2,36000,1.08783344177
482389,482579,484668,190,2089,2,36000,1.0909526089
482413,482601,483943,188,1342,2,36000,1.14008941878
482428,482686,484464,258,1778,2,36000,1.14510686164
482452,482705,484517,253,1812,2,36000,1.13962472406
482487,482753,484707,266,1954,2,36000,1.13613101331
482569,482841,484632,272,1791,2,36000,1.15187046343
482589,482848,484770,259,1922,2,36000,1.13475546306
482677,482856,484675,179,1819,2,36000,1.09840571743
482695,482931,484416,236,1485,2,36000,1.15892255892
482742,482939,484744,197,1805,2,36000,1.10914127424
482829,483061,484861,232,1800,2,36000,1.12888888889
482844,483078,485028,234,1950,2,36000,1.12
482846,483085,484866,239,1781,2,36000,1.13419427288
482921,483122,484237,201,1115,2,36000,1.1802690583
482936,483128,483979,192,851,2,36000,1.22561692127
483050,483135,485003,85,1868,2,36000,1.04550321199
483068,483156,485016,88,1860,2,36000,1.04731182796
483083,483227,484393,144,1166,2,36000,1.12349914237
483113,483303,485114,190,1811,2,36000,1.10491441193
483114,483358,485442,244,2084,2,36000,1.11708253359
483129,483383,484602,254,1219,2,36000,1.20836751436
483144,483405,484712,261,1307,2,36000,1.19969395562
483216,483507,485594,291,2087,2,36000,1.13943459511
483294,483538,485243,244,1705,2,36000,1.1431085044
483348,483663,485535,315,1872,2,36000,1.16826923077
483372,483705,484960,333,1255,2,36000,1.26533864542
483393,483732,485665,339,1933,2,36000,1.17537506467
483499,483762,484619,263,857,2,36000,1.30688448075
483526,483809,485494,283,1685,2,36000,1.16795252226
483652,483852,485823,200,1971,2,36000,1.10147133435
483694,483866,485839,172,1973,2,36000,1.08717688799
483721,483905,485532,184,1627,2,36000,1.11309157959
483751,483941,485877,190,1936,2,36000,1.09814049587
483796,483956,485319,160,1363,2,36000,1.11738811445
483841,483990,485507,149,1517,2,36000,1.09822017139
483856,484049,484898,193,849,2,36000,1.2273262662
483862,485672,1090490,1810,604818,14,604800,1.0029926358
483895,484055,485967,160,1912,2,36000,1.08368200837
483931,484114,486268,183,2154,2,36000,1.08495821727
483946,484146,486158,200,2012,2,36000,1.09940357853
483982,484197,486006,215,1809,2,36000,1.11885019348
484039,484234,485845,195,1611,2,36000,1.12104283054
484054,484248,486018,194,1770,2,36000,1.10960451977
484102,484317,485479,215,1162,2,36000,1.18502581756
484135,484404,486323,269,1919,2,36000,1.14017717561
484185,484429,486237,244,1808,2,36000,1.13495575221
484224,484475,486061,251,1586,2,36000,1.15825977301
484239,484528,486412,289,1884,2,36000,1.1533970276
484305,484615,485968,310,1353,2,36000,1.22912047302
484393,484631,486672,238,2041,2,36000,1.11660950514
484417,484643,486192,226,1549,2,36000,1.14590058102
484465,484679,485763,214,1084,2,36000,1.19741697417
484519,484686,485468,167,782,2,36000,1.21355498721
484603,484718,485923,115,1205,2,36000,1.09543568465
484621,484725,486499,104,1774,2,36000,1.05862457723
484635,484756,486472,121,1716,2,36000,1.07051282051
484669,484781,486614,112,1833,2,36000,1.06110201855
484683,484873,486065,190,1192,2,36000,1.15939597315
484708,484879,486653,171,1774,2,36000,1.09639233371
484723,484910,486775,187,1865,2,36000,1.10026809651
484744,484973,486702,229,1729,2,36000,1.13244650087
484771,485015,486736,244,1721,2,36000,1.14177803603
484861,485027,486020,166,993,2,36000,1.16717019134
484876,485039,486969,163,1930,2,36000,1.08445595855
484883,485704,590905,821,105201,2,108000,1.00780410833
484897,485126,486815,229,1689,2,36000,1.13558318532
484963,485255,486980,292,1725,2,36000,1.16927536232
485005,485330,486996,325,1666,2,36000,1.19507803121
485019,485454,487508,435,2054,2,36000,1.211781889
485034,485480,486714,446,1234,2,36000,1.36142625608
485116,485492,486537,376,1045,2,36000,1.35980861244
485245,485506,487408,261,1902,2,36000,1.13722397476
485320,485520,487495,200,1975,2,36000,1.10126582278
485444,485544,487293,100,1749,2,36000,1.05717552887
485471,485550,486727,79,1177,2,36000,1.06711979609
485486,485605,487600,119,1995,2,36000,1.05964912281
485500,485715,486864,215,1149,2,36000,1.18711923412
485515,485775,487640,260,1865,2,36000,1.13941018767
485533,485834,487681,301,1847,2,36000,1.16296697347
485548,485851,487806,303,1955,2,36000,1.15498721228
485593,485858,487897,265,2039,2,36000,1.12996566945
485665,485888,487803,223,1915,2,36000,1.11644908616
485766,485935,487591,169,1656,2,36000,1.1020531401
485830,485978,487931,148,1953,2,36000,1.07578084997
485848,485985,487736,137,1751,2,36000,1.07824100514
485850,486017,487835,167,1818,2,36000,1.09185918592
485881,486029,486994,148,965,2,36000,1.15336787565
485925,486035,487932,110,1897,2,36000,1.05798629415
485976,486072,487565,96,1493,2,36000,1.06430006698
485977,486079,488066,102,1987,2,36000,1.05133366885
486011,486170,487109,159,939,2,36000,1.16932907348
486029,486203,488028,174,1825,2,36000,1.09534246575
486030,486248,487283,218,1035,2,36000,1.21062801932
486063,486279,488546,216,2267,2,36000,1.09528010587
486079,486314,488168,235,1854,2,36000,1.12675296656
486159,486319,487747,160,1428,2,36000,1.11204481793
486192,486330,487177,138,847,2,36000,1.16292798111
486237,486335,488087,98,1752,2,36000,1.05593607306
486270,486341,488169,71,1828,2,36000,1.03884026258
486324,486423,487761,99,1338,2,36000,1.07399103139
486415,486484,488216,69,1732,2,36000,1.03983833718
486475,486511,488563,36,2052,2,36000,1.01754385965
486499,486549,488414,50,1865,2,36000,1.02680965147
486538,486626,487589,88,963,2,36000,1.09138110073
486617,486664,488456,47,1792,2,36000,1.02622767857
486653,486683,488614,30,1931,2,36000,1.01553599171
486671,486713,488590,42,1877,2,36000,1.02237613213
486704,486725,488554,21,1829,2,36000,1.01148168398
486719,486738,488646,19,1908,2,36000,1.00995807128
486733,486748,488479,15,1731,2,36000,1.00866551127
486749,486786,488190,37,1404,2,36000,1.02635327635
486777,486826,488615,49,1789,2,36000,1.02738960313
486819,486876,488566,57,1690,2,36000,1.03372781065
486864,486981,487921,117,940,2,36000,1.12446808511
486969,486992,488111,23,1119,2,36000,1.02055406613
486984,487005,488971,21,1966,2,36000,1.01068158698
486999,487011,488457,12,1446,2,36000,1.00829875519
487001,487121,488299,120,1178,2,36000,1.10186757216
487109,487188,488969,79,1781,2,36000,1.04435710275
487175,487295,489383,120,2088,2,36000,1.05747126437
487214,487758,595787,544,108029,2,108000,1.00503568486
487218,489916,835549,2698,345633,4,345600,1.0078059676
487284,487305,488995,21,1690,2,36000,1.0124260355
487299,487420,488845,121,1425,2,36000,1.0849122807
487407,487507,489598,100,2091,2,36000,1.04782400765
487498,487518,489453,20,1935,2,36000,1.01033591731
487513,487576,489411,63,1835,2,36000,1.03433242507
487567,487600,489442,33,1842,2,36000,1.01791530945
487591,487607,489434,16,1827,2,36000,1.008757526
487606,487613,489528,7,1915,2,36000,1.00365535248
487607,487651,489117,44,1466,2,36000,1.03001364256
487640,487692,489620,52,1928,2,36000,1.02697095436
487682,487747,489317,65,1570,2,36000,1.04140127389
487736,487772,489405,36,1633,2,36000,1.02204531537
487751,487814,489733,63,1919,2,36000,1.03282959875
487766,487821,489738,55,1917,2,36000,1.02869066249
487805,487846,488733,41,887,2,36000,1.04622322435
487806,487908,489707,102,1799,2,36000,1.05669816565
487836,487932,489952,96,2020,2,36000,1.04752475248
487839,489088,496240,1249,7152,4,14400,1.17463646532
487856,487862,487868,6,6,1,576000,1.2
487896,487942,489941,46,1999,2,36000,1.02301150575
487923,487948,489747,25,1799,2,36000,1.01389660923
487938,488039,489164,101,1125,2,36000,1.08977777778
487939,488077,489322,138,1245,2,36000,1.11084337349
487963,487969,497246,6,9277,1,576000,1.00064676081
488030,488099,489938,69,1839,2,36000,1.03752039152
488066,488122,489143,56,1021,2,36000,1.05484818805
488087,488180,489039,93,859,2,36000,1.10826542491
488111,488185,489505,74,1320,2,36000,1.05606060606
488165,488201,489231,36,1030,2,36000,1.03495145631
488167,488227,489990,60,1763,2,36000,1.03403289847
488190,488310,489407,120,1097,2,36000,1.10938924339
488199,488981,490963,782,1982,1,10800,1.39455095863
488217,488425,490212,208,1787,2,36000,1.11639619474
488298,488467,490351,169,1884,2,36000,1.08970276008
488416,488474,490412,58,1938,2,36000,1.02992776058
488458,488491,489992,33,1501,2,36000,1.0219853431
488460,488558,490282,98,1724,2,36000,1.05684454756
488480,488565,490363,85,1798,2,36000,1.04727474972
488547,488574,490277,27,1703,2,36000,1.01585437463
488562,488580,490412,18,1832,2,36000,1.00982532751
488563,488601,490657,38,2056,2,36000,1.01848249027
488578,488626,490665,48,2039,2,36000,1.02354095145
488592,488631,490332,39,1701,2,36000,1.02292768959
488621,488657,490372,36,1715,2,36000,1.02099125364
488622,488744,490362,122,1618,2,36000,1.07540173053
488646,488856,490615,210,1759,2,36000,1.11938601478
488733,488988,490814,255,1826,2,36000,1.13964950712
488845,489006,490676,161,1670,2,36000,1.09640718563
488969,489050,491123,81,2073,2,36000,1.03907380608
488971,489072,490967,101,1895,2,36000,1.05329815303
488995,489077,490781,82,1704,2,36000,1.04812206573
489040,489083,490683,43,1600,2,36000,1.026875
489118,489128,490704,10,1576,2,36000,1.00634517766
489123,489921,499989,798,10068,1,21600,1.07926102503
489145,489154,490790,9,1636,2,36000,1.00550122249
489166,489175,490976,9,1801,2,36000,1.00499722376
489232,489243,490098,11,855,2,36000,1.01286549708
489317,489328,490974,11,1646,2,36000,1.00668286756
489331,489337,491054,6,1717,2,36000,1.00349446709
489386,489395,491337,9,1942,2,36000,1.00463439753
489407,489417,490780,10,1363,2,36000,1.00733675715
489408,489424,491365,16,1941,2,36000,1.00824317362
489423,489430,491280,7,1850,2,36000,1.00378378378
489437,489446,491299,9,1853,2,36000,1.00485698867
489452,489458,491379,6,1921,2,36000,1.00312337324
489453,489464,490472,11,1008,2,36000,1.01091269841
489505,489516,491338,11,1822,2,36000,1.00603732162
489529,489540,491532,11,1992,2,36000,1.00552208835
489599,489609,491146,10,1537,2,36000,1.00650618087
489620,489631,490789,11,1158,2,36000,1.00949913644
489707,489719,491523,12,1804,2,36000,1.0066518847
489734,489744,491668,10,1924,2,36000,1.0051975052
489749,489755,490930,6,1175,2,36000,1.00510638298
489750,489761,490846,11,1085,2,36000,1.01013824885
489937,489944,491628,7,1684,2,36000,1.0041567696
489953,489959,491807,6,1848,2,36000,1.00324675325
489954,489965,491834,11,1869,2,36000,1.00588550027
489990,489997,491884,7,1887,2,36000,1.00370959194
489992,490002,491840,10,1838,2,36000,1.00544069641
490097,490103,491769,6,1666,2,36000,1.00360144058
490193,491121,491773,928,652,17,18000,2.42331288344
490212,490218,492156,6,1938,2,36000,1.00309597523
490278,490284,492058,6,1774,2,36000,1.00338218715
490293,490299,491929,6,1630,2,36000,1.0036809816
490335,490341,492219,6,1878,2,36000,1.00319488818
490353,490359,492188,6,1829,2,36000,1.00328048114
490368,490374,492254,6,1880,2,36000,1.00319148936
490369,490380,492038,11,1658,2,36000,1.0066344994
490384,490390,492088,6,1698,2,36000,1.0035335689
490411,490417,491867,6,1450,2,36000,1.00413793103
490426,490432,492271,6,1839,2,36000,1.00326264274
490474,490480,492228,6,1748,2,36000,1.00343249428
490616,490622,492697,6,2075,2,36000,1.00289156627
490658,490664,492280,6,1616,2,36000,1.00371287129
490673,490679,492526,6,1847,2,36000,1.0032485111
490688,490694,492345,6,1651,2,36000,1.00363416111
490689,490700,491836,11,1136,2,36000,1.00968309859
490707,490713,492620,6,1907,2,36000,1.00314630309
490782,490788,492566,6,1778,2,36000,1.00337457818
490783,490794,492402,11,1608,2,36000,1.00684079602
490791,490974,574238,183,83264,2,108000,1.00219782859
490798,490804,492564,6,1760,2,36000,1.00340909091
490800,490810,492532,10,1722,2,36000,1.00580720093
490815,490821,492282,6,1461,2,36000,1.00410677618
490848,490854,492688,6,1834,2,36000,1.00327153762
490859,491126,492704,267,1578,1,18000,1.16920152091
490872,490879,491040,7,161,1,7200,1.04347826087
490932,490938,492753,6,1815,2,36000,1.00330578512
490968,490979,491826,11,847,2,36000,1.01298701299
490983,490989,492358,6,1369,2,36000,1.00438276114
490985,490995,492960,10,1965,2,36000,1.00508905852
491054,491065,492878,11,1813,2,36000,1.00606729178
491123,491132,492437,9,1305,2,36000,1.00689655172
491147,491153,492983,6,1830,2,36000,1.00327868852
491228,491234,492360,6,1126,1,86400,1.0053285968
491279,491286,493101,7,1815,2,36000,1.00385674931
491300,491307,493310,7,2003,2,36000,1.00349475786
491340,491346,493195,6,1849,2,36000,1.0032449973
491341,491352,493205,11,1853,2,36000,1.00593631948
491349,491639,491715,290,76,1,3600,4.81578947368
491365,491371,493489,6,2118,2,36000,1.00283286119
491380,491387,493382,7,1995,2,36000,1.00350877193
491519,491525,493434,6,1909,2,36000,1.00314300681
491534,491540,493477,6,1937,2,36000,1.00309757357
491625,491631,493258,6,1627,2,36000,1.0036877689
491667,491673,493381,6,1708,2,36000,1.00351288056
491769,491776,493536,7,1760,2,36000,1.00397727273
491809,491815,493509,6,1694,2,36000,1.00354191263
491827,491833,493068,6,1235,2,36000,1.0048582996
491835,491841,562047,6,70206,2,108000,1.00008546278
491842,491848,493264,6,1416,2,36000,1.00423728814
491843,491854,493801,11,1947,2,36000,1.00564971751
491845,491859,493985,14,2126,2,36000,1.00658513641
491866,491872,493669,6,1797,2,36000,1.00333889816
491883,491890,493869,7,1979,2,36000,1.00353713997
491931,491938,493372,7,1434,2,36000,1.00488145049
492040,492046,493873,6,1827,2,36000,1.00328407225
492058,492064,493916,6,1852,2,36000,1.00323974082
492087,492094,493839,7,1745,2,36000,1.00401146132
492157,492163,494056,6,1893,2,36000,1.00316957211
492189,492196,494186,7,1990,2,36000,1.00351758794
492220,492226,494472,6,2246,2,36000,1.00267141585
492235,492241,493959,6,1718,2,36000,1.00349243306
492256,492262,494063,6,1801,2,36000,1.00333148251
492274,492280,493535,6,1255,2,36000,1.00478087649
492289,492295,494022,6,1727,2,36000,1.00347423277
492290,492301,493610,11,1309,2,36000,1.00840336134
492314,492374,492529,60,155,1,1200,1.38709677419
492347,492353,494107,6,1754,2,36000,1.00342075257
492362,492368,494109,6,1741,2,36000,1.00344629523
492398,492449,497046,51,4597,1,86400,1.01109419186
492404,492410,494272,6,1862,2,36000,1.00322234157
492437,492443,494449,6,2006,2,36000,1.00299102692
492527,492533,494293,6,1760,2,36000,1.00340909091
492542,492548,494291,6,1743,2,36000,1.00344234079
492566,492572,494767,6,2195,2,36000,1.00273348519
492568,492578,494432,10,1854,2,36000,1.00539374326
492621,492628,493428,7,800,2,36000,1.00875
492688,492694,494429,6,1735,2,36000,1.00345821326
492702,492708,494751,6,2043,2,36000,1.00293685756
492754,492760,494183,6,1423,2,36000,1.00421644413
492871,492877,510904,6,18027,20,18000,1.00033283408
492877,492883,494742,6,1859,2,36000,1.00322754169
492877,496958,514966,4081,18008,20,18000,1.22662150155
492962,492968,494822,6,1854,2,36000,1.00323624595
492983,492989,494754,6,1765,2,36000,1.00339943343
493070,493076,494979,6,1903,2,36000,1.00315291645
493103,493109,494368,6,1259,2,36000,1.00476568705
493196,493203,495266,7,2063,2,36000,1.00339311682
493211,493217,495265,6,2048,2,36000,1.0029296875
493260,493266,495048,6,1782,2,36000,1.00336700337
493275,493281,495235,6,1954,2,36000,1.00307062436
493311,493317,495485,6,2168,2,36000,1.00276752768
493374,493380,495104,6,1724,2,36000,1.00348027842
493389,493395,494859,6,1464,2,36000,1.00409836066
493390,493401,494800,11,1399,2,36000,1.00786275911
493429,493435,495319,6,1884,2,36000,1.00318471338
493444,493450,495177,6,1727,2,36000,1.00347423277
493477,493484,495652,7,2168,2,36000,1.00322878229
493494,493500,494960,6,1460,2,36000,1.00410958904
493509,493515,495482,6,1967,2,36000,1.00305033045
493537,493543,495605,6,2062,2,36000,1.00290979631
493538,493549,495540,11,1991,2,36000,1.00552486188
493540,495457,522754,1917,27297,10,43200,1.07022749753
493612,493621,495344,9,1723,2,36000,1.00522344748
493667,493681,495115,14,1434,2,36000,1.00976290098
493802,493813,495443,11,1630,2,36000,1.00674846626
493840,493850,495764,10,1914,2,36000,1.0052246604
493870,493880,495830,10,1950,2,36000,1.00512820513
493885,493891,495446,6,1555,2,36000,1.0038585209
493919,493927,495771,8,1844,2,36000,1.00433839479
493961,493970,495903,9,1933,2,36000,1.00465597517
493985,494067,496035,82,1968,2,36000,1.04166666667
493986,493996,602000,10,108004,2,108000,1.00009258916
494021,496045,528607,2024,32562,10,43200,1.06215834408
494024,494074,495958,50,1884,2,36000,1.02653927813
494058,494118,495500,60,1382,2,36000,1.04341534009
494073,494125,495911,52,1786,2,36000,1.02911534155
494107,494194,496169,87,1975,2,36000,1.04405063291
494123,494201,496146,78,1945,2,36000,1.04010282776
494184,494274,495499,90,1225,2,36000,1.07346938776
494199,494280,495990,81,1710,2,36000,1.04736842105
494271,494286,496359,15,2073,2,36000,1.00723589001
494290,494303,496304,13,2001,2,36000,1.00649675162
494305,494311,495709,6,1398,2,36000,1.00429184549
494368,494440,496286,72,1846,2,36000,1.03900325027
494431,494447,496372,16,1925,2,36000,1.00831168831
494433,494460,495382,27,922,2,36000,1.02928416486
494447,494483,495471,36,988,2,36000,1.03643724696
494472,494754,496923,282,2169,2,36000,1.13001383126
494744,494762,496232,18,1470,2,36000,1.01224489796
494759,494768,496078,9,1310,2,36000,1.00687022901
494761,494778,496120,17,1342,2,36000,1.01266766021
494775,494811,495670,36,859,2,36000,1.04190919674
494802,494833,496633,31,1800,2,36000,1.01722222222
494823,494971,496946,148,1975,2,36000,1.07493670886
494859,495060,496904,201,1844,2,36000,1.1090021692
494904,494991,512345,87,17354,1,54000,1.00501325343
494908,494997,516800,89,21803,1,54000,1.00408200706
494911,495115,495547,204,432,1,54000,1.47222222222
494915,495121,497924,206,2803,1,54000,1.07349268641
494961,495127,496963,166,1836,2,36000,1.09041394336
494979,495188,496004,209,816,2,36000,1.25612745098
495049,495276,496850,227,1574,2,36000,1.14421855146
495103,495283,496652,180,1369,2,36000,1.13148283419
495119,495330,497400,211,2070,2,36000,1.10193236715
495176,495355,497300,179,1945,2,36000,1.09203084833
495233,495393,496249,160,856,2,36000,1.18691588785
495266,495483,497294,217,1811,2,36000,1.11982330204
495268,495493,497344,225,1851,2,36000,1.12155591572
495319,495500,497384,181,1884,2,36000,1.09607218684
495346,495510,497333,164,1823,2,36000,1.08996160176
495381,495517,497234,136,1717,2,36000,1.07920792079
495443,495551,497386,108,1835,2,36000,1.05885558583
495459,495616,496703,157,1087,2,36000,1.14443422263
495473,495664,497481,191,1817,2,36000,1.10511832691
495489,495681,497629,192,1948,2,36000,1.09856262834
495490,495775,497571,285,1796,2,36000,1.15868596882
495505,495783,497567,278,1784,2,36000,1.15582959641
495507,495841,497220,334,1379,2,36000,1.24220449601
495541,495915,496898,374,983,2,36000,1.38046795524
495607,495923,497698,316,1775,2,36000,1.17802816901
495652,495969,497252,317,1283,2,36000,1.2470771629
495673,496001,497700,328,1699,2,36000,1.19305473808
495682,495720,577357,38,81637,2,108000,1.00046547521
495709,496015,496893,306,878,2,36000,1.34851936219
495763,496052,498010,289,1958,2,36000,1.14759959142
495778,496074,497983,296,1909,2,36000,1.15505500262
495829,496089,497117,260,1028,2,36000,1.25291828794
495904,496131,497371,227,1240,2,36000,1.18306451613
495919,496157,497870,238,1713,2,36000,1.13893753649
495958,496180,498232,222,2052,2,36000,1.1081871345
495989,496244,497971,255,1727,2,36000,1.14765489288
496003,496251,498162,248,1911,2,36000,1.12977498692
496036,496256,498174,220,1918,2,36000,1.11470281543
496078,496263,497980,185,1717,2,36000,1.10774606872
496120,496297,497908,177,1611,2,36000,1.10986964618
496147,496315,498345,168,2030,2,36000,1.08275862069
496168,496370,497498,202,1128,2,36000,1.17907801418
496234,496383,498187,149,1804,2,36000,1.08259423503
496249,496620,498531,371,1911,2,36000,1.19413919414
496285,496625,498238,340,1613,2,36000,1.21078735276
496306,496631,498571,325,1940,2,36000,1.1675257732
496360,496636,498482,276,1846,2,36000,1.14951245937
496375,496644,498635,269,1991,2,36000,1.13510798594
496540,496615,497186,75,571,1,18000,1.13134851138
496636,496663,498352,27,1689,2,36000,1.01598579041
496654,496714,498552,60,1838,2,36000,1.03264417845
496699,496861,498759,162,1898,2,36000,1.08535300316
496852,496904,497750,52,846,2,36000,1.06146572104
496894,496910,498014,16,1104,2,36000,1.01449275362
496909,496916,498606,7,1690,2,36000,1.00414201183
496910,496927,498358,17,1431,2,36000,1.01187980433
496916,496922,496932,6,10,1,576000,1.6
496925,496934,498820,9,1886,2,36000,1.00477200424
496946,496952,498667,6,1715,2,36000,1.00349854227
496964,496970,498539,6,1569,2,36000,1.00382409178
496976,496982,873603,6,376621,1,576000,1.00001593114
497097,497103,741675,6,244572,1,576000,1.00002453265
497120,497126,499000,6,1874,2,36000,1.00320170758
497167,497174,682123,7,184949,1,576000,1.00003784827
497220,497226,499078,6,1852,2,36000,1.00323974082
497228,497234,558752,6,61518,1,576000,1.00009753243
497235,497241,498372,6,1131,2,36000,1.00530503979
497253,497259,499564,6,2305,2,36000,1.00260303688
497295,497301,499292,6,1991,2,36000,1.00301356102
497310,497316,499512,6,2196,2,36000,1.00273224044
497334,497340,498633,6,1293,2,36000,1.00464037123
497349,497355,499039,6,1684,2,36000,1.00356294537
497373,497379,499053,6,1674,2,36000,1.00358422939
497388,497394,499268,6,1874,2,36000,1.00320170758
497389,497400,498674,11,1274,2,36000,1.00863422292
497404,497410,498509,6,1099,2,36000,1.00545950864
497482,497489,499282,7,1793,2,36000,1.00390407139
497497,497504,498980,7,1476,2,36000,1.00474254743
497570,497576,499245,6,1669,2,36000,1.00359496705
497585,497591,499307,6,1716,2,36000,1.0034965035
497617,497623,497754,6,131,1,1200,1.04580152672
497630,497636,499587,6,1951,2,36000,1.00307534598
497699,497705,499490,6,1785,2,36000,1.00336134454
497711,497717,497992,6,275,1,18000,1.02181818182
497714,497723,499707,9,1984,2,36000,1.00453629032
497753,497759,499155,6,1396,2,36000,1.00429799427
497871,497878,499328,7,1450,2,36000,1.00482758621
497908,497914,498785,6,871,2,36000,1.00688863375
497971,497977,499960,6,1983,2,36000,1.00302571861
497986,497991,499489,5,1498,2,36000,1.00333778371
497987,497997,499873,10,1876,2,36000,1.00533049041
498011,498017,499945,6,1928,2,36000,1.0031120332
498026,498032,499884,6,1852,2,36000,1.00323974082
498164,498170,500080,6,1910,2,36000,1.00314136126
498179,498185,500045,6,1860,2,36000,1.00322580645
498194,498200,499533,6,1333,2,36000,1.00450112528
498233,498239,499394,6,1155,2,36000,1.00519480519
498248,498254,499403,6,1149,2,36000,1.00522193211
498347,498353,499338,6,985,2,36000,1.00609137056
498362,498368,499901,6,1533,2,36000,1.00391389432
498363,498374,499618,11,1244,2,36000,1.00884244373
498378,498384,499509,6,1125,2,36000,1.00533333333
498484,498490,499637,6,1147,2,36000,1.00523103749
498511,498517,500255,6,1738,2,36000,1.00345224396
498531,498538,500504,7,1966,2,36000,1.00356052899
498546,498553,500579,7,2026,2,36000,1.00345508391
498561,498567,499976,6,1409,2,36000,1.00425833925
498576,498582,500344,6,1762,2,36000,1.00340522134
498606,498612,500317,6,1705,2,36000,1.00351906158
498633,498639,500657,6,2018,2,36000,1.00297324083
498648,498654,500447,6,1793,2,36000,1.0033463469
498666,498672,500467,6,1795,2,36000,1.00334261838
498681,498687,500647,6,1960,2,36000,1.00306122449
498763,498769,500647,6,1878,2,36000,1.00319488818
498787,498793,499622,6,829,2,36000,1.00723763571
498822,498829,500509,7,1680,2,36000,1.00416666667
498982,498988,500655,6,1667,2,36000,1.00359928014
499000,499006,501018,6,2012,2,36000,1.00298210736
499038,499045,500085,7,1040,2,36000,1.00673076923
499053,499059,500828,6,1769,2,36000,1.00339174675
499080,499086,500792,6,1706,2,36000,1.00351699883
499137,499143,819121,6,319978,1,532800,1.00001875129
499155,499166,501023,11,1857,2,36000,1.00592353258
499155,499161,769965,6,270804,1,532800,1.00002215625
499163,499172,815277,9,316105,1,532800,1.00002847155
499246,499252,501296,6,2044,2,36000,1.00293542074
499270,499276,501189,6,1913,2,36000,1.00313643492
499284,499290,500991,6,1701,2,36000,1.00352733686
499299,499305,501053,6,1748,2,36000,1.00343249428
499314,499320,500209,6,889,2,36000,1.00674915636
499328,499335,501156,7,1821,2,36000,1.00384404174
499343,499349,500805,6,1456,2,36000,1.00412087912
499394,499401,501240,7,1839,2,36000,1.00380641653
499408,499414,499442,6,28,6,600,1.21428571429
499409,499420,501171,11,1751,2,36000,1.0062821245
499491,499497,501428,6,1931,2,36000,1.00310719834
499492,499503,501300,11,1797,2,36000,1.0061213133
499502,499509,499538,7,29,1,1200,1.24137931034
499510,499516,501552,6,2036,2,36000,1.00294695481
499525,499531,501506,6,1975,2,36000,1.00303797468
499539,499546,500464,7,918,2,36000,1.00762527233
499563,499570,501433,7,1863,2,36000,1.00375738057
499587,499594,501172,7,1578,2,36000,1.00443599493
499617,499623,501389,6,1766,2,36000,1.00339750849
499632,499638,501574,6,1936,2,36000,1.00309917355
499647,499653,501448,6,1795,2,36000,1.00334261838
499707,499713,501269,6,1556,2,36000,1.00385604113
499876,499882,500497,6,615,3,600,1.00975609756
499876,499887,501660,11,1773,2,36000,1.00620417372
499891,499897,501931,6,2034,2,36000,1.00294985251
499905,499911,501676,6,1765,2,36000,1.00339943343
499945,499951,501160,6,1209,2,36000,1.00496277916
499959,499966,501230,7,1264,2,36000,1.00553797468
499977,499983,501059,6,1076,2,36000,1.00557620818
500046,500053,502132,7,2079,2,36000,1.00336700337
500080,500086,501091,6,1005,2,36000,1.00597014925
500094,500101,501753,7,1652,2,36000,1.00423728814
500209,500215,501026,6,811,2,36000,1.00739827374
500257,500264,502123,7,1859,2,36000,1.0037654653
500318,500324,501764,6,1440,2,36000,1.00416666667
500345,500351,502257,6,1906,2,36000,1.00314795383
500447,500453,501742,6,1289,2,36000,1.00465477114
500465,500472,502357,7,1885,2,36000,1.00371352785
500467,500478,502442,11,1964,2,36000,1.00560081466
500505,500512,502189,7,1677,2,36000,1.00417412045
500520,500526,502027,6,1501,2,36000,1.00399733511
500580,500586,501522,6,936,2,36000,1.00641025641
500646,500652,502074,6,1422,2,36000,1.00421940928
500661,500667,502897,6,2230,2,36000,1.00269058296
500663,500673,501707,10,1034,2,36000,1.00967117988
500664,500678,502217,14,1539,2,36000,1.00909681611
500793,500800,502065,7,1265,2,36000,1.00553359684
500808,500814,502598,6,1784,2,36000,1.0033632287
500829,500835,502571,6,1736,2,36000,1.0034562212
500970,500976,501230,6,254,1,3600,1.02362204724
500992,500998,502877,6,1879,2,36000,1.00319318787
501019,501025,502771,6,1746,2,36000,1.00343642612
501034,501040,502978,6,1938,2,36000,1.00309597523
501035,501046,503157,11,2111,2,36000,1.00521080057
501053,501059,502345,6,1286,2,36000,1.00466562986
501067,501074,502869,7,1795,2,36000,1.00389972145
501091,501098,502992,7,1894,2,36000,1.00369588173
501157,501164,502891,7,1727,2,36000,1.00405327157
501173,501179,502797,6,1618,2,36000,1.00370828183
501174,501185,503088,11,1903,2,36000,1.00578034682
501175,501190,502813,15,1623,2,36000,1.00924214418
501190,501196,503375,6,2179,2,36000,1.00275355668
501232,501238,503065,6,1827,2,36000,1.00328407225
501247,501253,503216,6,1963,2,36000,1.0030565461
501271,501277,503024,6,1747,2,36000,1.00343445907
501296,501302,502589,6,1287,2,36000,1.00466200466
501310,501316,503281,6,1965,2,36000,1.00305343511
501344,501350,502038,6,688,5,1200,1.00872093023
501391,501398,503304,7,1906,2,36000,1.0036726128
501427,501433,503224,6,1791,2,36000,1.00335008375
501442,501448,503416,6,1968,2,36000,1.00304878049
501457,501463,502652,6,1189,2,36000,1.00504625736
501505,501511,503342,6,1831,2,36000,1.00327689787
501523,501529,503756,6,2227,2,36000,1.00269420745
501553,501559,503105,6,1546,2,36000,1.00388098318
501574,501580,503748,6,2168,2,36000,1.00276752768
501661,501667,503118,6,1451,2,36000,1.00413507926
501676,501682,503069,6,1387,2,36000,1.0043258832
501706,501712,503993,6,2281,2,36000,1.00263042525
501742,501748,503631,6,1883,2,36000,1.00318640467
501757,501763,503608,6,1845,2,36000,1.00325203252
501771,501778,503688,7,1910,2,36000,1.00366492147
501931,501937,503820,6,1883,2,36000,1.00318640467
502030,502036,503695,6,1659,2,36000,1.00361663653
502066,502072,503380,6,1308,2,36000,1.00458715596
502081,502087,503772,6,1685,2,36000,1.00356083086
502123,502129,503357,6,1228,2,36000,1.00488599349
502138,502143,504249,5,2106,2,36000,1.00237416904
502189,502195,504008,6,1813,2,36000,1.00330943188
502219,502225,503049,6,824,2,36000,1.0072815534
502258,502264,504289,6,2025,2,36000,1.00296296296
502345,502352,504300,7,1948,2,36000,1.00359342916
502360,502366,503766,6,1400,2,36000,1.00428571429
502442,502448,503937,6,1489,2,36000,1.00402955003
502571,502578,504427,7,1849,2,36000,1.00378583018
502589,502595,504365,6,1770,2,36000,1.00338983051
502604,502610,504320,6,1710,2,36000,1.00350877193
502652,502658,504185,6,1527,2,36000,1.00392927308
502772,502779,504221,7,1442,2,36000,1.00485436893
502797,502803,504692,6,1889,2,36000,1.00317628375
502818,502824,504866,6,2042,2,36000,1.00293829579
502872,502878,504727,6,1849,2,36000,1.0032449973
502887,502893,504913,6,2020,2,36000,1.00297029703
502902,502908,504530,6,1622,2,36000,1.00369913687
502903,502914,504299,11,1385,2,36000,1.00794223827
502978,502984,504370,6,1386,2,36000,1.00432900433
502993,502999,504759,6,1760,2,36000,1.00340909091
503023,503029,505007,6,1978,2,36000,1.00303336704
503050,503056,504989,6,1933,2,36000,1.00310398345
503068,503074,504991,6,1917,2,36000,1.00312989045
503069,503080,504174,11,1094,2,36000,1.01005484461
503087,503094,504951,7,1857,2,36000,1.00376952073
503105,503112,505051,7,1939,2,36000,1.0036101083
503120,503126,504858,6,1732,2,36000,1.00346420323
503159,503165,505662,6,2497,2,36000,1.00240288346
503216,503222,505101,6,1879,2,36000,1.00319318787
503231,503237,505097,6,1860,2,36000,1.00322580645
503282,503288,505064,6,1776,2,36000,1.00337837838
503303,503309,505370,6,2061,2,36000,1.00291120815
503342,503348,505151,6,1803,2,36000,1.00332778702
503357,503363,505113,6,1750,2,36000,1.00342857143
503374,503381,505170,7,1789,2,36000,1.00391280045
503389,503396,505216,7,1820,2,36000,1.00384615385
503416,503422,505062,6,1640,2,36000,1.00365853659
503610,503616,505307,6,1691,2,36000,1.00354819633
503631,503637,505743,6,2106,2,36000,1.00284900285
503688,503694,504582,6,888,2,36000,1.00675675676
503703,503709,506064,6,2355,2,36000,1.0025477707
503747,503753,505719,6,1966,2,36000,1.00305188199
503762,503768,504906,6,1138,2,36000,1.00527240773
503777,503783,504943,6,1160,2,36000,1.00517241379
503779,503789,505883,10,2094,2,36000,1.00477554919
503820,503827,505535,7,1708,2,36000,1.00409836066
503938,503944,504930,6,986,2,36000,1.0060851927
503992,503999,505692,7,1693,2,36000,1.00413467218
504007,504014,505295,7,1281,2,36000,1.00546448087
504176,504183,505808,7,1625,2,36000,1.00430769231
504191,504197,505502,6,1305,2,36000,1.00459770115
504221,504228,505110,7,882,2,36000,1.00793650794
504248,504254,505682,6,1428,2,36000,1.00420168067
504290,504297,506186,7,1889,2,36000,1.00370566437
504305,504311,505582,6,1271,2,36000,1.00472069237
504307,504317,506125,10,1808,2,36000,1.00553097345
504322,504328,506223,6,1895,2,36000,1.00316622691
504367,504373,505261,6,888,2,36000,1.00675675676
504381,504387,506218,6,1831,2,36000,1.00327689787
504426,504432,505859,6,1427,2,36000,1.00420462509
504532,504538,506258,6,1720,2,36000,1.00348837209
504583,504589,506401,6,1812,2,36000,1.00331125828
504692,504698,506217,6,1519,2,36000,1.00394996708
504728,504734,506786,6,2052,2,36000,1.00292397661
504761,504767,506646,6,1879,2,36000,1.00319318787
504860,504866,506700,6,1834,2,36000,1.00327153762
504875,504881,506508,6,1627,2,36000,1.0036877689
504908,504914,506716,6,1802,2,36000,1.00332963374
504923,504929,506818,6,1889,2,36000,1.00317628375
504938,504944,506641,6,1697,2,36000,1.00353565115
504953,504959,506964,6,2005,2,36000,1.0029925187
504954,504965,506618,11,1653,2,36000,1.00665456745
504990,504996,506297,6,1301,2,36000,1.00461183705
505005,505011,505942,6,931,2,36000,1.00644468314
505020,505026,506633,6,1607,2,36000,1.00373366521
505050,505056,506685,6,1629,2,36000,1.00368324125
505065,505071,506897,6,1826,2,36000,1.00328587076
505066,505077,507036,11,1959,2,36000,1.00561510975
505099,505106,506904,7,1798,2,36000,1.00389321468
505101,505111,506769,10,1658,2,36000,1.00603136309
505116,505122,506858,6,1736,2,36000,1.0034562212
505117,505128,507001,11,1873,2,36000,1.00587293113
505153,505159,507013,6,1854,2,36000,1.00323624595
505171,505177,506965,6,1788,2,36000,1.0033557047
505216,505222,506684,6,1462,2,36000,1.00410396717
505261,505267,507069,6,1802,2,36000,1.00332963374
505297,505303,507128,6,1825,2,36000,1.00328767123
505312,505318,507630,6,2312,2,36000,1.00259515571
505369,505376,507033,7,1657,2,36000,1.00422450211
505502,505508,506434,6,926,2,36000,1.00647948164
505535,505541,507290,6,1749,2,36000,1.00343053173
505583,505589,506699,6,1110,2,36000,1.00540540541
505664,505670,507516,6,1846,2,36000,1.00325027086
505682,505688,507673,6,1985,2,36000,1.00302267003
505697,505703,507687,6,1984,2,36000,1.00302419355
505718,505724,507620,6,1896,2,36000,1.00316455696
505745,505751,507703,6,1952,2,36000,1.00307377049
505808,505814,507351,6,1537,2,36000,1.00390370852
505860,505866,507607,6,1741,2,36000,1.00344629523
505884,505890,507775,6,1885,2,36000,1.00318302387
505945,505951,507808,6,1857,2,36000,1.00323101777
506066,506072,507866,6,1794,2,36000,1.00334448161
506127,506133,507559,6,1426,2,36000,1.00420757363
506187,506193,508084,6,1891,2,36000,1.00317292438
506217,506223,507494,6,1271,2,36000,1.00472069237
506232,506238,507924,6,1686,2,36000,1.00355871886
506233,506244,508011,11,1767,2,36000,1.00622524052
506260,506266,508721,6,2455,2,36000,1.00244399185
506299,506305,508319,6,2014,2,36000,1.00297914598
506402,506408,507965,6,1557,2,36000,1.00385356455
506435,506441,508173,6,1732,2,36000,1.00346420323
506510,506516,508358,6,1842,2,36000,1.00325732899
506619,506625,508376,6,1751,2,36000,1.00342661336
506634,506640,508560,6,1920,2,36000,1.003125
506649,506655,508205,6,1550,2,36000,1.00387096774
506650,506661,508562,11,1901,2,36000,1.0057864282
506683,506689,507851,6,1162,2,36000,1.00516351119
506698,506704,508529,6,1825,2,36000,1.00328767123
506700,506710,508254,10,1544,2,36000,1.00647668394
506715,506721,508592,6,1871,2,36000,1.00320684126
506716,506727,508522,11,1795,2,36000,1.0061281337
506770,506777,508708,7,1931,2,36000,1.00362506473
506785,506791,508776,6,1985,2,36000,1.00302267003
506818,506824,508676,6,1852,2,36000,1.00323974082
506857,506863,508649,6,1786,2,36000,1.00335946249
506899,506906,508821,7,1915,2,36000,1.00365535248
506914,506921,508607,7,1686,2,36000,1.00415183867
506963,506969,508795,6,1826,2,36000,1.00328587076
506977,506983,508767,6,1784,2,36000,1.0033632287
507001,507007,508780,6,1773,2,36000,1.00338409475
507016,507022,508461,6,1439,2,36000,1.0041695622
507034,507040,508682,6,1642,2,36000,1.00365408039
507049,507055,508222,6,1167,2,36000,1.00514138817
507070,507076,508517,6,1441,2,36000,1.00416377516
507130,507136,508827,6,1691,2,36000,1.00354819633
507290,507296,508630,6,1334,2,36000,1.00449775112
507354,507360,508876,6,1516,2,36000,1.00395778364
507493,507499,508828,6,1329,2,36000,1.00451467269
507517,507523,508423,6,900,2,36000,1.00666666667
507559,507565,509458,6,1893,2,36000,1.00316957211
507607,507613,509546,6,1933,2,36000,1.00310398345
507622,507628,509435,6,1807,2,36000,1.00332042059
507637,507643,509652,6,2009,2,36000,1.00298656048
507673,507679,509593,6,1914,2,36000,1.00313479624
507688,507694,509037,6,1343,2,36000,1.00446760983
507703,507709,509258,6,1549,2,36000,1.00387346675
507775,507781,508750,6,969,2,36000,1.00619195046
507809,507815,509022,6,1207,2,36000,1.00497100249
507851,507857,509722,6,1865,2,36000,1.00321715818
507866,507872,509693,6,1821,2,36000,1.00329489292
507929,507935,509810,6,1875,2,36000,1.0032
507969,507975,509946,6,1971,2,36000,1.00304414003
508011,508017,509822,6,1805,2,36000,1.00332409972
508084,508090,509896,6,1806,2,36000,1.00332225914
508174,508181,509608,7,1427,2,36000,1.00490539594
508207,508214,510027,7,1813,2,36000,1.00386100386
508222,508228,510020,6,1792,2,36000,1.00334821429
508255,508262,510105,7,1843,2,36000,1.00379815518
508319,508325,509177,6,852,2,36000,1.00704225352
508358,508364,510273,6,1909,2,36000,1.00314300681
508376,508383,510428,7,2045,2,36000,1.00342298289
508425,508431,509979,6,1548,2,36000,1.00387596899
508461,508467,510266,6,1799,2,36000,1.00333518621
508518,508524,509659,6,1135,2,36000,1.00528634361
508534,508539,510345,5,1806,2,36000,1.00276854928
508535,508545,510566,10,2021,2,36000,1.00494804552
508562,508568,510581,6,2013,2,36000,1.00298062593
508564,508574,510364,10,1790,2,36000,1.00558659218
508594,508600,510653,6,2053,2,36000,1.00292255236
508609,508615,510381,6,1766,2,36000,1.00339750849
508630,508636,510670,6,2034,2,36000,1.00294985251
508651,508657,510542,6,1885,2,36000,1.00318302387
508678,508684,510240,6,1556,2,36000,1.00385604113
508693,508699,510681,6,1982,2,36000,1.00302724521
508708,508714,510643,6,1929,2,36000,1.00311041991
508723,508729,509975,6,1246,2,36000,1.00481540931
508750,508756,510590,6,1834,2,36000,1.00327153762
508768,508774,509811,6,1037,2,36000,1.00578592093
508783,508789,510187,6,1398,2,36000,1.00429184549
508784,508795,510647,11,1852,2,36000,1.00593952484
508799,508805,510690,6,1885,2,36000,1.00318302387
508823,508829,510848,6,2019,2,36000,1.0029717682
508838,508844,510763,6,1919,2,36000,1.00312662845
508839,508850,510174,11,1324,2,36000,1.0083081571
508878,508884,509937,6,1053,2,36000,1.0056980057
509024,509030,510564,6,1534,2,36000,1.00391134289
509039,509045,510737,6,1692,2,36000,1.00354609929
509178,509184,511133,6,1949,2,36000,1.0030785018
509260,509266,511025,6,1759,2,36000,1.00341102899
509435,509441,511365,6,1924,2,36000,1.00311850312
509459,509465,511241,6,1776,2,36000,1.00337837838
509546,509552,511096,6,1544,2,36000,1.00388601036
509595,509601,511332,6,1731,2,36000,1.00346620451
509609,509615,511108,6,1493,2,36000,1.00401875419
509654,509661,511326,7,1665,2,36000,1.0042042042
509669,509675,511614,6,1939,2,36000,1.00309437855
509693,509699,511539,6,1840,2,36000,1.00326086957
509723,509729,511361,6,1632,2,36000,1.00367647059
509811,509817,511881,6,2064,2,36000,1.00290697674
509812,509823,511800,11,1977,2,36000,1.00556398584
509827,509833,511545,6,1712,2,36000,1.0035046729
509896,509903,511847,7,1944,2,36000,1.00360082305
509939,509945,511689,6,1744,2,36000,1.00344036697
509953,509960,511257,7,1297,2,36000,1.00539707016
509974,509981,511785,7,1804,2,36000,1.00388026608
509989,509995,511607,6,1612,2,36000,1.00372208437
510020,510026,510883,6,857,2,36000,1.00700116686
510035,510041,511394,6,1353,2,36000,1.0044345898
510107,510113,511300,6,1187,2,36000,1.0050547599
510180,510186,511662,6,1476,2,36000,1.00406504065
510195,510201,512236,6,2035,2,36000,1.00294840295
510240,510246,511953,6,1707,2,36000,1.00351493849
510264,510270,511883,6,1613,2,36000,1.00371977681
510279,510284,511291,5,1007,2,36000,1.0049652433
510345,510351,512025,6,1674,2,36000,1.00358422939
510366,510372,512282,6,1910,2,36000,1.00314136126
510381,510387,512052,6,1665,2,36000,1.0036036036
510429,510435,512155,6,1720,2,36000,1.00348837209
510543,510549,512181,6,1632,2,36000,1.00367647059
510564,510570,512507,6,1937,2,36000,1.00309757357
510579,510585,511654,6,1069,2,36000,1.00561272217
510594,510600,512410,6,1810,2,36000,1.00331491713
510596,510607,511695,11,1088,2,36000,1.01011029412
510644,510650,512521,6,1871,2,36000,1.00320684126
510659,510665,512678,6,2013,2,36000,1.00298062593
510660,510671,512389,11,1718,2,36000,1.00640279395
510675,510681,511927,6,1246,2,36000,1.00481540931
510690,510696,511929,6,1233,2,36000,1.00486618005
510691,510702,512515,11,1813,2,36000,1.00606729178
510737,510743,511902,6,1159,2,36000,1.00517687662
510764,510770,512060,6,1290,2,36000,1.00465116279
510848,510854,512854,6,2000,2,36000,1.003
510884,510890,512709,6,1819,2,36000,1.00329851567
511027,511033,512887,6,1854,2,36000,1.00323624595
511099,511105,513012,6,1907,2,36000,1.00314630309
511114,511120,512960,6,1840,2,36000,1.00326086957
511135,511141,513070,6,1929,2,36000,1.00311041991
511241,511247,513155,6,1908,2,36000,1.00314465409
511259,511265,512970,6,1705,2,36000,1.00351906158
511292,511298,512914,6,1616,2,36000,1.00371287129
511307,511313,513141,6,1828,2,36000,1.00328227571
511324,511331,512539,7,1208,2,36000,1.00579470199
511340,511346,513516,6,2170,2,36000,1.00276497696
511360,511366,513194,6,1828,2,36000,1.00328227571
511375,511382,513314,7,1932,2,36000,1.00362318841
511394,511405,513301,11,1896,2,36000,1.00580168776
511394,511400,536399,6,24999,6,144000,1.0002400096
511540,511546,512538,6,992,2,36000,1.0060483871
511555,511561,512817,6,1256,2,36000,1.00477707006
511610,511616,513565,6,1949,2,36000,1.0030785018
511625,511631,513592,6,1961,2,36000,1.00305966344
511655,511661,513015,6,1354,2,36000,1.00443131462
511669,511676,513599,7,1923,2,36000,1.00364014561
511690,511697,512898,7,1201,2,36000,1.00582847627
511706,511712,512998,6,1286,2,36000,1.00466562986
511787,511793,513284,6,1491,2,36000,1.00402414487
511802,511808,513571,6,1763,2,36000,1.00340328985
511847,511853,513350,6,1497,2,36000,1.00400801603
511880,511887,513383,7,1496,2,36000,1.00467914439
511895,511901,513920,6,2019,2,36000,1.0029717682
511910,511916,513767,6,1851,2,36000,1.00324149109
511928,511934,513205,6,1271,2,36000,1.00472069237
511943,511949,512785,6,836,2,36000,1.00717703349
511958,511964,514083,6,2119,2,36000,1.0028315243
512027,512034,513863,7,1829,2,36000,1.00382722799
512054,512060,513872,6,1812,2,36000,1.00331125828
512069,512075,513474,6,1399,2,36000,1.0042887777
512156,512163,513974,7,1811,2,36000,1.00386526781
512184,512190,514081,6,1891,2,36000,1.00317292438
512235,512241,513853,6,1612,2,36000,1.00372208437
512284,512290,514500,6,2210,2,36000,1.00271493213
512390,512396,514240,6,1844,2,36000,1.0032537961
512410,512417,514045,7,1628,2,36000,1.0042997543
512507,512513,514460,6,1947,2,36000,1.0030816641
512522,512528,514300,6,1772,2,36000,1.00338600451
512523,512534,514403,11,1869,2,36000,1.00588550027
512538,512545,514519,7,1974,2,36000,1.00354609929
512540,512551,513927,11,1376,2,36000,1.00799418605
512679,512685,514557,6,1872,2,36000,1.00320512821
512709,512715,514048,6,1333,2,36000,1.00450112528
512784,512790,514314,6,1524,2,36000,1.00393700787
512817,512823,514335,6,1512,2,36000,1.00396825397
512857,512863,513806,6,943,2,36000,1.00636267232
512887,512893,514841,6,1948,2,36000,1.00308008214
512901,512908,514374,7,1466,2,36000,1.00477489768
512916,512922,514390,6,1468,2,36000,1.00408719346
512961,512967,514848,6,1881,2,36000,1.00318979266
512976,512982,515063,6,2081,2,36000,1.00288322922
513000,513006,514805,6,1799,2,36000,1.00333518621
513015,513022,514799,7,1777,2,36000,1.00393922341
513017,513028,514452,11,1424,2,36000,1.0077247191
513071,513077,514806,6,1729,2,36000,1.003470214
513143,513149,515109,6,1960,2,36000,1.00306122449
513158,513164,514979,6,1815,2,36000,1.00330578512
513194,513200,515100,6,1900,2,36000,1.00315789474
513209,513215,514555,6,1340,2,36000,1.00447761194
513284,513290,515348,6,2058,2,36000,1.0029154519
513302,513308,514773,6,1465,2,36000,1.00409556314
513317,513323,515435,6,2112,2,36000,1.00284090909
513350,513356,515428,6,2072,2,36000,1.0028957529
513383,513389,515293,6,1904,2,36000,1.0031512605
513476,513483,514964,7,1481,2,36000,1.00472653612
513516,513522,515358,6,1836,2,36000,1.00326797386
513567,513573,515094,6,1521,2,36000,1.00394477318
513582,513588,515460,6,1872,2,36000,1.00320512821
513597,513603,514860,6,1257,2,36000,1.00477326969
513612,513618,515399,6,1781,2,36000,1.00336889388
513769,513775,515639,6,1864,2,36000,1.00321888412
513808,513814,515646,6,1832,2,36000,1.00327510917
513856,513862,515772,6,1910,2,36000,1.00314136126
513871,513877,515340,6,1463,2,36000,1.004101162
513885,513891,515478,6,1587,2,36000,1.00378071834
513921,513928,515592,7,1664,2,36000,1.00420673077
513936,513942,515275,6,1333,2,36000,1.00450112528
513975,513982,515931,7,1949,2,36000,1.00359158543
514045,514051,515770,6,1719,2,36000,1.0034904014
514060,514066,516028,6,1962,2,36000,1.00305810398
514081,514087,516140,6,2053,2,36000,1.00292255236
514095,514102,515925,7,1823,2,36000,1.00383982447
514240,514247,515682,7,1435,2,36000,1.00487804878
514301,514307,515958,6,1651,2,36000,1.00363416111
514316,514322,515995,6,1673,2,36000,1.00358637179
514337,514343,516148,6,1805,2,36000,1.00332409972
514376,514382,515352,6,970,2,36000,1.00618556701
514391,514397,515803,6,1406,2,36000,1.00426742532
514405,514412,515962,7,1550,2,36000,1.00451612903
514454,514460,516182,6,1722,2,36000,1.00348432056
514469,514475,516465,6,1990,2,36000,1.00301507538
514502,514508,515942,6,1434,2,36000,1.00418410042
514520,514526,516261,6,1735,2,36000,1.00345821326
514556,514562,516338,6,1776,2,36000,1.00337837838
514557,514568,516243,11,1675,2,36000,1.00656716418
514775,514781,516489,6,1708,2,36000,1.00351288056
514802,514808,516227,6,1419,2,36000,1.00422832981
514817,514823,516104,6,1281,2,36000,1.00468384075
514818,514829,516296,11,1467,2,36000,1.00749829584
514842,514848,516576,6,1728,2,36000,1.00347222222
514857,514863,516683,6,1820,2,36000,1.0032967033
514872,514878,516428,6,1550,2,36000,1.00387096774
514966,514972,516742,6,1770,2,36000,1.00338983051
514981,514987,516979,6,1992,2,36000,1.00301204819
515065,515071,516830,6,1759,2,36000,1.00341102899
515096,515102,516281,6,1179,2,36000,1.00508905852
515111,515117,517233,6,2116,2,36000,1.00283553875
515112,515123,517057,11,1934,2,36000,1.0056876939
515277,515283,517309,6,2026,2,36000,1.00296150049
515295,515301,517580,6,2279,2,36000,1.00263273366
515341,515348,517349,7,2001,2,36000,1.00349825087
515357,515363,517036,6,1673,2,36000,1.00358637179
515358,515369,516630,11,1261,2,36000,1.00872323553
515373,515379,517082,6,1703,2,36000,1.00352319436
515401,515407,517219,6,1812,2,36000,1.00331125828
515429,515435,516576,6,1141,2,36000,1.00525854514
515444,515450,517143,6,1693,2,36000,1.00354400473
515459,515465,517361,6,1896,2,36000,1.00316455696
515478,515484,517189,6,1705,2,36000,1.00351906158
515594,515600,517680,6,2080,2,36000,1.00288461538
515640,515646,517436,6,1790,2,36000,1.00335195531
515655,515662,517806,7,2144,2,36000,1.00326492537
515683,515689,517179,6,1490,2,36000,1.00402684564
515773,515779,517570,6,1791,2,36000,1.00335008375
515774,515785,516817,11,1032,2,36000,1.01065891473
515805,515812,517890,7,2078,2,36000,1.00336862368
515927,515933,517899,6,1966,2,36000,1.00305188199
515942,515948,517681,6,1733,2,36000,1.00346220427
515943,515954,517928,11,1974,2,36000,1.00557244174
515958,515964,517374,6,1410,2,36000,1.00425531915
515973,515979,518143,6,2164,2,36000,1.00277264325
515997,516003,517777,6,1774,2,36000,1.00338218715
516030,516036,517871,6,1835,2,36000,1.00326975477
516106,516112,518787,6,2675,2,36000,1.00224299065
516142,516148,517674,6,1526,2,36000,1.00393184797
516158,516164,517133,6,969,2,36000,1.00619195046
516183,516189,517980,6,1791,2,36000,1.00335008375
516229,516235,518100,6,1865,2,36000,1.00321715818
516244,516250,518030,6,1780,2,36000,1.00337078652
516262,516268,518188,6,1920,2,36000,1.003125
516283,516289,517761,6,1472,2,36000,1.00407608696
516298,516304,517823,6,1519,2,36000,1.00394996708
516341,516347,518065,6,1718,2,36000,1.00349243306
516428,516434,517955,6,1521,2,36000,1.00394477318
516467,516473,517696,6,1223,2,36000,1.00490596893
516491,516497,518032,6,1535,2,36000,1.00390879479
516579,516585,518332,6,1747,2,36000,1.00343445907
516581,516591,518575,10,1984,2,36000,1.00504032258
516632,516638,518408,6,1770,2,36000,1.00338983051
516683,516689,517792,6,1103,2,36000,1.00543970988
516743,516749,518001,6,1252,2,36000,1.00479233227
516819,516825,518215,6,1390,2,36000,1.00431654676
516834,516840,518481,6,1641,2,36000,1.00365630713
516980,516986,518036,6,1050,2,36000,1.00571428571
517037,517043,519122,6,2079,2,36000,1.00288600289
517058,517064,518473,6,1409,2,36000,1.00425833925
517082,517089,518424,7,1335,2,36000,1.00524344569
517134,517140,519086,6,1946,2,36000,1.00308324769
517149,517155,519098,6,1943,2,36000,1.00308800823
517179,517185,519127,6,1942,2,36000,1.00308959835
517193,517200,518952,7,1752,2,36000,1.00399543379
517221,517227,518701,6,1474,2,36000,1.00407055631
517236,517242,519077,6,1835,2,36000,1.00326975477
517311,517317,518819,6,1502,2,36000,1.00399467377
517350,517356,519391,6,2035,2,36000,1.00294840295
517365,517371,519490,6,2119,2,36000,1.0028315243
517380,517386,519184,6,1798,2,36000,1.00333704116
517437,517443,519198,6,1755,2,36000,1.00341880342
517570,517576,519580,6,2004,2,36000,1.00299401198
517584,517591,519535,7,1944,2,36000,1.00360082305
517675,517681,519434,6,1753,2,36000,1.00342270394
517690,517696,519578,6,1882,2,36000,1.00318809777
517691,517702,519144,11,1442,2,36000,1.00762829404
517706,517712,519654,6,1942,2,36000,1.00308959835
517763,517769,519617,6,1848,2,36000,1.00324675325
517778,517784,519365,6,1581,2,36000,1.00379506641
517793,517799,519592,6,1793,2,36000,1.0033463469
517807,517814,519468,7,1654,2,36000,1.00423216445
517825,517831,519271,6,1440,2,36000,1.00416666667
517873,517880,519960,7,2080,2,36000,1.00336538462
517891,517897,519237,6,1340,2,36000,1.00447761194
517906,517912,520019,6,2107,2,36000,1.00284765069
517927,517933,520204,6,2271,2,36000,1.00264200793
517954,517960,519665,6,1705,2,36000,1.00351906158
517981,517987,520090,6,2103,2,36000,1.00285306705
518002,518008,519765,6,1757,2,36000,1.00341491178
518032,518038,519878,6,1840,2,36000,1.00326086957
518033,518044,519898,11,1854,2,36000,1.00593311758
518048,518054,519674,6,1620,2,36000,1.0037037037
518066,518072,519869,6,1797,2,36000,1.00333889816
518102,518108,519895,6,1787,2,36000,1.00335758254
518144,518150,520092,6,1942,2,36000,1.00308959835
518189,518196,520428,7,2232,2,36000,1.00313620072
518216,518223,519503,7,1280,2,36000,1.00546875
518332,518338,519696,6,1358,2,36000,1.00441826215
518407,518413,520011,6,1598,2,36000,1.00375469337
518425,518431,520311,6,1880,2,36000,1.00319148936
518473,518480,520241,7,1761,2,36000,1.0039750142
518488,518494,519628,6,1134,2,36000,1.00529100529
518576,518582,520396,6,1814,2,36000,1.0033076075
518703,518709,520589,6,1880,2,36000,1.00319148936
518788,518794,520944,6,2150,2,36000,1.00279069767
518818,518824,520738,6,1914,2,36000,1.00313479624
518954,518960,520823,6,1863,2,36000,1.00322061192
519078,519084,520415,6,1331,2,36000,1.00450788881
519093,519099,520923,6,1824,2,36000,1.00328947368
519107,519114,521130,7,2016,2,36000,1.00347222222
519122,519128,520822,6,1694,2,36000,1.00354191263
519137,519143,520999,6,1856,2,36000,1.00323275862
519153,519159,521116,6,1957,2,36000,1.00306591722
519186,519192,521210,6,2018,2,36000,1.00297324083
519201,519207,520447,6,1240,2,36000,1.00483870968
519237,519243,520494,6,1251,2,36000,1.00479616307
519273,519279,520714,6,1435,2,36000,1.00418118467
519366,519372,521379,6,2007,2,36000,1.00298953662
519390,519397,520346,7,949,2,36000,1.00737618546
519436,519442,521064,6,1622,2,36000,1.00369913687
519469,519475,521152,6,1677,2,36000,1.00357781753
519490,519496,520699,6,1203,2,36000,1.00498753117
519505,519511,520457,6,946,2,36000,1.00634249471
519535,519541,521266,6,1725,2,36000,1.00347826087
519580,519586,520817,6,1231,2,36000,1.00487408611
519581,519592,520843,11,1251,2,36000,1.00879296563
519596,519602,521057,6,1455,2,36000,1.00412371134
519617,519623,521498,6,1875,2,36000,1.0032
519632,519638,521187,6,1549,2,36000,1.00387346675
519656,519662,520976,6,1314,2,36000,1.00456621005
519670,519676,521074,6,1398,2,36000,1.00429184549
519685,519691,521806,6,2115,2,36000,1.00283687943
519700,519706,521309,6,1603,2,36000,1.00374298191
519766,519772,521588,6,1816,2,36000,1.00330396476
519872,519878,521455,6,1577,2,36000,1.00380469245
519887,519893,521359,6,1466,2,36000,1.00409276944
519901,519907,521198,6,1291,2,36000,1.00464756003
519903,519913,521604,10,1691,2,36000,1.00591366056
519960,519966,521582,6,1616,2,36000,1.00371287129
520011,520017,520965,6,948,2,36000,1.00632911392
520026,520032,520961,6,929,2,36000,1.00645855759
520092,520098,521710,6,1612,2,36000,1.00372208437
520094,520104,522101,10,1997,2,36000,1.00500751127
520206,520212,521647,6,1435,2,36000,1.00418118467
520242,520248,521995,6,1747,2,36000,1.00343445907
520311,520317,522088,6,1771,2,36000,1.00338791643
520347,520353,522365,6,2012,2,36000,1.00298210736
520398,520404,522504,6,2100,2,36000,1.00285714286
520416,520422,521452,6,1030,2,36000,1.00582524272
520431,520437,521532,6,1095,2,36000,1.00547945205
520448,520455,522311,7,1856,2,36000,1.00377155172
520463,520469,522125,6,1656,2,36000,1.00362318841
520496,520502,522068,6,1566,2,36000,1.00383141762
520589,520596,521980,7,1384,2,36000,1.00505780347
520701,520707,522595,6,1888,2,36000,1.0031779661
520716,520722,522327,6,1605,2,36000,1.00373831776
520740,520746,522818,6,2072,2,36000,1.0028957529
520818,520824,522631,6,1807,2,36000,1.00332042059
520833,520839,522713,6,1874,2,36000,1.00320170758
520834,520845,522695,11,1850,2,36000,1.00594594595
520849,520855,522737,6,1882,2,36000,1.00318809777
520925,520931,522123,6,1192,2,36000,1.00503355705
520945,520952,523189,7,2237,2,36000,1.00312919088
520960,520966,522669,6,1703,2,36000,1.00352319436
520975,520981,522956,6,1975,2,36000,1.00303797468
520990,520996,522577,6,1581,2,36000,1.00379506641
521005,521010,522868,5,1858,2,36000,1.00269106566
521059,521065,523075,6,2010,2,36000,1.00298507463
521074,521080,522231,6,1151,2,36000,1.00521285838
521075,521086,522990,11,1904,2,36000,1.00577731092
521117,521123,522980,6,1857,2,36000,1.00323101777
521132,521138,522800,6,1662,2,36000,1.0036101083
521153,521159,522883,6,1724,2,36000,1.00348027842
521189,521195,522938,6,1743,2,36000,1.00344234079
521204,521210,523091,6,1881,2,36000,1.00318979266
521219,521225,522594,6,1369,2,36000,1.00438276114
521267,521273,522942,6,1669,2,36000,1.00359496705
521309,521315,523280,6,1965,2,36000,1.00305343511
521360,521366,522525,6,1159,2,36000,1.00517687662
521380,521387,523425,7,2038,2,36000,1.00343473994
521453,521459,523398,6,1939,2,36000,1.00309437855
521467,521474,523453,7,1979,2,36000,1.00353713997
521498,521504,523288,6,1784,2,36000,1.0033632287
521531,521537,523295,6,1758,2,36000,1.00341296928
521585,521591,522544,6,953,2,36000,1.00629590766
521600,521606,523063,6,1457,2,36000,1.00411805079
521614,521621,523037,7,1416,2,36000,1.00494350282
521647,521654,523486,7,1832,2,36000,1.0038209607
521711,521717,523344,6,1627,2,36000,1.0036877689
521807,521813,523886,6,2073,2,36000,1.00289435601
521983,521989,523469,6,1480,2,36000,1.00405405405
521998,522004,523612,6,1608,2,36000,1.00373134328
522070,522076,523529,6,1453,2,36000,1.00412938747
522088,522094,524080,6,1986,2,36000,1.00302114804
522103,522109,523634,6,1525,2,36000,1.00393442623
522124,522130,523999,6,1869,2,36000,1.00321027287
522125,522136,523472,11,1336,2,36000,1.00823353293
522231,522237,523771,6,1534,2,36000,1.00391134289
522312,522318,523933,6,1615,2,36000,1.00371517028
522327,522333,524338,6,2005,2,36000,1.0029925187
522366,522372,524154,6,1782,2,36000,1.00336700337
522505,522511,523966,6,1455,2,36000,1.00412371134
522526,522532,524261,6,1729,2,36000,1.003470214
522544,522550,524366,6,1816,2,36000,1.00330396476
522577,522583,524326,6,1743,2,36000,1.00344234079
522595,522601,523991,6,1390,2,36000,1.00431654676
522596,522607,524588,11,1981,2,36000,1.00555275114
522632,522639,524554,7,1915,2,36000,1.00365535248
522668,522675,524669,7,1994,2,36000,1.00351053159
522695,522702,524139,7,1437,2,36000,1.00487125957
522713,522720,524573,7,1853,2,36000,1.00377765785
522737,522744,523983,7,1239,2,36000,1.00564971751
522801,522807,524238,6,1431,2,36000,1.00419287212
522819,522825,524851,6,2026,2,36000,1.00296150049
522870,522876,523919,6,1043,2,36000,1.00575263663
522885,522891,524411,6,1520,2,36000,1.00394736842
522939,522946,525069,7,2123,2,36000,1.00329722091
522954,522960,524926,6,1966,2,36000,1.00305188199
522969,522975,524363,6,1388,2,36000,1.00432276657
522984,522990,525002,6,2012,2,36000,1.00298210736
522999,523005,524865,6,1860,2,36000,1.00322580645
523038,523044,524630,6,1586,2,36000,1.00378310214
523065,523071,524782,6,1711,2,36000,1.00350672122
523079,523085,524473,6,1388,2,36000,1.00432276657
523094,523100,524875,6,1775,2,36000,1.00338028169
523191,523197,524964,6,1767,2,36000,1.00339558574
523279,523285,524955,6,1670,2,36000,1.00359281437
523294,523299,525146,5,1847,2,36000,1.00270709258
523308,523315,524542,7,1227,2,36000,1.00570497148
523345,523351,524992,6,1641,2,36000,1.00365630713
523399,523405,524342,6,937,2,36000,1.00640341515
523426,523432,524962,6,1530,2,36000,1.00392156863
523453,523459,524628,6,1169,2,36000,1.00513259196
523471,523477,524712,6,1235,2,36000,1.0048582996
523485,523492,524439,7,947,2,36000,1.00739176346
523500,523506,524509,6,1003,2,36000,1.00598205384
523530,523536,525598,6,2062,2,36000,1.00290979631
523615,523621,525841,6,2220,2,36000,1.0027027027
523636,523642,525561,6,1919,2,36000,1.00312662845
523772,523778,524812,6,1034,2,36000,1.00580270793
523887,523893,525198,6,1305,2,36000,1.00459770115
523920,523926,525285,6,1359,2,36000,1.00441501104
523935,523941,525909,6,1968,2,36000,1.00304878049
523968,523974,526054,6,2080,2,36000,1.00288461538
523986,523992,525952,6,1960,2,36000,1.00306122449
524001,524007,525893,6,1886,2,36000,1.00318133616
524002,524013,525344,11,1331,2,36000,1.00826446281
524080,524086,525630,6,1544,2,36000,1.00388601036
524141,524147,526008,6,1861,2,36000,1.00322407308
524155,524162,525717,7,1555,2,36000,1.00450160772
524240,524246,526063,6,1817,2,36000,1.0033021464
524261,524267,525759,6,1492,2,36000,1.00402144772
524327,524333,526243,6,1910,2,36000,1.00314136126
524342,524348,526199,6,1851,2,36000,1.00324149109
524344,524354,526334,10,1980,2,36000,1.00505050505
524365,524371,525974,6,1603,2,36000,1.00374298191
524379,524385,525860,6,1475,2,36000,1.00406779661
524412,524418,526202,6,1784,2,36000,1.0033632287
524439,524445,525907,6,1462,2,36000,1.00410396717
524475,524481,525684,6,1203,2,36000,1.00498753117
524511,524517,526186,6,1669,2,36000,1.00359496705
524544,524550,526556,6,2006,2,36000,1.00299102692
524559,524565,526489,6,1924,2,36000,1.00311850312
524574,524580,526399,6,1819,2,36000,1.00329851567
524589,524595,526563,6,1968,2,36000,1.00304878049
524628,524634,526303,6,1669,2,36000,1.00359496705
524643,524649,525894,6,1245,2,36000,1.00481927711
524670,524676,526129,6,1453,2,36000,1.00412938747
524712,524718,525568,6,850,2,36000,1.00705882353
524784,524790,526858,6,2068,2,36000,1.00290135397
524814,524820,526321,6,1501,2,36000,1.00399733511
524853,524859,526303,6,1444,2,36000,1.00415512465
524868,524874,527039,6,2165,2,36000,1.00277136259
524882,524889,526690,7,1801,2,36000,1.00388672959
524928,524934,526426,6,1492,2,36000,1.00402144772
524954,524961,526971,7,2010,2,36000,1.00348258706
524970,524975,526363,5,1388,2,36000,1.00360230548
524971,524981,527067,10,2086,2,36000,1.00479386385
524995,525001,526219,6,1218,2,36000,1.00492610837
525010,525016,526837,6,1821,2,36000,1.00329489292
525070,525076,526319,6,1243,2,36000,1.00482703138
525148,525154,527025,6,1871,2,36000,1.00320684126
525199,525205,526658,6,1453,2,36000,1.00412938747
525287,525293,526590,6,1297,2,36000,1.00462606014
525344,525350,526309,6,959,2,36000,1.00625651721
525562,525568,527356,6,1788,2,36000,1.0033557047
525576,525583,527050,7,1467,2,36000,1.00477164281
525597,525603,527544,6,1941,2,36000,1.00309119011
525630,525637,527820,7,2183,2,36000,1.00320659643
525684,525691,527887,7,2196,2,36000,1.00318761384
525718,525724,526618,6,894,2,36000,1.0067114094
525760,525766,527321,6,1555,2,36000,1.0038585209
525841,525847,527772,6,1925,2,36000,1.00311688312
525862,525868,526980,6,1112,2,36000,1.00539568345
525895,525901,527731,6,1830,2,36000,1.00327868852
525897,525907,527814,10,1907,2,36000,1.00524383849
525912,525917,527726,5,1809,2,36000,1.00276395799
525913,525924,527512,11,1588,2,36000,1.00692695214
525955,525961,527106,6,1145,2,36000,1.00524017467
525976,525982,527892,6,1910,2,36000,1.00314136126
526009,526015,527377,6,1362,2,36000,1.00440528634
526054,526060,527872,6,1812,2,36000,1.00331125828
526069,526074,527299,5,1225,2,36000,1.00408163265
526132,526138,527668,6,1530,2,36000,1.00392156863
526186,526192,528100,6,1908,2,36000,1.00314465409
526201,526207,527953,6,1746,2,36000,1.00343642612
526216,526222,527171,6,949,2,36000,1.00632244468
526230,526237,528137,7,1900,2,36000,1.00368421053
526245,526251,527993,6,1742,2,36000,1.00344431688
526304,526310,528347,6,2037,2,36000,1.0029455081
526305,526316,527589,11,1273,2,36000,1.0086410055
526320,526326,528119,6,1793,2,36000,1.0033463469
526321,526332,528203,11,1871,2,36000,1.00587920898
526336,526342,527663,6,1321,2,36000,1.00454201363
526338,526348,528312,10,1964,2,36000,1.00509164969
526365,526371,528677,6,2306,2,36000,1.00260190807
526401,526407,527868,6,1461,2,36000,1.00410677618
526428,526434,528382,6,1948,2,36000,1.00308008214
526491,526497,528050,6,1553,2,36000,1.00386349002
526558,526563,527947,5,1384,2,36000,1.00361271676
526572,526579,528482,7,1903,2,36000,1.00367840252
526590,526596,528438,6,1842,2,36000,1.00325732899
526620,526627,528432,7,1805,2,36000,1.00387811634
526659,526665,528559,6,1894,2,36000,1.00316789863
526689,526696,528197,7,1501,2,36000,1.00466355763
526837,526843,528239,6,1396,2,36000,1.00429799427
526858,526864,528888,6,2024,2,36000,1.00296442688
526973,526979,528978,6,1999,2,36000,1.00300150075
526987,526993,528675,6,1682,2,36000,1.00356718193
527027,527033,528902,6,1869,2,36000,1.00321027287
527041,527048,528750,7,1702,2,36000,1.00411280846
527056,527062,529069,6,2007,2,36000,1.00298953662
527071,527077,529201,6,2124,2,36000,1.00282485876
527107,527113,528785,6,1672,2,36000,1.00358851675
527173,527179,529271,6,2092,2,36000,1.00286806883
527300,527306,529028,6,1722,2,36000,1.00348432056
527321,527327,528682,6,1355,2,36000,1.00442804428
527357,527363,528829,6,1466,2,36000,1.00409276944
527377,527384,528643,7,1259,2,36000,1.00555996823
527513,527519,529202,6,1683,2,36000,1.00356506239
527546,527552,529493,6,1941,2,36000,1.00309119011
527591,527597,529347,6,1750,2,36000,1.00342857143
527664,527670,529510,6,1840,2,36000,1.00326086957
527679,527685,529275,6,1590,2,36000,1.00377358491
527698,527704,527875,6,171,1,3600,1.0350877193
527727,527733,529827,6,2094,2,36000,1.00286532951
527742,527748,529501,6,1753,2,36000,1.00342270394
527772,527778,529684,6,1906,2,36000,1.00314795383
527817,527823,529598,6,1775,2,36000,1.00338028169
527831,527838,529843,7,2005,2,36000,1.00349127182
527867,527874,529755,7,1881,2,36000,1.00372142477
527882,527888,529678,6,1790,2,36000,1.00335195531
527897,527903,529609,6,1706,2,36000,1.00351699883
527898,527909,529941,11,2032,2,36000,1.00541338583
527949,527956,529577,7,1621,2,36000,1.00431832202
527964,527970,529808,6,1838,2,36000,1.00326441785
527994,528000,530181,6,2181,2,36000,1.00275103164
528051,528057,529581,6,1524,2,36000,1.00393700787
528054,528063,528401,9,338,1,3600,1.02662721893
528099,528105,529983,6,1878,2,36000,1.00319488818
528117,528123,530156,6,2033,2,36000,1.00295130349
528138,528144,529908,6,1764,2,36000,1.00340136054
528198,528204,529612,6,1408,2,36000,1.00426136364
528213,528219,530117,6,1898,2,36000,1.00316122234
528240,528246,530087,6,1841,2,36000,1.00325909832
528312,528318,530190,6,1872,2,36000,1.00320512821
528348,528354,530225,6,1871,2,36000,1.00320684126
528381,528387,530415,6,2028,2,36000,1.00295857988
528435,528441,530142,6,1701,2,36000,1.00352733686
528450,528456,530437,6,1981,2,36000,1.00302877335
528483,528489,530459,6,1970,2,36000,1.00304568528
528558,528565,529692,7,1127,2,36000,1.00621118012
528643,528649,529946,6,1297,2,36000,1.00462606014
528677,528683,530127,6,1444,2,36000,1.00415512465
528678,528689,530599,11,1910,2,36000,1.0057591623
528693,528699,530585,6,1886,2,36000,1.00318133616
528750,528756,530764,6,2008,2,36000,1.00298804781
528754,528762,529590,8,828,1,3600,1.00966183575
528786,528792,530652,6,1860,2,36000,1.00322580645
528831,528837,529778,6,941,2,36000,1.00637619554
528888,528895,530746,7,1851,2,36000,1.0037817396
528903,528909,530870,6,1961,2,36000,1.00305966344
528979,528985,530281,6,1296,2,36000,1.00462962963
529030,529036,530450,6,1414,2,36000,1.00424328147
529069,529075,530155,6,1080,2,36000,1.00555555556
529202,529208,530457,6,1249,2,36000,1.00480384307
529203,529214,531109,11,1895,2,36000,1.00580474934
529273,529279,530608,6,1329,2,36000,1.00451467269
529287,529293,531169,6,1876,2,36000,1.00319829424
529348,529354,531152,6,1798,2,36000,1.00333704116
529496,529502,531361,6,1859,2,36000,1.00322754169
529511,529517,531496,6,1979,2,36000,1.00303183426
529512,529523,531417,11,1894,2,36000,1.00580781415
529579,529585,530872,6,1287,2,36000,1.00466200466
529593,529600,531532,7,1932,2,36000,1.00362318841
529608,529615,530584,7,969,2,36000,1.00722394221
529610,529620,531591,10,1971,2,36000,1.00507356672
529625,529631,531619,6,1988,2,36000,1.00301810865
529676,529682,531577,6,1895,2,36000,1.00316622691
529691,529697,531422,6,1725,2,36000,1.00347826087
529706,529712,531788,6,2076,2,36000,1.00289017341
529754,529760,531451,6,1691,2,36000,1.00354819633
529781,529787,531670,6,1883,2,36000,1.00318640467
529808,529814,531542,6,1728,2,36000,1.00347222222
529829,529835,530807,6,972,2,36000,1.00617283951
529844,529850,531268,6,1418,2,36000,1.00423131171
529910,529916,531674,6,1758,2,36000,1.00341296928
529945,529951,531757,6,1806,2,36000,1.00332225914
529959,529965,532028,6,2063,2,36000,1.00290838585
529983,529989,531794,6,1805,2,36000,1.00332409972
530089,530095,531775,6,1680,2,36000,1.00357142857
530119,530125,531579,6,1454,2,36000,1.00412654746
530134,530140,532051,6,1911,2,36000,1.00313971743
530148,530154,531416,6,1262,2,36000,1.00475435816
530164,530170,531633,6,1463,2,36000,1.004101162
530165,530176,531260,11,1084,2,36000,1.01014760148
530183,530189,531844,6,1655,2,36000,1.00362537764
530198,530204,531747,6,1543,2,36000,1.00388852884
530225,530231,531612,6,1381,2,36000,1.00434467777
530282,530288,531820,6,1532,2,36000,1.00391644909
530415,530421,531821,6,1400,2,36000,1.00428571429
530436,530442,531818,6,1376,2,36000,1.00436046512
530451,530457,532284,6,1827,2,36000,1.00328407225
530466,530472,532319,6,1847,2,36000,1.0032485111
530467,530478,531840,11,1362,2,36000,1.0080763583
530585,530591,531911,6,1320,2,36000,1.00454545455
530586,530597,532111,11,1514,2,36000,1.0072655218
530601,530607,532622,6,2015,2,36000,1.00297766749
530616,530622,531811,6,1189,2,36000,1.00504625736
530652,530658,532401,6,1743,2,36000,1.00344234079
530746,530752,532003,6,1251,2,36000,1.00479616307
530763,530770,532562,7,1792,2,36000,1.00390625
530782,530788,530901,6,113,1,3600,1.05309734513
530809,530815,532587,6,1772,2,36000,1.00338600451
530872,530879,532777,7,1898,2,36000,1.00368809273
530874,530885,531957,11,1072,2,36000,1.01026119403
531069,531075,531384,6,309,1,3600,1.01941747573
531109,531116,532747,7,1631,2,36000,1.00429184549
531152,531158,532460,6,1302,2,36000,1.00460829493
531170,531176,532687,6,1511,2,36000,1.00397088021
531230,531237,531399,7,162,1,3600,1.04320987654
531260,531266,532950,6,1684,2,36000,1.00356294537
531275,531281,532902,6,1621,2,36000,1.00370141888
531362,531368,533281,6,1913,2,36000,1.00313643492
531416,531422,533219,6,1797,2,36000,1.00333889816
531418,531428,533124,10,1696,2,36000,1.00589622642
531432,531439,533118,7,1679,2,36000,1.0041691483
531450,531456,533173,6,1717,2,36000,1.00349446709
531496,531502,533242,6,1740,2,36000,1.00344827586
531535,531541,533393,6,1852,2,36000,1.00323974082
531549,531555,533081,6,1526,2,36000,1.00393184797
531566,531572,531914,6,342,1,3600,1.01754385965
531577,531583,533411,6,1828,2,36000,1.00328227571
531578,531589,532746,11,1157,2,36000,1.00950734659
531593,531599,533403,6,1804,2,36000,1.00332594235
531614,531620,533435,6,1815,2,36000,1.00330578512
531628,531635,533485,7,1850,2,36000,1.00378378378
531643,531649,533055,6,1406,2,36000,1.00426742532
531670,531676,533136,6,1460,2,36000,1.00410958904
531685,531691,533368,6,1677,2,36000,1.00357781753
531748,531754,533620,6,1866,2,36000,1.00321543408
531763,531770,532610,7,840,2,36000,1.00833333333
531778,531784,533372,6,1588,2,36000,1.00377833753
531793,531799,532984,6,1185,2,36000,1.00506329114
531794,531805,533108,11,1303,2,36000,1.00844205679
531812,531819,533546,7,1727,2,36000,1.00405327157
531827,531833,533893,6,2060,2,36000,1.00291262136
531829,531839,533881,10,2042,2,36000,1.00489715965
531830,531844,533577,14,1733,2,36000,1.00807847663
531845,531851,533385,6,1534,2,36000,1.00391134289
531846,531857,533433,11,1576,2,36000,1.00697969543
531854,531863,532461,9,598,1,3600,1.01505016722
531912,531919,533380,7,1461,2,36000,1.00479123888
531958,531964,533671,6,1707,2,36000,1.00351493849
532006,532012,533193,6,1181,2,36000,1.0050804403
532030,532036,533566,6,1530,2,36000,1.00392156863
532051,532057,533756,6,1699,2,36000,1.00353148911
532111,532117,533711,6,1594,2,36000,1.00376411543
532284,532290,534040,6,1750,2,36000,1.00342857143
532288,532296,533163,8,867,1,3600,1.0092272203
532320,532326,534172,6,1846,2,36000,1.00325027086
532401,532408,534517,7,2109,2,36000,1.00331910858
532462,532471,534239,9,1768,2,36000,1.00509049774
532562,532568,534671,6,2103,2,36000,1.00285306705
532583,532589,534484,6,1895,2,36000,1.00316622691
532610,532616,534454,6,1838,2,36000,1.00326441785
532625,532631,534577,6,1946,2,36000,1.00308324769
532688,532694,534606,6,1912,2,36000,1.00313807531
532746,532752,534485,6,1733,2,36000,1.00346220427
532747,532758,534163,11,1405,2,36000,1.00782918149
532777,532784,534519,7,1735,2,36000,1.00403458213
532904,532910,534814,6,1904,2,36000,1.0031512605
532952,532958,534780,6,1822,2,36000,1.00329308452
532986,532992,534626,6,1634,2,36000,1.00367197062
533055,533061,535087,6,2026,2,36000,1.00296150049
533082,533088,535165,6,2077,2,36000,1.0028887819
533109,533115,534858,6,1743,2,36000,1.00344234079
533124,533130,534736,6,1606,2,36000,1.00373599004
533125,533136,534830,11,1694,2,36000,1.00649350649
533140,533147,534917,7,1770,2,36000,1.00395480226
533174,533180,534734,6,1554,2,36000,1.00386100386
533194,533201,535091,7,1890,2,36000,1.0037037037
533218,533225,534799,7,1574,2,36000,1.00444726811
533243,533249,534935,6,1686,2,36000,1.00355871886
533282,533288,534302,6,1014,2,36000,1.00591715976
533369,533375,534907,6,1532,2,36000,1.00391644909
533384,533391,535030,7,1639,2,36000,1.00427089689
533386,533397,535294,11,1897,2,36000,1.00579862941
533387,533402,534469,15,1067,2,36000,1.01405810684
533402,533408,535338,6,1930,2,36000,1.00310880829
533417,533423,534603,6,1180,2,36000,1.00508474576
533419,533429,535256,10,1827,2,36000,1.00547345375
533434,533440,534683,6,1243,2,36000,1.00482703138
533448,533454,535334,6,1880,2,36000,1.00319148936
533487,533493,535153,6,1660,2,36000,1.00361445783
533547,533554,534705,7,1151,2,36000,1.00608166811
533569,533575,535137,6,1562,2,36000,1.00384122919
533584,533590,535513,6,1923,2,36000,1.0031201248
533620,533626,534831,6,1205,2,36000,1.00497925311
533671,533677,535593,6,1916,2,36000,1.00313152401
533713,533719,535721,6,2002,2,36000,1.002997003
533758,533764,535303,6,1539,2,36000,1.00389863548
533882,533889,535785,7,1896,2,36000,1.00369198312
533897,533903,535356,6,1453,2,36000,1.00412938747
534039,534045,535900,6,1855,2,36000,1.00323450135
534163,534170,535460,7,1290,2,36000,1.00542635659
534178,534185,535480,7,1295,2,36000,1.00540540541
534239,534245,535581,6,1336,2,36000,1.00449101796
534303,534309,535976,6,1667,2,36000,1.00359928014
534386,534392,534505,6,113,1,3600,1.05309734513
534454,534460,536288,6,1828,2,36000,1.00328227571
534469,534475,536297,6,1822,2,36000,1.00329308452
534484,534490,536191,6,1701,2,36000,1.00352733686
534499,534505,536014,6,1509,2,36000,1.00397614314
534516,534523,535594,7,1071,2,36000,1.00653594771
534531,534537,536334,6,1797,2,36000,1.00333889816
534577,534583,536104,6,1521,2,36000,1.00394477318
534604,534610,536293,6,1683,2,36000,1.00356506239
534619,534625,536105,6,1480,2,36000,1.00405405405
534634,534640,536419,6,1779,2,36000,1.00337268128
534673,534679,536521,6,1842,2,36000,1.00325732899
534680,534685,534995,5,310,1,3600,1.01612903226
534688,534694,536280,6,1586,2,36000,1.00378310214
534706,534712,536193,6,1481,2,36000,1.00405131668
534736,534742,536090,6,1348,2,36000,1.00445103858
534738,534748,536339,10,1591,2,36000,1.00628535512
534783,534789,536536,6,1747,2,36000,1.00343445907
534801,534807,536121,6,1314,2,36000,1.00456621005
534815,534821,536436,6,1615,2,36000,1.00371517028
534830,534836,536740,6,1904,2,36000,1.0031512605
534832,534842,536653,10,1811,2,36000,1.00552181115
534859,534865,536721,6,1856,2,36000,1.00323275862
534904,534910,535033,6,123,1,1800,1.0487804878
534910,534916,536491,6,1575,2,36000,1.00380952381
534925,534931,536646,6,1715,2,36000,1.00349854227
534940,534946,536891,6,1945,2,36000,1.0030848329
535031,535037,536542,6,1505,2,36000,1.00398671096
535088,535094,536736,6,1642,2,36000,1.00365408039
535103,535109,536293,6,1184,2,36000,1.00506756757
535136,535143,536670,7,1527,2,36000,1.00458415193
535154,535161,537149,7,1988,2,36000,1.00352112676
535169,535176,536976,7,1800,2,36000,1.00388888889
535257,535263,537308,6,2045,2,36000,1.00293398533
535296,535302,537006,6,1704,2,36000,1.00352112676
535311,535317,536848,6,1531,2,36000,1.00391900718
535327,535333,535444,6,111,1,1800,1.05405405405
535335,535341,536592,6,1251,2,36000,1.00479616307
535350,535356,537242,6,1886,2,36000,1.00318133616
535365,535371,536701,6,1330,2,36000,1.0045112782
535436,535442,536046,6,604,1,3600,1.00993377483
535462,535468,536828,6,1360,2,36000,1.00441176471
535479,535486,537210,7,1724,2,36000,1.00406032483
535516,535522,537093,6,1571,2,36000,1.00381922342
535582,535588,537679,6,2091,2,36000,1.00286944046
535597,535603,537218,6,1615,2,36000,1.00371517028
535599,535609,537337,10,1728,2,36000,1.00578703704
535722,535728,537377,6,1649,2,36000,1.00363856883
535786,535792,537796,6,2004,2,36000,1.00299401198
535901,535907,537708,6,1801,2,36000,1.00333148251
535977,535983,537442,6,1459,2,36000,1.00411240576
536016,536022,537074,6,1052,2,36000,1.00570342205
536097,536103,537972,6,1869,2,36000,1.00321027287
536112,536118,537606,6,1488,2,36000,1.00403225806
536113,536124,537740,11,1616,2,36000,1.00680693069
536126,536132,536641,6,509,1,1800,1.01178781925
536128,536138,537486,10,1348,2,36000,1.00741839763
536191,536197,537608,6,1411,2,36000,1.00425230333
536206,536213,537842,7,1629,2,36000,1.00429711479
536282,536288,538241,6,1953,2,36000,1.00307219662
536297,536303,537916,6,1613,2,36000,1.00371977681
536298,536309,538293,11,1984,2,36000,1.00554435484
536300,536314,537980,14,1666,2,36000,1.00840336134
536301,536320,537739,19,1419,2,36000,1.01338971106
536334,536340,537835,6,1495,2,36000,1.00401337793
536349,536355,538302,6,1947,2,36000,1.0030816641
536419,536425,538163,6,1738,2,36000,1.00345224396
536437,536443,537472,6,1029,2,36000,1.00583090379
536492,536498,537764,6,1266,2,36000,1.00473933649
536522,536528,537761,6,1233,2,36000,1.00486618005
536540,536546,538215,6,1669,2,36000,1.00359496705
536555,536561,538372,6,1811,2,36000,1.00331308669
536592,536598,538386,6,1788,2,36000,1.0033557047
536648,536654,538501,6,1847,2,36000,1.0032485111
536664,536670,538002,6,1332,2,36000,1.0045045045
536679,536685,538280,6,1595,2,36000,1.00376175549
536703,536710,538576,7,1866,2,36000,1.00375133976
536722,536728,538700,6,1972,2,36000,1.00304259635
536736,536743,538348,7,1605,2,36000,1.00436137072
536754,536760,538660,6,1900,2,36000,1.00315789474
536831,536837,538718,6,1881,2,36000,1.00318979266
536849,536855,538260,6,1405,2,36000,1.00427046263
536892,536898,538511,6,1613,2,36000,1.00371977681
536980,536986,538444,6,1458,2,36000,1.00411522634
537007,537013,538568,6,1555,2,36000,1.0038585209
537074,537080,538561,6,1481,2,36000,1.00405131668
537096,537102,538528,6,1426,2,36000,1.00420757363
537151,537157,538854,6,1697,2,36000,1.00353565115
537212,537218,539137,6,1919,2,36000,1.00312662845
537227,537233,539138,6,1905,2,36000,1.0031496063
537242,537248,539311,6,2063,2,36000,1.00290838585
537308,537314,539096,6,1782,2,36000,1.00336700337
537339,537345,539181,6,1836,2,36000,1.00326797386
537378,537384,538876,6,1492,2,36000,1.00402144772
537445,537451,539198,6,1747,2,36000,1.00343445907
537472,537478,539335,6,1857,2,36000,1.00323101777
537487,537493,539149,6,1656,2,36000,1.00362318841
537605,537611,539432,6,1821,2,36000,1.00329489292
537620,537626,539171,6,1545,2,36000,1.00388349515
537680,537687,539476,7,1789,2,36000,1.00391280045
537708,537714,539544,6,1830,2,36000,1.00327868852
537742,537748,539655,6,1907,2,36000,1.00314630309
537743,537754,539785,11,2031,2,36000,1.00541605121
537761,537767,539540,6,1773,2,36000,1.00338409475
537776,537782,539263,6,1481,2,36000,1.00405131668
537797,537803,539173,6,1370,2,36000,1.00437956204
537837,537843,539196,6,1353,2,36000,1.0044345898
537852,537858,539664,6,1806,2,36000,1.00332225914
537918,537923,539992,5,2069,2,36000,1.00241662639
537973,537979,539852,6,1873,2,36000,1.00320341698
537988,537994,539858,6,1864,2,36000,1.00321888412
538003,538009,539567,6,1558,2,36000,1.00385109114
538165,538171,540002,6,1831,2,36000,1.00327689787
538216,538222,539967,6,1745,2,36000,1.00343839542
538243,538249,539781,6,1532,2,36000,1.00391644909
538261,538267,540325,6,2058,2,36000,1.0029154519
538279,538285,539898,6,1613,2,36000,1.00371977681
538294,538300,539852,6,1552,2,36000,1.00386597938
538309,538315,540309,6,1994,2,36000,1.00300902708
538348,538354,540138,6,1784,2,36000,1.0033632287
538358,538365,538419,7,54,1,1800,1.12962962963
538375,538381,540204,6,1823,2,36000,1.00329127811
538389,538396,540247,7,1851,2,36000,1.0037817396
538444,538450,540141,6,1691,2,36000,1.00354819633
538501,538507,540825,6,2318,2,36000,1.00258843831
538516,538522,540140,6,1618,2,36000,1.00370828183
538531,538537,540435,6,1898,2,36000,1.00316122234
538564,538570,539751,6,1181,2,36000,1.0050804403
538579,538585,540469,6,1884,2,36000,1.00318471338
538581,538591,539872,10,1281,2,36000,1.00780640125
538634,538640,538763,6,123,1,1800,1.0487804878
538662,538668,540047,6,1379,2,36000,1.00435097897
538702,538708,539688,6,980,2,36000,1.00612244898
538717,538723,540703,6,1980,2,36000,1.00303030303
538723,538729,538810,6,81,1,1800,1.07407407407
538854,538860,540554,6,1694,2,36000,1.00354191263
538878,538885,540904,7,2019,2,36000,1.0034670629
539084,539090,539192,6,102,1,1800,1.05882352941
539096,539102,540790,6,1688,2,36000,1.00355450237
539139,539145,540602,6,1457,2,36000,1.00411805079
539140,539151,540696,11,1545,2,36000,1.0071197411
539155,539161,540514,6,1353,2,36000,1.0044345898
539173,539180,541218,7,2038,2,36000,1.00343473994
539175,539186,541045,11,1859,2,36000,1.00591715976
539190,539196,541131,6,1935,2,36000,1.00310077519
539205,539211,540991,6,1780,2,36000,1.00337078652
539206,539217,540850,11,1633,2,36000,1.00673606859
539267,539273,540931,6,1658,2,36000,1.00361881785
539312,539318,541170,6,1852,2,36000,1.00323974082
539335,539342,541220,7,1878,2,36000,1.00372736954
539432,539439,540926,7,1487,2,36000,1.00470746469
539477,539484,541293,7,1809,2,36000,1.00386954118
539541,539547,541488,6,1941,2,36000,1.00309119011
539556,539562,541634,6,2072,2,36000,1.0028957529
539571,539577,540911,6,1334,2,36000,1.00449775112
539644,539650,539944,6,294,1,1800,1.02040816327
539655,539662,541385,7,1723,2,36000,1.00406268137
539671,539676,541439,5,1763,2,36000,1.00283607487
539689,539695,541643,6,1948,2,36000,1.00308008214
539752,539758,541038,6,1280,2,36000,1.0046875
539782,539788,541428,6,1640,2,36000,1.00365853659
539797,539803,541332,6,1529,2,36000,1.00392413342
539854,539860,541623,6,1763,2,36000,1.00340328985
539856,539866,541828,10,1962,2,36000,1.00509683996
539870,539876,540989,6,1113,2,36000,1.00539083558
539881,539887,540410,6,523,1,1800,1.01147227533
539885,539893,541343,8,1450,2,36000,1.00551724138
539900,539906,541429,6,1523,2,36000,1.00393959291
539969,539976,541979,7,2003,2,36000,1.00349475786
539993,540000,542221,7,2221,2,36000,1.00315173345
540009,540015,541278,6,1263,2,36000,1.00475059382
540048,540054,541531,6,1477,2,36000,1.00406228842
540140,540147,541775,7,1628,2,36000,1.0042997543
540142,540153,541660,11,1507,2,36000,1.00729927007
540143,540158,541986,15,1828,2,36000,1.00820568928
540204,540210,542032,6,1822,2,36000,1.00329308452
540249,540255,542094,6,1839,2,36000,1.00326264274
540309,540315,542167,6,1852,2,36000,1.00323974082
540327,540333,541744,6,1411,2,36000,1.00425230333
540436,540442,542149,6,1707,2,36000,1.00351493849
540472,540478,542422,6,1944,2,36000,1.00308641975
540517,540523,542313,6,1790,2,36000,1.00335195531
540556,540563,542639,7,2076,2,36000,1.00337186898
540602,540608,542037,6,1429,2,36000,1.00419874038
540698,540705,542315,7,1610,2,36000,1.00434782609
540713,540719,542444,6,1725,2,36000,1.00347826087
540789,540795,542503,6,1708,2,36000,1.00351288056
540825,540831,542457,6,1626,2,36000,1.0036900369
540852,540858,542551,6,1693,2,36000,1.00354400473
540906,540912,542736,6,1824,2,36000,1.00328947368
540921,540927,542635,6,1708,2,36000,1.00351288056
540936,540942,542108,6,1166,2,36000,1.0051457976
540938,540948,542746,10,1798,2,36000,1.00556173526
540989,540995,542761,6,1766,2,36000,1.00339750849
541004,541010,542763,6,1753,2,36000,1.00342270394
541040,541046,542312,6,1266,2,36000,1.00473933649
541055,541061,542428,6,1367,2,36000,1.00438917337
541130,541137,543134,7,1997,2,36000,1.00350525789
541169,541175,542954,6,1779,2,36000,1.00337268128
541217,541224,543033,7,1809,2,36000,1.00386954118
541232,541239,543144,7,1905,2,36000,1.00367454068
541278,541284,543132,6,1848,2,36000,1.00324675325
541293,541299,543048,6,1749,2,36000,1.00343053173
541332,541338,543010,6,1672,2,36000,1.00358851675
541346,541353,542807,7,1454,2,36000,1.00481430536
541386,541392,543255,6,1863,2,36000,1.00322061192
541428,541434,543203,6,1769,2,36000,1.00339174675
541429,541440,542895,11,1455,2,36000,1.00756013746
541444,541450,543281,6,1831,2,36000,1.00327689787
541487,541493,543213,6,1720,2,36000,1.00348837209
541532,541538,543324,6,1786,2,36000,1.00335946249
541626,541632,542819,6,1187,2,36000,1.0050547599
541640,541647,543400,7,1753,2,36000,1.00399315459
541655,541661,543693,6,2032,2,36000,1.00295275591
541670,541676,543471,6,1795,2,36000,1.00334261838
541746,541752,543299,6,1547,2,36000,1.00387847447
541776,541782,543057,6,1275,2,36000,1.00470588235
541827,541833,543417,6,1584,2,36000,1.00378787879
541981,541988,543757,7,1769,2,36000,1.00395703787
541996,542002,543521,6,1519,2,36000,1.00394996708
542032,542038,543818,6,1780,2,36000,1.00337078652
542047,542053,543395,6,1342,2,36000,1.0044709389
542096,542102,543416,6,1314,2,36000,1.00456621005
542110,542117,543929,7,1812,2,36000,1.00386313466
542150,542156,543669,6,1513,2,36000,1.0039656312
542168,542174,543691,6,1517,2,36000,1.00395517469
542222,542228,544194,6,1966,2,36000,1.00305188199
542263,542269,542319,6,50,1,1800,1.12
542313,542319,543612,6,1293,2,36000,1.00464037123
542314,542325,544043,11,1718,2,36000,1.00640279395
542329,542335,544050,6,1715,2,36000,1.00349854227
542423,542430,544197,7,1767,2,36000,1.00396151669
542438,542444,543613,6,1169,2,36000,1.00513259196
542453,542459,544076,6,1617,2,36000,1.00371057514
542468,542474,544309,6,1835,2,36000,1.00326975477
542504,542510,544144,6,1634,2,36000,1.00367197062
542552,542558,543786,6,1228,2,36000,1.00488599349
542637,542643,544362,6,1719,2,36000,1.0034904014
542638,542649,544364,11,1715,2,36000,1.00641399417
542652,542659,542739,7,80,1,1800,1.0875
542738,542749,544177,11,1428,2,36000,1.00770308123
542753,542759,544706,6,1947,2,36000,1.0030816641
542768,542774,544483,6,1709,2,36000,1.00351082504
542770,542780,544604,10,1824,2,36000,1.00548245614
542809,542815,544539,6,1724,2,36000,1.00348027842
542824,542830,544087,6,1257,2,36000,1.00477326969
542896,542902,544284,6,1382,2,36000,1.00434153401
542953,542959,544277,6,1318,2,36000,1.00455235205
543010,543016,544501,6,1485,2,36000,1.00404040404
543034,543041,544749,7,1708,2,36000,1.00409836066
543050,543056,545093,6,2037,2,36000,1.0029455081
543065,543071,545155,6,2084,2,36000,1.00287907869
543134,543140,544715,6,1575,2,36000,1.00380952381
543135,543146,544858,11,1712,2,36000,1.00642523364
543150,543156,544397,6,1241,2,36000,1.00483481064
543201,543207,545079,6,1872,2,36000,1.00320512821
543216,543222,545073,6,1851,2,36000,1.00324149109
543255,543261,544953,6,1692,2,36000,1.00354609929
543282,543288,545102,6,1814,2,36000,1.0033076075
543300,543306,545212,6,1906,2,36000,1.00314795383
543324,543330,545154,6,1824,2,36000,1.00328947368
543397,543403,544900,6,1497,2,36000,1.00400801603
543412,543418,545040,6,1622,2,36000,1.00369913687
543427,543433,544692,6,1259,2,36000,1.00476568705
543428,543439,545129,11,1690,2,36000,1.00650887574
543467,543474,544961,7,1487,2,36000,1.00470746469
543522,543528,545255,6,1727,2,36000,1.00347423277
543613,543619,544860,6,1241,2,36000,1.00483481064
543614,543625,545296,11,1671,2,36000,1.0065828845
543671,543677,545457,6,1780,2,36000,1.00337078652
543692,543698,545683,6,1985,2,36000,1.00302267003
543694,543705,545804,11,2099,2,36000,1.00524059076
543751,543757,544043,6,286,1,1800,1.02097902098
543760,543766,545534,6,1768,2,36000,1.00339366516
543787,543793,545230,6,1437,2,36000,1.00417536534
543820,543826,545116,6,1290,2,36000,1.00465116279
543932,543938,545560,6,1622,2,36000,1.00369913687
544043,544053,545700,10,1647,2,36000,1.00607164542
544058,544064,545683,6,1619,2,36000,1.00370599135
544079,544086,545559,7,1473,2,36000,1.00475220638
544094,544100,545805,6,1705,2,36000,1.00351906158
544145,544151,546019,6,1868,2,36000,1.00321199143
544178,544185,546148,7,1963,2,36000,1.00356597045
544193,544199,545526,6,1327,2,36000,1.00452147702
544208,544214,546460,6,2246,2,36000,1.00267141585
544277,544284,546076,7,1792,2,36000,1.00390625
544292,544298,545905,6,1607,2,36000,1.00373366521
544310,544316,545927,6,1611,2,36000,1.00372439479
544361,544368,546282,7,1914,2,36000,1.00365726228
544376,544382,545715,6,1333,2,36000,1.00450112528
544397,544403,546461,6,2058,2,36000,1.0029154519
544485,544491,545993,6,1502,2,36000,1.00399467377
544503,544509,546283,6,1774,2,36000,1.00338218715
544539,544545,546396,6,1851,2,36000,1.00324149109
544605,544611,546595,6,1984,2,36000,1.00302419355
544692,544698,546361,6,1663,2,36000,1.00360793746
544707,544713,546310,6,1597,2,36000,1.00375704446
544722,544728,546693,6,1965,2,36000,1.00305343511
544749,544756,546303,7,1547,2,36000,1.00452488688
544858,544864,546772,6,1908,2,36000,1.00314465409
544873,544879,546362,6,1483,2,36000,1.004045853
544900,544906,546335,6,1429,2,36000,1.00419874038
544954,544960,546296,6,1336,2,36000,1.00449101796
544969,544975,546699,6,1724,2,36000,1.00348027842
545042,545048,547127,6,2079,2,36000,1.00288600289
545075,545081,547164,6,2083,2,36000,1.00288046087
545090,545096,546831,6,1735,2,36000,1.00345821326
545105,545111,546956,6,1845,2,36000,1.00325203252
545106,545117,546707,11,1590,2,36000,1.00691823899
545121,545126,547057,5,1931,2,36000,1.00258933195
545136,545142,546553,6,1411,2,36000,1.00425230333
545154,545160,546709,6,1549,2,36000,1.00387346675
545169,545175,547068,6,1893,2,36000,1.00316957211
545214,545220,546454,6,1234,2,36000,1.00486223663
545232,545238,546634,6,1396,2,36000,1.00429799427
545256,545262,546805,6,1543,2,36000,1.00388852884
545301,545306,546874,5,1568,2,36000,1.00318877551
545458,545464,547251,6,1787,2,36000,1.00335758254
545527,545534,546570,7,1036,2,36000,1.00675675676
545542,545548,547403,6,1855,2,36000,1.00323450135
545560,545567,547495,7,1928,2,36000,1.00363070539
545562,545572,547634,10,2062,2,36000,1.00484966052
545683,545689,547418,6,1729,2,36000,1.003470214
545684,545695,547506,11,1811,2,36000,1.00607399227
545699,545705,547474,6,1769,2,36000,1.00339174675
545714,545720,547253,6,1533,2,36000,1.00391389432
545805,545811,547848,6,2037,2,36000,1.0029455081
545806,545817,547069,11,1252,2,36000,1.00878594249
545906,545912,547373,6,1461,2,36000,1.00410677618
545930,545936,547776,6,1840,2,36000,1.00326086957
545993,545999,547663,6,1664,2,36000,1.00360576923
546020,546026,547645,6,1619,2,36000,1.00370599135
546071,546078,547833,7,1755,2,36000,1.00398860399
546150,546156,548255,6,2099,2,36000,1.00285850405
546280,546286,548362,6,2076,2,36000,1.00289017341
546295,546301,548169,6,1868,2,36000,1.00321199143
546297,546307,548198,10,1891,2,36000,1.0052882073
546312,546318,547592,6,1274,2,36000,1.00470957614
546313,546324,547710,11,1386,2,36000,1.00793650794
546337,546343,548128,6,1785,2,36000,1.00336134454
546361,546368,548475,7,2107,2,36000,1.00332225914
546363,546374,548238,11,1864,2,36000,1.00590128755
546396,546402,548349,6,1947,2,36000,1.0030816641
546453,546459,548449,6,1990,2,36000,1.00301507538
546468,546474,548398,6,1924,2,36000,1.00311850312
546469,546480,547862,11,1382,2,36000,1.00795947902
546554,546560,548633,6,2073,2,36000,1.00289435601
546572,546578,548541,6,1963,2,36000,1.0030565461
546596,546602,548648,6,2046,2,36000,1.00293255132
546635,546641,548375,6,1734,2,36000,1.00346020761
546693,546699,548130,6,1431,2,36000,1.00419287212
546708,546714,548531,6,1817,2,36000,1.0033021464
546709,546720,548568,11,1848,2,36000,1.00595238095
546724,546730,548531,6,1801,2,36000,1.00333148251
546772,546778,548000,6,1222,2,36000,1.00490998363
546805,546812,548321,7,1509,2,36000,1.00463883366
546836,546842,548224,6,1382,2,36000,1.00434153401
546875,546881,548755,6,1874,2,36000,1.00320170758
546959,546966,548489,7,1523,2,36000,1.00459619173
547059,547065,548731,6,1666,2,36000,1.00360144058
547075,547080,548344,5,1264,2,36000,1.0039556962
547076,547086,548946,10,1860,2,36000,1.00537634409
547127,547133,548770,6,1637,2,36000,1.0036652413
547167,547173,549056,6,1883,2,36000,1.00318640467
547248,547254,548348,6,1094,2,36000,1.00548446069
547263,547269,548643,6,1374,2,36000,1.00436681223
547375,547381,548879,6,1498,2,36000,1.00400534045
547405,547411,548991,6,1580,2,36000,1.00379746835
547420,547426,549211,6,1785,2,36000,1.00336134454
547474,547480,548328,6,848,2,36000,1.0070754717
547495,547501,549064,6,1563,2,36000,1.00383877159
547510,547516,549419,6,1903,2,36000,1.00315291645
547592,547598,549258,6,1660,2,36000,1.00361445783
547634,547640,549057,6,1417,2,36000,1.00423429781
547649,547655,549717,6,2062,2,36000,1.00290979631
547664,547670,549653,6,1983,2,36000,1.00302571861
547712,547718,549723,6,2005,2,36000,1.0029925187
547778,547784,549099,6,1315,2,36000,1.00456273764
547836,547842,549826,6,1984,2,36000,1.00302419355
547851,547857,549353,6,1496,2,36000,1.00401069519
547866,547872,549766,6,1894,2,36000,1.00316789863
548002,548008,549783,6,1775,2,36000,1.00338028169
548129,548135,550251,6,2116,2,36000,1.00283553875
548144,548150,549679,6,1529,2,36000,1.00392413342
548171,548177,549907,6,1730,2,36000,1.00346820809
548198,548204,549915,6,1711,2,36000,1.00350672122
548225,548231,550211,6,1980,2,36000,1.00303030303
548240,548246,549701,6,1455,2,36000,1.00412371134
548255,548261,549393,6,1132,2,36000,1.00530035336
548321,548327,549748,6,1421,2,36000,1.00422237861
548336,548342,549835,6,1493,2,36000,1.00401875419
548351,548357,550226,6,1869,2,36000,1.00321027287
548353,548363,550239,10,1876,2,36000,1.00533049041
548354,548368,550353,14,1985,2,36000,1.00705289673
548369,548375,550148,6,1773,2,36000,1.00338409475
548384,548390,550378,6,1988,2,36000,1.00301810865
548399,548405,550129,6,1724,2,36000,1.00348027842
548447,548453,550252,6,1799,2,36000,1.00333518621
548477,548483,550480,6,1997,2,36000,1.00300450676
548492,548498,550450,6,1952,2,36000,1.00307377049
548534,548540,550271,6,1731,2,36000,1.00346620451
548536,548546,550618,10,2072,2,36000,1.00482625483
548550,548557,550285,7,1728,2,36000,1.00405092593
548568,548575,550315,7,1740,2,36000,1.00402298851
548632,548639,550605,7,1966,2,36000,1.00356052899
548647,548654,549900,7,1246,2,36000,1.00561797753
548649,548660,550713,11,2053,2,36000,1.00535801266
548734,548740,550720,6,1980,2,36000,1.00303030303
548755,548761,550487,6,1726,2,36000,1.00347624565
548773,548779,550497,6,1718,2,36000,1.00349243306
548879,548885,550539,6,1654,2,36000,1.00362756953
548948,548954,550794,6,1840,2,36000,1.00326086957
548990,548997,551121,7,2124,2,36000,1.00329566855
549057,549063,550873,6,1810,2,36000,1.00331491713
549058,549069,550677,11,1608,2,36000,1.00684079602
549073,549079,551110,6,2031,2,36000,1.00295420975
549100,549106,550753,6,1647,2,36000,1.00364298725
549213,549219,551163,6,1944,2,36000,1.00308641975
549258,549264,551362,6,2098,2,36000,1.00285986654
549355,549361,551313,6,1952,2,36000,1.00307377049
549394,549400,551089,6,1689,2,36000,1.00355239787
549421,549427,551361,6,1934,2,36000,1.00310237849
549655,549661,551543,6,1882,2,36000,1.00318809777
549682,549688,551550,6,1862,2,36000,1.00322234157
549703,549709,551247,6,1538,2,36000,1.00390117035
549718,549724,551451,6,1727,2,36000,1.00347423277
549733,549739,551043,6,1304,2,36000,1.00460122699
549750,549757,551475,7,1718,2,36000,1.00407450524
549768,549775,550953,7,1178,2,36000,1.00594227504
549783,549789,551472,6,1683,2,36000,1.00356506239
549825,549832,551639,7,1807,2,36000,1.00387382402
549840,549846,551488,6,1642,2,36000,1.00365408039
549901,549907,551730,6,1823,2,36000,1.00329127811
549916,549922,551963,6,2041,2,36000,1.00293973542
549917,549928,551686,11,1758,2,36000,1.00625711035
550129,550135,551925,6,1790,2,36000,1.00335195531
550150,550156,551736,6,1580,2,36000,1.00379746835
550210,550217,551905,7,1688,2,36000,1.00414691943
550225,550232,552285,7,2053,2,36000,1.00340964442
550240,550246,551585,6,1339,2,36000,1.00448095594
550255,550261,552159,6,1898,2,36000,1.00316122234
550257,550268,551759,11,1491,2,36000,1.00737759893
550272,550278,551834,6,1556,2,36000,1.00385604113
550287,550293,551837,6,1544,2,36000,1.00388601036
550317,550323,551884,6,1561,2,36000,1.00384368994
550353,550359,552012,6,1653,2,36000,1.00362976407
550380,550386,552304,6,1918,2,36000,1.0031282586
550452,550458,552393,6,1935,2,36000,1.00310077519
550483,550489,552261,6,1772,2,36000,1.00338600451
550498,550504,552243,6,1739,2,36000,1.00345025877
550499,550510,552048,11,1538,2,36000,1.00715214564
550539,550545,551767,6,1222,2,36000,1.00490998363
550605,550611,552401,6,1790,2,36000,1.00335195531
550620,550626,552523,6,1897,2,36000,1.00316288877
550678,550684,551801,6,1117,2,36000,1.00537153089
550714,550720,552828,6,2108,2,36000,1.00284629981
550729,550735,552636,6,1901,2,36000,1.00315623356
550753,550759,552534,6,1775,2,36000,1.00338028169
550795,550802,552286,7,1484,2,36000,1.00471698113
550874,550880,552184,6,1304,2,36000,1.00460122699
550953,550959,552604,6,1645,2,36000,1.00364741641
551044,551050,552996,6,1946,2,36000,1.00308324769
551089,551095,553050,6,1955,2,36000,1.00306905371
551110,551116,552964,6,1848,2,36000,1.00324675325
551125,551131,553178,6,2047,2,36000,1.00293111871
551164,551170,553055,6,1885,2,36000,1.00318302387
551248,551255,553135,7,1880,2,36000,1.00372340426
551315,551321,553052,6,1731,2,36000,1.00346620451
551361,551367,552888,6,1521,2,36000,1.00394477318
551375,551382,553397,7,2015,2,36000,1.00347394541
551452,551458,552803,6,1345,2,36000,1.00446096654
551473,551480,553184,7,1704,2,36000,1.00410798122
551489,551495,552880,6,1385,2,36000,1.00433212996
551490,551501,553348,11,1847,2,36000,1.00595560368
551545,551551,553248,6,1697,2,36000,1.00353565115
551559,551566,552761,7,1195,2,36000,1.00585774059
551587,551593,553477,6,1884,2,36000,1.00318471338
551641,551647,553925,6,2278,2,36000,1.00263388938
551686,551692,553474,6,1782,2,36000,1.00336700337
551732,551738,553681,6,1943,2,36000,1.00308800823
551747,551753,553504,6,1751,2,36000,1.00342661336
551762,551768,553421,6,1653,2,36000,1.00362976407
551777,551783,553616,6,1833,2,36000,1.00327332242
551801,551807,553617,6,1810,2,36000,1.00331491713
551834,551840,553728,6,1888,2,36000,1.0031779661
551849,551855,553529,6,1674,2,36000,1.00358422939
551885,551891,553390,6,1499,2,36000,1.00400266845
551906,551912,553730,6,1818,2,36000,1.00330033003
551928,551934,553541,6,1607,2,36000,1.00373366521
551964,551970,553207,6,1237,2,36000,1.00485044462
552012,552019,554088,7,2069,2,36000,1.00338327695
552048,552055,553646,7,1591,2,36000,1.00439974859
552160,552166,553888,6,1722,2,36000,1.00348432056
552184,552190,553366,6,1176,2,36000,1.00510204082
552244,552251,554240,7,1989,2,36000,1.00351935646
552263,552269,554045,6,1776,2,36000,1.00337837838
552287,552293,554369,6,2076,2,36000,1.00289017341
552288,552299,554239,11,1940,2,36000,1.00567010309
552306,552312,553918,6,1606,2,36000,1.00373599004
552394,552400,554303,6,1903,2,36000,1.00315291645
552409,552415,554341,6,1926,2,36000,1.0031152648
552524,552530,554165,6,1635,2,36000,1.00366972477
552539,552545,554492,6,1947,2,36000,1.0030816641
552605,552611,554510,6,1899,2,36000,1.00315955766
552639,552645,554220,6,1575,2,36000,1.00380952381
552757,552763,554630,6,1867,2,36000,1.00321371184
552805,552811,554806,6,1995,2,36000,1.0030075188
552829,552835,554259,6,1424,2,36000,1.00421348315
552881,552887,554637,6,1750,2,36000,1.00342857143
552896,552902,554747,6,1845,2,36000,1.00325203252
552965,552971,554387,6,1416,2,36000,1.00423728814
552998,553004,554898,6,1894,2,36000,1.00316789863
553050,553056,554855,6,1799,2,36000,1.00333518621
553065,553071,555049,6,1978,2,36000,1.00303336704
553066,553077,555020,11,1943,2,36000,1.00566134843
553136,553142,554929,6,1787,2,36000,1.00335758254
553178,553184,554870,6,1686,2,36000,1.00355871886
553193,553199,555438,6,2239,2,36000,1.00267976775
553208,553214,554843,6,1629,2,36000,1.00368324125
553247,553254,555125,7,1871,2,36000,1.0037413148
553350,553356,555236,6,1880,2,36000,1.00319148936
553368,553375,555288,7,1913,2,36000,1.00365917407
553385,553391,591182,6,37791,1,90000,1.00015876796
553393,553399,555033,6,1634,2,36000,1.00367197062
553408,553414,555582,6,2168,2,36000,1.00276752768
553423,553429,554798,6,1369,2,36000,1.00438276114
553474,553480,555397,6,1917,2,36000,1.00312989045
553489,553495,555338,6,1843,2,36000,1.00325556158
553504,553510,555157,6,1647,2,36000,1.00364298725
553531,553537,554716,6,1179,2,36000,1.00508905852
553538,553544,608817,6,55273,1,90000,1.0001085521
553546,553552,555401,6,1849,2,36000,1.0032449973
553596,553602,602492,6,48890,1,90000,1.00012272448
553619,553625,555462,6,1837,2,36000,1.00326619488
553620,553631,555466,11,1835,2,36000,1.00599455041
553627,553637,733678,10,180041,1,180000,1.0000555429
553647,553653,555418,6,1765,2,36000,1.00339943343
553683,553690,555402,7,1712,2,36000,1.00408878505
553729,553735,555194,6,1459,2,36000,1.00411240576
553744,553750,555659,6,1909,2,36000,1.00314300681
553889,553895,555224,6,1329,2,36000,1.00451467269
553920,553926,555846,6,1920,2,36000,1.003125
553934,553941,555873,7,1932,2,36000,1.00362318841
554043,554049,556016,6,1967,2,36000,1.00305033045
554089,554095,555746,6,1651,2,36000,1.00363416111
554164,554171,555904,7,1733,2,36000,1.00403923832
554222,554228,555787,6,1559,2,36000,1.00384862091
554241,554247,556218,6,1971,2,36000,1.00304414003
554242,554253,556024,11,1771,2,36000,1.00621118012
554260,554266,556313,6,2047,2,36000,1.00293111871
554305,554311,556267,6,1956,2,36000,1.00306748466
554342,554348,555714,6,1366,2,36000,1.00439238653
554369,554375,556253,6,1878,2,36000,1.00319488818
554387,554393,555717,6,1324,2,36000,1.00453172205
554493,554499,555819,6,1320,2,36000,1.00454545455
554511,554517,555940,6,1423,2,36000,1.00421644413
554632,554638,556489,6,1851,2,36000,1.00324149109
554647,554653,556751,6,2098,2,36000,1.00285986654
554717,554723,556816,6,2093,2,36000,1.00286669852
554750,554756,556532,6,1776,2,36000,1.00337837838
554799,554805,556898,6,2093,2,36000,1.00286669852
554814,554820,556708,6,1888,2,36000,1.0031779661
554844,554850,556800,6,1950,2,36000,1.00307692308
554859,554865,556215,6,1350,2,36000,1.00444444444
554874,554880,556714,6,1834,2,36000,1.00327153762
554898,554904,556756,6,1852,2,36000,1.00323974082
554931,554937,556831,6,1894,2,36000,1.00316789863
555022,555028,556839,6,1811,2,36000,1.00331308669
555037,555043,556881,6,1838,2,36000,1.00326441785
555052,555058,556633,6,1575,2,36000,1.00380952381
555124,555130,557011,6,1881,2,36000,1.00318979266
555158,555164,556424,6,1260,2,36000,1.00476190476
555194,555200,556564,6,1364,2,36000,1.00439882698
555224,555230,557331,6,2101,2,36000,1.00285578296
555239,555245,557117,6,1872,2,36000,1.00320512821
555287,555294,557573,7,2279,2,36000,1.0030715226
555336,555342,557194,6,1852,2,36000,1.00323974082
555400,555406,556930,6,1524,2,36000,1.00393700787
555415,555421,556475,6,1054,2,36000,1.00569259962
555416,555427,557138,11,1711,2,36000,1.0064289889
555432,555438,557202,6,1764,2,36000,1.00340136054
555447,555453,557416,6,1963,2,36000,1.0030565461
555461,555468,556788,7,1320,2,36000,1.0053030303
555476,555483,557174,7,1691,2,36000,1.00413956239
555583,555589,557434,6,1845,2,36000,1.00325203252
555659,555665,557575,6,1910,2,36000,1.00314136126
555717,555723,556883,6,1160,2,36000,1.00517241379
555718,555729,557686,11,1957,2,36000,1.00562084824
555746,555752,557054,6,1302,2,36000,1.00460829493
555788,555794,557291,6,1497,2,36000,1.00400801603
555821,555827,557396,6,1569,2,36000,1.00382409178
555845,555852,557359,7,1507,2,36000,1.00464499005
555873,555879,557829,6,1950,2,36000,1.00307692308
555905,555912,557991,7,2079,2,36000,1.00336700337
555942,555948,557789,6,1841,2,36000,1.00325909832
556018,556024,557577,6,1553,2,36000,1.00386349002
556033,556039,557486,6,1447,2,36000,1.00414651002
556216,556222,558301,6,2079,2,36000,1.00288600289
556231,556237,558028,6,1791,2,36000,1.00335008375
556255,556261,558072,6,1811,2,36000,1.00331308669
556270,556276,558199,6,1923,2,36000,1.0031201248
556313,556319,558179,6,1860,2,36000,1.00322580645
556425,556431,558280,6,1849,2,36000,1.0032449973
556476,556482,558296,6,1814,2,36000,1.0033076075
556491,556497,558040,6,1543,2,36000,1.00388852884
556533,556539,558610,6,2071,2,36000,1.00289715113
556567,556573,558178,6,1605,2,36000,1.00373831776
556633,556639,558246,6,1607,2,36000,1.00373366521
556709,556715,558436,6,1721,2,36000,1.00348634515
556724,556730,558404,6,1674,2,36000,1.00358422939
556751,556757,558372,6,1615,2,36000,1.00371517028
556766,556772,558571,6,1799,2,36000,1.00333518621
556790,556796,558538,6,1742,2,36000,1.00344431688
556805,556811,558373,6,1562,2,36000,1.00384122919
556820,556826,558244,6,1418,2,36000,1.00423131171
556835,556841,558792,6,1951,2,36000,1.00307534598
556850,556856,558476,6,1620,2,36000,1.0037037037
556883,556890,558515,7,1625,2,36000,1.00430769231
556885,556896,558680,11,1784,2,36000,1.00616591928
556900,556906,558721,6,1815,2,36000,1.00330578512
556930,556936,558669,6,1733,2,36000,1.00346220427
557011,557018,558448,7,1430,2,36000,1.0048951049
557054,557060,558893,6,1833,2,36000,1.00327332242
557117,557124,558641,7,1517,2,36000,1.00461437047
557139,557145,558655,6,1510,2,36000,1.00397350993
557175,557181,558996,6,1815,2,36000,1.00330578512
557196,557202,558855,6,1653,2,36000,1.00362976407
557211,557217,558804,6,1587,2,36000,1.00378071834
557293,557299,558700,6,1401,2,36000,1.00428265525
557332,557339,559300,7,1961,2,36000,1.00356960734
557360,557366,559126,6,1760,2,36000,1.00340909091
557399,557405,559176,6,1771,2,36000,1.00338791643
557417,557423,559302,6,1879,2,36000,1.00319318787
557435,557441,559410,6,1969,2,36000,1.0030472321
557487,557493,559360,6,1867,2,36000,1.00321371184
557576,557582,558836,6,1254,2,36000,1.004784689
557577,557588,559404,11,1816,2,36000,1.00605726872
557592,557598,559367,6,1769,2,36000,1.00339174675
557686,557692,559599,6,1907,2,36000,1.00314630309
557790,557797,559613,7,1816,2,36000,1.00385462555
557830,557836,559769,6,1933,2,36000,1.00310398345
557991,557998,559263,7,1265,2,36000,1.00553359684
558028,558034,559791,6,1757,2,36000,1.00341491178
558044,558050,558847,6,797,2,36000,1.00752823087
558075,558081,559854,6,1773,2,36000,1.00338409475
558180,558186,559718,6,1532,2,36000,1.00391644909
558181,558192,560018,11,1826,2,36000,1.00602409639
558199,558206,559604,7,1398,2,36000,1.00500715308
558236,558242,572991,6,14749,32,356400,1.00040680724
558245,558251,559634,6,1383,2,36000,1.00433839479
558247,558257,559993,10,1736,2,36000,1.00576036866
558281,558287,559965,6,1678,2,36000,1.00357568534
558296,558302,560124,6,1822,2,36000,1.00329308452
558311,558317,559871,6,1554,2,36000,1.00386100386
558372,558378,560341,6,1963,2,36000,1.0030565461
558387,558393,560101,6,1708,2,36000,1.00351288056
558405,558411,560057,6,1646,2,36000,1.00364520049
558438,558444,560288,6,1844,2,36000,1.0032537961
558454,558459,559820,5,1361,2,36000,1.00367376929
558480,558486,559691,6,1205,2,36000,1.00497925311
558516,558522,559982,6,1460,2,36000,1.00410958904
558540,558546,560499,6,1953,2,36000,1.00307219662
558573,558580,560447,7,1867,2,36000,1.00374933048
558613,558619,560397,6,1778,2,36000,1.00337457818
558643,558650,560016,7,1366,2,36000,1.00512445095
558659,558665,560048,6,1383,2,36000,1.00433839479
558675,558681,560417,6,1736,2,36000,1.0034562212
558690,558696,560498,6,1802,2,36000,1.00332963374
558705,558711,560479,6,1768,2,36000,1.00339366516
558723,558729,560255,6,1526,2,36000,1.00393184797
558766,558772,935272,6,376500,1,576000,1.00001593625
558793,558799,560057,6,1258,2,36000,1.00476947536
558810,558816,560758,6,1942,2,36000,1.00308959835
558837,558844,560363,7,1519,2,36000,1.00460829493
558853,558858,560485,5,1627,2,36000,1.00307314075
558869,558876,560587,7,1711,2,36000,1.00409117475
558896,558902,560668,6,1766,2,36000,1.00339750849
558996,559002,560904,6,1902,2,36000,1.00315457413
559047,559054,559134,7,80,1,576000,1.0875
559111,559118,559631,7,513,1,576000,1.01364522417
559127,559133,561017,6,1884,2,36000,1.00318471338
559155,559161,559289,6,128,1,576000,1.046875
559178,559184,560994,6,1810,2,36000,1.00331491713
559263,559269,561045,6,1776,2,36000,1.00337837838
559288,559294,559647,6,353,1,576000,1.01699716714
559300,559306,561309,6,2003,2,36000,1.00299550674
559315,559321,560555,6,1234,2,36000,1.00486223663
559363,559369,561222,6,1853,2,36000,1.00323799244
559378,559384,561235,6,1851,2,36000,1.00324149109
559405,559411,560901,6,1490,2,36000,1.00402684564
559420,559426,560635,6,1209,2,36000,1.00496277916
559555,559561,575561,6,16000,1,576000,1.000375
559602,559608,561501,6,1893,2,36000,1.00316957211
559620,559625,561256,5,1631,2,36000,1.00306560392
559621,559631,561495,10,1864,2,36000,1.00536480687
559636,559642,561646,6,2004,2,36000,1.00299401198
559644,559650,720837,6,161187,1,576000,1.00003722385
559659,559665,882627,6,322962,1,576000,1.00001857804
559692,559698,560897,6,1199,2,36000,1.00500417014
559719,559726,561252,7,1526,2,36000,1.00458715596
559771,559777,561619,6,1842,2,36000,1.00325732899
559792,559798,561519,6,1721,2,36000,1.00348634515
559820,559826,561601,6,1775,2,36000,1.00338028169
559856,559862,561185,6,1323,2,36000,1.00453514739
559871,559877,561585,6,1708,2,36000,1.00351288056
559965,559971,561733,6,1762,2,36000,1.00340522134
559983,559989,562094,6,2105,2,36000,1.00285035629
559998,560004,561748,6,1744,2,36000,1.00344036697
560016,560022,561713,6,1691,2,36000,1.00354819633
560032,560038,561511,6,1473,2,36000,1.00407331976
560050,560056,561232,6,1176,2,36000,1.00510204082
560065,560071,561122,6,1051,2,36000,1.00570884872
560066,560077,561828,11,1751,2,36000,1.0062821245
560103,560109,561576,6,1467,2,36000,1.00408997955
560127,560133,561923,6,1790,2,36000,1.00335195531
560255,560260,561732,5,1472,2,36000,1.00339673913
560288,560294,561801,6,1507,2,36000,1.00398142004
560343,560349,562283,6,1934,2,36000,1.00310237849
560364,560370,562109,6,1739,2,36000,1.00345025877
560397,560403,562110,6,1707,2,36000,1.00351493849
560418,560424,562175,6,1751,2,36000,1.00342661336
560448,560454,562317,6,1863,2,36000,1.00322061192
560482,560488,561944,6,1456,2,36000,1.00412087912
560496,560502,562293,6,1791,2,36000,1.00335008375
560511,560518,561898,7,1380,2,36000,1.00507246377
560513,560524,562726,11,2202,2,36000,1.00499545867
560555,560561,561805,6,1244,2,36000,1.00482315113
560589,560595,561824,6,1229,2,36000,1.0048820179
560637,560643,562375,6,1732,2,36000,1.00346420323
560670,560676,562441,6,1765,2,36000,1.00339943343
560759,560765,562700,6,1935,2,36000,1.00310077519
560896,560902,562558,6,1656,2,36000,1.00362318841
560911,560917,562687,6,1770,2,36000,1.00338983051
560912,560923,562704,11,1781,2,36000,1.00617630545
560994,561000,562903,6,1903,2,36000,1.00315291645
561018,561024,562774,6,1750,2,36000,1.00342857143
561045,561051,562928,6,1877,2,36000,1.0031965903
561124,561130,562333,6,1203,2,36000,1.00498753117
561185,561191,562893,6,1702,2,36000,1.00352526439
561224,561231,563029,7,1798,2,36000,1.00389321468
561240,561245,562758,5,1513,2,36000,1.00330469266
561241,561252,563035,11,1783,2,36000,1.00616937745
561257,561263,562681,6,1418,2,36000,1.00423131171
561258,561269,562570,11,1301,2,36000,1.00845503459
561309,561315,563183,6,1868,2,36000,1.00321199143
561498,561503,562763,5,1260,2,36000,1.00396825397
561513,561519,562756,6,1237,2,36000,1.00485044462
561515,561525,562954,10,1429,2,36000,1.00699790063
561529,561536,563458,7,1922,2,36000,1.00364203954
561578,561584,562998,6,1414,2,36000,1.00424328147
561593,561599,563359,6,1760,2,36000,1.00340909091
561608,561614,563563,6,1949,2,36000,1.0030785018
561623,561629,563776,6,2147,2,36000,1.00279459711
561647,561654,563519,7,1865,2,36000,1.00375335121
561714,561720,563283,6,1563,2,36000,1.00383877159
561732,561739,563523,7,1784,2,36000,1.00392376682
561734,561744,563188,10,1444,2,36000,1.00692520776
561749,561755,563196,6,1441,2,36000,1.00416377516
561803,561809,562969,6,1160,2,36000,1.00517241379
561818,561824,563589,6,1765,2,36000,1.00339943343
561834,561840,563273,6,1433,2,36000,1.00418702024
561835,561846,563525,11,1679,2,36000,1.00655151876
561899,561905,563164,6,1259,2,36000,1.00476568705
561926,561932,563644,6,1712,2,36000,1.0035046729
561944,561950,564042,6,2092,2,36000,1.00286806883
562094,562100,563897,6,1797,2,36000,1.00333889816
562109,562115,563819,6,1704,2,36000,1.00352112676
562124,562130,564040,6,1910,2,36000,1.00314136126
562175,562181,563969,6,1788,2,36000,1.0033557047
562285,562291,563845,6,1554,2,36000,1.00386100386
562300,562306,564332,6,2026,2,36000,1.00296150049
562318,562325,563960,7,1635,2,36000,1.00428134557
562333,562340,564085,7,1745,2,36000,1.00401146132
562376,562382,564063,6,1681,2,36000,1.00356930399
562442,562449,564577,7,2128,2,36000,1.00328947368
562561,562567,564294,6,1727,2,36000,1.00347423277
562576,562581,564596,5,2015,2,36000,1.00248138958
562682,562688,564159,6,1471,2,36000,1.00407885792
562697,562703,563978,6,1275,2,36000,1.00470588235
562712,562718,564159,6,1441,2,36000,1.00416377516
562713,562724,564409,11,1685,2,36000,1.00652818991
562729,562735,564723,6,1988,2,36000,1.00301810865
562756,562762,564087,6,1325,2,36000,1.00452830189
562771,562777,564714,6,1937,2,36000,1.00309757357
562773,562783,564323,10,1540,2,36000,1.00649350649
562787,562794,564708,7,1914,2,36000,1.00365726228
562894,562900,564675,6,1775,2,36000,1.00338028169
562909,562915,563977,6,1062,2,36000,1.00564971751
562927,562933,564586,6,1653,2,36000,1.00362976407
562955,562961,565094,6,2133,2,36000,1.00281293952
562969,562976,564466,7,1490,2,36000,1.00469798658
563000,563006,564956,6,1950,2,36000,1.00307692308
563030,563036,564549,6,1513,2,36000,1.0039656312
563045,563051,565619,6,2568,2,36000,1.0023364486
563164,563170,565207,6,2037,2,36000,1.0029455081
563185,563191,564977,6,1786,2,36000,1.00335946249
563200,563206,564570,6,1364,2,36000,1.00439882698
563202,563212,564816,10,1604,2,36000,1.00623441397
563274,563280,565168,6,1888,2,36000,1.0031779661
563289,563295,564598,6,1303,2,36000,1.00460475825
563359,563365,565137,6,1772,2,36000,1.00338600451
563459,563465,565060,6,1595,2,36000,1.00376175549
563520,563526,564918,6,1392,2,36000,1.00431034483
563535,563541,565399,6,1858,2,36000,1.00322927879
563536,563547,564855,11,1308,2,36000,1.00840978593
563564,563570,564946,6,1376,2,36000,1.00436046512
563591,563597,565299,6,1702,2,36000,1.00352526439
563645,563651,565067,6,1416,2,36000,1.00423728814
563776,563782,565438,6,1656,2,36000,1.00362318841
563818,563825,565824,7,1999,2,36000,1.00350175088
563846,563852,565500,6,1648,2,36000,1.0036407767
563894,563901,565163,7,1262,2,36000,1.00554675119
563961,563967,565663,6,1696,2,36000,1.00353773585
563976,563983,565825,7,1842,2,36000,1.00380021716
563978,563988,565423,10,1435,2,36000,1.00696864111
563979,563994,565407,15,1413,2,36000,1.01061571125
564040,564047,565769,7,1722,2,36000,1.00406504065
564056,564062,565594,6,1532,2,36000,1.00391644909
564072,564078,565804,6,1726,2,36000,1.00347624565
564087,564094,566232,7,2138,2,36000,1.00327408793
564089,564099,565471,10,1372,2,36000,1.00728862974
564162,564168,566214,6,2046,2,36000,1.00293255132
564163,564174,565409,11,1235,2,36000,1.00890688259
564293,564300,565533,7,1233,2,36000,1.00567721006
564324,564330,565838,6,1508,2,36000,1.00397877984
564339,564345,565908,6,1563,2,36000,1.00383877159
564409,564415,566236,6,1821,2,36000,1.00329489292
564466,564472,566036,6,1564,2,36000,1.00383631714
564548,564555,566214,7,1659,2,36000,1.00421940928
564570,564576,566411,6,1835,2,36000,1.00326975477
564585,564591,566437,6,1846,2,36000,1.00325027086
564600,564606,566399,6,1793,2,36000,1.0033463469
564602,564612,566395,10,1783,2,36000,1.00560852496
564603,564617,565856,14,1239,2,36000,1.01129943503
564673,564679,566542,6,1863,2,36000,1.00322061192
564709,564715,566598,6,1883,2,36000,1.00318640467
564724,564730,566514,6,1784,2,36000,1.0033632287
564726,564736,566271,10,1535,2,36000,1.00651465798
564816,564822,566862,6,2040,2,36000,1.00294117647
564856,564862,566142,6,1280,2,36000,1.0046875
564919,564925,566715,6,1790,2,36000,1.00335195531
564947,564953,566897,6,1944,2,36000,1.00308641975
564962,564968,567388,6,2420,2,36000,1.00247933884
564977,564983,566505,6,1522,2,36000,1.00394218134
565062,565068,566848,6,1780,2,36000,1.00337078652
565077,565083,566521,6,1438,2,36000,1.00417246175
565095,565101,566844,6,1743,2,36000,1.00344234079
565140,565146,566464,6,1318,2,36000,1.00455235205
565164,565170,566973,6,1803,2,36000,1.00332778702
565179,565185,566717,6,1532,2,36000,1.00391644909
565207,565213,566829,6,1616,2,36000,1.00371287129
565300,565307,567336,7,2029,2,36000,1.00344997536
565400,565407,567234,7,1827,2,36000,1.00383141762
565416,565422,567285,6,1863,2,36000,1.00322061192
565417,565428,566980,11,1552,2,36000,1.00708762887
565432,565438,567270,6,1832,2,36000,1.00327510917
565447,565453,567190,6,1737,2,36000,1.00345423143
565471,565477,567221,6,1744,2,36000,1.00344036697
565502,565508,567521,6,2013,2,36000,1.00298062593
565535,565541,566968,6,1427,2,36000,1.00420462509
565596,565602,567370,6,1768,2,36000,1.00339366516
565617,565623,567576,6,1953,2,36000,1.00307219662
565665,565671,567123,6,1452,2,36000,1.0041322314
565775,565780,567438,5,1658,2,36000,1.00301568154
565776,565786,567566,10,1780,2,36000,1.00561797753
565777,565791,567472,14,1681,2,36000,1.00832837597
565778,565796,567705,18,1909,2,36000,1.00942902043
565780,565802,567500,22,1698,2,36000,1.01295641932
565781,565808,567323,27,1515,2,36000,1.01782178218
565782,565813,567061,31,1248,2,36000,1.02483974359
565784,565818,567165,34,1347,2,36000,1.02524127691
565785,565823,568605,38,2782,2,36000,1.01365923796
565786,565828,567807,42,1979,2,36000,1.02122283982
565788,565834,567751,46,1917,2,36000,1.02399582681
565789,565839,567772,50,1933,2,36000,1.02586652871
565790,565844,567308,54,1464,2,36000,1.0368852459
565792,565849,567756,57,1907,2,36000,1.02988987939
565793,565854,567585,61,1731,2,36000,1.03523974581
565794,565860,567723,66,1863,2,36000,1.03542673108
565796,565865,567060,69,1195,2,36000,1.05774058577
565797,565870,567181,73,1311,2,36000,1.05568268497
565798,565875,567151,77,1276,2,36000,1.06034482759
565799,565880,567935,81,2055,2,36000,1.03941605839
565801,565886,567911,85,2025,2,36000,1.04197530864
565802,565891,567801,89,1910,2,36000,1.04659685864
565803,565897,567602,94,1705,2,36000,1.05513196481
565805,565902,567736,97,1834,2,36000,1.05288985823
565806,565908,567585,102,1677,2,36000,1.06082289803
565807,565913,567669,106,1756,2,36000,1.06036446469
565809,565918,567925,109,2007,2,36000,1.0543099153
565810,565923,567494,113,1571,2,36000,1.07192870783
565811,565928,567722,117,1794,2,36000,1.0652173913
565813,565934,567466,121,1532,2,36000,1.07898172324
565814,565939,567512,125,1573,2,36000,1.07946598856
565815,565944,567264,129,1320,2,36000,1.09772727273
565816,565949,567801,133,1852,2,36000,1.07181425486
565818,565954,567863,136,1909,2,36000,1.07124148769
565819,565960,567461,141,1501,2,36000,1.09393737508
565820,565965,567916,145,1951,2,36000,1.0743208611
565822,565972,567814,150,1842,2,36000,1.08143322476
565823,565978,567713,155,1735,2,36000,1.08933717579
565825,565983,567496,158,1513,2,36000,1.10442828817
565826,565988,567861,162,1873,2,36000,1.08649225841
565827,565993,567753,166,1760,2,36000,1.09431818182
565829,565998,567747,169,1749,2,36000,1.0966266438
565830,566004,567750,174,1746,2,36000,1.09965635739
565831,566009,567790,178,1781,2,36000,1.09994385177
565832,566014,567463,182,1449,2,36000,1.12560386473
565834,566019,567982,185,1963,2,36000,1.09424350484
565835,566024,567898,189,1874,2,36000,1.10085378869
565837,566029,567793,192,1764,2,36000,1.10884353741
565838,566037,567424,199,1387,2,36000,1.14347512617
565839,566042,567918,203,1876,2,36000,1.10820895522
565841,566047,567289,206,1242,2,36000,1.16586151369
565858,566052,567891,194,1839,2,36000,1.10549211528
565859,566058,568104,199,2046,2,36000,1.0972629521
565860,566063,567894,203,1831,2,36000,1.11086837794
565862,566068,567897,206,1829,2,36000,1.11262985238
565863,566079,567501,216,1422,2,36000,1.15189873418
565909,566074,568176,165,2102,2,36000,1.07849666984
566038,566153,567977,115,1824,2,36000,1.06304824561
566142,566225,567811,83,1586,2,36000,1.05233291299
566215,566230,567647,15,1417,2,36000,1.01058574453
566217,566243,567867,26,1624,2,36000,1.01600985222
566232,566249,568234,17,1985,2,36000,1.00856423174
566247,566282,568312,35,2030,2,36000,1.01724137931
566271,566406,567924,135,1518,2,36000,1.08893280632
566397,566412,568313,15,1901,2,36000,1.0078905839
566412,566423,568165,11,1742,2,36000,1.00631458094
566413,566448,568216,35,1768,2,36000,1.01979638009
566438,566475,567989,37,1514,2,36000,1.02443857332
566465,566516,568388,51,1872,2,36000,1.02724358974
566508,566525,568488,17,1963,2,36000,1.00866021396
566523,566533,568359,10,1826,2,36000,1.00547645126
566525,566554,568425,29,1871,2,36000,1.01549973276
566543,566609,568021,66,1412,2,36000,1.04674220963
566597,566726,568640,129,1914,2,36000,1.06739811912
566715,566732,568239,17,1507,2,36000,1.01128069011
566730,566840,568359,110,1519,2,36000,1.0724160632
566830,566855,568524,25,1669,2,36000,1.01497902936
566846,566861,568405,15,1544,2,36000,1.00971502591
566861,566873,568586,12,1713,2,36000,1.00700525394
566877,566909,568284,32,1375,2,36000,1.02327272727
566898,566979,568360,81,1381,2,36000,1.05865314989
566968,566985,568841,17,1856,2,36000,1.00915948276
566984,566991,568824,7,1833,2,36000,1.00381887616
566985,567071,569103,86,2032,2,36000,1.04232283465
567061,567078,568511,17,1433,2,36000,1.01186322401
567062,567134,568723,72,1589,2,36000,1.04531151668
567123,567162,569004,39,1842,2,36000,1.02117263844
567151,567176,568649,25,1473,2,36000,1.01697216565
567166,567192,569168,26,1976,2,36000,1.01315789474
567181,567201,568450,20,1249,2,36000,1.01601281025
567197,567232,569022,35,1790,2,36000,1.01955307263
567221,567245,568665,24,1420,2,36000,1.01690140845
567236,567276,569012,40,1736,2,36000,1.02304147465
567263,567282,569188,19,1906,2,36000,1.00996852046
567279,567296,569187,17,1891,2,36000,1.00898995241
567294,567302,569072,8,1770,2,36000,1.00451977401
567295,567319,568672,24,1353,2,36000,1.0177383592
567310,567334,569252,24,1918,2,36000,1.01251303441
567325,567347,569381,22,2034,2,36000,1.01081612586
567340,567382,569209,42,1827,2,36000,1.02298850575
567371,567400,569327,29,1927,2,36000,1.01504929943
567389,567435,569544,46,2109,2,36000,1.02181128497
567423,567450,568699,27,1249,2,36000,1.02161729384
567441,567472,569174,31,1702,2,36000,1.01821386604
567459,567478,568721,19,1243,2,36000,1.01528559936
567460,567483,569458,23,1975,2,36000,1.01164556962
567476,567489,569742,13,2253,2,36000,1.00577008433
567477,567506,569332,29,1826,2,36000,1.01588170865
567497,567513,569253,16,1740,2,36000,1.0091954023
567498,567518,569185,20,1667,2,36000,1.01199760048
567514,567524,568990,10,1466,2,36000,1.0068212824
567515,567529,569299,14,1770,2,36000,1.00790960452
567516,567535,569164,19,1629,2,36000,1.0116635973
567531,567577,569417,46,1840,2,36000,1.025
567568,567587,569756,19,2169,2,36000,1.00875979714
567584,567596,569547,12,1951,2,36000,1.00615069195
567585,567602,568724,17,1122,2,36000,1.01515151515
567586,567613,569450,27,1837,2,36000,1.01469787697
567604,567658,569554,54,1896,2,36000,1.02848101266
567647,567680,569670,33,1990,2,36000,1.01658291457
567671,567716,569477,45,1761,2,36000,1.02555366269
567705,567724,569224,19,1500,2,36000,1.01266666667
567720,567733,569644,13,1911,2,36000,1.00680272109
567722,567739,569205,17,1466,2,36000,1.01159618008
567737,567748,569317,11,1569,2,36000,1.00701083493
567738,567758,569893,20,2135,2,36000,1.0093676815
567755,567764,569243,9,1479,2,36000,1.0060851927
567756,567769,569106,13,1337,2,36000,1.00972326103
567757,567775,569159,18,1384,2,36000,1.01300578035
567759,567781,569715,22,1934,2,36000,1.0113753878
567774,567788,569682,14,1894,2,36000,1.00739176346
567776,567801,569589,25,1788,2,36000,1.01398210291
567792,567807,569458,15,1651,2,36000,1.00908540279
567808,567814,570012,6,2198,2,36000,1.00272975432
567809,567820,569740,11,1920,2,36000,1.00572916667
567811,567825,569773,14,1948,2,36000,1.00718685832
567812,567831,569194,19,1363,2,36000,1.01393983859
567828,567837,569824,9,1987,2,36000,1.00452944137
567829,567872,569511,43,1639,2,36000,1.02623550946
567863,567878,569945,15,2067,2,36000,1.00725689405
567864,567883,569905,19,2022,2,36000,1.00939663699
567879,567902,569723,23,1821,2,36000,1.01263042284
567895,567908,569584,13,1676,2,36000,1.00775656325
567897,567913,569860,16,1947,2,36000,1.00821777093
567912,567919,569497,7,1578,2,36000,1.00443599493
567913,567925,569811,12,1886,2,36000,1.00636267232
567915,567931,569618,16,1687,2,36000,1.00948429164
567931,567937,569901,6,1964,2,36000,1.00305498982
567932,567943,569942,11,1999,2,36000,1.00550275138
567933,567948,569638,15,1690,2,36000,1.00887573964
567935,567954,569414,19,1460,2,36000,1.01301369863
567950,567988,569731,38,1743,2,36000,1.02180149168
567977,567994,569581,17,1587,2,36000,1.01071203529
567993,568000,569931,7,1931,2,36000,1.00362506473
567994,568032,569408,38,1376,2,36000,1.02761627907
568022,568115,569507,93,1392,2,36000,1.06681034483
568107,568177,570127,70,1950,2,36000,1.0358974359
568169,568187,569865,18,1678,2,36000,1.01072705602
568184,568228,570260,44,2032,2,36000,1.02165354331
568217,568245,569920,28,1675,2,36000,1.01671641791
568236,568251,569882,15,1631,2,36000,1.00919681177
568251,568295,570289,44,1994,2,36000,1.0220661986
568284,568324,570272,40,1948,2,36000,1.0205338809
568315,568329,570265,14,1936,2,36000,1.00723140496
568316,568370,570292,54,1922,2,36000,1.02809573361
568362,568376,570240,14,1864,2,36000,1.00751072961
568364,568381,569653,17,1272,2,36000,1.01336477987
568365,568399,570152,34,1753,2,36000,1.0193953223
568389,568416,569965,27,1549,2,36000,1.01743060039
568407,568436,570476,29,2040,2,36000,1.01421568627
568425,568461,570269,36,1808,2,36000,1.01991150442
568450,568500,570256,50,1756,2,36000,1.0284738041
568489,568522,570412,33,1890,2,36000,1.01746031746
568511,568535,570212,24,1677,2,36000,1.01431127013
568526,568597,570492,71,1895,2,36000,1.03746701847
568586,568616,570471,30,1855,2,36000,1.01617250674
568605,568652,569747,47,1095,2,36000,1.04292237443
568641,568660,570602,19,1942,2,36000,1.00978372812
568656,568677,570086,21,1409,2,36000,1.01490418737
568672,568683,570596,11,1913,2,36000,1.00575013068
568673,568710,570047,37,1337,2,36000,1.02767389678
568700,568732,570524,32,1792,2,36000,1.01785714286
568722,568738,570285,16,1547,2,36000,1.01034259858
568737,568744,570578,7,1834,2,36000,1.00381679389
568738,568835,570586,97,1751,2,36000,1.05539691605
568824,568852,570356,28,1504,2,36000,1.01861702128
568842,569001,571038,159,2037,2,36000,1.07805596465
568992,569015,570217,23,1202,2,36000,1.01913477537
569007,569024,571146,17,2122,2,36000,1.00801131008
569022,569033,570959,11,1926,2,36000,1.0057113188
569023,569084,570737,61,1653,2,36000,1.03690260133
569075,569114,571057,39,1943,2,36000,1.02007205353
569103,569121,570314,18,1193,2,36000,1.01508801341
569118,569171,571028,53,1857,2,36000,1.02854065697
569160,569177,571164,17,1987,2,36000,1.00855561147
569176,569183,570650,7,1467,2,36000,1.00477164281
569177,569189,570934,12,1745,2,36000,1.00687679083
569178,569197,570733,19,1536,2,36000,1.01236979167
569194,569203,570388,9,1185,2,36000,1.00759493671
569196,569208,571117,12,1909,2,36000,1.00628601362
569197,569221,570717,24,1496,2,36000,1.01604278075
569198,569214,571015,16,1801,2,36000,1.00888395336
569214,569226,570821,12,1595,2,36000,1.00752351097
569215,569235,571087,20,1852,2,36000,1.01079913607
569230,569255,571070,25,1815,2,36000,1.01377410468
569246,569263,570894,17,1631,2,36000,1.01042305334
569261,569269,571004,8,1735,2,36000,1.00461095101
569262,569310,570786,48,1476,2,36000,1.0325203252
569301,569328,571314,27,1986,2,36000,1.01359516616
569317,569338,571355,21,2017,2,36000,1.01041150223
569333,569345,571293,12,1948,2,36000,1.00616016427
569334,569392,571114,58,1722,2,36000,1.03368176539
569383,569419,571325,36,1906,2,36000,1.01888772298
569410,569426,570820,16,1394,2,36000,1.01147776184
569426,569432,571200,6,1768,2,36000,1.00339366516
569427,569461,571507,34,2046,2,36000,1.01661779081
569452,569469,571404,17,1935,2,36000,1.00878552972
569467,569475,570700,8,1225,2,36000,1.00653061224
569469,569489,571082,20,1593,2,36000,1.01255492781
569484,569508,571130,24,1622,2,36000,1.01479654747
569499,569519,571266,20,1747,2,36000,1.01144819691
569515,569525,571480,10,1955,2,36000,1.00511508951
569516,569555,571054,39,1499,2,36000,1.0260173449
569543,569561,571472,18,1911,2,36000,1.00941915228
569559,569567,570733,8,1166,2,36000,1.00686106346
569561,569592,571202,31,1610,2,36000,1.01925465839
569582,569598,571454,16,1856,2,36000,1.00862068966
569597,569604,571447,7,1843,2,36000,1.00379815518
569598,569629,571574,31,1945,2,36000,1.01593830334
569619,569649,571627,30,1978,2,36000,1.01516683519
569638,569655,571535,17,1880,2,36000,1.00904255319
569653,569664,571575,11,1911,2,36000,1.00575614861
569654,569681,571358,27,1677,2,36000,1.01610017889
569673,569693,571069,20,1376,2,36000,1.01453488372
569688,569727,571137,39,1410,2,36000,1.02765957447
569719,569734,571555,15,1821,2,36000,1.00823723229
569734,569742,571621,8,1879,2,36000,1.00425758382
569735,569751,571486,16,1735,2,36000,1.00922190202
569752,569758,571625,6,1867,2,36000,1.00321371184
569753,569764,571637,11,1873,2,36000,1.00587293113
569755,569770,571575,15,1805,2,36000,1.00831024931
569770,569784,571130,14,1346,2,36000,1.01040118871
569786,569822,571743,36,1921,2,36000,1.01874023946
569813,569836,571767,23,1931,2,36000,1.01191092698
569828,569871,571537,43,1666,2,36000,1.02581032413
569861,569878,571976,17,2098,2,36000,1.0081029552
569876,569893,571764,17,1871,2,36000,1.00908605024
569891,569904,571851,13,1947,2,36000,1.00667693888
569907,569913,571435,6,1522,2,36000,1.00394218134
569908,569919,571884,11,1965,2,36000,1.00559796438
569910,569931,571827,21,1896,2,36000,1.01107594937
569925,569942,571840,17,1898,2,36000,1.00895679663
569940,569954,571509,14,1555,2,36000,1.00900321543
569955,569961,571301,6,1340,2,36000,1.00447761194
569956,569976,571588,20,1612,2,36000,1.01240694789
569971,570023,571798,52,1775,2,36000,1.02929577465
570014,570058,571894,44,1836,2,36000,1.02396514161
570047,570097,571607,50,1510,2,36000,1.03311258278
570087,570138,571676,51,1538,2,36000,1.03315994798
570127,570163,571937,36,1774,2,36000,1.02029312289
570154,570224,571698,70,1474,2,36000,1.04748982361
570215,570230,572073,15,1843,2,36000,1.00813890396
570230,570251,572278,21,2027,2,36000,1.01036013814
570245,570267,572166,22,1899,2,36000,1.01158504476
570260,570274,572036,14,1762,2,36000,1.00794551646
570261,570280,571644,19,1364,2,36000,1.01392961877
570277,570286,572399,9,2113,2,36000,1.0042593469
570278,570291,572192,13,1901,2,36000,1.00683850605
570280,570298,572091,18,1793,2,36000,1.01003904071
570295,570304,571790,9,1486,2,36000,1.00605652759
570297,570309,572155,12,1846,2,36000,1.00650054171
570298,570325,572162,27,1837,2,36000,1.01469787697
570316,570368,572156,52,1788,2,36000,1.02908277405
570359,570400,571763,41,1363,2,36000,1.03008070433
570389,570423,571727,34,1304,2,36000,1.02607361963
570413,570482,572443,69,1961,2,36000,1.03518612953
570471,570489,571624,18,1135,2,36000,1.01585903084
570486,570503,572300,17,1797,2,36000,1.00946021146
570501,570535,571822,34,1287,2,36000,1.02641802642
570526,570589,572079,63,1490,2,36000,1.04228187919
570580,570597,572220,17,1623,2,36000,1.01047443007
570595,570607,572103,12,1496,2,36000,1.00802139037
570610,570616,572383,6,1767,2,36000,1.00339558574
570612,570661,572436,49,1775,2,36000,1.0276056338
570651,570711,571977,60,1266,2,36000,1.04739336493
570700,570728,572789,28,2061,2,36000,1.01358563804
570719,570744,572830,25,2086,2,36000,1.01198465964
570734,570749,572709,15,1960,2,36000,1.00765306122
570736,570755,572519,19,1764,2,36000,1.01077097506
570751,570797,572588,46,1791,2,36000,1.02568397543
570787,570831,572721,44,1890,2,36000,1.02328042328
570821,570838,572454,17,1616,2,36000,1.01051980198
570822,570906,572755,84,1849,2,36000,1.04542996214
570896,570945,573008,49,2063,2,36000,1.02375181774
570935,570971,572968,36,1997,2,36000,1.01802704056
570960,571015,572892,55,1877,2,36000,1.02930207778
571005,571026,572583,21,1557,2,36000,1.01348747592
571020,571039,572564,19,1525,2,36000,1.01245901639
571035,571049,572492,14,1443,2,36000,1.0097020097
571051,571066,572871,15,1805,2,36000,1.00831024931
571066,571072,573009,6,1937,2,36000,1.00309757357
571067,571080,572744,13,1664,2,36000,1.0078125
571083,571089,572730,6,1641,2,36000,1.00365630713
571085,571095,573214,10,2119,2,36000,1.00471920717
571086,571101,572781,15,1680,2,36000,1.00892857143
571101,571125,573041,24,1916,2,36000,1.01252609603
571116,571131,573132,15,2001,2,36000,1.00749625187
571117,571142,573166,25,2024,2,36000,1.01235177866
571133,571147,572766,14,1619,2,36000,1.00864731316
571135,571154,573101,19,1947,2,36000,1.00975860298
571150,571160,573128,10,1968,2,36000,1.00508130081
571151,571175,573050,24,1875,2,36000,1.0128
571167,571211,573138,44,1927,2,36000,1.02283341982
571204,571217,572976,13,1759,2,36000,1.00739056282
571205,571278,573259,73,1981,2,36000,1.03685007572
571269,571304,573015,35,1711,2,36000,1.02045587376
571294,571312,573162,18,1850,2,36000,1.00972972973
571309,571325,573092,16,1767,2,36000,1.0090548953
571324,571336,573157,12,1821,2,36000,1.00658978583
571339,571366,573400,27,2034,2,36000,1.01327433628
571357,571372,573233,15,1861,2,36000,1.0080601827
571372,571415,573467,43,2052,2,36000,1.02095516569
571406,571446,572780,40,1334,2,36000,1.0299850075
571436,571459,573508,23,2049,2,36000,1.0112249878
571451,571465,573529,14,2064,2,36000,1.00678294574
571466,571483,573383,17,1900,2,36000,1.00894736842
571482,571491,573277,9,1786,2,36000,1.00503919373
571483,571498,573157,15,1659,2,36000,1.00904159132
571498,571518,572983,20,1465,2,36000,1.01365187713
571514,571525,573568,11,2043,2,36000,1.00538423886
571515,571547,573543,32,1996,2,36000,1.01603206413
571536,571554,573215,18,1661,2,36000,1.01083684527
571551,571566,573331,15,1765,2,36000,1.00849858357
571566,571585,572913,19,1328,2,36000,1.01430722892
571582,571591,573474,9,1883,2,36000,1.00477960701
571583,571596,573330,13,1734,2,36000,1.00749711649
571584,571602,573421,18,1819,2,36000,1.009895547
571599,571618,573611,19,1993,2,36000,1.00953336678
571614,571633,573409,19,1776,2,36000,1.0106981982
571630,571639,573079,9,1440,2,36000,1.00625
571631,571644,572846,13,1202,2,36000,1.01081530782
571633,571650,573052,17,1402,2,36000,1.01212553495
571634,571656,573555,22,1899,2,36000,1.01158504476
571649,571661,573524,12,1863,2,36000,1.00644122383
571651,571687,573581,36,1894,2,36000,1.01900739176
571678,571709,573408,31,1699,2,36000,1.01824602707
571699,571738,573712,39,1974,2,36000,1.01975683891
571730,571754,573528,24,1774,2,36000,1.01352874859
571744,571774,573501,30,1727,2,36000,1.01737116387
571763,571781,573585,18,1804,2,36000,1.00997782705
571778,571787,573165,9,1378,2,36000,1.00653120464
571780,571801,573801,21,2000,2,36000,1.0105
571795,571809,572977,14,1168,2,36000,1.01198630137
571810,571834,573766,24,1932,2,36000,1.01242236025
571825,571840,573022,15,1182,2,36000,1.01269035533
571841,571851,573375,10,1524,2,36000,1.00656167979
571842,571862,573413,20,1551,2,36000,1.01289490651
571857,571895,573756,38,1861,2,36000,1.0204191295
571885,571905,573438,20,1533,2,36000,1.01304631442
571900,571949,573162,49,1213,2,36000,1.04039571311
571939,571987,573442,48,1455,2,36000,1.03298969072
571979,571993,573380,14,1387,2,36000,1.01009372747
571981,572047,573870,66,1823,2,36000,1.03620405924
572039,572084,573925,45,1841,2,36000,1.02444323737
572073,572090,573957,17,1867,2,36000,1.00910551687
572088,572103,573876,15,1773,2,36000,1.00846023689
572103,572114,574058,11,1944,2,36000,1.00565843621
572105,572166,574201,61,2035,2,36000,1.02997542998
572157,572172,574005,15,1833,2,36000,1.00818330606
572158,572178,573616,20,1438,2,36000,1.01390820584
572173,572184,574122,11,1938,2,36000,1.00567595459
572174,572203,573720,29,1517,2,36000,1.01911667765
572193,572232,574023,39,1791,2,36000,1.02177554439
572223,572289,573911,66,1622,2,36000,1.04069050555
572279,572312,574533,33,2221,2,36000,1.01485817199
572303,572395,573888,92,1493,2,36000,1.06162089752
572385,572410,573805,25,1395,2,36000,1.01792114695
572401,572447,574224,46,1777,2,36000,1.02588632527
572437,572455,574231,18,1776,2,36000,1.01013513514
572452,572465,574333,13,1868,2,36000,1.00695931478
572467,572503,574546,36,2043,2,36000,1.01762114537
572495,572530,574285,35,1755,2,36000,1.01994301994
572519,572575,574467,56,1892,2,36000,1.02959830867
572565,572595,574430,30,1835,2,36000,1.01634877384
572586,572601,574233,15,1632,2,36000,1.00919117647
572601,572721,574413,120,1692,2,36000,1.07092198582
572711,572732,574531,21,1799,2,36000,1.01167315175
572726,572741,574485,15,1744,2,36000,1.00860091743
572742,572757,574807,15,2050,2,36000,1.00731707317
572757,572767,574717,10,1950,2,36000,1.00512820513
572758,572777,574203,19,1426,2,36000,1.01332398317
572773,572791,574705,18,1914,2,36000,1.00940438871
572789,572797,574009,8,1212,2,36000,1.00660066007
572790,572804,574469,14,1665,2,36000,1.00840840841
572791,572841,574352,50,1511,2,36000,1.03309066843
572831,572858,574746,27,1888,2,36000,1.01430084746
572849,572882,574552,33,1670,2,36000,1.01976047904
572870,572903,574980,33,2077,2,36000,1.01588830043
572892,572924,574556,32,1632,2,36000,1.01960784314
572913,572979,574777,66,1798,2,36000,1.03670745273
572968,572987,574824,19,1837,2,36000,1.01034295046
572983,572993,574884,10,1891,2,36000,1.0052882073
572984,572999,574568,15,1569,2,36000,1.00956022945
572999,573005,574751,6,1746,2,36000,1.00343642612
573015,573021,574688,6,1667,2,36000,1.00359928014
573016,573027,574735,11,1708,2,36000,1.00644028103
573018,573032,574713,14,1681,2,36000,1.00832837597
573033,573038,575017,5,1979,2,36000,1.00252652855
573048,573054,575011,6,1957,2,36000,1.00306591722
573063,573069,574876,6,1807,2,36000,1.00332042059
573064,573075,574957,11,1882,2,36000,1.00584484591
573079,573086,574806,7,1720,2,36000,1.00406976744
573094,573100,574944,6,1844,2,36000,1.0032537961
573109,573115,574401,6,1286,2,36000,1.00466562986
573127,573134,574998,7,1864,2,36000,1.00375536481
573143,573149,574738,6,1589,2,36000,1.00377595972
573144,573155,574873,11,1718,2,36000,1.00640279395
573160,573166,574689,6,1523,2,36000,1.00393959291
573161,573172,575235,11,2063,2,36000,1.00533204072
573177,573183,575007,6,1824,2,36000,1.00328947368
573178,573189,574984,11,1795,2,36000,1.0061281337
573180,573194,575519,14,2325,2,36000,1.00602150538
573181,573200,574384,19,1184,2,36000,1.0160472973
573214,573220,574762,6,1542,2,36000,1.00389105058
573216,573226,575126,10,1900,2,36000,1.00526315789
573234,573240,575379,6,2139,2,36000,1.00280504909
573262,573268,574901,6,1633,2,36000,1.00367421923
573277,573283,575242,6,1959,2,36000,1.00306278714
573331,573338,575308,7,1970,2,36000,1.00355329949
573333,573344,575180,11,1836,2,36000,1.0059912854
573375,573381,575296,6,1915,2,36000,1.00313315927
573391,573397,574724,6,1327,2,36000,1.00452147702
573392,573403,575426,11,2023,2,36000,1.00543746911
573407,573413,575095,6,1682,2,36000,1.00356718193
573409,573419,575145,10,1726,2,36000,1.00579374276
573424,573430,575233,6,1803,2,36000,1.00332778702
573426,573436,575421,10,1985,2,36000,1.00503778338
573427,573441,575381,14,1940,2,36000,1.00721649485
573442,573448,575062,6,1614,2,36000,1.00371747212
573443,573454,575199,11,1745,2,36000,1.00630372493
573468,573474,575424,6,1950,2,36000,1.00307692308
573483,573489,575337,6,1848,2,36000,1.00324675325
573504,573510,575252,6,1742,2,36000,1.00344431688
573519,573525,575061,6,1536,2,36000,1.00390625
573535,573540,575369,5,1829,2,36000,1.00273373428
573536,573546,575444,10,1898,2,36000,1.0052687039
573537,573551,574949,14,1398,2,36000,1.01001430615
573552,573559,574937,7,1378,2,36000,1.00507982583
573568,573574,575533,6,1959,2,36000,1.00306278714
573569,573580,575622,11,2042,2,36000,1.00538687561
573586,573592,575433,6,1841,2,36000,1.00325909832
573587,573598,575457,11,1859,2,36000,1.00591715976
573612,573618,575136,6,1518,2,36000,1.00395256917
573627,573633,574743,6,1110,2,36000,1.00540540541
573713,573719,575630,6,1911,2,36000,1.00313971743
573728,573734,575745,6,2011,2,36000,1.00298359025
573758,573765,575315,7,1550,2,36000,1.00451612903
573774,573780,575590,6,1810,2,36000,1.00331491713
573801,573807,575814,6,2007,2,36000,1.00298953662
573816,573822,575688,6,1866,2,36000,1.00321543408
573871,573877,575887,6,2010,2,36000,1.00298507463
573886,573892,575417,6,1525,2,36000,1.00393442623
573901,573907,575231,6,1324,2,36000,1.00453172205
573916,573922,575678,6,1756,2,36000,1.00341685649
573931,573937,575588,6,1651,2,36000,1.00363416111
573958,573965,575659,7,1694,2,36000,1.0041322314
574011,574017,575844,6,1827,2,36000,1.00328407225
574012,574023,575185,11,1162,2,36000,1.00946643718
574027,574036,575834,9,1798,2,36000,1.00500556174
574061,574067,575944,6,1877,2,36000,1.0031965903
574122,574128,575647,6,1519,2,36000,1.00394996708
574201,574208,576076,7,1868,2,36000,1.00374732334
574216,574223,575372,7,1149,2,36000,1.00609225413
574232,574238,575662,6,1424,2,36000,1.00421348315
574233,574244,576180,11,1936,2,36000,1.00568181818
574248,574254,576093,6,1839,2,36000,1.00326264274
574288,574294,575943,6,1649,2,36000,1.00363856883
574334,574340,576090,6,1750,2,36000,1.00342857143
574352,574358,576329,6,1971,2,36000,1.00304414003
574385,574391,576247,6,1856,2,36000,1.00323275862
574403,574409,576255,6,1846,2,36000,1.00325027086
574418,574424,575858,6,1434,2,36000,1.00418410042
574433,574440,576159,7,1719,2,36000,1.00407213496
574470,574476,575779,6,1303,2,36000,1.00460475825
574471,574482,575615,11,1133,2,36000,1.00970873786
574486,574493,576239,7,1746,2,36000,1.0040091638
574529,574535,576369,6,1834,2,36000,1.00327153762
574545,574551,576573,6,2022,2,36000,1.00296735905
574546,574557,576472,11,1915,2,36000,1.00574412533
574563,574569,575881,6,1312,2,36000,1.00457317073
574564,574575,576131,11,1556,2,36000,1.00706940874
574580,574586,576456,6,1870,2,36000,1.00320855615
574689,574695,576518,6,1823,2,36000,1.00329127811
574690,574701,576410,11,1709,2,36000,1.00643651258
574706,574712,576559,6,1847,2,36000,1.0032485111
574721,574727,576807,6,2080,2,36000,1.00288461538
574722,574733,576641,11,1908,2,36000,1.00576519916
574738,574744,576632,6,1888,2,36000,1.0031779661
574739,574750,576951,11,2201,2,36000,1.00499772831
574740,574755,576513,15,1758,2,36000,1.00853242321
574756,574762,576343,6,1581,2,36000,1.00379506641
574757,574768,576275,11,1507,2,36000,1.00729927007
574759,574773,576486,14,1713,2,36000,1.00817279626
574774,574780,576683,6,1903,2,36000,1.00315291645
574789,574795,576539,6,1744,2,36000,1.00344036697
574808,574814,576448,6,1634,2,36000,1.00367197062
574809,574820,576535,11,1715,2,36000,1.00641399417
574827,574833,576797,6,1964,2,36000,1.00305498982
574876,574883,576584,7,1701,2,36000,1.00411522634
574878,574889,576664,11,1775,2,36000,1.0061971831
574893,574899,576741,6,1842,2,36000,1.00325732899
574908,574914,576990,6,2076,2,36000,1.00289017341
574938,574944,576918,6,1974,2,36000,1.00303951368
574954,574960,576926,6,1966,2,36000,1.00305188199
574955,574966,576630,11,1664,2,36000,1.00661057692
574970,574976,576151,6,1175,2,36000,1.00510638298
574986,574991,576540,5,1549,2,36000,1.00322788896
574987,574997,576732,10,1735,2,36000,1.00576368876
575002,575008,576820,6,1812,2,36000,1.00331125828
575008,575014,585468,6,10454,1,86400,1.00057394299
575018,575024,576969,6,1945,2,36000,1.0030848329
575019,575030,576869,11,1839,2,36000,1.00598151169
575021,575035,577031,14,1996,2,36000,1.00701402806
575064,575070,577110,6,2040,2,36000,1.00294117647
575065,575076,577057,11,1981,2,36000,1.00555275114
575095,575101,576926,6,1825,2,36000,1.00328767123
575129,575135,576652,6,1517,2,36000,1.00395517469
575140,575146,661567,6,86421,1,86400,1.00006942757
575144,575152,576481,8,1329,2,36000,1.00601956358
575146,575157,576435,11,1278,2,36000,1.00860719875
575183,575189,576551,6,1362,2,36000,1.00440528634
575198,575204,577079,6,1875,2,36000,1.0032
575213,575219,576998,6,1779,2,36000,1.00337268128
575235,575241,577045,6,1804,2,36000,1.00332594235
575236,575247,576741,11,1494,2,36000,1.00736278447
575237,575252,577242,15,1990,2,36000,1.00753768844
575253,575259,577003,6,1744,2,36000,1.00344036697
575254,575265,576982,11,1717,2,36000,1.00640652301
575296,575303,577149,7,1846,2,36000,1.00379198267
575312,575318,576534,6,1216,2,36000,1.00493421053
575327,575333,576945,6,1612,2,36000,1.00372208437
575342,575348,577412,6,2064,2,36000,1.00290697674
575370,575376,577351,6,1975,2,36000,1.00303797468
575385,575392,577032,7,1640,2,36000,1.00426829268
575387,575398,576777,11,1379,2,36000,1.00797679478
575388,575403,577220,15,1817,2,36000,1.00825536599
575419,575425,577308,6,1883,2,36000,1.00318640467
575434,575441,577313,7,1872,2,36000,1.00373931624
575436,575447,576809,11,1362,2,36000,1.0080763583
575437,575452,577209,15,1757,2,36000,1.00853727945
575438,575457,577360,19,1903,2,36000,1.00998423542
575453,575464,577671,11,2207,2,36000,1.00498414137
575469,575475,576771,6,1296,2,36000,1.00462962963
575520,575526,577493,6,1967,2,36000,1.00305033045
575535,575542,577420,7,1878,2,36000,1.00372736954
575591,575597,577328,6,1731,2,36000,1.00346620451
575592,575603,577289,11,1686,2,36000,1.00652431791
575617,575623,577507,6,1884,2,36000,1.00318471338
575632,575638,577337,6,1699,2,36000,1.00353148911
575633,575644,577479,11,1835,2,36000,1.00599455041
575648,575654,576738,6,1084,2,36000,1.00553505535
575664,575670,577105,6,1435,2,36000,1.00418118467
575665,575676,577417,11,1741,2,36000,1.00631820793
575681,575687,577305,6,1618,2,36000,1.00370828183
575696,575702,576986,6,1284,2,36000,1.0046728972
575748,575754,577760,6,2006,2,36000,1.00299102692
575781,575787,577070,6,1283,2,36000,1.00467653936
575815,575821,577548,6,1727,2,36000,1.00347423277
575837,575843,577525,6,1682,2,36000,1.00356718193
575852,575858,577936,6,2078,2,36000,1.00288739172
575867,575873,577727,6,1854,2,36000,1.00323624595
575882,575889,577428,7,1539,2,36000,1.00454840806
575898,575904,577778,6,1874,2,36000,1.00320170758
575944,575950,578145,6,2195,2,36000,1.00273348519
575945,575956,577895,11,1939,2,36000,1.00567302733
576077,576083,577678,6,1595,2,36000,1.00376175549
576092,576098,578019,6,1921,2,36000,1.00312337324
576094,576104,578166,10,2062,2,36000,1.00484966052
576133,576139,577789,6,1650,2,36000,1.00363636364
576151,576158,577375,7,1217,2,36000,1.00575184881
576167,576173,577481,6,1308,2,36000,1.00458715596
576182,576188,577648,6,1460,2,36000,1.00410958904
576240,576246,578501,6,2255,2,36000,1.00266075388
576255,576261,578198,6,1937,2,36000,1.00309757357
576256,576267,577838,11,1571,2,36000,1.00700190961
576277,576284,577934,7,1650,2,36000,1.00424242424
576329,576335,578149,6,1814,2,36000,1.0033076075
576344,576350,578329,6,1979,2,36000,1.00303183426
576372,576378,577532,6,1154,2,36000,1.00519930676
576411,576417,578291,6,1874,2,36000,1.00320170758
576436,576442,578424,6,1982,2,36000,1.00302724521
576451,576457,578288,6,1831,2,36000,1.00327689787
576466,576472,577802,6,1330,2,36000,1.0045112782
576481,576487,578199,6,1712,2,36000,1.0035046729
576482,576493,578441,11,1948,2,36000,1.00564681725
576497,576504,577622,7,1118,2,36000,1.00626118068
576512,576519,578233,7,1714,2,36000,1.004084014
576528,576534,578470,6,1936,2,36000,1.00309917355
576544,576550,578041,6,1491,2,36000,1.00402414487
576546,576556,577713,10,1157,2,36000,1.00864304235
576547,576561,578646,14,2085,2,36000,1.0067146283
576548,576566,578366,18,1800,2,36000,1.01
576564,576573,578220,9,1647,2,36000,1.00546448087
576565,576578,578330,13,1752,2,36000,1.00742009132
576580,576587,577981,7,1394,2,36000,1.0050215208
576596,576602,578356,6,1754,2,36000,1.00342075257
576629,576635,577693,6,1058,2,36000,1.0056710775
576645,576651,578591,6,1940,2,36000,1.00309278351
576646,576657,578522,11,1865,2,36000,1.00589812332
576661,576667,578685,6,2018,2,36000,1.00297324083
576676,576682,578668,6,1986,2,36000,1.00302114804
576692,576698,578315,6,1617,2,36000,1.00371057514
576735,576741,578384,6,1643,2,36000,1.00365185636
576751,576757,577962,6,1205,2,36000,1.00497925311
576752,576763,578549,11,1786,2,36000,1.00615901456
576753,576768,578648,15,1880,2,36000,1.0079787234
576772,576778,578569,6,1791,2,36000,1.00335008375
576787,576793,578745,6,1952,2,36000,1.00307377049
576802,576808,578034,6,1226,2,36000,1.00489396411
576818,576824,578906,6,2082,2,36000,1.00288184438
576819,576830,578566,11,1736,2,36000,1.00633640553
576834,576840,578489,6,1649,2,36000,1.00363856883
576871,576877,578739,6,1862,2,36000,1.00322234157
576919,576925,578874,6,1949,2,36000,1.0030785018
576935,576941,578761,6,1820,2,36000,1.0032967033
576936,576947,578700,11,1753,2,36000,1.00627495722
576952,576958,578926,6,1968,2,36000,1.00304878049
576953,576964,578975,11,2011,2,36000,1.00546991546
576971,576977,578958,6,1981,2,36000,1.00302877335
576987,576993,578275,6,1282,2,36000,1.00468018721
576988,576999,578947,11,1948,2,36000,1.00564681725
577003,577009,578800,6,1791,2,36000,1.00335008375
577005,577015,578932,10,1917,2,36000,1.00521648409
577006,577020,578973,14,1953,2,36000,1.00716845878
577034,577040,578996,6,1956,2,36000,1.00306748466
577035,577046,578784,11,1738,2,36000,1.00632911392
577050,577056,578653,6,1597,2,36000,1.00375704446
577065,577071,578960,6,1889,2,36000,1.00317628375
577081,577087,579019,6,1932,2,36000,1.00310559006
577082,577093,578490,11,1397,2,36000,1.00787401575
577107,577113,578814,6,1701,2,36000,1.00352733686
577122,577128,578240,6,1112,2,36000,1.00539568345
577149,577155,579138,6,1983,2,36000,1.00302571861
577210,577216,579668,6,2452,2,36000,1.00244698206
577225,577231,579105,6,1874,2,36000,1.00320170758
577244,577250,578263,6,1013,2,36000,1.00592300099
577289,577295,578895,6,1600,2,36000,1.00375
577308,577314,579196,6,1882,2,36000,1.00318809777
577309,577320,579267,11,1947,2,36000,1.00564971751
577325,577331,579004,6,1673,2,36000,1.00358637179
577340,577346,579106,6,1760,2,36000,1.00340909091
577341,577352,579295,11,1943,2,36000,1.00566134843
577357,577362,578523,5,1161,2,36000,1.00430663221
577372,577378,579053,6,1675,2,36000,1.00358208955
577387,577393,579400,6,2007,2,36000,1.00298953662
577414,577421,579447,7,2026,2,36000,1.00345508391
577430,577436,579173,6,1737,2,36000,1.00345423143
577431,577442,579069,11,1627,2,36000,1.00676090965
577433,577447,579146,14,1699,2,36000,1.00824014126
577482,577488,579431,6,1943,2,36000,1.00308800823
577483,577494,579494,11,2000,2,36000,1.0055
577498,577504,579256,6,1752,2,36000,1.00342465753
577514,577520,579597,6,2077,2,36000,1.0028887819
577529,577535,579265,6,1730,2,36000,1.00346820809
577544,577550,579524,6,1974,2,36000,1.00303951368
577559,577565,579538,6,1973,2,36000,1.00304105423
577623,577629,579457,6,1828,2,36000,1.00328227571
577651,577657,579211,6,1554,2,36000,1.00386100386
577672,577678,579308,6,1630,2,36000,1.0036809816
577687,577693,579176,6,1483,2,36000,1.004045853
577702,577708,579708,6,2000,2,36000,1.003
577717,577723,579363,6,1640,2,36000,1.00365853659
577732,577738,579141,6,1403,2,36000,1.00427655025
577763,577769,579643,6,1874,2,36000,1.00320170758
577781,577788,579551,7,1763,2,36000,1.00397050482
577797,577803,579797,6,1994,2,36000,1.00300902708
577812,577818,579957,6,2139,2,36000,1.00280504909
577839,577845,579711,6,1866,2,36000,1.00321543408
577897,577903,579790,6,1887,2,36000,1.00317965024
577934,577940,579942,6,2002,2,36000,1.002997003
577949,577955,579558,6,1603,2,36000,1.00374298191
577964,577970,579809,6,1839,2,36000,1.00326264274
577982,577988,579486,6,1498,2,36000,1.00400534045
578022,578028,579901,6,1873,2,36000,1.00320341698
578037,578043,579656,6,1613,2,36000,1.00371977681
578052,578058,579917,6,1859,2,36000,1.00322754169
578147,578153,579485,6,1332,2,36000,1.0045045045
578162,578169,579692,7,1523,2,36000,1.00459619173
578178,578184,580247,6,2063,2,36000,1.00290838585
578199,578205,579730,6,1525,2,36000,1.00393442623
578201,578211,579343,10,1132,2,36000,1.00883392226
578222,578228,580044,6,1816,2,36000,1.00330396476
578237,578243,580215,6,1972,2,36000,1.00304259635
578252,578258,579727,6,1469,2,36000,1.00408441116
578274,578280,579557,6,1277,2,36000,1.00469851214
578276,578286,580407,10,2121,2,36000,1.00471475719
578277,578291,579995,14,1704,2,36000,1.00821596244
578278,578297,579745,19,1448,2,36000,1.01312154696
578279,578302,580196,23,1894,2,36000,1.0121436114
578281,578308,580254,27,1946,2,36000,1.01387461459
578283,578313,580012,30,1699,2,36000,1.01765744556
578285,578318,579394,33,1076,2,36000,1.03066914498
578286,578324,580377,38,2053,2,36000,1.0185094983
578287,578329,580174,42,1845,2,36000,1.02276422764
578289,578334,580036,45,1702,2,36000,1.02643948296
578290,578339,580274,49,1935,2,36000,1.02532299742
578291,578344,580205,53,1861,2,36000,1.0284793122
578293,578350,580321,57,1971,2,36000,1.02891933029
578294,578355,580242,61,1887,2,36000,1.03232644409
578295,578360,579698,65,1338,2,36000,1.0485799701
578297,578365,579794,68,1429,2,36000,1.04758572428
578298,578370,580326,72,1956,2,36000,1.03680981595
578300,578376,579984,76,1608,2,36000,1.04726368159
578301,578381,580195,80,1814,2,36000,1.0441014333
578302,578386,579634,84,1248,2,36000,1.06730769231
578303,578392,579823,89,1431,2,36000,1.06219426974
578320,578398,580037,78,1639,2,36000,1.0475899939
578321,578403,580277,82,1874,2,36000,1.04375667022
578322,578408,579716,86,1308,2,36000,1.06574923547
578338,578413,580352,75,1939,2,36000,1.03867973182
578340,578418,579499,78,1081,2,36000,1.07215541166
578358,578425,580234,67,1809,2,36000,1.03703703704
578373,578435,579938,62,1503,2,36000,1.04125083167
578389,578452,580289,63,1837,2,36000,1.03429504627
578425,578481,580314,56,1833,2,36000,1.03055100927
578444,578500,580002,56,1502,2,36000,1.03728362184
578471,578507,579973,36,1466,2,36000,1.02455661664
578490,578514,580224,24,1710,2,36000,1.01403508772
578491,578534,580397,43,1863,2,36000,1.02308105207
578506,578539,580387,33,1848,2,36000,1.01785714286
578525,578561,580074,36,1513,2,36000,1.02379378718
578526,578577,580123,51,1546,2,36000,1.03298835705
578551,578584,580396,33,1812,2,36000,1.01821192053
578569,578602,579967,33,1365,2,36000,1.02417582418
578571,578657,580560,86,1903,2,36000,1.04519180242
578592,578663,580647,71,1984,2,36000,1.03578629032
578648,578670,580452,22,1782,2,36000,1.01234567901
578649,578680,580291,31,1611,2,36000,1.01924270639
578664,578697,580010,33,1313,2,36000,1.02513328256
578680,578711,580452,31,1741,2,36000,1.0178058587
578695,578750,580606,55,1856,2,36000,1.02963362069
578710,578757,580572,47,1815,2,36000,1.0258953168
578741,578772,580266,31,1494,2,36000,1.02074966533
578756,578795,580019,39,1224,2,36000,1.0318627451
578771,578812,579875,41,1063,2,36000,1.03857008467
578787,578825,580649,38,1824,2,36000,1.02083333333
578802,578885,580705,83,1820,2,36000,1.0456043956
578817,578906,580676,89,1770,2,36000,1.05028248588
578875,578917,580792,42,1875,2,36000,1.0224
578897,578937,580811,40,1874,2,36000,1.02134471718
578912,578944,580686,32,1742,2,36000,1.01836969001
578928,578958,580509,30,1551,2,36000,1.01934235977
578943,578971,580720,28,1749,2,36000,1.01600914808
578969,578977,580993,8,2016,2,36000,1.00396825397
578970,578984,580479,14,1495,2,36000,1.00936454849
578972,578990,580804,18,1814,2,36000,1.00992282249
578988,579007,580322,19,1315,2,36000,1.0144486692
578989,579016,580925,27,1909,2,36000,1.01414353064
579005,579030,580656,25,1626,2,36000,1.01537515375
579006,579064,579936,58,872,2,36000,1.06651376147
579022,579080,580979,58,1899,2,36000,1.03054239073
579055,579116,581025,61,1909,2,36000,1.03195390257
579071,579122,580559,51,1437,2,36000,1.03549060543
579108,579149,581045,41,1896,2,36000,1.02162447257
579109,579155,581131,46,1976,2,36000,1.02327935223
579141,579161,580794,20,1633,2,36000,1.01224739743
579156,579184,580628,28,1444,2,36000,1.01939058172
579158,579191,581081,33,1890,2,36000,1.01746031746
579176,579207,581006,31,1799,2,36000,1.01723179544
579177,579222,580420,45,1198,2,36000,1.03756260434
579199,579267,580720,68,1453,2,36000,1.04679972471
579215,579276,580954,61,1678,2,36000,1.03635280095
579258,579283,581198,25,1915,2,36000,1.01305483029
579273,579306,580923,33,1617,2,36000,1.02040816327
579275,579320,581352,45,2032,2,36000,1.02214566929
579296,579354,581179,58,1825,2,36000,1.03178082192
579312,579374,581433,62,2059,2,36000,1.03011170471
579346,579405,581298,59,1893,2,36000,1.03116745906
579364,579411,581432,47,2021,2,36000,1.02325581395
579396,579442,581528,46,2086,2,36000,1.02205177373
579411,579459,581359,48,1900,2,36000,1.02526315789
579432,579468,581203,36,1735,2,36000,1.02074927954
579448,579498,581308,50,1810,2,36000,1.02762430939
579463,579504,581420,41,1916,2,36000,1.02139874739
579488,579510,580874,22,1364,2,36000,1.01612903226
579490,579515,581843,25,2328,2,36000,1.01073883162
579509,579535,581145,26,1610,2,36000,1.01614906832
579511,579549,581411,38,1862,2,36000,1.02040816327
579526,579562,581525,36,1963,2,36000,1.01833927662
579542,579568,581371,26,1803,2,36000,1.01442041043
579559,579574,581667,15,2093,2,36000,1.0071667463
579560,579608,581488,48,1880,2,36000,1.02553191489
579562,579646,581634,84,1988,2,36000,1.04225352113
579599,579654,581519,55,1865,2,36000,1.02949061662
579636,579667,581569,31,1902,2,36000,1.01629863302
579651,579679,581658,28,1979,2,36000,1.01414855988
579666,579703,581730,37,2027,2,36000,1.01825357671
579682,579709,581295,27,1586,2,36000,1.01702395965
579698,579719,581458,21,1739,2,36000,1.01207590569
579699,579725,581854,26,2129,2,36000,1.01221230625
579715,579731,581604,16,1873,2,36000,1.00854244527
579717,579738,581672,21,1934,2,36000,1.01085832472
579718,579744,581613,26,1869,2,36000,1.01391118245
579734,579756,581734,22,1978,2,36000,1.0111223458
579736,579801,582376,65,2575,2,36000,1.02524271845
579751,579807,581362,56,1555,2,36000,1.03601286174
579791,579813,581994,22,2181,2,36000,1.010087116
579806,579820,581238,14,1418,2,36000,1.00987306065
579808,579834,581366,26,1532,2,36000,1.01697127937
579823,579886,581702,63,1816,2,36000,1.03469162996
579824,579912,580882,88,970,2,36000,1.09072164948
579876,579929,581743,53,1814,2,36000,1.02921719956
579901,579947,581730,46,1783,2,36000,1.02579921481
579921,579954,581855,33,1901,2,36000,1.01735928459
579936,579960,581852,24,1892,2,36000,1.01268498943
579952,579968,581778,16,1810,2,36000,1.00883977901
579953,579979,581820,26,1841,2,36000,1.01412275937
579969,579986,581606,17,1620,2,36000,1.01049382716
579970,579995,581628,25,1633,2,36000,1.01530924679
579985,580006,582055,21,2049,2,36000,1.0102489019
579987,580013,581520,26,1507,2,36000,1.01725282017
580002,580022,581467,20,1445,2,36000,1.01384083045
580003,580028,581968,25,1940,2,36000,1.01288659794
580024,580034,581888,10,1854,2,36000,1.00539374326
580025,580047,581672,22,1625,2,36000,1.01353846154
580026,580053,581896,27,1843,2,36000,1.01465002713
580042,580060,581848,18,1788,2,36000,1.01006711409
580043,580086,581809,43,1723,2,36000,1.02495647127
580058,580135,581685,77,1550,2,36000,1.04967741935
580081,580185,582210,104,2025,2,36000,1.05135802469
580127,580206,582157,79,1951,2,36000,1.04049205536
580175,580213,582181,38,1968,2,36000,1.01930894309
580197,580220,582091,23,1871,2,36000,1.0122928915
580198,580226,581912,28,1686,2,36000,1.01660735469
580213,580235,582272,22,2037,2,36000,1.01080019637
580229,580245,581988,16,1743,2,36000,1.00917957544
580230,580255,581814,25,1559,2,36000,1.01603592046
580246,580261,582262,15,2001,2,36000,1.00749625187
580247,580268,581997,21,1729,2,36000,1.01214574899
580249,580277,581712,28,1435,2,36000,1.01951219512
580264,580285,582225,21,1940,2,36000,1.01082474227
580265,580291,582213,26,1922,2,36000,1.01352757544
580281,580301,582162,20,1861,2,36000,1.01074691026
580283,580308,582089,25,1781,2,36000,1.01403705783
580298,580325,581715,27,1390,2,36000,1.01942446043
580299,580332,582211,33,1879,2,36000,1.01756253326
580315,580338,582229,23,1891,2,36000,1.01216287678
580330,580343,582316,13,1973,2,36000,1.00658895084
580332,580364,581790,32,1426,2,36000,1.02244039271
580333,580388,582447,55,2059,2,36000,1.02671199611
580354,580398,581886,44,1488,2,36000,1.02956989247
580381,580407,582232,26,1825,2,36000,1.01424657534
580396,580414,582336,18,1922,2,36000,1.00936524454
580397,580421,582397,24,1976,2,36000,1.01214574899
580413,580432,582286,19,1854,2,36000,1.01024811219
580414,580463,582301,49,1838,2,36000,1.0266594124
580429,580469,582277,40,1808,2,36000,1.02212389381
580457,580491,582370,34,1879,2,36000,1.01809473124
580459,580520,582383,61,1863,2,36000,1.03274288782
580481,580571,582072,90,1501,2,36000,1.05996002665
580512,580576,582665,64,2089,2,36000,1.03063666826
580561,580583,581924,22,1341,2,36000,1.01640566741
580562,580617,582519,55,1902,2,36000,1.02891692955
580578,580639,582613,61,1974,2,36000,1.03090172239
580608,580658,582457,50,1799,2,36000,1.02779321845
580629,580664,582446,35,1782,2,36000,1.01964085297
580648,580670,582371,22,1701,2,36000,1.01293356849
580663,580687,582361,24,1674,2,36000,1.01433691756
580665,580697,582349,32,1652,2,36000,1.01937046005
580680,580716,582663,36,1947,2,36000,1.01848998459
580695,580731,582596,36,1865,2,36000,1.01930294906
580710,580736,582467,26,1731,2,36000,1.01502021953
580726,580803,582573,77,1770,2,36000,1.04350282486
580727,580810,582483,83,1673,2,36000,1.04961147639
580801,580816,582746,15,1930,2,36000,1.00777202073
580803,580822,582873,19,2051,2,36000,1.00926377377
580819,580885,582692,66,1807,2,36000,1.03652462645
580820,580893,582933,73,2040,2,36000,1.03578431373
580875,580934,582379,59,1445,2,36000,1.04083044983
580890,580941,582849,51,1908,2,36000,1.02672955975
580924,580965,582858,41,1893,2,36000,1.02165874274
580925,580990,582801,65,1811,2,36000,1.0358917725
580956,581004,582790,48,1786,2,36000,1.02687569989
580980,581018,582883,38,1865,2,36000,1.02037533512
580995,581036,582927,41,1891,2,36000,1.02168164992
581010,581057,582922,47,1865,2,36000,1.02520107239
581025,581092,583095,67,2003,2,36000,1.03344982526
581047,581142,583113,95,1971,2,36000,1.04819888382
581080,581156,583086,76,1930,2,36000,1.03937823834
581132,581190,583183,58,1993,2,36000,1.0291018565
581147,581209,582508,62,1299,2,36000,1.04772902232
581178,581216,582715,38,1499,2,36000,1.02535023349
581200,581250,582698,50,1448,2,36000,1.03453038674
581216,581306,582654,90,1348,2,36000,1.06676557864
581240,581312,583080,72,1768,2,36000,1.0407239819
581295,581320,582574,25,1254,2,36000,1.01993620415
581310,581363,583284,53,1921,2,36000,1.02758979698
581312,581371,582986,59,1615,2,36000,1.03653250774
581355,581377,582537,22,1160,2,36000,1.01896551724
581370,581382,583261,12,1879,2,36000,1.00638637573
581372,581389,583387,17,1998,2,36000,1.00850850851
581373,581423,583164,50,1741,2,36000,1.02871912694
581375,581431,583249,56,1818,2,36000,1.03080308031
581412,581443,582912,31,1469,2,36000,1.02110279101
581427,581450,582964,23,1514,2,36000,1.01519154557
581443,581470,583547,27,2077,2,36000,1.01299951854
581444,581478,583560,34,2082,2,36000,1.01633045149
581459,581499,582562,40,1063,2,36000,1.03762935089
581475,581530,583563,55,2033,2,36000,1.02705361535
581490,581537,583388,47,1851,2,36000,1.02539168017
581521,581542,582924,21,1382,2,36000,1.01519536903
581522,581549,583449,27,1900,2,36000,1.01421052632
581538,581580,583396,42,1816,2,36000,1.0231277533
581539,581615,582854,76,1239,2,36000,1.06133979015
581570,581622,583572,52,1950,2,36000,1.02666666667
581606,581629,583043,23,1414,2,36000,1.01626591231
581608,581640,583649,32,2009,2,36000,1.01592832255
581623,581646,583714,23,2068,2,36000,1.01112185687
581639,581669,583581,30,1912,2,36000,1.01569037657
581640,581678,583503,38,1825,2,36000,1.02082191781
581658,581685,583606,27,1921,2,36000,1.01405517959
581674,581690,583831,16,2141,2,36000,1.00747314339
581676,581697,583603,21,1906,2,36000,1.01101783841
581677,581713,583534,36,1821,2,36000,1.0197693575
581692,581723,583525,31,1802,2,36000,1.01720310766
581707,581729,583503,22,1774,2,36000,1.01240135287
581723,581741,583598,18,1857,2,36000,1.00969305331
581724,581746,583361,22,1615,2,36000,1.01362229102
581740,581753,583745,13,1992,2,36000,1.00652610442
581741,581760,583545,19,1785,2,36000,1.0106442577
581742,581789,583804,47,2015,2,36000,1.02332506203
581758,581801,583788,43,1987,2,36000,1.02164066432
581780,581820,583570,40,1750,2,36000,1.02285714286
581795,581827,583687,32,1860,2,36000,1.01720430108
581810,581833,583784,23,1951,2,36000,1.01178882624
581826,581855,583792,29,1937,2,36000,1.01497160558
581827,581861,583715,34,1854,2,36000,1.01833872708
581846,581867,583747,21,1880,2,36000,1.01117021277
581861,581872,583768,11,1896,2,36000,1.00580168776
581863,581879,583164,16,1285,2,36000,1.01245136187
581864,581897,583425,33,1528,2,36000,1.02159685864
581865,581903,583702,38,1799,2,36000,1.02112284603
581887,581909,583797,22,1888,2,36000,1.01165254237
581902,581924,583298,22,1374,2,36000,1.01601164483
581904,581935,583807,31,1872,2,36000,1.01655982906
581919,581979,583564,60,1585,2,36000,1.03785488959
581934,581999,583687,65,1688,2,36000,1.038507109
581971,582006,584304,35,2298,2,36000,1.01523063534
581989,582012,583773,23,1761,2,36000,1.01306076093
582005,582066,583910,61,1844,2,36000,1.0330802603
582006,582083,584006,77,1923,2,36000,1.04004160166
582055,582100,583870,45,1770,2,36000,1.02542372881
582073,582107,583791,34,1684,2,36000,1.02019002375
582089,582168,583972,79,1804,2,36000,1.04379157428
582105,582175,584134,70,1959,2,36000,1.03573251659
582157,582192,584089,35,1897,2,36000,1.0184501845
582172,582222,583500,50,1278,2,36000,1.03912363067
582187,582227,584318,40,2091,2,36000,1.01912960306
582212,582233,584192,21,1959,2,36000,1.01071975498
582213,582239,583618,26,1379,2,36000,1.0188542422
582228,582245,584078,17,1833,2,36000,1.00927441353
582230,582251,583766,21,1515,2,36000,1.01386138614
582231,582273,584066,42,1793,2,36000,1.02342442833
582246,582283,584300,37,2017,2,36000,1.01834407536
582265,582289,584067,24,1778,2,36000,1.01349831271
582281,582298,583851,17,1553,2,36000,1.01094655505
582282,582312,584102,30,1790,2,36000,1.01675977654
582297,582327,584127,30,1800,2,36000,1.01666666667
582312,582347,583988,35,1641,2,36000,1.02132845826
582327,582360,584319,33,1959,2,36000,1.01684532925
582342,582372,584186,30,1814,2,36000,1.01653803749
582358,582381,584232,23,1851,2,36000,1.01242571583
582373,582387,583962,14,1575,2,36000,1.00888888889
582375,582393,584255,18,1862,2,36000,1.0096670247
582376,582399,584316,23,1917,2,36000,1.01199791341
582392,582405,584411,13,2006,2,36000,1.00648055833
582393,582411,584303,18,1892,2,36000,1.00951374207
582395,582458,583877,63,1419,2,36000,1.044397463
582410,582463,583785,53,1322,2,36000,1.04009077156
582447,582469,583509,22,1040,2,36000,1.02115384615
582448,582478,583789,30,1311,2,36000,1.02288329519
582463,582495,584422,32,1927,2,36000,1.01660612351
582479,582519,584179,40,1660,2,36000,1.02409638554
582494,582530,584400,36,1870,2,36000,1.0192513369
582509,582548,584279,39,1731,2,36000,1.02253032929
582525,582573,583800,48,1227,2,36000,1.0391198044
582540,582584,584090,44,1506,2,36000,1.02921646746
582565,582590,584121,25,1531,2,36000,1.0163291966
582580,582607,584353,27,1746,2,36000,1.01546391753
582582,582624,584379,42,1755,2,36000,1.02393162393
582597,582665,584546,68,1881,2,36000,1.03615098352
582615,582674,584552,59,1878,2,36000,1.03141640043
582655,582681,584309,26,1628,2,36000,1.01597051597
582671,582703,584351,32,1648,2,36000,1.01941747573
582672,582710,584131,38,1421,2,36000,1.02674173118
582693,582726,584246,33,1520,2,36000,1.02171052632
582709,582757,584625,48,1868,2,36000,1.02569593148
582724,582801,584528,77,1727,2,36000,1.04458598726
582749,582812,584478,63,1666,2,36000,1.03781512605
582791,582861,584466,70,1605,2,36000,1.04361370717
582807,582867,584458,60,1591,2,36000,1.03771213074
582849,582873,584634,24,1761,2,36000,1.0136286201
582865,582884,584863,19,1979,2,36000,1.00960080849
582867,582894,584526,27,1632,2,36000,1.01654411765
582882,582924,584592,42,1668,2,36000,1.02517985612
582897,582933,584808,36,1875,2,36000,1.0192
582912,582939,584798,27,1859,2,36000,1.0145239376
582928,582944,584971,16,2027,2,36000,1.00789343858
582930,582951,585095,21,2144,2,36000,1.00979477612
582931,582976,584376,45,1400,2,36000,1.03214285714
582946,582997,584805,51,1808,2,36000,1.0282079646
582965,583054,584582,89,1528,2,36000,1.0582460733
582986,583091,584529,105,1438,2,36000,1.07301808067
583044,583097,585150,53,2053,2,36000,1.0258158792
583081,583106,585173,25,2067,2,36000,1.01209482342
583096,583125,584297,29,1172,2,36000,1.0247440273
583098,583175,585022,77,1847,2,36000,1.04168922577
583116,583180,585115,64,1935,2,36000,1.0330749354
583165,583194,585007,29,1813,2,36000,1.01599558742
583166,583260,585157,94,1897,2,36000,1.04955192409
583185,583272,585163,87,1891,2,36000,1.04600740349
583252,583295,585165,43,1870,2,36000,1.02299465241
583267,583309,585212,42,1903,2,36000,1.02207041513
583286,583372,585288,86,1916,2,36000,1.04488517745
583301,583398,584915,97,1517,2,36000,1.06394199077
583362,583405,585401,43,1996,2,36000,1.02154308617
583387,583411,585332,24,1921,2,36000,1.01249349297
583402,583437,584981,35,1544,2,36000,1.02266839378
583403,583461,585109,58,1648,2,36000,1.03519417476
583427,583511,585558,84,2047,2,36000,1.04103566194
583449,583518,585278,69,1760,2,36000,1.03920454545
583501,583523,584845,22,1322,2,36000,1.01664145234
583517,583529,585100,12,1571,2,36000,1.00763844685
583518,583537,585450,19,1913,2,36000,1.00993204391
583519,583545,585516,26,1971,2,36000,1.01319127347
583535,583556,585556,21,2000,2,36000,1.0105
583536,583562,585665,26,2103,2,36000,1.01236329054
583552,583571,585178,19,1607,2,36000,1.01182327318
583553,583578,585370,25,1792,2,36000,1.01395089286
583569,583584,585476,15,1892,2,36000,1.00792811839
583570,583590,585534,20,1944,2,36000,1.01028806584
583571,583596,584734,25,1138,2,36000,1.02196836555
583587,583602,585034,15,1432,2,36000,1.01047486034
583589,583609,585011,20,1402,2,36000,1.01426533524
583590,583616,585309,26,1693,2,36000,1.01535735381
583606,583623,585091,17,1468,2,36000,1.01158038147
583607,583629,585585,22,1956,2,36000,1.01124744376
583622,583660,585652,38,1992,2,36000,1.01907630522
583624,583698,585526,74,1828,2,36000,1.04048140044
583651,583703,585658,52,1955,2,36000,1.02659846547
583688,583713,585020,25,1307,2,36000,1.01912777353
583689,583726,585872,37,2146,2,36000,1.01724137931
583704,583732,584943,28,1211,2,36000,1.02312138728
583720,583756,585701,36,1945,2,36000,1.01850899743
583721,583763,585645,42,1882,2,36000,1.02231668438
583745,583777,585668,32,1891,2,36000,1.01692226335
583760,583783,585751,23,1968,2,36000,1.01168699187
583776,583790,585024,14,1234,2,36000,1.0113452188
583777,583796,586017,19,2221,2,36000,1.00855470509
583779,583801,585669,22,1868,2,36000,1.01177730193
583795,583807,585604,12,1797,2,36000,1.00667779633
583797,583812,585271,15,1459,2,36000,1.01028101439
583798,583818,585491,20,1673,2,36000,1.01195457262
583799,583823,585779,24,1956,2,36000,1.01226993865
583801,583829,586102,28,2273,2,36000,1.01231852178
583802,583835,585787,33,1952,2,36000,1.0169057377
583818,583840,585149,22,1309,2,36000,1.01680672269
583819,583845,585794,26,1949,2,36000,1.01334017445
583820,583851,585849,31,1998,2,36000,1.01551551552
583821,583862,585824,41,1962,2,36000,1.02089704383
583837,583881,585420,44,1539,2,36000,1.0285899935
583852,583888,585995,36,2107,2,36000,1.01708590413
583870,583921,585974,51,2053,2,36000,1.02484169508
583886,583974,585889,88,1915,2,36000,1.04595300261
583911,583983,586438,72,2455,2,36000,1.02932790224
583963,583999,585941,36,1942,2,36000,1.01853759011
583978,584017,585878,39,1861,2,36000,1.02095647501
583993,584077,585830,84,1753,2,36000,1.04791785511
584008,584084,585201,76,1117,2,36000,1.06803939123
584070,584091,585236,21,1145,2,36000,1.01834061135
584071,584100,585449,29,1349,2,36000,1.02149740549
584086,584106,585922,20,1816,2,36000,1.01101321586
584102,584114,585953,12,1839,2,36000,1.00652528548
584104,584133,586092,29,1959,2,36000,1.01480347116
584105,584139,586137,34,1998,2,36000,1.01701701702
584123,584145,586037,22,1892,2,36000,1.01162790698
584139,584150,585635,11,1485,2,36000,1.00740740741
584140,584191,586009,51,1818,2,36000,1.02805280528
584142,584198,586056,56,1858,2,36000,1.03013993541
584181,584204,585816,23,1612,2,36000,1.01426799007
584197,584245,586137,48,1892,2,36000,1.02536997886
584198,584258,585518,60,1260,2,36000,1.04761904762
584232,584266,585714,34,1448,2,36000,1.02348066298
584247,584290,586226,43,1936,2,36000,1.0222107438
584262,584308,586165,46,1857,2,36000,1.02477113624
584280,584315,586402,35,2087,2,36000,1.01677048395
584299,584320,586071,21,1751,2,36000,1.01199314677
584315,584326,586167,11,1841,2,36000,1.00597501358
584316,584331,586232,15,1901,2,36000,1.0078905839
584318,584338,586215,20,1877,2,36000,1.01065530101
584319,584343,585653,24,1310,2,36000,1.01832061069
584320,584349,586289,29,1940,2,36000,1.01494845361
584336,584363,586460,27,2097,2,36000,1.01287553648
584337,584370,586134,33,1764,2,36000,1.01870748299
584352,584387,586370,35,1983,2,36000,1.01765002521
584354,584393,586165,39,1772,2,36000,1.02200902935
584378,584411,586137,33,1726,2,36000,1.0191193511
584393,584423,586219,30,1796,2,36000,1.01670378619
584409,584434,586609,25,2175,2,36000,1.01149425287
584424,584470,586520,46,2050,2,36000,1.02243902439
584425,584478,586341,53,1863,2,36000,1.02844873859
584459,584489,586658,30,2169,2,36000,1.01383125864
584475,584539,586602,64,2063,2,36000,1.03102278236
584490,584544,586257,54,1713,2,36000,1.03152364273
584530,584550,586412,20,1862,2,36000,1.01074113856
584531,584557,586464,26,1907,2,36000,1.01363398007
584532,584563,586287,31,1724,2,36000,1.01798143852
584548,584593,586286,45,1693,2,36000,1.02658003544
584563,584603,586118,40,1515,2,36000,1.02640264026
584585,584637,586753,52,2116,2,36000,1.02457466919
584600,584645,586425,45,1780,2,36000,1.02528089888
584627,584745,586350,118,1605,2,36000,1.07352024922
584643,584809,586675,166,1866,2,36000,1.08896034298
584735,584816,586809,81,1993,2,36000,1.04064224787
584799,584822,586721,23,1899,2,36000,1.0121116377
584815,584857,586760,42,1903,2,36000,1.02207041513
584816,584874,586632,58,1758,2,36000,1.03299203641
584847,584927,586841,80,1914,2,36000,1.04179728318
584863,584954,586700,91,1746,2,36000,1.05211912944
584918,584982,586394,64,1412,2,36000,1.04532577904
584946,584992,587066,46,2074,2,36000,1.02217936355
584973,585018,586975,45,1957,2,36000,1.02299437915
584990,585025,586658,35,1633,2,36000,1.0214329455
585009,585031,586842,22,1811,2,36000,1.01214798454
585025,585037,586927,12,1890,2,36000,1.00634920635
585026,585043,586929,17,1886,2,36000,1.00901378579
585027,585049,586851,22,1802,2,36000,1.01220865705
585029,585102,586092,73,990,2,36000,1.07373737374
585044,585109,586937,65,1828,2,36000,1.03555798687
585093,585115,587035,22,1920,2,36000,1.01145833333
585109,585121,586698,12,1577,2,36000,1.00760938491
585111,585127,586969,16,1842,2,36000,1.00868621064
585112,585161,587036,49,1875,2,36000,1.02613333333
585127,585166,586958,39,1792,2,36000,1.02176339286
585152,585172,586670,20,1498,2,36000,1.01335113485
585153,585179,587122,26,1943,2,36000,1.01338136902
585169,585184,587247,15,2063,2,36000,1.00727096461
585171,585191,586745,20,1554,2,36000,1.01287001287
585172,585196,587166,24,1970,2,36000,1.01218274112
585187,585212,587149,25,1937,2,36000,1.01290655653
585189,585224,586852,35,1628,2,36000,1.0214987715
585204,585248,586520,44,1272,2,36000,1.03459119497
585219,585282,587138,63,1856,2,36000,1.03394396552
585238,585289,587415,51,2126,2,36000,1.02398871119
585274,585299,586805,25,1506,2,36000,1.0166002656
585290,585320,586531,30,1211,2,36000,1.02477291495
585291,585343,587270,52,1927,2,36000,1.0269849507
585309,585381,587253,72,1872,2,36000,1.03846153846
585334,585413,587444,79,2031,2,36000,1.03889709503
585370,585431,586959,61,1528,2,36000,1.03992146597
585404,585460,586836,56,1376,2,36000,1.04069767442
585422,585467,586859,45,1392,2,36000,1.03232758621
585450,585478,587641,28,2163,2,36000,1.01294498382
585451,585487,587560,36,2073,2,36000,1.01736613603
585479,585503,587247,24,1744,2,36000,1.01376146789
585494,585528,587439,34,1911,2,36000,1.01779173208
585519,585535,587354,16,1819,2,36000,1.00879604178
585520,585541,587586,21,2045,2,36000,1.01026894866
585536,585547,587475,11,1928,2,36000,1.00570539419
585537,585567,587207,30,1640,2,36000,1.01829268293
585558,585574,587296,16,1722,2,36000,1.00929152149
585560,585596,587410,36,1814,2,36000,1.01984564498
585587,585615,586994,28,1379,2,36000,1.02030456853
585606,585646,587058,40,1412,2,36000,1.0283286119
585636,585656,587372,20,1716,2,36000,1.01165501166
585652,585663,587642,11,1979,2,36000,1.00555836281
585653,585669,587644,16,1975,2,36000,1.00810126582
585670,585676,587074,6,1398,2,36000,1.00429184549
585671,585682,587556,11,1874,2,36000,1.00586979723
585672,585688,587141,16,1453,2,36000,1.01101169993
585674,585693,587224,19,1531,2,36000,1.01241018942
585675,585712,587605,37,1893,2,36000,1.01954569466
585700,585725,587392,25,1667,2,36000,1.0149970006
585715,585763,587604,48,1841,2,36000,1.02607278653
585752,585790,587664,38,1874,2,36000,1.02027748132
585779,585798,587406,19,1608,2,36000,1.0118159204
585795,585805,587303,10,1498,2,36000,1.00667556742
585797,585828,587919,31,2091,2,36000,1.01482544237
585818,585835,587889,17,2054,2,36000,1.00827653359
585834,585841,587762,7,1921,2,36000,1.00364393545
585835,585860,587898,25,2038,2,36000,1.01226692836
585850,585883,587324,33,1441,2,36000,1.02290076336
585875,585890,587565,15,1675,2,36000,1.00895522388
585890,585901,587709,11,1808,2,36000,1.0060840708
585892,585933,587530,41,1597,2,36000,1.02567313713
585922,585953,587834,31,1881,2,36000,1.01648059543
585944,585964,587743,20,1779,2,36000,1.01124227094
585959,585985,588085,26,2100,2,36000,1.01238095238
585977,586007,587756,30,1749,2,36000,1.01715265866
585996,586020,587851,24,1831,2,36000,1.01310759148
586011,586028,588160,17,2132,2,36000,1.00797373358
586026,586047,587483,21,1436,2,36000,1.01462395543
586041,586068,587853,27,1785,2,36000,1.01512605042
586057,586082,587881,25,1799,2,36000,1.01389660923
586072,586103,587774,31,1671,2,36000,1.01855176541
586094,586108,587996,14,1888,2,36000,1.00741525424
586096,586115,588168,19,2053,2,36000,1.00925474915
586111,586129,587626,18,1497,2,36000,1.0120240481
586126,586145,587969,19,1824,2,36000,1.01041666667
586143,586151,588224,8,2073,2,36000,1.00385914134
586144,586157,588023,13,1866,2,36000,1.00696677385
586145,586162,587989,17,1827,2,36000,1.00930487137
586146,586176,588141,30,1965,2,36000,1.01526717557
586165,586181,588031,16,1850,2,36000,1.00864864865
586166,586187,587968,21,1781,2,36000,1.01179112858
586182,586226,588107,44,1881,2,36000,1.02339181287
586215,586232,588094,17,1862,2,36000,1.00912996778
586231,586238,588000,7,1762,2,36000,1.00397275823
586232,586244,587587,12,1343,2,36000,1.00893521966
586247,586268,587318,21,1050,2,36000,1.02
586263,586297,588169,34,1872,2,36000,1.01816239316
586288,586303,588076,15,1773,2,36000,1.00846023689
586289,586308,587787,19,1479,2,36000,1.01284651792
586291,586353,588347,62,1994,2,36000,1.03109327984
586343,586361,588487,18,2126,2,36000,1.00846660395
586358,586380,588362,22,1982,2,36000,1.01109989909
586373,586406,588363,33,1957,2,36000,1.01686254471
586395,586414,588494,19,2080,2,36000,1.00913461538
586410,586424,588436,14,2012,2,36000,1.0069582505
586425,586437,588268,12,1831,2,36000,1.00655379574
586426,586449,588025,23,1576,2,36000,1.01459390863
586442,586471,587968,29,1497,2,36000,1.01937207749
586463,586477,588013,14,1536,2,36000,1.00911458333
586465,586531,588353,66,1822,2,36000,1.03622392975
586521,586536,588462,15,1926,2,36000,1.00778816199
586522,586543,587900,21,1357,2,36000,1.01547531319
586537,586613,587944,76,1331,2,36000,1.05709992487
586605,586620,588312,15,1692,2,36000,1.00886524823
586620,586643,588658,23,2015,2,36000,1.01141439206
586635,586670,587953,35,1283,2,36000,1.02727981294
586660,586675,588132,15,1457,2,36000,1.01029512697
586662,586682,588485,20,1803,2,36000,1.01109262341
586677,586688,588219,11,1531,2,36000,1.00718484651
586678,586709,587985,31,1276,2,36000,1.02429467085
586700,586716,588366,16,1650,2,36000,1.0096969697
586701,586732,588616,31,1884,2,36000,1.01645435244
586723,586757,588359,34,1602,2,36000,1.02122347066
586747,586764,588687,17,1923,2,36000,1.00884035361
586763,586772,588840,9,2068,2,36000,1.00435203095
586764,586817,588371,53,1554,2,36000,1.03410553411
586807,586823,588788,16,1965,2,36000,1.00814249364
586822,586847,588744,25,1897,2,36000,1.01317870322
586838,586853,587968,15,1115,2,36000,1.0134529148
586853,586860,588640,7,1780,2,36000,1.00393258427
586855,586866,588513,11,1647,2,36000,1.00667880996
586856,586871,588795,15,1924,2,36000,1.0077962578
586857,586878,588687,21,1809,2,36000,1.01160862355
586873,586939,588761,66,1822,2,36000,1.03622392975
586928,586945,588681,17,1736,2,36000,1.00979262673
586944,586951,588372,7,1421,2,36000,1.00492610837
586945,586969,588568,24,1599,2,36000,1.01500938086
586963,586975,588867,12,1892,2,36000,1.00634249471
586964,586981,588610,17,1629,2,36000,1.01043585021
586979,586987,588787,8,1800,2,36000,1.00444444444
586981,587005,588821,24,1816,2,36000,1.01321585903
586996,587046,588995,50,1949,2,36000,1.02565418163
587036,587052,588940,16,1888,2,36000,1.00847457627
587037,587069,588776,32,1707,2,36000,1.01874633861
587059,587077,588843,18,1766,2,36000,1.01019252548
587074,587085,588965,11,1880,2,36000,1.00585106383
587075,587133,589023,58,1890,2,36000,1.03068783069
587125,587149,589070,24,1921,2,36000,1.01249349297
587139,587155,589131,16,1976,2,36000,1.00809716599
587155,587161,588757,6,1596,2,36000,1.0037593985
587156,587177,588878,21,1701,2,36000,1.01234567901
587172,587219,588974,47,1755,2,36000,1.02678062678
587208,587235,589350,27,2115,2,36000,1.01276595745
587227,587258,589022,31,1764,2,36000,1.01757369615
587249,587263,589309,14,2046,2,36000,1.00684261975
587250,587269,589180,19,1911,2,36000,1.00994243851
587265,587281,589100,16,1819,2,36000,1.00879604178
587280,587307,589203,27,1896,2,36000,1.01424050633
587299,587314,589113,15,1799,2,36000,1.00833796554
587314,587329,589217,15,1888,2,36000,1.00794491525
587329,587336,589065,7,1729,2,36000,1.004048583
587330,587366,589189,36,1823,2,36000,1.01974766868
587355,587383,589397,28,2014,2,36000,1.01390268123
587373,587403,588573,30,1170,2,36000,1.02564102564
587395,587417,589431,22,2014,2,36000,1.01092353525
587410,587424,589263,14,1839,2,36000,1.00761283306
587411,587430,588676,19,1246,2,36000,1.01524879615
587427,587450,589209,23,1759,2,36000,1.01307561114
587442,587456,588995,14,1539,2,36000,1.00909681611
587457,587487,589351,30,1864,2,36000,1.0160944206
587475,587494,589304,19,1810,2,36000,1.01049723757
587491,587541,589478,50,1937,2,36000,1.02581311306
587531,587567,589353,36,1786,2,36000,1.02015677492
587558,587573,589401,15,1828,2,36000,1.00820568928
587573,587579,589524,6,1945,2,36000,1.0030848329
587575,587597,589626,22,2029,2,36000,1.01084277969
587590,587604,589332,14,1728,2,36000,1.00810185185
587592,587615,589368,23,1753,2,36000,1.01312036509
587607,587622,589644,15,2022,2,36000,1.00741839763
587608,587637,589476,29,1839,2,36000,1.01576943991
587626,587652,589519,26,1867,2,36000,1.01392608463
587642,587659,589452,17,1793,2,36000,1.00948131623
587643,587664,589495,21,1831,2,36000,1.01146914255
587659,587676,589647,17,1971,2,36000,1.00862506342
587674,587720,589228,46,1508,2,36000,1.03050397878
587711,587754,589613,43,1859,2,36000,1.02313071544
587744,587767,589243,23,1476,2,36000,1.01558265583
587759,587773,589568,14,1795,2,36000,1.0077994429
587775,587786,589122,11,1336,2,36000,1.00823353293
587776,587798,588752,22,954,2,36000,1.02306079665
587791,587846,589699,55,1853,2,36000,1.02968159741
587837,587863,589737,26,1874,2,36000,1.01387406617
587852,587869,589565,17,1696,2,36000,1.01002358491
587867,587893,589968,26,2075,2,36000,1.01253012048
587883,587901,589474,18,1573,2,36000,1.01144310235
587899,587909,589900,10,1991,2,36000,1.00502260171
587901,587916,589534,15,1618,2,36000,1.00927070457
587902,587930,589531,28,1601,2,36000,1.01748906933
587920,587955,589552,35,1597,2,36000,1.02191609267
587945,587964,589871,19,1907,2,36000,1.00996329313
587960,587980,590155,20,2175,2,36000,1.0091954023
587977,587986,589819,9,1833,2,36000,1.00490998363
587979,587991,589191,12,1200,2,36000,1.01
587980,587996,589723,16,1727,2,36000,1.00926462073
587981,588002,589511,21,1509,2,36000,1.01391650099
587997,588008,589299,11,1291,2,36000,1.00852052672
587998,588013,590014,15,2001,2,36000,1.00749625187
588000,588020,589816,20,1796,2,36000,1.01113585746
588015,588026,589952,11,1926,2,36000,1.0057113188
588016,588034,589956,18,1922,2,36000,1.00936524454
588032,588040,589823,8,1783,2,36000,1.00448681997
588033,588047,589748,14,1701,2,36000,1.00823045267
588035,588087,589566,52,1479,2,36000,1.03515889114
588077,588096,589569,19,1473,2,36000,1.01289884589
588093,588106,589931,13,1825,2,36000,1.00712328767
588108,588118,589919,10,1801,2,36000,1.00555247085
588109,588144,589946,35,1802,2,36000,1.01942286349
588134,588153,590092,19,1939,2,36000,1.00979886539
588149,588170,589984,21,1814,2,36000,1.01157662624
588164,588179,590710,15,2531,2,36000,1.00592651126
588180,588185,589555,5,1370,2,36000,1.00364963504
588181,588230,590335,49,2105,2,36000,1.02327790974
588221,588236,589722,15,1486,2,36000,1.01009421265
588236,588279,589945,43,1666,2,36000,1.02581032413
588269,588324,589711,55,1387,2,36000,1.03965392934
588312,588358,590214,46,1856,2,36000,1.02478448276
588348,588364,590297,16,1933,2,36000,1.00827728919
588365,588371,590059,6,1688,2,36000,1.00355450237
588366,588377,590285,11,1908,2,36000,1.00576519916
588368,588383,590419,15,2036,2,36000,1.00736738703
588369,588388,589727,19,1339,2,36000,1.0141896938
588384,588394,590311,10,1917,2,36000,1.00521648409
588386,588400,589975,14,1575,2,36000,1.00888888889
588387,588447,590260,60,1813,2,36000,1.03309431881
588436,588473,590328,37,1855,2,36000,1.01994609164
588464,588496,590479,32,1983,2,36000,1.01613716591
588489,588503,589836,14,1333,2,36000,1.01050262566
588490,588510,590536,20,2026,2,36000,1.00987166831
588505,588524,590391,19,1867,2,36000,1.01017675415
588520,588579,590386,59,1807,2,36000,1.03265080243
588570,588585,590790,15,2205,2,36000,1.00680272109
588585,588621,590595,36,1974,2,36000,1.01823708207
588613,588628,590548,15,1920,2,36000,1.0078125
588629,588651,590534,22,1883,2,36000,1.0116834838
588644,588669,590622,25,1953,2,36000,1.01280081925
588659,588687,590009,28,1322,2,36000,1.02118003026
588678,588693,590461,15,1768,2,36000,1.0084841629
588694,588700,590648,6,1948,2,36000,1.00308008214
588695,588706,590071,11,1365,2,36000,1.00805860806
588697,588755,590594,58,1839,2,36000,1.03153887983
588745,588763,589868,18,1105,2,36000,1.01628959276
588762,588769,590328,7,1559,2,36000,1.00449005773
588763,588775,590069,12,1294,2,36000,1.00927357032
588764,588787,590415,23,1628,2,36000,1.01412776413
588779,588799,590409,20,1610,2,36000,1.01242236025
588795,588805,590732,10,1927,2,36000,1.0051894136
588796,588811,590265,15,1454,2,36000,1.01031636864
588798,588832,590833,34,2001,2,36000,1.01699150425
588822,588851,589965,29,1114,2,36000,1.02603231598
588840,588857,590311,17,1454,2,36000,1.01169188446
588856,588878,590859,22,1981,2,36000,1.01110550227
588871,588889,590703,18,1814,2,36000,1.00992282249
588886,588951,590873,65,1922,2,36000,1.03381893861
588941,588976,590550,35,1574,2,36000,1.02223634053
588966,588985,590667,19,1682,2,36000,1.0112960761
588981,589006,590113,25,1107,2,36000,1.02258355917
588996,589012,590393,16,1381,2,36000,1.01158580739
588998,589033,590895,35,1862,2,36000,1.01879699248
589022,589040,591084,18,2044,2,36000,1.00880626223
589037,589076,591056,39,1980,2,36000,1.0196969697
589065,589082,590676,17,1594,2,36000,1.01066499373
589080,589111,590356,31,1245,2,36000,1.02489959839
589101,589124,590826,23,1702,2,36000,1.01351351351
589117,589133,590873,16,1740,2,36000,1.0091954023
589132,589143,590558,11,1415,2,36000,1.00777385159
589134,589192,591073,58,1881,2,36000,1.03083466241
589183,589201,590457,18,1256,2,36000,1.01433121019
589198,589207,591055,9,1848,2,36000,1.00487012987
589199,589214,590454,15,1240,2,36000,1.01209677419
589215,589221,591037,6,1816,2,36000,1.00330396476
589216,589228,590378,12,1150,2,36000,1.01043478261
589232,589239,591112,7,1873,2,36000,1.00373731981
589233,589255,591081,22,1826,2,36000,1.01204819277
589248,589274,590962,26,1688,2,36000,1.0154028436
589264,589311,591379,47,2068,2,36000,1.02272727273
589301,589318,591143,17,1825,2,36000,1.00931506849
589317,589324,591193,7,1869,2,36000,1.00374531835
589318,589343,591235,25,1892,2,36000,1.01321353066
589333,589361,590680,28,1319,2,36000,1.02122820318
589352,589367,591212,15,1845,2,36000,1.0081300813
589353,589372,591346,19,1974,2,36000,1.00962512665
589369,589379,590531,10,1152,2,36000,1.00868055556
589370,589408,591581,38,2173,2,36000,1.01748734468
589397,589414,591027,17,1613,2,36000,1.01053936764
589412,589442,590818,30,1376,2,36000,1.02180232558
589431,589464,591066,33,1602,2,36000,1.02059925094
589455,589486,591239,31,1753,2,36000,1.01768397034
589477,589493,590757,16,1264,2,36000,1.01265822785
589478,589499,591334,21,1835,2,36000,1.01144414169
589493,589506,591503,13,1997,2,36000,1.00650976465
589509,589522,591177,13,1655,2,36000,1.00785498489
589524,589530,591543,6,2013,2,36000,1.00298062593
589526,589536,591371,10,1835,2,36000,1.00544959128
589527,589543,591507,16,1964,2,36000,1.00814663951
589542,589549,591329,7,1780,2,36000,1.00393258427
589544,589563,591459,19,1896,2,36000,1.01002109705
589559,589569,591409,10,1840,2,36000,1.00543478261
589561,589577,591453,16,1876,2,36000,1.00852878465
589577,589583,591165,6,1582,2,36000,1.00379266751
589578,589589,591702,11,2113,2,36000,1.00520586843
589579,589594,591101,15,1507,2,36000,1.0099535501
589581,589624,591161,43,1537,2,36000,1.02797657775
589614,589637,591342,23,1705,2,36000,1.01348973607
589629,589655,591425,26,1770,2,36000,1.01468926554
589645,589661,591548,16,1887,2,36000,1.0084790673
589660,589711,591545,51,1834,2,36000,1.02780806979
589699,589723,591746,24,2023,2,36000,1.01186356896
589715,589733,591643,18,1910,2,36000,1.00942408377
589731,589739,590858,8,1119,2,36000,1.00714924039
589732,589744,591714,12,1970,2,36000,1.00609137056
589733,589750,591608,17,1858,2,36000,1.00914962325
589749,589759,591443,10,1684,2,36000,1.00593824228
589750,589827,591474,77,1647,2,36000,1.0467516697
589817,589834,591591,17,1757,2,36000,1.00967558338
589833,589840,591293,7,1453,2,36000,1.00481761872
589834,589847,591265,13,1418,2,36000,1.00916784203
589849,589880,592084,31,2204,2,36000,1.01406533575
589870,589887,591942,17,2055,2,36000,1.00827250608
589872,589911,592251,39,2340,2,36000,1.01666666667
589902,589930,592021,28,2091,2,36000,1.01339072214
589921,589942,591799,21,1857,2,36000,1.0113085622
589936,589956,591913,20,1957,2,36000,1.01021972407
589951,589962,591468,11,1506,2,36000,1.00730411687
589953,589968,591823,15,1855,2,36000,1.00808625337
589954,589973,591527,19,1554,2,36000,1.01222651223
589970,589979,591807,9,1828,2,36000,1.00492341357
589972,589985,591573,13,1588,2,36000,1.00818639798
589973,589991,591429,18,1438,2,36000,1.01251738526
589988,589997,592075,9,2078,2,36000,1.00433108758
589990,590020,591833,30,1813,2,36000,1.0165471594
590011,590026,591464,15,1438,2,36000,1.01043115438
590027,590070,591555,43,1485,2,36000,1.02895622896
590059,590081,591885,22,1804,2,36000,1.01219512195
590075,590088,592049,13,1961,2,36000,1.00662927078
590076,590103,592011,27,1908,2,36000,1.0141509434
590094,590124,591568,30,1444,2,36000,1.02077562327
590113,590167,591764,54,1597,2,36000,1.03381340013
590157,590225,591713,68,1488,2,36000,1.04569892473
590215,590271,592005,56,1734,2,36000,1.03229527105
590264,590277,591495,13,1218,2,36000,1.01067323481
590279,590296,592013,17,1717,2,36000,1.0099009901
590295,590308,592234,13,1926,2,36000,1.00674974039
590310,590323,592296,13,1973,2,36000,1.00658895084
590326,590332,592512,6,2180,2,36000,1.00275229358
590327,590339,592279,12,1940,2,36000,1.00618556701
590343,590349,591740,6,1391,2,36000,1.00431344357
590344,590355,592129,11,1774,2,36000,1.00620067644
590345,590367,591505,22,1138,2,36000,1.01933216169
590363,590389,591672,26,1283,2,36000,1.0202650039
590378,590398,591896,20,1498,2,36000,1.01335113485
590394,590404,592230,10,1826,2,36000,1.00547645126
590395,590410,591905,15,1495,2,36000,1.01003344482
590397,590420,592165,23,1745,2,36000,1.01318051576
590412,590427,592167,15,1740,2,36000,1.00862068966
590428,590434,592525,6,2091,2,36000,1.00286944046
590429,590465,592375,36,1910,2,36000,1.01884816754
590457,590471,592389,14,1918,2,36000,1.00729927007
590458,590477,592459,19,1982,2,36000,1.00958627649
590473,590490,592439,17,1949,2,36000,1.00872242175
590489,590542,591892,53,1350,2,36000,1.03925925926
590531,590548,592132,17,1584,2,36000,1.01073232323
590547,590554,592472,7,1918,2,36000,1.00364963504
590548,590561,592548,13,1987,2,36000,1.00654252642
590564,590570,592351,6,1781,2,36000,1.00336889388
590565,590576,592376,11,1800,2,36000,1.00611111111
590567,590605,592151,38,1546,2,36000,1.02457956016
590595,590611,592524,16,1913,2,36000,1.00836382645
590596,590633,592613,37,1980,2,36000,1.01868686869
590624,590660,592325,36,1665,2,36000,1.02162162162
590651,590678,592480,27,1802,2,36000,1.01498335183
590670,590687,592639,17,1952,2,36000,1.00870901639
590686,590693,592537,7,1844,2,36000,1.00379609544
590687,590715,592334,28,1619,2,36000,1.01729462631
590705,590721,592674,16,1953,2,36000,1.00819252432
590721,590743,593027,22,2284,2,36000,1.00963222417
590736,590768,592638,32,1870,2,36000,1.01711229947
590757,590801,592427,44,1626,2,36000,1.0270602706
590791,590830,592608,39,1778,2,36000,1.02193475816
590818,590837,592504,19,1667,2,36000,1.01139772046
590834,590845,592993,11,2148,2,36000,1.00512104283
590835,590870,593013,35,2143,2,36000,1.01633224452
590861,590875,592798,14,1923,2,36000,1.00728029121
590862,590884,592704,22,1820,2,36000,1.01208791209
590878,590889,592156,11,1267,2,36000,1.00868192581
590879,590907,592855,28,1948,2,36000,1.01437371663
590897,590916,592490,19,1574,2,36000,1.01207115629
590964,590973,592847,9,1874,2,36000,1.00480256137
591029,591038,592914,9,1876,2,36000,1.00479744136
591044,591050,592914,6,1864,2,36000,1.00321888412
591060,591066,592412,6,1346,2,36000,1.0044576523
591061,591072,592919,11,1847,2,36000,1.00595560368
591076,591082,592556,6,1474,2,36000,1.00407055631
591078,591088,592831,10,1743,2,36000,1.00573723465
591093,591099,592923,6,1824,2,36000,1.00328947368
591095,591105,592989,10,1884,2,36000,1.00530785563
591110,591116,592933,6,1817,2,36000,1.0033021464
591125,591132,593180,7,2048,2,36000,1.00341796875
591144,591154,593116,10,1962,2,36000,1.00509683996
591162,591172,592095,10,923,2,36000,1.01083423619
591178,591184,592649,6,1465,2,36000,1.00409556314
591179,591190,592480,11,1290,2,36000,1.00852713178
591194,591204,592833,10,1629,2,36000,1.00613873542
591213,591224,593110,11,1886,2,36000,1.00583244963
591237,591246,592330,9,1084,2,36000,1.00830258303
591253,591259,592658,6,1399,2,36000,1.0042887777
591268,591276,593258,8,1982,2,36000,1.00403632694
591295,591304,593132,9,1828,2,36000,1.00492341357
591329,591340,593039,11,1699,2,36000,1.0064743967
591344,591350,592870,6,1520,2,36000,1.00394736842
591346,591356,593063,10,1707,2,36000,1.00585823081
591361,591367,593083,6,1716,2,36000,1.0034965035
591376,591382,593456,6,2074,2,36000,1.00289296046
591392,591398,592886,6,1488,2,36000,1.00403225806
591410,591420,592958,10,1538,2,36000,1.00650195059
591428,591437,592569,9,1132,2,36000,1.00795053004
591444,591450,593275,6,1825,2,36000,1.00328767123
591445,591456,593078,11,1622,2,36000,1.00678175092
591461,591467,593300,6,1833,2,36000,1.00327332242
591462,591473,593035,11,1562,2,36000,1.00704225352
591478,591484,593526,6,2042,2,36000,1.00293829579
591480,591490,593127,10,1637,2,36000,1.00610873549
591481,591495,593335,14,1840,2,36000,1.00760869565
591496,591506,593123,10,1617,2,36000,1.0061842919
591512,591518,592748,6,1230,2,36000,1.00487804878
591513,591524,593008,11,1484,2,36000,1.00741239892
591514,591529,593348,15,1819,2,36000,1.00824628917
591529,591538,592661,9,1123,2,36000,1.00801424755
591545,591555,593488,10,1933,2,36000,1.00517330574
591546,591562,592825,16,1263,2,36000,1.0126682502
591562,591568,593617,6,2049,2,36000,1.00292825769
591563,591574,593631,11,2057,2,36000,1.00534759358
591579,591584,593427,5,1843,2,36000,1.00271296799
591580,591590,592761,10,1171,2,36000,1.00853970965
591596,591602,593317,6,1715,2,36000,1.00349854227
591597,591608,593488,11,1880,2,36000,1.00585106383
591612,591620,593671,8,2051,2,36000,1.00390053632
591646,591655,593469,9,1814,2,36000,1.00496141125
591673,591683,593078,10,1395,2,36000,1.00716845878
591704,591714,593714,10,2000,2,36000,1.005
591720,591726,593506,6,1780,2,36000,1.00337078652
591721,591732,594122,11,2390,2,36000,1.00460251046
591742,591751,593738,9,1987,2,36000,1.00452944137
591758,591764,593763,6,1999,2,36000,1.00300150075
591773,591779,593538,6,1759,2,36000,1.00341102899
591800,591811,593737,11,1926,2,36000,1.0057113188
591815,591822,593778,7,1956,2,36000,1.00357873211
591831,591837,593128,6,1291,2,36000,1.00464756003
591846,591852,593648,6,1796,2,36000,1.00334075724
591886,591892,593510,6,1618,2,36000,1.00370828183
591902,591908,593950,6,2042,2,36000,1.00293829579
591903,591914,593198,11,1284,2,36000,1.00856697819
591919,591924,592751,5,827,2,36000,1.00604594921
591920,591930,593865,10,1935,2,36000,1.00516795866
591944,591950,593831,6,1881,2,36000,1.00318979266
592006,592012,594068,6,2056,2,36000,1.00291828794
592021,592027,593684,6,1657,2,36000,1.00362100181
592022,592033,593832,11,1799,2,36000,1.00611450806
592024,592038,594074,14,2036,2,36000,1.0068762279
592052,592058,593913,6,1855,2,36000,1.00323450135
592076,592082,593845,6,1763,2,36000,1.00340328985
592091,592097,593910,6,1813,2,36000,1.00330943188
592106,592113,594047,7,1934,2,36000,1.00361944157
592128,592134,594175,6,2041,2,36000,1.00293973542
592143,592149,594313,6,2164,2,36000,1.00277264325
592159,592165,594119,6,1954,2,36000,1.00307062436
592160,592171,593751,11,1580,2,36000,1.00696202532
592176,592182,594162,6,1980,2,36000,1.00303030303
592177,592188,594299,11,2111,2,36000,1.00521080057
592232,592238,593399,6,1161,2,36000,1.00516795866
592248,592254,593901,6,1647,2,36000,1.00364298725
592263,592269,593159,6,890,2,36000,1.00674157303
592281,592288,594023,7,1735,2,36000,1.00403458213
592297,592303,594169,6,1866,2,36000,1.00321543408
592327,592333,594258,6,1925,2,36000,1.00311688312
592343,592349,594227,6,1878,2,36000,1.00319488818
592344,592355,593882,11,1527,2,36000,1.00720366732
592359,592365,593514,6,1149,2,36000,1.00522193211
592378,592384,594378,6,1994,2,36000,1.00300902708
592379,592390,594301,11,1911,2,36000,1.00575614861
592394,592400,594157,6,1757,2,36000,1.00341491178
592412,592419,594366,7,1947,2,36000,1.00359527478
592428,592434,594173,6,1739,2,36000,1.00345025877
592443,592449,593509,6,1060,2,36000,1.00566037736
592461,592467,594069,6,1602,2,36000,1.00374531835
592476,592483,594393,7,1910,2,36000,1.00366492147
592492,592498,594216,6,1718,2,36000,1.00349243306
592493,592504,594284,11,1780,2,36000,1.00617977528
592495,592509,593794,14,1285,2,36000,1.01089494163
592510,592516,594278,6,1762,2,36000,1.00340522134
592526,592532,594137,6,1605,2,36000,1.00373831776
592527,592538,594520,11,1982,2,36000,1.00554994955
592528,592543,594460,15,1917,2,36000,1.00782472613
592544,592549,594357,5,1808,2,36000,1.00276548673
592559,592565,594409,6,1844,2,36000,1.0032537961
592560,592571,594267,11,1696,2,36000,1.00648584906
592575,592581,594465,6,1884,2,36000,1.00318471338
592609,592615,594200,6,1585,2,36000,1.00378548896
592624,592630,594430,6,1800,2,36000,1.00333333333
592640,592646,593796,6,1150,2,36000,1.0052173913
592641,592652,594699,11,2047,2,36000,1.00537371764
592656,592662,594406,6,1744,2,36000,1.00344036697
592672,592678,594020,6,1342,2,36000,1.0044709389
592673,592684,594518,11,1834,2,36000,1.00599781897
592688,592695,594214,7,1519,2,36000,1.00460829493
592707,592713,594109,6,1396,2,36000,1.00429799427
592750,592756,594413,6,1657,2,36000,1.00362100181
592766,592772,594668,6,1896,2,36000,1.00316455696
592767,592778,595669,11,2891,2,36000,1.0038049118
592798,592804,594455,6,1651,2,36000,1.00363416111
592825,592832,594241,7,1409,2,36000,1.00496806246
592841,592847,594759,6,1912,2,36000,1.00313807531
592842,592853,594476,11,1623,2,36000,1.0067775724
592858,592864,594619,6,1755,2,36000,1.00341880342
592859,592870,594744,11,1874,2,36000,1.00586979723
592874,592880,594752,6,1872,2,36000,1.00320512821
592889,592896,594686,7,1790,2,36000,1.00391061453
592914,592920,594739,6,1819,2,36000,1.00329851567
592915,592926,594707,11,1781,2,36000,1.00617630545
592931,592937,594667,6,1730,2,36000,1.00346820809
592932,592943,595021,11,2078,2,36000,1.00529355149
592948,592954,595022,6,2068,2,36000,1.00290135397
592963,592969,594269,6,1300,2,36000,1.00461538462
592991,592997,594592,6,1595,2,36000,1.00376175549
593006,593012,595062,6,2050,2,36000,1.00292682927
593022,593028,594755,6,1727,2,36000,1.00347423277
593023,593034,594948,11,1914,2,36000,1.00574712644
593039,593045,594697,6,1652,2,36000,1.00363196126
593040,593051,594379,11,1328,2,36000,1.00828313253
593041,593056,594807,15,1751,2,36000,1.00856653341
593066,593072,595118,6,2046,2,36000,1.00293255132
593081,593088,594921,7,1833,2,36000,1.00381887616
593083,593094,594760,11,1666,2,36000,1.00660264106
593098,593104,594836,6,1732,2,36000,1.00346420323
593113,593119,594207,6,1088,2,36000,1.00551470588
593129,593136,594347,7,1211,2,36000,1.00578034682
593131,593142,594953,11,1811,2,36000,1.00607399227
593132,593147,594692,15,1545,2,36000,1.00970873786
593133,593153,594686,20,1533,2,36000,1.01304631442
593149,593159,594775,10,1616,2,36000,1.00618811881
593164,593170,595125,6,1955,2,36000,1.00306905371
593182,593188,595095,6,1907,2,36000,1.00314630309
593200,593207,595034,7,1827,2,36000,1.00383141762
593259,593265,594532,6,1267,2,36000,1.0047355959
593277,593283,594961,6,1678,2,36000,1.00357568534
593302,593308,595303,6,1995,2,36000,1.0030075188
593320,593326,594336,6,1010,2,36000,1.00594059406
593339,593345,594988,6,1643,2,36000,1.00365185636
593354,593360,594833,6,1473,2,36000,1.00407331976
593400,593406,595201,6,1795,2,36000,1.00334261838
593427,593433,594664,6,1231,2,36000,1.00487408611
593458,593464,595380,6,1916,2,36000,1.00313152401
593473,593479,595368,6,1889,2,36000,1.00317628375
593488,593495,595413,7,1918,2,36000,1.00364963504
593490,593501,594996,11,1495,2,36000,1.00735785953
593508,593514,595400,6,1886,2,36000,1.00318133616
593524,593530,594594,6,1064,2,36000,1.00563909774
593525,593536,595590,11,2054,2,36000,1.00535540409
593527,593541,595406,14,1865,2,36000,1.00750670241
593542,593548,595475,6,1927,2,36000,1.00311364816
593543,593554,594977,11,1423,2,36000,1.00773014758
593617,593623,595243,6,1620,2,36000,1.0037037037
593632,593639,595634,7,1995,2,36000,1.00350877193
593648,593654,595367,6,1713,2,36000,1.00350262697
593672,593679,595119,7,1440,2,36000,1.00486111111
593688,593694,595639,6,1945,2,36000,1.0030848329
593715,593721,595740,6,2019,2,36000,1.0029717682
593740,593746,595770,6,2024,2,36000,1.00296442688
593741,593752,595428,11,1676,2,36000,1.00656324582
593757,593763,595496,6,1733,2,36000,1.00346220427
593772,593778,595416,6,1638,2,36000,1.00366300366
593788,593794,595736,6,1942,2,36000,1.00308959835
593803,593809,595645,6,1836,2,36000,1.00326797386
593804,593815,595769,11,1954,2,36000,1.00562947799
593829,593835,595708,6,1873,2,36000,1.00320341698
593844,593851,595632,7,1781,2,36000,1.00393037619
593846,593857,595978,11,2121,2,36000,1.00518623291
593867,593874,595675,7,1801,2,36000,1.00388672959
593882,593889,595848,7,1959,2,36000,1.00357325166
593904,593910,595474,6,1564,2,36000,1.00383631714
593919,593925,595826,6,1901,2,36000,1.00315623356
593921,593931,595208,10,1277,2,36000,1.00783085356
593951,593957,595534,6,1577,2,36000,1.00380469245
594023,594029,596074,6,2045,2,36000,1.00293398533
594024,594035,595535,11,1500,2,36000,1.00733333333
594049,594055,595870,6,1815,2,36000,1.00330578512
594071,594077,595351,6,1274,2,36000,1.00470957614
594072,594083,595798,11,1715,2,36000,1.00641399417
594087,594093,596023,6,1930,2,36000,1.00310880829
594112,594118,595986,6,1868,2,36000,1.00321199143
594127,594133,596191,6,2058,2,36000,1.0029154519
594128,594139,596081,11,1942,2,36000,1.00566426365
594144,594149,595285,5,1136,2,36000,1.00440140845
594159,594165,595590,6,1425,2,36000,1.00421052632
594175,594181,595988,6,1807,2,36000,1.00332042059
594176,594187,595988,11,1801,2,36000,1.00610771793
594178,594192,595839,14,1647,2,36000,1.00850030358
594179,594198,595928,19,1730,2,36000,1.01098265896
594204,594210,596291,6,2081,2,36000,1.00288322922
594227,594232,595734,5,1502,2,36000,1.00332889481
594228,594238,596521,10,2283,2,36000,1.00438020149
594229,594243,596076,14,1833,2,36000,1.00763775232
594231,594248,596132,17,1884,2,36000,1.00902335456
594246,594255,596069,9,1814,2,36000,1.00496141125
594261,594268,595688,7,1420,2,36000,1.00492957746
594277,594283,595945,6,1662,2,36000,1.0036101083
594278,594289,596198,11,1909,2,36000,1.00576217915
594295,594301,595868,6,1567,2,36000,1.00382897256
594296,594307,596050,11,1743,2,36000,1.00631095812
594312,594318,596052,6,1734,2,36000,1.00346020761
594313,594324,595694,11,1370,2,36000,1.00802919708
594328,594335,596273,7,1938,2,36000,1.0036119711
594344,594350,595883,6,1533,2,36000,1.00391389432
594359,594366,596105,7,1739,2,36000,1.0040253019
594361,594371,595764,10,1393,2,36000,1.0071787509
594376,594382,595991,6,1609,2,36000,1.00372902424
594391,594398,595927,7,1529,2,36000,1.00457815566
594393,594404,596309,11,1905,2,36000,1.00577427822
594409,594415,595716,6,1301,2,36000,1.00461183705
594410,594421,596170,11,1749,2,36000,1.00628930818
594412,594426,596434,14,2008,2,36000,1.00697211155
594427,594433,596315,6,1882,2,36000,1.00318809777
594442,594448,596392,6,1944,2,36000,1.00308641975
594461,594467,596343,6,1876,2,36000,1.00319829424
594462,594473,596140,11,1667,2,36000,1.00659868026
594479,594485,596367,6,1882,2,36000,1.00318809777
594481,594491,596058,10,1567,2,36000,1.00638162093
594518,594524,596365,6,1841,2,36000,1.00325909832
594534,594540,596251,6,1711,2,36000,1.00350672122
594535,594546,596465,11,1919,2,36000,1.00573215216
594593,594599,596585,6,1986,2,36000,1.00302114804
594608,594615,596539,7,1924,2,36000,1.00363825364
594624,594630,596444,6,1814,2,36000,1.0033076075
594666,594672,595872,6,1200,2,36000,1.005
594687,594693,596705,6,2012,2,36000,1.00298210736
594688,594699,596589,11,1890,2,36000,1.00582010582
594690,594704,596837,14,2133,2,36000,1.00656352555
594691,594710,596276,19,1566,2,36000,1.01213282248
594709,594716,596611,7,1895,2,36000,1.0036939314
594710,594721,596004,11,1283,2,36000,1.00857365549
594711,594727,595829,16,1102,2,36000,1.01451905626
594713,594732,596403,19,1671,2,36000,1.01137043686
594741,594747,596096,6,1349,2,36000,1.00444773907
594757,594763,596675,6,1912,2,36000,1.00313807531
594758,594769,596465,11,1696,2,36000,1.00648584906
594760,594774,596669,14,1895,2,36000,1.0073878628
594776,594782,595903,6,1121,2,36000,1.00535236396
594777,594788,596515,11,1727,2,36000,1.00636942675
594778,594793,596300,15,1507,2,36000,1.0099535501
594809,594815,596545,6,1730,2,36000,1.00346820809
594834,594841,596662,7,1821,2,36000,1.00384404174
594851,594857,596740,6,1883,2,36000,1.00318640467
594924,594930,596725,6,1795,2,36000,1.00334261838
594948,594955,596895,7,1940,2,36000,1.00360824742
594971,594978,597202,7,2224,2,36000,1.00314748201
594973,594983,596216,10,1233,2,36000,1.00811030008
594992,594998,596804,6,1806,2,36000,1.00332225914
594993,595004,596619,11,1615,2,36000,1.00681114551
595011,595017,596804,6,1787,2,36000,1.00335758254
595027,595033,596976,6,1943,2,36000,1.00308800823
595028,595039,596902,11,1863,2,36000,1.00590445518
595044,595050,596170,6,1120,2,36000,1.00535714286
595067,595073,597065,6,1992,2,36000,1.00301204819
595097,595103,596984,6,1881,2,36000,1.00318979266
595121,595127,596808,6,1681,2,36000,1.00356930399
595123,595133,596989,10,1856,2,36000,1.00538793103
595138,595144,597119,6,1975,2,36000,1.00303797468
595203,595209,597137,6,1928,2,36000,1.0031120332
595223,595229,596849,6,1620,2,36000,1.0037037037
595247,595253,596690,6,1437,2,36000,1.00417536534
595287,595293,597238,6,1945,2,36000,1.0030848329
595305,595311,596410,6,1099,2,36000,1.00545950864
595351,595358,596937,7,1579,2,36000,1.00443318556
595370,595376,597070,6,1694,2,36000,1.00354191263
595371,595382,597284,11,1902,2,36000,1.00578338591
595391,595397,597103,6,1706,2,36000,1.00351699883
595407,595413,597294,6,1881,2,36000,1.00318979266
595408,595419,597219,11,1800,2,36000,1.00611111111
595425,595431,596879,6,1448,2,36000,1.00414364641
595426,595437,597203,11,1766,2,36000,1.00622876557
595441,595448,596589,7,1141,2,36000,1.00613496933
595476,595482,597420,6,1938,2,36000,1.00309597523
595477,595488,597424,11,1936,2,36000,1.00568181818
595499,595505,596871,6,1366,2,36000,1.00439238653
595537,595543,597165,6,1622,2,36000,1.00369913687
595538,595549,597168,11,1619,2,36000,1.00679431748
595591,595597,596823,6,1226,2,36000,1.00489396411
595592,595603,597026,11,1423,2,36000,1.00773014758
595632,595638,597289,6,1651,2,36000,1.00363416111
595648,595654,597619,6,1965,2,36000,1.00305343511
595650,595660,597713,10,2053,2,36000,1.0048709206
595651,595665,596742,14,1077,2,36000,1.01299907149
595666,595672,597093,6,1421,2,36000,1.00422237861
595681,595687,597598,6,1911,2,36000,1.00313971743
595697,595703,596741,6,1038,2,36000,1.00578034682
595698,595709,596879,11,1170,2,36000,1.0094017094
595713,595719,597537,6,1818,2,36000,1.00330033003
595729,595735,597299,6,1564,2,36000,1.00383631714
595746,595752,597751,6,1999,2,36000,1.00300150075
595747,595758,597672,11,1914,2,36000,1.00574712644
595748,595763,597119,15,1356,2,36000,1.0110619469
595767,595773,596913,6,1140,2,36000,1.00526315789
595783,595789,597223,6,1434,2,36000,1.00418410042
595784,595795,597694,11,1899,2,36000,1.00579252238
595799,595805,597680,6,1875,2,36000,1.0032
595827,595833,597385,6,1552,2,36000,1.00386597938
595843,595849,597653,6,1804,2,36000,1.00332594235
595844,595855,597311,11,1456,2,36000,1.00755494505
595859,595866,597416,7,1550,2,36000,1.00451612903
595875,595881,597822,6,1941,2,36000,1.00309119011
595876,595887,597284,11,1397,2,36000,1.00787401575
595877,595892,597324,15,1432,2,36000,1.01047486034
595893,595898,597334,5,1436,2,36000,1.00348189415
595908,595914,597275,6,1361,2,36000,1.00440852314
595929,595936,597798,7,1862,2,36000,1.0037593985
595931,595941,597576,10,1635,2,36000,1.00611620795
595946,595952,597530,6,1578,2,36000,1.00380228137
595980,595986,597599,6,1613,2,36000,1.00371977681
595996,596002,597905,6,1903,2,36000,1.00315291645
595997,596008,597862,11,1854,2,36000,1.00593311758
595999,596013,597819,14,1806,2,36000,1.00775193798
596000,596018,597912,18,1894,2,36000,1.00950369588
596015,596024,597952,9,1928,2,36000,1.00466804979
596031,596037,598028,6,1991,2,36000,1.00301356102
596053,596059,597810,6,1751,2,36000,1.00342661336
596054,596065,597655,11,1590,2,36000,1.00691823899
596069,596076,597040,7,964,2,36000,1.00726141079
596071,596082,597848,11,1766,2,36000,1.00622876557
596087,596092,597943,5,1851,2,36000,1.00270124257
596088,596098,597657,10,1559,2,36000,1.00641436818
596089,596103,597709,14,1606,2,36000,1.00871731009
596105,596111,598064,6,1953,2,36000,1.00307219662
596120,596126,597935,6,1809,2,36000,1.00331674959
596135,596142,597943,7,1801,2,36000,1.00388672959
596151,596157,598116,6,1959,2,36000,1.00306278714
596172,596178,598006,6,1828,2,36000,1.00328227571
596174,596184,597759,10,1575,2,36000,1.00634920635
596192,596198,598009,6,1811,2,36000,1.00331308669
596208,596214,597935,6,1721,2,36000,1.00348634515
596223,596229,598178,6,1949,2,36000,1.0030785018
596251,596257,598041,6,1784,2,36000,1.0033632287
596275,596282,598070,7,1788,2,36000,1.00391498881
596291,596297,598179,6,1882,2,36000,1.00318809777
596292,596303,598153,11,1850,2,36000,1.00594594595
596308,596314,598082,6,1768,2,36000,1.00339366516
596309,596320,598290,11,1970,2,36000,1.00558375635
596325,596331,597431,6,1100,2,36000,1.00545454545
596343,596350,598436,7,2086,2,36000,1.0033557047
596368,596374,598643,6,2269,2,36000,1.00264433671
596369,596380,598359,11,1979,2,36000,1.00555836281
596394,596400,598304,6,1904,2,36000,1.0031512605
596409,596415,598467,6,2052,2,36000,1.00292397661
596411,596421,597954,10,1533,2,36000,1.00652315721
596436,596442,597651,6,1209,2,36000,1.00496277916
596452,596458,598323,6,1865,2,36000,1.00321715818
596467,596474,598401,7,1927,2,36000,1.00363258952
596469,596481,598500,12,2019,2,36000,1.0059435364
596518,596524,597987,6,1463,2,36000,1.004101162
596534,596540,597624,6,1084,2,36000,1.00553505535
596549,596555,598381,6,1826,2,36000,1.00328587076
596551,596561,598427,10,1866,2,36000,1.00535905681
596588,596594,598410,6,1816,2,36000,1.00330396476
596589,596600,598424,11,1824,2,36000,1.00603070175
596605,596611,597656,6,1045,2,36000,1.00574162679
596620,596627,598529,7,1902,2,36000,1.00368033649
596622,596632,598203,10,1571,2,36000,1.00636537237
596664,596671,598477,7,1806,2,36000,1.00387596899
596680,596686,597878,6,1192,2,36000,1.00503355705
596681,596692,598762,11,2070,2,36000,1.00531400966
596697,596703,598477,6,1774,2,36000,1.00338218715
596712,596718,598538,6,1820,2,36000,1.0032967033
596727,596733,598752,6,2019,2,36000,1.0029717682
596743,596749,598208,6,1459,2,36000,1.00411240576
596745,596755,598106,10,1351,2,36000,1.0074019245
596746,596760,597959,14,1199,2,36000,1.011676397
596805,596811,598697,6,1886,2,36000,1.00318133616
596806,596817,598603,11,1786,2,36000,1.00615901456
596822,596828,598802,6,1974,2,36000,1.00303951368
596837,596843,598025,6,1182,2,36000,1.00507614213
596838,596849,599095,11,2246,2,36000,1.00489759573
596854,596860,597941,6,1081,2,36000,1.00555041628
596872,596878,598733,6,1855,2,36000,1.00323450135
596890,596896,598805,6,1909,2,36000,1.00314300681
596891,596902,598550,11,1648,2,36000,1.00667475728
596908,596914,598565,6,1651,2,36000,1.00363416111
596910,596920,598921,10,2001,2,36000,1.00499750125
596925,596931,598162,6,1231,2,36000,1.00487408611
596940,596946,598595,6,1649,2,36000,1.00363856883
596977,596983,598971,6,1988,2,36000,1.00301810865
596993,596999,598879,6,1880,2,36000,1.00319148936
596994,597005,598970,11,1965,2,36000,1.00559796438
597029,597035,598863,6,1828,2,36000,1.00328227571
597045,597051,598829,6,1778,2,36000,1.00337457818
597067,597073,599092,6,2019,2,36000,1.0029717682
597082,597088,599041,6,1953,2,36000,1.00307219662
597097,597104,598607,7,1503,2,36000,1.00465735196
597113,597119,598421,6,1302,2,36000,1.00460829493
597129,597135,599088,6,1953,2,36000,1.00307219662
597130,597141,599103,11,1962,2,36000,1.00560652396
597147,597153,598663,6,1510,2,36000,1.00397350993
597166,597172,599147,6,1975,2,36000,1.00303797468
597182,597188,598522,6,1334,2,36000,1.00449775112
597200,597206,598248,6,1042,2,36000,1.00575815739
597217,597223,598706,6,1483,2,36000,1.004045853
597235,597241,599480,6,2239,2,36000,1.00267976775
597236,597247,599105,11,1858,2,36000,1.00592034446
597252,597258,599053,6,1795,2,36000,1.00334261838
597277,597283,598998,6,1715,2,36000,1.00349854227
597293,597299,599350,6,2051,2,36000,1.00292540224
597295,597305,598809,10,1504,2,36000,1.00664893617
597296,597310,599232,14,1922,2,36000,1.00728407908
597311,597318,598823,7,1505,2,36000,1.00465116279
597313,597324,598419,11,1095,2,36000,1.0100456621
597314,597329,599237,15,1908,2,36000,1.00786163522
597330,597335,599163,5,1828,2,36000,1.00273522976
597345,597351,599261,6,1910,2,36000,1.00314136126
597388,597394,599247,6,1853,2,36000,1.00323799244
597419,597425,598734,6,1309,2,36000,1.00458365164
597435,597441,598555,6,1114,2,36000,1.00538599641
597436,597447,598696,11,1249,2,36000,1.00880704564
597437,597452,599254,15,1802,2,36000,1.00832408435
597530,597536,598903,6,1367,2,36000,1.00438917337
597545,597551,599480,6,1929,2,36000,1.00311041991
597579,597585,599463,6,1878,2,36000,1.00319488818
597597,597603,599128,6,1525,2,36000,1.00393442623
597613,597619,599379,6,1760,2,36000,1.00340909091
597629,597635,599558,6,1923,2,36000,1.0031201248
597630,597641,598753,11,1112,2,36000,1.00989208633
597652,597658,598961,6,1303,2,36000,1.00460475825
597668,597675,599092,7,1417,2,36000,1.00494001411
597670,597680,598884,10,1204,2,36000,1.00830564784
597671,597687,599613,16,1926,2,36000,1.00830737279
597672,597692,599735,20,2043,2,36000,1.00978952521
597688,597698,599515,10,1817,2,36000,1.00550357733
597689,597703,599719,14,2016,2,36000,1.00694444444
597705,597711,599646,6,1935,2,36000,1.00310077519
597720,597726,599593,6,1867,2,36000,1.00321371184
597722,597732,599638,10,1906,2,36000,1.00524658972
597752,597758,599803,6,2045,2,36000,1.00293398533
597767,597774,599396,7,1622,2,36000,1.00431565968
597802,597809,599771,7,1962,2,36000,1.00356778797
597818,597824,599571,6,1747,2,36000,1.00343445907
597833,597839,598966,6,1127,2,36000,1.00532386868
597835,597845,599812,10,1967,2,36000,1.00508388409
597850,597856,599771,6,1915,2,36000,1.00313315927
597865,597872,599725,7,1853,2,36000,1.00377765785
597881,597887,599755,6,1868,2,36000,1.00321199143
597905,597912,599777,7,1865,2,36000,1.00375335121
597921,597927,599860,6,1933,2,36000,1.00310398345
597936,597943,599896,7,1953,2,36000,1.00358422939
597938,597948,599848,10,1900,2,36000,1.00526315789
597955,597961,599000,6,1039,2,36000,1.00577478345
597956,597967,599858,11,1891,2,36000,1.00581702803
597957,597972,599773,15,1801,2,36000,1.00832870627
597959,597978,599751,19,1773,2,36000,1.01071630006
597960,597983,599399,23,1416,2,36000,1.01624293785
597976,597989,599952,13,1963,2,36000,1.00662251656
597991,597997,600099,6,2102,2,36000,1.00285442436
598007,598013,600041,6,2028,2,36000,1.00295857988
598022,598028,599612,6,1584,2,36000,1.00378787879
598037,598044,599832,7,1788,2,36000,1.00391498881
598039,598050,600037,11,1987,2,36000,1.0055359839
598055,598061,599263,6,1202,2,36000,1.00499168053
598070,598076,599973,6,1897,2,36000,1.00316288877
598071,598082,599850,11,1768,2,36000,1.00622171946
598087,598093,600023,6,1930,2,36000,1.00310880829
598111,598117,599901,6,1784,2,36000,1.0033632287
598113,598123,600115,10,1992,2,36000,1.00502008032
598114,598128,599864,14,1736,2,36000,1.00806451613
598115,598133,599388,18,1255,2,36000,1.01434262948
598117,598139,599920,22,1781,2,36000,1.01235261089
598118,598145,600056,27,1911,2,36000,1.01412872841
598119,598150,600136,31,1986,2,36000,1.01560926485
598120,598155,599176,35,1021,2,36000,1.03428011753
598122,598164,599922,42,1758,2,36000,1.02389078498
598123,598173,600029,50,1856,2,36000,1.02693965517
598124,598189,600063,65,1874,2,36000,1.03468516542
598140,598196,600020,56,1824,2,36000,1.03070175439
598155,598214,600090,59,1876,2,36000,1.03144989339
598171,598221,600043,50,1822,2,36000,1.02744237102
598187,598259,600179,72,1920,2,36000,1.0375
598188,598301,600139,113,1838,2,36000,1.06147986942
598204,598315,600315,111,2000,2,36000,1.0555
598219,598334,600137,115,1803,2,36000,1.06378258458
598250,598370,600027,120,1657,2,36000,1.07242003621
598260,598266,646510,6,48244,1,86400,1.0001243678
598290,598392,600230,102,1838,2,36000,1.05549510337
598306,598412,600144,106,1732,2,36000,1.06120092379
598325,598421,600095,96,1674,2,36000,1.05734767025
598362,598430,600266,68,1836,2,36000,1.03703703704
598384,598437,600325,53,1888,2,36000,1.0280720339
598402,598443,600302,41,1859,2,36000,1.02205486821
598418,598449,599853,31,1404,2,36000,1.02207977208
598434,598454,600416,20,1962,2,36000,1.01019367992
598436,598479,600424,43,1945,2,36000,1.02210796915
598437,598488,599689,51,1201,2,36000,1.04246461282
598438,598493,599504,55,1011,2,36000,1.05440158259
598454,598512,599880,58,1368,2,36000,1.04239766082
598469,598533,600405,64,1872,2,36000,1.03418803419
598485,598540,600421,55,1881,2,36000,1.02923976608
598486,598551,600509,65,1958,2,36000,1.03319713994
598501,598561,600272,60,1711,2,36000,1.03506721216
598523,598567,599746,44,1179,2,36000,1.03731976251
598539,598577,600512,38,1935,2,36000,1.01963824289
598541,598606,599489,65,883,2,36000,1.07361268403
598556,598614,600701,58,2087,2,36000,1.02779108769
598558,598621,600297,63,1676,2,36000,1.03758949881
598573,598654,600520,81,1866,2,36000,1.04340836013
598598,598674,600398,76,1724,2,36000,1.04408352668
598613,598708,600548,95,1840,2,36000,1.05163043478
598615,598713,600177,98,1464,2,36000,1.06693989071
598646,598720,600710,74,1990,2,36000,1.03718592965
598664,598745,600922,81,2177,2,36000,1.03720716582
598699,598751,600053,52,1302,2,36000,1.03993855607
598700,598763,600111,63,1348,2,36000,1.04673590504
598715,598770,600359,55,1589,2,36000,1.03461296413
598734,598777,600394,43,1617,2,36000,1.02659245516
598735,598816,600576,81,1760,2,36000,1.04602272727
598754,598822,600796,68,1974,2,36000,1.03444782168
598756,598828,600727,72,1899,2,36000,1.03791469194
598771,598835,600485,64,1650,2,36000,1.03878787879
598806,598842,600766,36,1924,2,36000,1.01871101871
598807,598875,600810,68,1935,2,36000,1.03514211886
598822,598890,600809,68,1919,2,36000,1.03543512246
598838,598897,600770,59,1873,2,36000,1.03150026695
598839,598914,600764,75,1850,2,36000,1.04054054054
598867,598932,600477,65,1545,2,36000,1.04207119741
598882,598973,600800,91,1827,2,36000,1.04980842912
598898,598979,600028,81,1049,2,36000,1.07721639657
598913,598986,600526,73,1540,2,36000,1.0474025974
598929,598991,600970,62,1979,2,36000,1.03132895402
598962,599009,600296,47,1287,2,36000,1.03651903652
598979,599016,600747,37,1731,2,36000,1.02137492779
598980,599054,600648,74,1594,2,36000,1.04642409034
598982,599064,600397,82,1333,2,36000,1.06151537884
599000,599100,600848,100,1748,2,36000,1.05720823799
599001,599107,600895,106,1788,2,36000,1.05928411633
599046,599112,600752,66,1640,2,36000,1.04024390244
599061,599118,600345,57,1227,2,36000,1.04645476773
599089,599124,601056,35,1932,2,36000,1.01811594203
599106,599129,600738,23,1609,2,36000,1.01429459291
599107,599139,600297,32,1158,2,36000,1.02763385147
599108,599158,601067,50,1909,2,36000,1.02619172342
599110,599174,600912,64,1738,2,36000,1.03682393556
599111,599188,600623,77,1435,2,36000,1.05365853659
599130,599244,601102,114,1858,2,36000,1.06135629709
599149,599251,601403,102,2152,2,36000,1.04739776952
599164,599258,601017,94,1759,2,36000,1.05343945424
599180,599265,600601,85,1336,2,36000,1.06362275449
599235,599272,601221,37,1949,2,36000,1.01898409441
599251,599279,600508,28,1229,2,36000,1.0227827502
599252,599361,601383,109,2022,2,36000,1.05390702275
599269,599390,601278,121,1888,2,36000,1.06408898305
599270,599399,601337,129,1938,2,36000,1.06656346749
599271,599407,601366,136,1959,2,36000,1.06942317509
599351,599414,601193,63,1779,2,36000,1.03541315346
599376,599474,601371,98,1897,2,36000,1.05166051661
599391,599492,601371,101,1879,2,36000,1.05375199574
599407,599497,600873,90,1376,2,36000,1.06540697674
599408,599504,601200,96,1696,2,36000,1.05660377358
599463,599515,601261,52,1746,2,36000,1.02978235968
599482,599526,601134,44,1608,2,36000,1.02736318408
599484,599569,601347,85,1778,2,36000,1.04780652418
599499,599582,601423,83,1841,2,36000,1.04508419337
599514,599605,601574,91,1969,2,36000,1.04621635348
599530,599623,601520,93,1897,2,36000,1.04902477596
599561,599629,601434,68,1805,2,36000,1.03767313019
599576,599650,601438,74,1788,2,36000,1.04138702461
599595,599657,601566,62,1909,2,36000,1.03247773704
599614,599701,600964,87,1263,2,36000,1.06888361045
599615,599731,601659,116,1928,2,36000,1.0601659751
599640,599738,601551,98,1813,2,36000,1.05405405405
599656,599746,601466,90,1720,2,36000,1.0523255814
599690,599758,601636,68,1878,2,36000,1.03620873269
599721,599765,601746,44,1981,2,36000,1.02221100454
599736,599772,601523,36,1751,2,36000,1.02055968018
599738,599782,600862,44,1080,2,36000,1.04074074074
599754,599787,601776,33,1989,2,36000,1.01659125189
599755,599794,601057,39,1263,2,36000,1.03087885986
599770,599799,601108,29,1309,2,36000,1.02215431627
599772,599815,601178,43,1363,2,36000,1.03154805576
599788,599823,601638,35,1815,2,36000,1.01928374656
599789,599843,601279,54,1436,2,36000,1.03760445682
599791,599859,601229,68,1370,2,36000,1.0496350365
599807,599866,601665,59,1799,2,36000,1.03279599778
599822,599871,601796,49,1925,2,36000,1.02545454545
599838,599878,601652,40,1774,2,36000,1.02254791432
599854,599883,601355,29,1472,2,36000,1.01970108696
599856,599889,601781,33,1892,2,36000,1.01744186047
599857,599895,601132,38,1237,2,36000,1.03071948262
599873,599908,601557,35,1649,2,36000,1.02122498484
599875,599914,601531,39,1617,2,36000,1.0241187384
599876,599931,601654,55,1723,2,36000,1.0319210679
599892,599937,600994,45,1057,2,36000,1.04257332072
599907,599963,601526,56,1563,2,36000,1.03582853487
599909,599984,601386,75,1402,2,36000,1.05349500713
599925,600032,601941,107,1909,2,36000,1.05605028811
599926,600039,602107,113,2068,2,36000,1.05464216634
599954,600045,601734,91,1689,2,36000,1.05387803434
599976,600051,601836,75,1785,2,36000,1.04201680672
600023,600057,601839,34,1782,2,36000,1.01907968575
600024,600062,601084,38,1022,2,36000,1.03718199609
600041,600069,602020,28,1951,2,36000,1.01435161456
600042,600074,601155,32,1081,2,36000,1.02960222017
600043,600079,602076,36,1997,2,36000,1.01802704056
600045,600084,601363,39,1279,2,36000,1.03049257232
600046,600091,601722,45,1631,2,36000,1.02759043532
600063,600101,602133,38,2032,2,36000,1.0187007874
600064,600108,601907,44,1799,2,36000,1.02445803224
600065,600115,602171,50,2056,2,36000,1.02431906615
600067,600122,602126,55,2004,2,36000,1.02744510978
600092,600129,601602,37,1473,2,36000,1.02511880516
600108,600147,602334,39,2187,2,36000,1.01783264746
600109,600154,601385,45,1231,2,36000,1.03655564582
600125,600159,601949,34,1790,2,36000,1.01899441341
600126,600166,602095,40,1929,2,36000,1.02073613271
600143,600188,601382,45,1194,2,36000,1.03768844221
600144,600195,601615,51,1420,2,36000,1.03591549296
600145,600241,602288,96,2047,2,36000,1.04689789936
600161,600277,602210,116,1933,2,36000,1.06001034661
600180,600284,601600,104,1316,2,36000,1.07902735562
600182,600308,602211,126,1903,2,36000,1.0662112454
600231,600313,602079,82,1766,2,36000,1.04643261608
600268,600318,602223,50,1905,2,36000,1.02624671916
600284,600324,601989,40,1665,2,36000,1.02402402402
600300,600331,602228,31,1897,2,36000,1.01634159199
600301,600338,602143,37,1805,2,36000,1.02049861496
600303,600356,602354,53,1998,2,36000,1.02652652653
600318,600370,602230,52,1860,2,36000,1.02795698925
600320,600405,601835,85,1430,2,36000,1.05944055944
600335,600411,602315,76,1904,2,36000,1.03991596639
600351,600417,601767,66,1350,2,36000,1.04888888889
600367,600423,602217,56,1794,2,36000,1.03121516165
600394,600430,602045,36,1615,2,36000,1.02229102167
600410,600436,602363,26,1927,2,36000,1.01349247535
600412,600443,602388,31,1945,2,36000,1.01593830334
600413,600488,602045,75,1557,2,36000,1.04816955684
600429,600496,602424,67,1928,2,36000,1.03475103734
600430,600519,601864,89,1345,2,36000,1.06617100372
600432,600525,602034,93,1509,2,36000,1.06163021869
600478,600530,602528,52,1998,2,36000,1.02602602603
600496,600537,602200,41,1663,2,36000,1.02465423933
600513,600542,602406,29,1864,2,36000,1.01555793991
600515,600560,602288,45,1728,2,36000,1.02604166667
600516,600588,601614,72,1026,2,36000,1.0701754386
600533,600612,602510,79,1898,2,36000,1.0416227608
600534,600634,601725,100,1091,2,36000,1.09165902841
600550,600659,602089,109,1430,2,36000,1.07622377622
600575,600712,602613,137,1901,2,36000,1.07206733298
600603,600722,601701,119,979,2,36000,1.1215526047
600625,600738,602800,113,2062,2,36000,1.05480116392
600650,600749,602584,99,1835,2,36000,1.05395095368
600703,600760,602626,57,1866,2,36000,1.03054662379
600719,600767,601794,48,1027,2,36000,1.04673807205
600734,600776,602622,42,1846,2,36000,1.02275189599
600750,600783,602578,33,1795,2,36000,1.01838440111
600751,600788,602545,37,1757,2,36000,1.02105862265
600768,600807,601881,39,1074,2,36000,1.03631284916
600769,600813,602510,44,1697,2,36000,1.02592810843
600770,600820,602595,50,1775,2,36000,1.02816901408
600786,600826,602610,40,1784,2,36000,1.02242152466
600802,600859,602411,57,1552,2,36000,1.03672680412
600803,600873,602698,70,1825,2,36000,1.03835616438
600819,600884,602184,65,1300,2,36000,1.05
600820,600906,602693,86,1787,2,36000,1.04812534975
600853,600923,602899,70,1976,2,36000,1.03542510121
600870,600934,602873,64,1939,2,36000,1.03300670449
600887,600975,602039,88,1064,2,36000,1.08270676692
600902,600981,602949,79,1968,2,36000,1.04014227642
600918,601005,602769,87,1764,2,36000,1.04931972789
600934,601028,602417,94,1389,2,36000,1.06767458603
600967,601067,602455,100,1388,2,36000,1.07204610951
600983,601074,603028,91,1954,2,36000,1.04657113613
600998,601081,602999,83,1918,2,36000,1.043274244
601020,601096,602308,76,1212,2,36000,1.06270627063
601062,601113,602995,51,1882,2,36000,1.02709883103
601064,601120,602602,56,1482,2,36000,1.03778677463
601079,601143,602675,64,1532,2,36000,1.04177545692
601095,601149,602448,54,1299,2,36000,1.0415704388
601110,601166,602905,56,1739,2,36000,1.03220241518
601112,601190,603197,78,2007,2,36000,1.03886397608
601133,601205,603272,72,2067,2,36000,1.03483309144
601135,601211,602524,76,1313,2,36000,1.05788271135
601157,601232,602411,75,1179,2,36000,1.06361323155
601182,601240,602409,58,1169,2,36000,1.0496150556
601197,601272,602667,75,1395,2,36000,1.05376344086
601216,601289,602628,73,1339,2,36000,1.05451829724
601231,601295,602904,64,1609,2,36000,1.03977625855
601233,601349,602805,116,1456,2,36000,1.07967032967
601262,601358,603177,96,1819,2,36000,1.05277625069
601285,601366,603249,81,1883,2,36000,1.04301646309
601287,601374,602988,87,1614,2,36000,1.05390334572
601339,601381,603273,42,1892,2,36000,1.0221987315
601354,601387,602849,33,1462,2,36000,1.02257181943
601370,601392,603167,22,1775,2,36000,1.0123943662
601371,601399,602792,28,1393,2,36000,1.02010050251
601375,601404,603520,29,2116,2,36000,1.01370510397
601392,601409,602373,17,964,2,36000,1.01763485477
601393,601414,602526,21,1112,2,36000,1.01888489209
601394,601421,603240,27,1819,2,36000,1.01484332051
601396,601434,602546,38,1112,2,36000,1.03417266187
601397,601445,603329,48,1884,2,36000,1.02547770701
601398,601452,603253,54,1801,2,36000,1.02998334259
601414,601477,603284,63,1807,2,36000,1.03486441616
601429,601531,602537,102,1006,2,36000,1.1013916501
601445,601538,603076,93,1538,2,36000,1.06046814044
601446,601544,603319,98,1775,2,36000,1.05521126761
601468,601550,603552,82,2002,2,36000,1.04095904096
601523,601563,603410,40,1847,2,36000,1.02165674066
601524,601569,602802,45,1233,2,36000,1.03649635036
601540,601577,603556,37,1979,2,36000,1.01869631127
601541,601586,603384,45,1798,2,36000,1.02502780868
601557,601611,603495,54,1884,2,36000,1.02866242038
601573,601618,603261,45,1643,2,36000,1.0273889227
601574,601626,603584,52,1958,2,36000,1.02655771195
601589,601631,603454,42,1823,2,36000,1.02303894679
601605,601647,602923,42,1276,2,36000,1.0329153605
601606,601653,603470,47,1817,2,36000,1.02586681343
601622,601664,603644,42,1980,2,36000,1.02121212121
601623,601671,603153,48,1482,2,36000,1.03238866397
601639,601677,603262,38,1585,2,36000,1.02397476341
601640,601683,603557,43,1874,2,36000,1.02294557097
601656,601712,603418,56,1706,2,36000,1.03282532239
601657,601733,603175,76,1442,2,36000,1.05270457698
601673,601740,602903,67,1163,2,36000,1.05760963027
601674,601746,603177,72,1431,2,36000,1.05031446541
601702,601757,603810,55,2053,2,36000,1.02679006332
601724,601778,603796,54,2018,2,36000,1.02675916749
601740,601787,603795,47,2008,2,36000,1.0234063745
601741,601794,603199,53,1405,2,36000,1.03772241993
601756,601806,603916,50,2110,2,36000,1.02369668246
601772,601813,603606,41,1793,2,36000,1.02286670385
601788,601847,602922,59,1075,2,36000,1.05488372093
601789,601853,603731,64,1878,2,36000,1.03407880724
601805,601859,603664,54,1805,2,36000,1.02991689751
601806,601875,604021,69,2146,2,36000,1.0321528425
601837,601893,603956,56,2063,2,36000,1.02714493456
601838,601919,603467,81,1548,2,36000,1.0523255814
601854,601952,603571,98,1619,2,36000,1.06053119209
601869,601960,603391,91,1431,2,36000,1.06359189378
601884,602001,604182,117,2181,2,36000,1.05364511692
601911,602011,603111,100,1100,2,36000,1.09090909091
601942,602032,603387,90,1355,2,36000,1.06642066421
601957,602046,603862,89,1816,2,36000,1.04900881057
601991,602053,603761,62,1708,2,36000,1.03629976581
602021,602059,604098,38,2039,2,36000,1.01863658656
602037,602064,603851,27,1787,2,36000,1.01510912143
602054,602087,603333,33,1246,2,36000,1.0264847512
602055,602094,603391,39,1297,2,36000,1.0300693909
602056,602100,603349,44,1249,2,36000,1.03522818255
602078,602107,603458,29,1351,2,36000,1.02146558105
602093,602118,603506,25,1388,2,36000,1.01801152738
602095,602137,603682,42,1545,2,36000,1.02718446602
602110,602144,603250,34,1106,2,36000,1.03074141049
602112,602154,604129,42,1975,2,36000,1.02126582278
602127,602182,604100,55,1918,2,36000,1.02867570386
602142,602195,603637,53,1442,2,36000,1.03675450763
602144,602211,603405,67,1194,2,36000,1.05611390285
602171,602221,603836,50,1615,2,36000,1.03095975232
602187,602228,603634,41,1406,2,36000,1.02916073969
602203,602233,604179,30,1946,2,36000,1.01541623844
602219,602239,603626,20,1387,2,36000,1.01441961067
602220,602244,603789,24,1545,2,36000,1.01553398058
602222,602251,603757,29,1506,2,36000,1.0192563081
602238,602299,604273,61,1974,2,36000,1.03090172239
602239,602304,604157,65,1853,2,36000,1.03507825148
602240,602320,603370,80,1050,2,36000,1.07619047619
602291,602327,604261,36,1934,2,36000,1.01861427094
602292,602345,603404,53,1059,2,36000,1.05004721435
602311,602366,603936,55,1570,2,36000,1.03503184713
602327,602374,603723,47,1349,2,36000,1.03484062268
602342,602385,604232,43,1847,2,36000,1.02328099621
602357,602399,603342,42,943,2,36000,1.04453870626
602373,602417,604271,44,1854,2,36000,1.02373247033
602388,602424,603776,36,1352,2,36000,1.02662721893
602389,602430,603545,41,1115,2,36000,1.03677130045
602408,602435,604401,27,1966,2,36000,1.01373346897
602426,602441,603421,15,980,2,36000,1.01530612245
602428,602446,603546,18,1100,2,36000,1.01636363636
602429,602459,603676,30,1217,2,36000,1.02465078061
602430,602466,604383,36,1917,2,36000,1.01877934272
602432,602522,604481,90,1959,2,36000,1.04594180704
602451,602527,604342,76,1815,2,36000,1.04187327824
602466,602536,604558,70,2022,2,36000,1.03461918892
602512,602543,604470,31,1927,2,36000,1.01608718215
602513,602548,604278,35,1730,2,36000,1.02023121387
602529,602555,604082,26,1527,2,36000,1.01702685003
602531,602562,604199,31,1637,2,36000,1.01893708002
602532,602568,603680,36,1112,2,36000,1.03237410072
602548,602590,604307,42,1717,2,36000,1.02446126966
602549,602597,604482,48,1885,2,36000,1.02546419098
602551,602606,604210,55,1604,2,36000,1.03428927681
602578,602613,604571,35,1958,2,36000,1.01787538304
602594,602622,604079,28,1457,2,36000,1.01921757035
602609,602628,604668,19,2040,2,36000,1.00931372549
602611,602634,603736,23,1102,2,36000,1.02087114338
602626,602640,604479,14,1839,2,36000,1.00761283306
602628,602679,603894,51,1215,2,36000,1.04197530864
602629,602646,604458,17,1812,2,36000,1.00938189845
602630,602686,604668,56,1982,2,36000,1.0282542886
602646,602704,604559,58,1855,2,36000,1.03126684636
602668,602711,604228,43,1517,2,36000,1.02834541859
602683,602780,604781,97,2001,2,36000,1.04847576212
602699,602804,604741,105,1937,2,36000,1.05420753743
602700,602811,604909,111,2098,2,36000,1.05290753098
602767,602818,604178,51,1360,2,36000,1.0375
602795,602824,604540,29,1716,2,36000,1.0168997669
602811,602860,605033,49,2173,2,36000,1.02254947078
602813,602884,604995,71,2111,2,36000,1.03363334912
602814,602910,604307,96,1397,2,36000,1.06871868289
602851,602916,604984,65,2068,2,36000,1.03143133462
602876,602921,604734,45,1813,2,36000,1.02482073911
602898,602927,604846,29,1919,2,36000,1.01511203752
602914,602933,604927,19,1994,2,36000,1.00952858576
602915,602939,605067,24,2128,2,36000,1.01127819549
602916,602960,604255,44,1295,2,36000,1.03397683398
602932,602999,604741,67,1742,2,36000,1.03846153846
602933,603006,604029,73,1023,2,36000,1.07135874878
602951,603012,604766,61,1754,2,36000,1.03477765108
602988,603040,604189,52,1149,2,36000,1.045256745
603005,603087,604398,82,1311,2,36000,1.06254767353
603006,603123,604988,117,1865,2,36000,1.06273458445
603031,603165,604711,134,1546,2,36000,1.08667529107
603077,603178,605033,101,1855,2,36000,1.05444743935
603113,603186,604299,73,1113,2,36000,1.06558849955
603157,603193,604819,36,1626,2,36000,1.0221402214
603172,603198,605276,26,2078,2,36000,1.0125120308
603188,603208,605033,20,1825,2,36000,1.01095890411
603190,603214,604491,24,1277,2,36000,1.01879404855
603191,603251,604315,60,1064,2,36000,1.05639097744
603207,603260,604325,53,1065,2,36000,1.04976525822
603208,603267,604681,59,1414,2,36000,1.04172560113
603242,603272,605276,30,2004,2,36000,1.01497005988
603258,603279,605499,21,2220,2,36000,1.00945945946
603259,603284,605193,25,1909,2,36000,1.01309586171
603260,603290,605068,30,1778,2,36000,1.01687289089
603276,603296,605125,20,1829,2,36000,1.01093493712
603278,603302,605082,24,1780,2,36000,1.01348314607
603279,603330,605191,51,1861,2,36000,1.02740462117
603280,603341,605396,61,2055,2,36000,1.0296836983
603296,603347,605333,51,1986,2,36000,1.02567975831
603320,603353,605023,33,1670,2,36000,1.01976047904
603336,603361,604369,25,1008,2,36000,1.0248015873
603337,603381,604893,44,1512,2,36000,1.0291005291
603353,603396,605269,43,1873,2,36000,1.02295782168
603354,603403,604727,49,1324,2,36000,1.03700906344
603372,603409,604765,37,1356,2,36000,1.02728613569
603388,603414,605090,26,1676,2,36000,1.01551312649
603389,603420,604532,31,1112,2,36000,1.02787769784
603405,603425,604988,20,1563,2,36000,1.01279590531
603406,603432,605380,26,1948,2,36000,1.01334702259
603408,603438,605261,30,1823,2,36000,1.01645639057
603409,603443,604668,34,1225,2,36000,1.02775510204
603425,603465,604599,40,1134,2,36000,1.03527336861
603427,603472,604889,45,1417,2,36000,1.03175723359
603428,603479,605204,51,1725,2,36000,1.02956521739
603456,603485,605308,29,1823,2,36000,1.01590784421
603472,603507,604849,35,1342,2,36000,1.0260804769
603473,603517,604928,44,1411,2,36000,1.03118355776
603474,603531,604589,57,1058,2,36000,1.05387523629
603496,603557,604469,61,912,2,36000,1.06688596491
603511,603562,604772,51,1210,2,36000,1.04214876033
603527,603569,605244,42,1675,2,36000,1.02507462687
603548,603575,604732,27,1157,2,36000,1.02333621435
603550,603580,604734,30,1154,2,36000,1.0259965338
603566,603586,604784,20,1198,2,36000,1.01669449082
603567,603595,605563,28,1968,2,36000,1.01422764228
603568,603617,605004,49,1387,2,36000,1.03532804614
603584,603637,605358,53,1721,2,36000,1.03079604881
603585,603646,604682,61,1036,2,36000,1.05888030888
603607,603653,605056,46,1403,2,36000,1.03278688525
603628,603659,604829,31,1170,2,36000,1.0264957265
603645,603675,604952,30,1277,2,36000,1.02349256069
603646,603687,604975,41,1288,2,36000,1.03183229814
603647,603694,605557,47,1863,2,36000,1.02522812668
603666,603699,605561,33,1862,2,36000,1.01772287863
603682,603734,605440,52,1706,2,36000,1.03048065651
603683,603742,605428,59,1686,2,36000,1.0349940688
603684,603749,605643,65,1894,2,36000,1.0343189018
603724,603769,605503,45,1734,2,36000,1.02595155709
603740,603776,605095,36,1319,2,36000,1.02729340409
603741,603787,605880,46,2093,2,36000,1.02197802198
603760,603801,605776,41,1975,2,36000,1.02075949367
603776,603807,605016,31,1209,2,36000,1.02564102564
603777,603814,605772,37,1958,2,36000,1.0188968335
603793,603821,605105,28,1284,2,36000,1.02180685358
603808,603847,605991,39,2144,2,36000,1.01819029851
603810,603863,605203,53,1340,2,36000,1.03955223881
603825,603874,605066,49,1192,2,36000,1.04110738255
603840,603905,605299,65,1394,2,36000,1.04662840746
603855,603927,605868,72,1941,2,36000,1.0370942813
603871,603947,605019,76,1072,2,36000,1.07089552239
603895,603967,605749,72,1782,2,36000,1.0404040404
603917,604033,605341,116,1308,2,36000,1.08868501529
603938,604040,605767,102,1727,2,36000,1.05906195715
603957,604092,605912,135,1820,2,36000,1.07417582418
604024,604099,605369,75,1270,2,36000,1.05905511811
604040,604110,606247,70,2137,2,36000,1.03275620028
604083,604117,605840,34,1723,2,36000,1.0197330238
604084,604140,605917,56,1777,2,36000,1.03151378728
604100,604168,605396,68,1228,2,36000,1.05537459283
604101,604189,605326,88,1137,2,36000,1.07739665787
604132,604196,605904,64,1708,2,36000,1.037470726
604160,604202,605694,42,1492,2,36000,1.02815013405
604178,604208,606034,30,1826,2,36000,1.01642935378
604179,604214,605272,35,1058,2,36000,1.03308128544
604195,604221,605727,26,1506,2,36000,1.01726427623
604196,604239,605948,43,1709,2,36000,1.02516091281
604211,604245,606255,34,2010,2,36000,1.01691542289
604213,604266,605703,53,1437,2,36000,1.03688239388
604228,604273,606385,45,2112,2,36000,1.02130681818
604244,604283,605801,39,1518,2,36000,1.0256916996
604259,604290,606120,31,1830,2,36000,1.01693989071
604275,604296,606472,21,2176,2,36000,1.00965073529
604277,604310,605945,33,1635,2,36000,1.02018348624
604278,604318,606076,40,1758,2,36000,1.02275312856
604293,604325,606142,32,1817,2,36000,1.01761144744
604310,604331,605384,21,1053,2,36000,1.01994301994
604311,604337,606254,26,1917,2,36000,1.01356285863
604312,604353,606123,41,1770,2,36000,1.02316384181
604328,604380,606406,52,2026,2,36000,1.02566633761
604329,604394,605652,65,1258,2,36000,1.05166931638
604345,604409,605514,64,1105,2,36000,1.05791855204
604372,604416,606019,44,1603,2,36000,1.027448534
604388,604469,606001,81,1532,2,36000,1.05287206266
604404,604480,605898,76,1418,2,36000,1.05359661495
604405,604486,606375,81,1889,2,36000,1.0428798306
604462,604493,605759,31,1266,2,36000,1.02448657188
604477,604498,605662,21,1164,2,36000,1.01804123711
604479,604503,605587,24,1084,2,36000,1.0221402214
604495,604509,606082,14,1573,2,36000,1.00890019072
604496,604543,606180,47,1637,2,36000,1.02871105681
604497,604551,605974,54,1423,2,36000,1.03794799719
604499,604569,605657,70,1088,2,36000,1.06433823529
604532,604576,606334,44,1758,2,36000,1.02502844141
604548,604583,606250,35,1667,2,36000,1.02099580084
604563,604600,605829,37,1229,2,36000,1.03010577705
604564,604610,606340,46,1730,2,36000,1.02658959538
604580,604679,606751,99,2072,2,36000,1.04777992278
604595,604685,606228,90,1543,2,36000,1.0583279326
604611,604690,606240,79,1550,2,36000,1.05096774194
604669,604696,606400,27,1704,2,36000,1.01584507042
604671,604701,606473,30,1772,2,36000,1.01693002257
604672,604722,605710,50,988,2,36000,1.05060728745
604688,604738,606990,50,2252,2,36000,1.02220248668
604689,604744,606495,55,1751,2,36000,1.0314106225
604713,604750,606410,37,1660,2,36000,1.02228915663
604729,604755,606375,26,1620,2,36000,1.01604938272
604745,604761,606789,16,2028,2,36000,1.00788954635
604747,604766,606577,19,1811,2,36000,1.01049144119
604748,604777,606666,29,1889,2,36000,1.01535203812
604749,604782,606285,33,1503,2,36000,1.02195608782
604750,604789,606540,39,1751,2,36000,1.02227298686
604766,604795,605971,29,1176,2,36000,1.02465986395
604767,604800,606323,33,1523,2,36000,1.021667761
604783,604830,606093,47,1263,2,36000,1.03721298496
604784,604840,606811,56,1971,2,36000,1.02841197362
