SubmitTime,StartTime,EndTime,QueuedTime,RunTime,NodesRequested,walltime,bslowdown
243,249,3817,6,3568,2,7200,1.00168161435
244,255,3704,11,3449,2,7200,1.00318933024
428,434,3906,6,3472,2,7200,1.0017281106
443,449,3830,6,3381,2,7200,1.00177462289
518,524,4178,6,3654,2,7200,1.00164203612
554,560,4046,6,3486,2,7200,1.0017211704
568,574,3896,6,3322,2,7200,1.00180614088
583,589,4036,6,3447,2,7200,1.00174064404
619,625,4156,6,3531,2,7200,1.00169923534
649,655,4250,6,3595,2,7200,1.0016689847
666,673,3963,7,3290,2,7200,1.00212765957
681,687,4397,6,3710,2,7200,1.00161725067
696,702,4196,6,3494,2,7200,1.00171722954
723,729,4087,6,3358,2,7200,1.00178677784
761,768,4388,7,3620,2,7200,1.00193370166
888,894,4409,6,3515,2,7200,1.00170697013
908,915,4280,7,3365,2,7200,1.00208023774
932,943,4273,11,3330,2,7200,1.0033033033
932,938,4177,6,3239,2,7200,1.00185242359
947,953,4387,6,3434,2,7200,1.00174723355
962,969,4609,7,3640,2,7200,1.00192307692
992,998,4549,6,3551,2,7200,1.00168966488
999,1005,4582,6,3577,2,7200,1.00167738328
1015,1021,4368,6,3347,2,7200,1.00179265013
1084,1091,4484,7,3393,2,7200,1.00206307103
1099,1111,4631,12,3520,2,7200,1.00340909091
1101,1117,4463,16,3346,2,7200,1.00478182905
1137,1143,4503,6,3360,2,7200,1.00178571429
1162,1168,4680,6,3512,2,7200,1.00170842825
1198,1204,4803,6,3599,2,7200,1.00166712976
1213,1219,4730,6,3511,2,7200,1.00170891484
1227,1234,4453,7,3219,2,7200,1.00217458838
1242,1248,4719,6,3471,2,7200,1.00172860847
1257,1263,4539,6,3276,2,7200,1.00183150183
1296,1302,4827,6,3525,2,7200,1.00170212766
1310,1317,4894,7,3577,2,7200,1.00195694716
1328,1334,4660,6,3326,2,7200,1.00180396873
1346,1352,4792,6,3440,2,7200,1.00174418605
1373,1379,4950,6,3571,2,7200,1.00168020162
1505,1512,4905,7,3393,2,7200,1.00206307103
1870,1876,5227,6,3351,2,7200,1.0017905103
1894,1900,5161,6,3261,2,7200,1.0018399264
2534,2540,6328,6,3788,2,7200,1.00158394931
3005,3011,6180,6,3169,2,7200,1.00189334175
3706,3712,7342,6,3630,2,7200,1.00165289256
3814,3821,7289,7,3468,2,7200,1.00201845444
3832,3838,7198,6,3360,2,7200,1.00178571429
3898,3904,7287,6,3383,2,7200,1.00177357375
3913,3919,7342,6,3423,2,7200,1.00175284838
3964,3970,7330,6,3360,2,7200,1.00178571429
4036,4042,7642,6,3600,2,7200,1.00166666667
4050,4057,7657,7,3600,2,7200,1.00194444444
4089,4096,7619,7,3523,2,7200,1.00198694295
4158,4165,7594,7,3429,2,7200,1.00204141149
4178,4184,7782,6,3598,2,7200,1.00166759311
4179,4190,7556,11,3366,2,7200,1.00326797386
4194,4200,7910,6,3710,2,7200,1.00161725067
4248,4254,7812,6,3558,2,7200,1.00168634064
4272,4278,7630,6,3352,2,7200,1.00178997613
4286,4293,7575,7,3282,2,7200,1.00213284583
4368,4374,7865,6,3491,2,7200,1.00171870524
4388,4395,7815,7,3420,2,7200,1.00204678363
4390,4401,7752,11,3351,2,7200,1.00328260221
4404,4411,7753,7,3342,2,7200,1.00209455416
4419,4425,8015,6,3590,2,7200,1.00167130919
4455,4461,7663,6,3202,2,7200,1.00187382886
4470,4476,7997,6,3521,2,7200,1.00170406135
4484,4491,7943,7,3452,2,7200,1.00202780997
4502,4508,7951,6,3443,2,7200,1.00174266628
4541,4547,8062,6,3515,2,7200,1.00170697013
4556,4562,8068,6,3506,2,7200,1.00171135197
4578,4585,8083,7,3498,2,7200,1.00200114351
4610,4616,8069,6,3453,2,7200,1.00173761946
4631,4637,8147,6,3510,2,7200,1.00170940171
4657,4663,7949,6,3286,2,7200,1.00182592818
4678,4684,8259,6,3575,2,7200,1.00167832168
4720,4726,7923,6,3197,2,7200,1.00187675946
4735,4741,8281,6,3540,2,7200,1.00169491525
4792,4798,8369,6,3571,2,7200,1.00168020162
4806,4813,8172,7,3359,2,7200,1.00208395356
4827,4833,8192,6,3359,2,7200,1.00178624591
4893,4899,8261,6,3362,2,7200,1.00178465199
4908,4914,8240,6,3326,2,7200,1.00180396873
4950,4956,8285,6,3329,2,7200,1.00180234305
5164,5170,8650,6,3480,2,7200,1.00172413793
5227,5234,8867,7,3633,2,7200,1.00192678227
6182,6188,9266,6,3078,2,7200,1.00194931774
6331,6337,9852,6,3515,2,7200,1.00170697013
6870,13171,52134,6301,38963,12,180000,1.16171752688
7200,7206,10965,6,3759,2,7200,1.00159616919
7290,7296,10443,6,3147,2,7200,1.00190657769
7291,7302,10654,11,3352,2,7200,1.00328162291
7333,7339,10706,6,3367,2,7200,1.00178200178
7348,7354,10511,6,3157,2,7200,1.00190053849
7349,7360,10742,11,3382,2,7200,1.00325251331
7557,7563,11177,6,3614,2,7200,1.00166021029
7575,7581,11119,6,3538,2,7200,1.00169587337
7596,7602,11131,6,3529,2,7200,1.00170019836
7620,7626,10964,6,3338,2,7200,1.00179748352
7634,7641,11223,7,3582,2,7200,1.00195421552
7650,7657,11239,7,3582,2,7200,1.00195421552
7665,7671,10972,6,3301,2,7200,1.00181763102
7667,7677,11097,10,3420,2,7200,1.00292397661
7754,7760,11321,6,3561,2,7200,1.00168491997
7755,7766,11372,11,3606,2,7200,1.00305047144
7785,7792,11097,7,3305,2,7200,1.00211800303
7815,7822,11071,7,3249,2,7200,1.00215450908
7817,7828,11492,11,3664,2,7200,1.00300218341
7865,7871,11502,6,3631,2,7200,1.00165243735
7910,7916,11243,6,3327,2,7200,1.00180342651
7924,7930,11513,6,3583,2,7200,1.00167457438
7942,7948,11265,6,3317,2,7200,1.00180886343
7957,7963,11356,6,3393,2,7200,1.0017683466
7958,7969,11212,11,3243,2,7200,1.00339192106
7997,8003,11371,6,3368,2,7200,1.00178147268
8015,8021,11518,6,3497,2,7200,1.00171575636
8063,8069,11587,6,3518,2,7200,1.0017055145
8078,8084,11733,6,3649,2,7200,1.00164428611
8079,8096,11696,17,3600,2,7200,1.00472222222
8085,8091,11907,6,3816,2,7200,1.00157232704
8148,8154,11705,6,3551,2,7200,1.00168966488
8172,8178,11623,6,3445,2,7200,1.00174165457
8193,8199,11734,6,3535,2,7200,1.00169731259
8241,8247,11681,6,3434,2,7200,1.00174723355
8262,8268,11667,6,3399,2,7200,1.00176522507
8263,8275,11835,12,3560,2,7200,1.00337078652
8281,8287,11690,6,3403,2,7200,1.00176315016
8296,8302,11733,6,3431,2,7200,1.00174876129
8371,8377,11893,6,3516,2,7200,1.00170648464
8651,8657,11693,6,3036,2,7200,1.00197628458
8868,8874,12132,6,3258,2,7200,1.00184162063
8961,8967,9142,6,175,1,3600,1.03428571429
9267,9273,12524,6,3251,2,7200,1.00184558597
9317,9323,9680,6,357,1,3600,1.01680672269
9474,17375,17382,7901,7,6,28800,790.8
9474,11529,17369,2055,5840,6,28800,1.35188356164
9475,17388,17391,7913,3,6,28800,791.6
9476,17412,17415,7936,3,6,28800,793.9
9476,17402,17406,7926,4,6,28800,793.0
9477,17423,17427,7946,4,6,28800,795.0
9478,17433,17436,7955,3,6,28800,795.8
9479,17445,17448,7966,3,6,28800,796.9
9479,17457,17461,7978,4,6,28800,798.2
9480,17469,17473,7989,4,6,28800,799.3
9546,16150,16152,6604,2,6,28800,660.6
9576,16167,16169,6591,2,6,28800,659.3
9580,16184,16186,6604,2,6,28800,660.6
9581,16210,16212,6629,2,6,28800,663.1
9582,16227,16229,6645,2,6,28800,664.7
9583,16244,16246,6661,2,6,28800,666.3
9583,16261,16263,6678,2,6,28800,668.0
9584,16295,16297,6711,2,6,28800,671.3
9584,16279,16280,6695,1,6,28800,669.6
9585,16312,16314,6727,2,6,28800,672.9
9585,16329,16331,6744,2,6,28800,674.6
9587,16346,16348,6759,2,6,28800,676.1
9853,9859,13379,6,3520,2,7200,1.00170454545
10045,10051,10916,6,865,1,3600,1.00693641618
10446,10452,14083,6,3631,2,7200,1.00165243735
10512,10518,14025,6,3507,2,7200,1.00171086399
10653,10659,14130,6,3471,2,7200,1.00172860847
10707,10713,13992,6,3279,2,7200,1.00182982617
10743,10749,14048,6,3299,2,7200,1.00181873295
10966,10972,14252,6,3280,2,7200,1.00182926829
10967,10979,14284,12,3305,2,7200,1.00363086233
10982,10988,14661,6,3673,2,7200,1.00163354206
11069,11076,14624,7,3548,2,7200,1.0019729425
11096,11102,14473,6,3371,2,7200,1.00177988727
11098,11108,14558,10,3450,2,7200,1.00289855072
11117,11123,14573,6,3450,2,7200,1.00173913043
11132,11138,14698,6,3560,2,7200,1.00168539326
11177,11183,14587,6,3404,2,7200,1.0017626322
11212,11219,14841,7,3622,2,7200,1.0019326339
11227,11233,14877,6,3644,2,7200,1.00164654226
11242,11248,14583,6,3335,2,7200,1.00179910045
11243,11254,14698,11,3444,2,7200,1.00319396051
11267,11275,14732,8,3457,2,7200,1.00231414521
11321,11327,14555,6,3228,2,7200,1.00185873606
11357,11363,15272,6,3909,2,7200,1.00153491942
11372,11378,14521,6,3143,2,7200,1.00190900414
11373,11384,15005,11,3621,2,7200,1.00303783485
11494,11500,14852,6,3352,2,7200,1.00178997613
11509,11515,14989,6,3474,2,7200,1.00172711572
11524,11535,14911,11,3376,2,7200,1.00325829384
11525,11541,14857,16,3316,2,7200,1.00482509047
11588,11594,14905,6,3311,2,7200,1.00181214135
11621,11627,15269,6,3642,2,7200,1.00164744646
11669,11675,15065,6,3390,2,7200,1.0017699115
11684,11690,15233,6,3543,2,7200,1.0016934801
11699,11705,15107,6,3402,2,7200,1.00176366843
11700,11711,15341,11,3630,2,7200,1.00303030303
11701,11717,15347,16,3630,2,7200,1.0044077135
11716,11723,15325,7,3602,2,7200,1.0019433648
11734,11741,15141,7,3400,2,7200,1.00205882353
11736,11748,15047,12,3299,2,7200,1.0036374659
11737,11753,15192,16,3439,2,7200,1.00465251527
11769,11775,11892,6,117,1,3600,1.05128205128
11830,11837,15198,7,3361,2,7200,1.00208271348
11893,11900,15394,7,3494,2,7200,1.00200343446
11909,11916,15240,7,3324,2,7200,1.00210589651
12076,12082,12412,6,330,1,3600,1.01818181818
12131,12138,15566,7,3428,2,7200,1.002042007
12526,12532,15888,6,3356,2,7200,1.00178784267
12892,12898,13534,6,636,1,3600,1.00943396226
12919,12925,13096,6,171,1,3600,1.0350877193
13276,13283,13637,7,354,1,3600,1.0197740113
13381,13387,16880,6,3493,2,7200,1.00171772116
13991,13997,17382,6,3385,2,7200,1.00177252585
14015,14021,14806,6,785,1,3600,1.0076433121
14027,14033,17659,6,3626,2,7200,1.00165471594
14048,14054,17444,6,3390,2,7200,1.0017699115
14084,14090,17487,6,3397,2,7200,1.00176626435
14132,14138,17520,6,3382,2,7200,1.00177409817
14252,14258,17800,6,3542,2,7200,1.00169395822
14285,14291,17760,6,3469,2,7200,1.00172960507
14471,14477,17877,6,3400,2,7200,1.00176470588
14522,14528,18092,6,3564,2,7200,1.00168350168
14555,14561,17933,6,3372,2,7200,1.00177935943
14559,14568,18454,9,3886,2,7200,1.00231600618
14573,14579,18172,6,3593,2,7200,1.00166991372
14588,14594,18157,6,3563,2,7200,1.00168397418
14589,14600,18070,11,3470,2,7200,1.00317002882
14625,14631,17992,6,3361,2,7200,1.00178518298
14661,14667,18111,6,3444,2,7200,1.00174216028
14700,14706,18375,6,3669,2,7200,1.00163532298
14702,14712,18287,10,3575,2,7200,1.0027972028
14731,14738,18384,7,3646,2,7200,1.00191991223
14843,14849,18394,6,3545,2,7200,1.00169252468
14858,14864,18200,6,3336,2,7200,1.00179856115
14859,14870,18270,11,3400,2,7200,1.00323529412
14877,14883,18148,6,3265,2,7200,1.00183767228
14906,14913,18157,7,3244,2,7200,1.00215782984
14921,14927,18311,6,3384,2,7200,1.00177304965
14990,14996,18524,6,3528,2,7200,1.00170068027
15008,15014,18618,6,3604,2,7200,1.00166481687
15047,15053,18507,6,3454,2,7200,1.00173711639
15064,15071,18493,7,3422,2,7200,1.00204558738
15106,15113,18471,7,3358,2,7200,1.00208457415
15142,15148,18601,6,3453,2,7200,1.00173761946
15193,15199,18491,6,3292,2,7200,1.00182260024
15208,15214,18613,6,3399,2,7200,1.00176522507
15235,15241,18504,6,3263,2,7200,1.00183879865
15243,15249,18767,6,3518,2,7200,1.0017055145
15271,15277,18679,6,3402,2,7200,1.00176366843
15285,15291,18785,6,3494,2,7200,1.00171722954
15327,15333,18906,6,3573,2,7200,1.00167926113
15342,15348,19027,6,3679,2,7200,1.00163087796
15357,15363,18601,6,3238,2,7200,1.00185299568
15396,15402,19028,6,3626,2,7200,1.00165471594
15567,15573,18811,6,3238,2,7200,1.00185299568
15890,15896,19301,6,3405,2,7200,1.00176211454
16070,16076,16194,6,118,1,3600,1.05084745763
16194,16204,16331,10,127,1,1800,1.07874015748
16380,16386,16713,6,327,1,3600,1.01834862385
16644,16650,16767,6,117,1,1800,1.05128205128
16883,16890,20224,7,3334,2,7200,1.00209958008
17200,17207,17820,7,613,1,3600,1.01141924959
17384,17395,20870,11,3475,2,7200,1.00316546763
17444,17451,20851,7,3400,2,7200,1.00205882353
17450,17463,18031,13,568,1,1800,1.02288732394
17486,17495,21023,9,3528,2,7200,1.00255102041
17522,17528,20864,6,3336,2,7200,1.00179856115
17660,17666,21051,6,3385,2,7200,1.00177252585
17759,17765,20968,6,3203,2,7200,1.00187324383
17801,17807,21046,6,3239,2,7200,1.00185242359
17876,17882,21333,6,3451,2,7200,1.00173862649
17933,17939,21180,6,3241,2,7200,1.00185128047
17993,18000,21603,7,3603,2,7200,1.00194282542
18072,18079,21473,7,3394,2,7200,1.00206246317
18090,18096,21468,6,3372,2,7200,1.00177935943
18113,18120,21673,7,3553,2,7200,1.00197016606
18149,18155,21763,6,3608,2,7200,1.00166297118
18164,18170,21668,6,3498,2,7200,1.00171526587
18165,18176,21559,11,3383,2,7200,1.00325155188
18180,18186,21549,6,3363,2,7200,1.00178412132
18198,18204,21771,6,3567,2,7200,1.00168208579
18270,18276,21856,6,3580,2,7200,1.00167597765
18288,18294,21817,6,3523,2,7200,1.00170309395
18312,18318,21734,6,3416,2,7200,1.00175644028
18378,18384,22043,6,3659,2,7200,1.00163979229
18393,18399,22025,6,3626,2,7200,1.00165471594
18394,18405,22026,11,3621,2,7200,1.00303783485
18458,18464,21972,6,3508,2,7200,1.00171037628
18472,18478,22162,6,3684,2,7200,1.0016286645
18490,18496,22105,6,3609,2,7200,1.00166251039
18505,18511,21821,6,3310,2,7200,1.00181268882
18506,18517,21895,11,3378,2,7200,1.00325636471
18521,18527,22104,6,3577,2,7200,1.00167738328
18535,18541,22113,6,3572,2,7200,1.00167973124
18602,18607,22180,5,3573,2,7200,1.00139938427
18603,18614,22017,11,3403,2,7200,1.00323244196
18618,18624,22226,6,3602,2,7200,1.00166574125
18619,18630,22231,11,3601,2,7200,1.00305470703
18679,18685,22215,6,3530,2,7200,1.00169971671
18771,18777,22298,6,3521,2,7200,1.00170406135
18785,18791,22027,6,3236,2,7200,1.00185414091
18808,18815,22298,7,3483,2,7200,1.0020097617
18905,18911,22380,6,3469,2,7200,1.00172960507
19028,19034,22640,6,3606,2,7200,1.00166389351
19030,19040,22658,10,3618,2,7200,1.00276395799
19303,19309,22802,6,3493,2,7200,1.00171772116
19355,19361,19414,6,53,1,1800,1.11320754717
19728,19734,19808,6,74,1,1800,1.08108108108
20227,20233,23864,6,3631,2,7200,1.00165243735
20288,20294,20415,6,121,1,1800,1.04958677686
20737,20743,20841,6,98,1,1800,1.0612244898
20811,20817,21107,6,290,1,1800,1.02068965517
20852,20858,24343,6,3485,2,7200,1.00172166428
20867,20873,24388,6,3515,2,7200,1.00170697013
20881,20887,24084,6,3197,2,7200,1.00187675946
20965,20971,24404,6,3433,2,7200,1.0017477425
21022,21028,24579,6,3551,2,7200,1.00168966488
21046,21052,24465,6,3413,2,7200,1.00175798418
21061,21067,24701,6,3634,2,7200,1.0016510732
21181,21188,24566,7,3378,2,7200,1.00207223209
21332,21338,24758,6,3420,2,7200,1.00175438596
21468,21474,25069,6,3595,2,7200,1.0016689847
21483,21489,24870,6,3381,2,7200,1.00177462289
21549,21555,24861,6,3306,2,7200,1.00181488203
21555,21561,22150,6,589,1,1800,1.01018675722
21563,21570,24991,7,3421,2,7200,1.00204618533
21603,21609,25161,6,3552,2,7200,1.00168918919
21669,21675,25235,6,3560,2,7200,1.00168539326
21684,21690,25114,6,3424,2,7200,1.00175233645
21735,21741,25105,6,3364,2,7200,1.00178359096
21765,21771,25199,6,3428,2,7200,1.00175029172
21779,21786,25257,7,3471,2,7200,1.00201670988
21818,21825,25250,7,3425,2,7200,1.00204379562
21833,21839,25117,6,3278,2,7200,1.00183038438
21857,21863,25341,6,3478,2,7200,1.00172512938
21896,21902,25208,6,3306,2,7200,1.00181488203
21976,21982,25633,6,3651,2,7200,1.00164338537
22016,22022,25578,6,3556,2,7200,1.00168728909
22031,22037,25222,6,3185,2,7200,1.00188383046
22033,22043,25555,10,3512,2,7200,1.00284738041
22034,22049,25385,15,3336,2,7200,1.00449640288
22049,22055,25412,6,3357,2,7200,1.0017873101
22103,22109,25443,6,3334,2,7200,1.00179964007
22117,22124,25580,7,3456,2,7200,1.00202546296
22119,22130,25744,11,3614,2,7200,1.00304371887
22164,22170,25628,6,3458,2,7200,1.001735107
22178,22185,25512,7,3327,2,7200,1.0021039976
22214,22221,25757,7,3536,2,7200,1.00197963801
22229,22235,25582,6,3347,2,7200,1.00179265013
22244,22250,25548,6,3298,2,7200,1.00181928441
22298,22304,25911,6,3607,2,7200,1.00166343222
22300,22311,25937,11,3626,2,7200,1.00303364589
22379,22385,26084,6,3699,2,7200,1.00162206002
22641,22647,26387,6,3740,2,7200,1.00160427807
22659,22665,26008,6,3343,2,7200,1.00179479509
22804,22810,26276,6,3466,2,7200,1.00173110214
23867,23873,27287,6,3414,2,7200,1.00175746924
24086,24092,27422,6,3330,2,7200,1.0018018018
24118,24124,24176,6,52,1,1800,1.11538461538
24345,24351,27867,6,3516,2,7200,1.00170648464
24390,24396,27880,6,3484,2,7200,1.00172215844
24404,24411,28080,7,3669,2,7200,1.00190787681
24467,24474,27832,7,3358,2,7200,1.00208457415
24513,24519,24601,6,82,1,1800,1.07317073171
24567,24573,27942,6,3369,2,7200,1.0017809439
24581,24588,27973,7,3385,2,7200,1.00206794682
24702,24708,28039,6,3331,2,7200,1.00180126088
24759,24765,28335,6,3570,2,7200,1.00168067227
24864,24870,28346,6,3476,2,7200,1.00172612198
24879,24889,28482,10,3593,2,7200,1.00278318954
24990,24996,28591,6,3595,2,7200,1.0016689847
25065,25071,28573,6,3502,2,7200,1.00171330668
25104,25110,28574,6,3464,2,7200,1.00173210162
25119,25125,28639,6,3514,2,7200,1.00170745589
25121,25132,28761,11,3629,2,7200,1.00303113805
25163,25169,28426,6,3257,2,7200,1.00184218606
25201,25208,28489,7,3281,2,7200,1.00213349589
25216,25222,28676,6,3454,2,7200,1.00173711639
25231,25237,28650,6,3413,2,7200,1.00175798418
25233,25244,28680,11,3436,2,7200,1.00320139697
25250,25257,28675,7,3418,2,7200,1.00204798128
25265,25272,28723,7,3451,2,7200,1.00202839757
25340,25346,28676,6,3330,2,7200,1.0018018018
25382,25388,28692,6,3304,2,7200,1.00181598063
25412,25418,29035,6,3617,2,7200,1.00165883329
25445,25451,28897,6,3446,2,7200,1.00174114916
25511,25517,29101,6,3584,2,7200,1.00167410714
25550,25556,29186,6,3630,2,7200,1.00165289256
25565,25571,29144,6,3573,2,7200,1.00167926113
25580,25586,28941,6,3355,2,7200,1.00178837556
25581,25592,29281,11,3689,2,7200,1.0029818379
25596,25602,29064,6,3462,2,7200,1.00173310225
25629,25635,29148,6,3513,2,7200,1.00170794193
25636,25642,29174,6,3532,2,7200,1.00169875425
25643,25651,25944,8,293,1,1800,1.02730375427
25746,25752,29312,6,3560,2,7200,1.00168539326
25761,25767,29121,6,3354,2,7200,1.00178890877
25912,25918,29242,6,3324,2,7200,1.00180505415
25938,25944,29106,6,3162,2,7200,1.00189753321
26008,26014,29484,6,3470,2,7200,1.00172910663
26084,26090,29679,6,3589,2,7200,1.00167177487
26277,26283,30004,6,3721,2,7200,1.00161246977
26388,26394,29915,6,3521,2,7200,1.00170406135
27288,27294,30788,6,3494,2,7200,1.00171722954
27422,27428,30874,6,3446,2,7200,1.00174114916
27831,27837,31353,6,3516,2,7200,1.00170648464
27867,27873,31318,6,3445,2,7200,1.00174165457
27882,27888,31479,6,3591,2,7200,1.00167084378
27942,27948,31328,6,3380,2,7200,1.00177514793
27975,27981,31629,6,3648,2,7200,1.00164473684
28041,28047,31238,6,3191,2,7200,1.00188028831
28080,28086,31525,6,3439,2,7200,1.00174469322
28336,28342,31700,6,3358,2,7200,1.00178677784
28351,28357,32098,6,3741,2,7200,1.00160384924
28426,28432,31906,6,3474,2,7200,1.00172711572
28483,28489,31994,6,3505,2,7200,1.00171184023
28498,28504,31891,6,3387,2,7200,1.00177147919
28573,28579,31949,6,3370,2,7200,1.00178041543
28575,28586,32032,11,3446,2,7200,1.00319210679
28589,28595,31871,6,3276,2,7200,1.00183150183
28640,28646,32087,6,3441,2,7200,1.00174367916
28655,28661,31960,6,3299,2,7200,1.00181873295
28676,28682,32065,6,3383,2,7200,1.00177357375
28678,28688,31931,10,3243,2,7200,1.0030835646
28679,28694,31985,15,3291,2,7200,1.00455788514
28694,28700,32064,6,3364,2,7200,1.00178359096
28695,28706,32236,11,3530,2,7200,1.00311614731
28725,28731,32032,6,3301,2,7200,1.00181763102
28764,28770,32205,6,3435,2,7200,1.00174672489
28896,28903,32218,7,3315,2,7200,1.00211161388
28941,28948,32172,7,3224,2,7200,1.00217121588
29035,29041,32618,6,3577,2,7200,1.00167738328
29064,29071,32620,7,3549,2,7200,1.00197238659
29100,29106,32790,6,3684,2,7200,1.0016286645
29108,29114,32660,6,3546,2,7200,1.00169204738
29121,29127,32578,6,3451,2,7200,1.00173862649
29145,29151,32484,6,3333,2,7200,1.00180018002
29161,29167,32597,6,3430,2,7200,1.00174927114
29175,29181,32853,6,3672,2,7200,1.00163398693
29188,29194,32715,6,3521,2,7200,1.00170406135
29245,29251,32686,6,3435,2,7200,1.00174672489
29280,29287,32673,7,3386,2,7200,1.00206733609
29310,29316,33037,6,3721,2,7200,1.00161246977
29485,29491,33016,6,3525,2,7200,1.00170212766
29681,29688,33206,7,3518,2,7200,1.00198976691
29913,29919,33523,6,3604,2,7200,1.00166481687
30006,30014,33449,8,3435,2,7200,1.00232896652
30789,30795,34201,6,3406,2,7200,1.00176159718
30872,30878,34507,6,3629,2,7200,1.00165334803
31237,31243,34867,6,3624,2,7200,1.00165562914
31318,31325,34703,7,3378,2,7200,1.00207223209
31333,31339,34817,6,3478,2,7200,1.00172512938
31354,31360,34708,6,3348,2,7200,1.0017921147
31474,31481,34856,7,3375,2,7200,1.00207407407
31525,31532,35321,7,3789,2,7200,1.00184745315
31631,31637,35225,6,3588,2,7200,1.0016722408
31703,31709,35180,6,3471,2,7200,1.00172860847
31872,31878,35327,6,3449,2,7200,1.00173963468
31892,31899,35347,7,3448,2,7200,1.00203016241
31907,31913,35120,6,3207,2,7200,1.00187090739
31931,31937,35583,6,3646,2,7200,1.00164563906
31949,31955,35460,6,3505,2,7200,1.00171184023
31964,31970,35379,6,3409,2,7200,1.00176004693
31988,31994,35461,6,3467,2,7200,1.00173060283
32002,32008,35311,6,3303,2,7200,1.00181653043
32032,32039,35033,7,2994,2,7200,1.00233800935
32034,32046,35367,12,3321,2,7200,1.00361336947
32064,32070,35668,6,3598,2,7200,1.00166759311
32079,32085,35717,6,3632,2,7200,1.00165198238
32094,32100,35328,6,3228,2,7200,1.00185873606
32095,32106,35606,11,3500,2,7200,1.00314285714
32173,32179,35622,6,3443,2,7200,1.00174266628
32203,32209,35507,6,3298,2,7200,1.00181928441
32221,32227,35489,6,3262,2,7200,1.00183936235
32236,32242,35597,6,3355,2,7200,1.00178837556
32486,32492,36060,6,3568,2,7200,1.00168161435
32579,32586,35980,7,3394,2,7200,1.00206246317
32597,32603,35814,6,3211,2,7200,1.00186857677
32618,32624,36048,6,3424,2,7200,1.00175233645
32633,32639,36027,6,3388,2,7200,1.00177095632
32662,32668,36232,6,3564,2,7200,1.00168350168
32672,32678,36016,6,3338,2,7200,1.00179748352
32687,32693,36126,6,3433,2,7200,1.0017477425
32714,39296,39583,6582,287,32,3600,23.9337979094
32716,32723,36034,7,3311,2,7200,1.0021141649
32789,32795,36264,6,3469,2,7200,1.00172960507
32856,32862,36294,6,3432,2,7200,1.00174825175
33017,33023,36365,6,3342,2,7200,1.00179533214
33038,33044,36332,6,3288,2,7200,1.00182481752
33119,39083,39284,5964,201,64,7200,30.671641791
33204,33211,36850,7,3639,2,7200,1.00192360539
33451,33458,36837,7,3379,2,7200,1.00207161882
33523,33531,37039,8,3508,2,7200,1.00228050171
34207,34213,37799,6,3586,2,7200,1.00167317345
34510,34516,37973,6,3457,2,7200,1.00173560891
34703,34709,38125,6,3416,2,7200,1.00175644028
34718,34725,38187,7,3462,2,7200,1.00202195263
34820,34826,38180,6,3354,2,7200,1.00178890877
34859,34865,38345,6,3480,2,7200,1.00172413793
34874,34880,38345,6,3465,2,7200,1.00173160173
35033,35039,38676,6,3637,2,7200,1.0016497113
35120,35127,38260,7,3133,2,7200,1.00223428024
35181,35187,38843,6,3656,2,7200,1.00164113786
35226,35232,38486,6,3254,2,7200,1.00184388445
35313,35319,38824,6,3505,2,7200,1.00171184023
35328,35335,38591,7,3256,2,7200,1.00214987715
35330,35342,38689,12,3347,2,7200,1.00358530027
35331,35347,38881,16,3534,2,7200,1.00452744765
35349,35355,38713,6,3358,2,7200,1.00178677784
35367,35373,38857,6,3484,2,7200,1.00172215844
35381,35388,38564,7,3176,2,7200,1.00220403023
35461,35467,38835,6,3368,2,7200,1.00178147268
35475,35481,38924,6,3443,2,7200,1.00174266628
35490,35496,38901,6,3405,2,7200,1.00176211454
35508,35514,39081,6,3567,2,7200,1.00168208579
35586,35592,39128,6,3536,2,7200,1.00169683258
35601,35607,38858,6,3251,2,7200,1.00184558597
35616,35622,38966,6,3344,2,7200,1.00179425837
35630,35636,39185,6,3549,2,7200,1.00169061708
35669,35675,39010,6,3335,2,7200,1.00179910045
35720,35726,38968,6,3242,2,7200,1.00185070944
35813,35820,39480,7,3660,2,7200,1.00191256831
35982,35988,39285,6,3297,2,7200,1.00181983621
36018,36025,39417,7,3392,2,7200,1.00206367925
36033,36039,39530,6,3491,2,7200,1.00171870524
36048,36054,39628,6,3574,2,7200,1.00167879127
36063,36070,39713,7,3643,2,7200,1.00192149327
36065,36078,39476,13,3398,2,7200,1.00382577987
36128,36134,39347,6,3213,2,7200,1.00186741363
36235,36241,39858,6,3617,2,7200,1.00165883329
36264,36270,39839,6,3569,2,7200,1.00168114318
36296,36302,39590,6,3288,2,7200,1.00182481752
36333,36343,39827,10,3484,2,7200,1.00287026406
36366,36376,39747,10,3371,2,7200,1.00296647879
36840,36848,40234,8,3386,2,7200,1.00236266982
36849,36861,40399,12,3538,2,7200,1.00339174675
36871,39302,46668,2431,7366,26,144000,1.33002986696
37039,37050,40268,11,3218,2,7200,1.00341827222
37800,37806,41118,6,3312,2,7200,1.0018115942
37973,37979,41277,6,3298,2,7200,1.00181928441
38127,38133,41686,6,3553,2,7200,1.00168871376
38181,38187,42011,6,3824,2,7200,1.00156903766
38195,38202,41479,7,3277,2,7200,1.00213610009
38261,38268,41986,7,3718,2,7200,1.00188273265
38346,38352,41812,6,3460,2,7200,1.00173410405
38347,38358,41854,11,3496,2,7200,1.00314645309
38483,38489,41945,6,3456,2,7200,1.00173611111
38564,38570,42151,6,3581,2,7200,1.00167550963
38591,38597,42096,6,3499,2,7200,1.00171477565
38678,38684,42082,6,3398,2,7200,1.00176574456
38693,38699,42109,6,3410,2,7200,1.00175953079
38714,38720,42086,6,3366,2,7200,1.00178253119
38822,38828,42272,6,3444,2,7200,1.00174216028
38837,38843,42276,6,3433,2,7200,1.0017477425
38852,38858,42298,6,3440,2,7200,1.00174418605
38867,38873,42330,6,3457,2,7200,1.00173560891
38868,38879,42438,11,3559,2,7200,1.00309075583
38883,38889,42391,6,3502,2,7200,1.00171330668
38904,38910,42387,6,3477,2,7200,1.00172562554
38924,38931,42387,7,3456,2,7200,1.00202546296
38963,38970,42551,7,3581,2,7200,1.00195476124
38965,38977,42445,12,3468,2,7200,1.00346020761
39010,39016,42331,6,3315,2,7200,1.00180995475
39017,39089,39090,72,1,2,600,7.3
39082,39095,42583,13,3488,2,7200,1.00372706422
39130,39136,42668,6,3532,2,7200,1.00169875425
39184,39190,42406,6,3216,2,7200,1.00186567164
39284,39290,42683,6,3393,2,7200,1.0017683466
39323,39330,39333,7,3,2,600,1.0
39347,39353,42622,6,3269,2,7200,1.00183542368
39416,39422,42834,6,3412,2,7200,1.00175849941
39443,39450,39455,7,5,2,600,1.2
39471,39594,39604,123,10,4,600,13.3
39476,39482,42747,6,3265,2,7200,1.00183767228
39491,39497,42679,6,3182,2,7200,1.00188560654
39533,39539,42774,6,3235,2,7200,1.00185471406
39593,39600,43140,7,3540,2,7200,1.00197740113
39629,39635,42959,6,3324,2,7200,1.00180505415
39662,39668,39669,6,1,2,600,1.0
39713,39719,43203,6,3484,2,7200,1.00172215844
39749,39755,43226,6,3471,2,7200,1.00172860847
39827,39833,43042,6,3209,2,7200,1.00186974135
39842,39848,43384,6,3536,2,7200,1.00169683258
39859,39865,43113,6,3248,2,7200,1.00184729064
40101,40107,40142,6,35,8,600,1.17142857143
40132,40138,40211,6,73,16,600,1.08219178082
40231,40237,43555,6,3318,2,7200,1.00180831826
40268,40274,43817,6,3543,2,7200,1.0016934801
40400,40407,44161,7,3754,2,7200,1.00186467768
40440,40446,41691,6,1245,16,1200,1.00481927711
41119,41125,44735,6,3610,2,7200,1.00166204986
41279,41285,44662,6,3377,2,7200,1.0017767249
41477,41484,44960,7,3476,2,7200,1.00201380898
41686,41692,45487,6,3795,2,7200,1.00158102767
41809,41815,45174,6,3359,2,7200,1.00178624591
41854,41860,45200,6,3340,2,7200,1.00179640719
41947,41954,45216,7,3262,2,7200,1.00214592275
41986,41993,45395,7,3402,2,7200,1.00205761317
42013,42020,45428,7,3408,2,7200,1.00205399061
42082,42089,45461,7,3372,2,7200,1.00207591934
42097,42103,45797,6,3694,2,7200,1.00162425555
42099,42109,45845,10,3736,2,7200,1.00267665953
42113,42119,45600,6,3481,2,7200,1.00172364263
42149,42155,45495,6,3340,2,7200,1.00179640719
42272,42279,45632,7,3353,2,7200,1.00208768267
42287,42293,45854,6,3561,2,7200,1.00168491997
42302,42308,45658,6,3350,2,7200,1.00179104478
42332,42338,45589,6,3251,2,7200,1.00184558597
42334,42345,45795,11,3450,2,7200,1.0031884058
42385,42391,45865,6,3474,2,7200,1.00172711572
42400,42406,45731,6,3325,2,7200,1.00180451128
42401,42412,46206,11,3794,2,7200,1.00289931471
42416,42422,45975,6,3553,2,7200,1.00168871376
42437,42443,45721,6,3278,2,7200,1.00183038438
42451,42458,46010,7,3552,2,7200,1.00197072072
42551,42557,46290,6,3733,2,7200,1.00160728636
42584,42590,45974,6,3384,2,7200,1.00177304965
42623,42629,46181,6,3552,2,7200,1.00168918919
42665,42671,46212,6,3541,2,7200,1.0016944366
42680,42686,46182,6,3496,2,7200,1.00171624714
42694,42700,46063,6,3363,2,7200,1.00178412132
42745,42751,46158,6,3407,2,7200,1.00176108013
42775,42781,46339,6,3558,2,7200,1.00168634064
42835,42841,46059,6,3218,2,7200,1.00186451212
42963,42969,46387,6,3418,2,7200,1.00175541252
43041,43048,46523,7,3475,2,7200,1.00201438849
43116,43122,46591,6,3469,2,7200,1.00172960507
43144,43150,46608,6,3458,2,7200,1.001735107
43204,43211,46639,7,3428,2,7200,1.002042007
43228,43234,46728,6,3494,2,7200,1.00171722954
43229,48862,51275,5633,2413,16,2400,3.33443845835
43385,43391,46775,6,3384,2,7200,1.00177304965
43555,43561,47018,6,3457,2,7200,1.00173560891
43816,43823,47277,7,3454,2,7200,1.00202663578
44161,44167,47791,6,3624,2,7200,1.00165562914
44662,44668,48269,6,3601,2,7200,1.00166620383
44736,44742,48405,6,3663,2,7200,1.00163800164
44960,44966,48495,6,3529,2,7200,1.00170019836
45175,45181,48502,6,3321,2,7200,1.00180668473
45198,45205,48695,7,3490,2,7200,1.00200573066
45216,45222,48805,6,3583,2,7200,1.00167457438
45397,45403,48739,6,3336,2,7200,1.00179856115
45427,45433,48740,6,3307,2,7200,1.00181433323
45459,45465,49072,6,3607,2,7200,1.00166343222
45486,45492,48706,6,3214,2,7200,1.00186683261
45501,45507,49059,6,3552,2,7200,1.00168918919
45591,45597,48934,6,3337,2,7200,1.00179802218
45606,45612,49269,6,3657,2,7200,1.00164068909
45633,45639,49063,6,3424,2,7200,1.00175233645
45657,45663,49256,6,3593,2,7200,1.00166991372
45720,45726,49146,6,3420,2,7200,1.00175438596
45734,45741,49142,7,3401,2,7200,1.00205821817
45795,45801,49129,6,3328,2,7200,1.00180288462
45796,45808,49007,12,3199,2,7200,1.00375117224
45847,45853,49462,6,3609,2,7200,1.00166251039
45862,45868,49255,6,3387,2,7200,1.00177147919
45968,45974,49338,6,3364,2,7200,1.00178359096
45983,45989,49656,6,3667,2,7200,1.00163621489
45984,45995,49545,11,3550,2,7200,1.00309859155
46011,46018,49494,7,3476,2,7200,1.00201380898
46059,46065,49447,6,3382,2,7200,1.00177409817
46074,46080,49334,6,3254,2,7200,1.00184388445
46155,46161,49477,6,3316,2,7200,1.00180940893
46179,46185,49542,6,3357,2,7200,1.0017873101
46194,46200,49428,6,3228,2,7200,1.00185873606
46209,46215,49736,6,3521,2,7200,1.00170406135
46223,46230,49584,7,3354,2,7200,1.00208706023
46292,46298,49673,6,3375,2,7200,1.00177777778
46340,46346,50152,6,3806,2,7200,1.00157645822
46388,46394,49851,6,3457,2,7200,1.00173560891
46524,46530,49818,6,3288,2,7200,1.00182481752
46596,46602,50118,6,3516,2,7200,1.00170648464
46611,46617,49935,6,3318,2,7200,1.00180831826
46638,46644,50296,6,3652,2,7200,1.00164293538
46653,47580,68292,927,20712,16,144000,1.0447566628
46729,46735,50169,6,3434,2,7200,1.00174723355
46776,46783,50442,7,3659,2,7200,1.00191309101
47019,47027,50348,8,3321,2,7200,1.00240891298
47278,47284,50898,6,3614,2,7200,1.00166021029
47792,47798,51099,6,3301,2,7200,1.00181763102
48271,48277,52000,6,3723,2,7200,1.00161160355
48408,48414,52048,6,3634,2,7200,1.0016510732
48493,48500,51853,7,3353,2,7200,1.00208768267
48508,48514,52009,6,3495,2,7200,1.0017167382
48543,48549,52006,6,3457,2,7200,1.00173560891
48544,48556,52095,12,3539,2,7200,1.00339078836
48545,48561,52040,16,3479,2,7200,1.00459902271
48547,48567,52014,20,3447,2,7200,1.00580214679
48548,48572,52240,24,3668,2,7200,1.00654307525
48549,48577,52010,28,3433,2,7200,1.00815613166
48550,48582,52135,32,3553,2,7200,1.0090064734
48552,48589,52016,37,3427,2,7200,1.01079661512
48553,48595,52258,42,3663,2,7200,1.01146601147
48554,48600,52286,46,3686,2,7200,1.01247965274
48556,48605,51769,49,3164,2,7200,1.01548672566
48557,48610,52012,53,3402,2,7200,1.01557907113
48558,48616,51861,58,3245,2,7200,1.01787365177
48560,48621,52005,61,3384,2,7200,1.01802600473
48561,48626,52042,65,3416,2,7200,1.01902810304
48562,48631,51837,69,3206,2,7200,1.02152214598
48564,48637,52212,73,3575,2,7200,1.02041958042
48565,48642,52016,77,3374,2,7200,1.02282157676
48566,48647,52003,81,3356,2,7200,1.02413587604
48568,48653,52035,85,3382,2,7200,1.02513305736
48569,48658,52290,89,3632,2,7200,1.02450440529
48570,48663,52206,93,3543,2,7200,1.02624894157
48572,48668,52213,96,3545,2,7200,1.02708039492
48573,48674,52152,101,3478,2,7200,1.02903967798
48574,48679,52004,105,3325,2,7200,1.03157894737
48576,48684,52134,108,3450,2,7200,1.03130434783
48577,48689,52007,112,3318,2,7200,1.03375527426
48578,48695,52353,117,3658,2,7200,1.03198469109
48580,48700,52001,120,3301,2,7200,1.03635262042
48581,48705,52293,124,3588,2,7200,1.03455964326
48698,48711,52324,13,3613,2,7200,1.00359811791
48712,48718,52213,6,3495,2,7200,1.0017167382
48739,48746,52373,7,3627,2,7200,1.00192996967
48754,48760,52238,6,3478,2,7200,1.00172512938
48805,48812,52330,7,3518,2,7200,1.00198976691
48935,48941,52413,6,3472,2,7200,1.0017281106
49007,49013,52294,6,3281,2,7200,1.00182871076
49058,49065,52155,7,3090,2,7200,1.00226537217
49073,49079,52400,6,3321,2,7200,1.00180668473
49074,49085,52571,11,3486,2,7200,1.00315547906
49129,49135,52748,6,3613,2,7200,1.0016606698
49143,49149,52557,6,3408,2,7200,1.00176056338
49158,49164,52435,6,3271,2,7200,1.00183430144
49258,49264,52701,6,3437,2,7200,1.00174570847
49259,49270,52709,11,3439,2,7200,1.00319860425
49274,49280,52817,6,3537,2,7200,1.00169635284
49334,49340,52802,6,3462,2,7200,1.00173310225
49349,49355,52916,6,3561,2,7200,1.00168491997
49427,49433,52641,6,3208,2,7200,1.00187032419
49445,49451,52821,6,3370,2,7200,1.00178041543
49463,49469,52862,6,3393,2,7200,1.0017683466
49478,49484,53089,6,3605,2,7200,1.00166435506
49493,49499,52987,6,3488,2,7200,1.00172018349
49544,49550,53090,6,3540,2,7200,1.00169491525
49559,49565,53151,6,3586,2,7200,1.00167317345
49585,49592,52971,7,3379,2,7200,1.00207161882
49658,49664,53030,6,3366,2,7200,1.00178253119
49676,49682,53176,6,3494,2,7200,1.00171722954
49736,49742,52948,6,3206,2,7200,1.00187149095
49820,49826,53361,6,3535,2,7200,1.00169731259
49850,49856,53486,6,3630,2,7200,1.00165289256
49937,49944,53408,7,3464,2,7200,1.00202078522
50119,50125,53564,6,3439,2,7200,1.00174469322
50152,50158,53702,6,3544,2,7200,1.00169300226
50170,50176,53752,6,3576,2,7200,1.00167785235
50297,50303,53555,6,3252,2,7200,1.00184501845
50352,50358,53874,6,3516,2,7200,1.00170648464
50445,50452,53713,7,3261,2,7200,1.0021465808
50897,50904,54371,7,3467,2,7200,1.00201903663
51097,51103,54514,6,3411,2,7200,1.00175901495
51767,51774,55403,7,3629,2,7200,1.00192890603
51840,51846,55495,6,3649,2,7200,1.00164428611
51855,51861,54964,6,3103,2,7200,1.00193361263
51870,51876,55527,6,3651,2,7200,1.00164338537
51871,51882,55790,11,3908,2,7200,1.002814739
51886,51892,55739,6,3847,2,7200,1.00155965688
51887,51898,55581,11,3683,2,7200,1.00298669563
51902,51909,55761,7,3852,2,7200,1.0018172378
51904,51915,55728,11,3813,2,7200,1.00288486756
51919,51925,55459,6,3534,2,7200,1.00169779287
51920,51931,55664,11,3733,2,7200,1.00294669167
51935,51941,55508,6,3567,2,7200,1.00168208579
51950,51956,55279,6,3323,2,7200,1.00180559735
51951,51962,55285,11,3323,2,7200,1.00331026181
51953,51967,55549,14,3582,2,7200,1.00390843104
51986,51992,55513,6,3521,2,7200,1.00170406135
52004,52010,55501,6,3491,2,7200,1.00171870524
52034,52040,55551,6,3511,2,7200,1.00170891484
52048,52054,55643,6,3589,2,7200,1.00167177487
52050,52066,55384,16,3318,2,7200,1.00482218204
52051,52060,55523,9,3463,2,7200,1.00259890269
52089,52095,55600,6,3505,2,7200,1.00171184023
52134,52140,55417,6,3277,2,7200,1.00183094294
52135,52146,55938,11,3792,2,7200,1.00290084388
52153,52159,55805,6,3646,2,7200,1.00164563906
52168,52174,55477,6,3303,2,7200,1.00181653043
52207,52213,55808,6,3595,2,7200,1.0016689847
52222,52229,55820,7,3591,2,7200,1.00194931774
52224,52236,55604,12,3368,2,7200,1.00356294537
52225,52241,55767,16,3526,2,7200,1.0045377198
52240,52247,55778,7,3531,2,7200,1.00198244123
52241,52252,55733,11,3481,2,7200,1.00316001149
52259,52265,55770,6,3505,2,7200,1.00171184023
52286,52292,55764,6,3472,2,7200,1.0017281106
52301,52308,55889,7,3581,2,7200,1.00195476124
52303,52313,55575,10,3262,2,7200,1.00306560392
52304,52320,56174,16,3854,2,7200,1.00415153088
52325,52331,55637,6,3306,2,7200,1.00181488203
52340,52346,55888,6,3542,2,7200,1.00169395822
52354,52361,55845,7,3484,2,7200,1.00200918485
52372,52378,56029,6,3651,2,7200,1.00164338537
52400,52406,55829,6,3423,2,7200,1.00175284838
52433,52439,55777,6,3338,2,7200,1.00179748352
52448,52454,55898,6,3444,2,7200,1.00174216028
52559,52566,55762,7,3196,2,7200,1.0021902378
52574,52581,56030,7,3449,2,7200,1.00202957379
52644,52650,56025,6,3375,2,7200,1.00177777778
52701,52707,56139,6,3432,2,7200,1.00174825175
52716,52722,56198,6,3476,2,7200,1.00172612198
52746,52752,56191,6,3439,2,7200,1.00174469322
52803,52809,56465,6,3656,2,7200,1.00164113786
52818,52825,56468,7,3643,2,7200,1.00192149327
52833,52839,56252,6,3413,2,7200,1.00175798418
52863,52869,56392,6,3523,2,7200,1.00170309395
52917,52923,56021,6,3098,2,7200,1.00193673338
52947,52953,56364,6,3411,2,7200,1.00175901495
52971,52977,56721,6,3744,2,7200,1.0016025641
52989,52995,56616,6,3621,2,7200,1.00165700083
53031,53037,56350,6,3313,2,7200,1.00181104739
53088,53094,56411,6,3317,2,7200,1.00180886343
53103,53109,56260,6,3151,2,7200,1.00190415741
53151,53157,56748,6,3591,2,7200,1.00167084378
53178,53184,56809,6,3625,2,7200,1.00165517241
53359,53365,56834,6,3469,2,7200,1.00172960507
53410,53416,56964,6,3548,2,7200,1.00169109357
53489,53495,56746,6,3251,2,7200,1.00184558597
53558,53564,57165,6,3601,2,7200,1.00166620383
53568,53574,57327,6,3753,2,7200,1.00159872102
53703,53709,57121,6,3412,2,7200,1.00175849941
53717,53723,57134,6,3411,2,7200,1.00175901495
53750,53756,57325,6,3569,2,7200,1.00168114318
53874,53880,57249,6,3369,2,7200,1.0017809439
54371,54377,57912,6,3535,2,7200,1.00169731259
54515,54521,57806,6,3285,2,7200,1.00182648402
54966,54972,58373,6,3401,2,7200,1.001764187
55280,55286,58652,6,3366,2,7200,1.00178253119
55295,55301,58609,6,3308,2,7200,1.00181378476
55385,55391,58662,6,3271,2,7200,1.00183430144
55403,55409,58852,6,3443,2,7200,1.00174266628
55418,55424,58826,6,3402,2,7200,1.00176366843
55435,108133,111764,52698,3631,25,3599,15.5133572019
55460,55466,59036,6,3570,2,7200,1.00168067227
55478,55484,58720,6,3236,2,7200,1.00185414091
55496,55502,59101,6,3599,2,7200,1.00166712976
55511,55517,59100,6,3583,2,7200,1.00167457438
55512,55523,59023,11,3500,2,7200,1.00314285714
55523,55529,58863,6,3334,2,7200,1.00179964007
55527,55537,59109,10,3572,2,7200,1.00279955207
55541,111778,115437,56237,3659,25,3599,16.3694998634
55542,55548,59057,6,3509,2,7200,1.00170988886
55557,55563,58955,6,3392,2,7200,1.00176886792
55558,55569,59122,11,3553,2,7200,1.00309597523
55576,55582,59233,6,3651,2,7200,1.00164338537
55591,55597,59107,6,3510,2,7200,1.00170940171
55606,55612,59252,6,3640,2,7200,1.00164835165
55607,55618,59154,11,3536,2,7200,1.00311085973
55637,55643,59164,6,3521,2,7200,1.00170406135
55652,55658,58929,6,3271,2,7200,1.00183430144
55666,55673,59298,7,3625,2,7200,1.00193103448
55730,55736,59236,6,3500,2,7200,1.00171428571
55745,55751,59240,6,3489,2,7200,1.00171969046
55746,55757,59217,11,3460,2,7200,1.00317919075
55761,55767,59229,6,3462,2,7200,1.00173310225
55763,55774,59097,11,3323,2,7200,1.00331026181
55779,55786,59292,7,3506,2,7200,1.0019965773
55780,55793,59357,13,3564,2,7200,1.00364758698
55782,55798,59181,16,3383,2,7200,1.00472953
55783,55803,59481,20,3678,2,7200,1.0054377379
55784,55808,59128,24,3320,2,7200,1.00722891566
55800,55815,59160,15,3345,2,7200,1.00448430493
55814,55822,59206,8,3384,2,7200,1.00236406619
55816,55828,59399,12,3571,2,7200,1.00336040325
55831,55837,59227,6,3390,2,7200,1.0017699115
55832,55844,59246,12,3402,2,7200,1.00352733686
55847,55853,59382,6,3529,2,7200,1.00170019836
55889,55896,59533,7,3637,2,7200,1.00192466318
55891,55903,59275,12,3372,2,7200,1.00355871886
55905,55912,59542,7,3630,2,7200,1.00192837466
55938,55946,59291,8,3345,2,7200,1.0023916293
56023,56029,59328,6,3299,2,7200,1.00181873295
56038,56044,59517,6,3473,2,7200,1.00172761301
56039,56050,59761,11,3711,2,7200,1.0029641606
56041,56055,59544,14,3489,2,7200,1.00401261106
56140,56146,59262,6,3116,2,7200,1.00192554557
56173,56179,59770,6,3591,2,7200,1.00167084378
56191,56197,59556,6,3359,2,7200,1.00178624591
56206,56212,59554,6,3342,2,7200,1.00179533214
56254,56260,59649,6,3389,2,7200,1.00177043376
56256,56267,59637,11,3370,2,7200,1.00326409496
56352,56358,59903,6,3545,2,7200,1.00169252468
56367,56373,59734,6,3361,2,7200,1.00178518298
56394,56400,59897,6,3497,2,7200,1.00171575636
56412,56418,59671,6,3253,2,7200,1.00184445128
56466,56472,59946,6,3474,2,7200,1.00172711572
56481,56487,59661,6,3174,2,7200,1.00189035917
56614,56620,60103,6,3483,2,7200,1.00172265289
56722,56729,60124,7,3395,2,7200,1.00206185567
56746,56752,60217,6,3465,2,7200,1.00173160173
56761,56767,60233,6,3466,2,7200,1.00173110214
56812,56818,60359,6,3541,2,7200,1.0016944366
56836,56842,60252,6,3410,2,7200,1.00175953079
56966,56972,60525,6,3553,2,7200,1.00168871376
57123,57129,60439,6,3310,2,7200,1.00181268882
57138,57144,60294,6,3150,2,7200,1.0019047619
57165,57171,60547,6,3376,2,7200,1.00177725118
57251,57257,60660,6,3403,2,7200,1.00176315016
57325,57331,60852,6,3521,2,7200,1.00170406135
57330,57338,60891,8,3553,2,7200,1.00225161835
57808,57815,61459,7,3644,2,7200,1.00192096597
57914,57920,61269,6,3349,2,7200,1.00179157958
58371,58378,61872,7,3494,2,7200,1.00200343446
58606,58613,62251,7,3638,2,7200,1.00192413414
58652,58658,61877,6,3219,2,7200,1.0018639329
58666,58672,62075,6,3403,2,7200,1.00176315016
58721,58727,62332,6,3605,2,7200,1.00166435506
58826,58832,62478,6,3646,2,7200,1.00164563906
58853,58859,62301,6,3442,2,7200,1.00174317257
58865,58871,62230,6,3359,2,7200,1.00178624591
58928,58935,62332,7,3397,2,7200,1.00206064174
58955,58961,62414,6,3453,2,7200,1.00173761946
59025,59031,62507,6,3476,2,7200,1.00172612198
59042,59047,62591,5,3544,2,7200,1.00141083521
59059,59066,62646,7,3580,2,7200,1.00195530726
59099,59105,62644,6,3539,2,7200,1.00169539418
59100,59112,62706,12,3594,2,7200,1.00333889816
59115,59121,62317,6,3196,2,7200,1.00187734668
59117,59127,62698,10,3571,2,7200,1.00280033604
59118,59133,62378,15,3245,2,7200,1.00462249615
59133,59139,62476,6,3337,2,7200,1.00179802218
59134,59145,62787,11,3642,2,7200,1.00302031851
59155,59161,62461,6,3300,2,7200,1.00181818182
59170,59176,62712,6,3536,2,7200,1.00169683258
59172,59183,62448,11,3265,2,7200,1.00336906585
59186,59192,62702,6,3510,2,7200,1.00170940171
59207,59213,62802,6,3589,2,7200,1.00167177487
59222,59228,62705,6,3477,2,7200,1.00172562554
59238,59244,62981,6,3737,2,7200,1.00160556596
59240,59251,62857,11,3606,2,7200,1.00305047144
59241,59256,62845,15,3589,2,7200,1.00417943717
59242,59261,63026,19,3765,2,7200,1.00504648074
59244,59266,62718,22,3452,2,7200,1.00637311703
59259,59273,62625,14,3352,2,7200,1.00417661098
59260,59278,62599,18,3321,2,7200,1.0054200542
59275,59284,62703,9,3419,2,7200,1.00263234864
59276,59290,62624,14,3334,2,7200,1.00419916017
59291,59298,62661,7,3363,2,7200,1.00208147487
59293,59303,62683,10,3380,2,7200,1.00295857988
59308,59314,62730,6,3416,2,7200,1.00175644028
59328,59335,62793,7,3458,2,7200,1.0020242915
59359,59365,62991,6,3626,2,7200,1.00165471594
59383,59389,62870,6,3481,2,7200,1.00172364263
59401,59407,62763,6,3356,2,7200,1.00178784267
59482,59488,63098,6,3610,2,7200,1.00166204986
59518,59524,63002,6,3478,2,7200,1.00172512938
59536,59542,62797,6,3255,2,7200,1.00184331797
59551,59557,62806,6,3249,2,7200,1.00184672207
59552,59563,62857,11,3294,2,7200,1.00333940498
59567,59574,62970,7,3396,2,7200,1.00206124853
59569,59580,62918,11,3338,2,7200,1.00329538646
59635,59641,62979,6,3338,2,7200,1.00179748352
59650,59656,63163,6,3507,2,7200,1.00171086399
59665,59671,63026,6,3355,2,7200,1.00178837556
59680,59686,63190,6,3504,2,7200,1.00171232877
59734,59740,62942,6,3202,2,7200,1.00187382886
59761,59767,63296,6,3529,2,7200,1.00170019836
59776,59782,63198,6,3416,2,7200,1.00175644028
59899,59906,63409,7,3503,2,7200,1.00199828718
59914,59920,63254,6,3334,2,7200,1.00179964007
59947,59953,63455,6,3502,2,7200,1.00171330668
60104,60110,63433,6,3323,2,7200,1.00180559735
60125,60131,63717,6,3586,2,7200,1.00167317345
60219,60225,63485,6,3260,2,7200,1.0018404908
60234,60240,63779,6,3539,2,7200,1.00169539418
60254,60261,63623,7,3362,2,7200,1.00208209399
60293,60300,63828,7,3528,2,7200,1.00198412698
60360,60366,63755,6,3389,2,7200,1.00177043376
60441,60447,63613,6,3166,2,7200,1.00189513582
60528,60534,63864,6,3330,2,7200,1.0018018018
60550,60556,63800,6,3244,2,7200,1.00184956843
60661,60667,64332,6,3665,2,7200,1.00163710778
60851,60857,64512,6,3655,2,7200,1.00164158687
60894,60900,64302,6,3402,2,7200,1.00176366843
60920,60926,74596,6,13670,4,36000,1.00043891734
61269,61275,64619,6,3344,2,7200,1.00179425837
61459,61465,64792,6,3327,2,7200,1.00180342651
61872,61879,65364,7,3485,2,7200,1.00200860832
61887,61893,65674,6,3781,2,7200,1.00158688178
62075,62081,65686,6,3605,2,7200,1.00166435506
62232,62238,65579,6,3341,2,7200,1.0017958695
62253,62259,65813,6,3554,2,7200,1.0016882386
62301,62307,65761,6,3454,2,7200,1.00173711639
62319,62325,65620,6,3295,2,7200,1.00182094082
62334,62340,65603,6,3263,2,7200,1.00183879865
62335,62346,65768,11,3422,2,7200,1.00321449445
62377,62384,65749,7,3365,2,7200,1.00208023774
62413,62420,65969,7,3549,2,7200,1.00197238659
62447,62453,66012,6,3559,2,7200,1.00168586682
62461,62467,66016,6,3549,2,7200,1.00169061708
62476,62482,65802,6,3320,2,7200,1.00180722892
62491,62497,66133,6,3636,2,7200,1.00165016502
62509,62515,65764,6,3249,2,7200,1.00184672207
62590,62596,66140,6,3544,2,7200,1.00169300226
62605,62611,65986,6,3375,2,7200,1.00177777778
62626,62632,66068,6,3436,2,7200,1.00174621653
62627,62639,66274,12,3635,2,7200,1.00330123796
62646,62652,66124,6,3472,2,7200,1.0017281106
62661,62667,66313,6,3646,2,7200,1.00164563906
62675,62682,66242,7,3560,2,7200,1.00196629213
62690,62696,66101,6,3405,2,7200,1.00176211454
62706,62712,65911,6,3199,2,7200,1.00187558612
62707,62719,66181,12,3462,2,7200,1.00346620451
62708,62724,66194,16,3470,2,7200,1.00461095101
62710,62729,66146,19,3417,2,7200,1.00556043313
62711,62734,66300,23,3566,2,7200,1.0064498037
62726,62740,66094,14,3354,2,7200,1.00417412045
62728,62746,66015,18,3269,2,7200,1.00550627103
62743,62752,66131,9,3379,2,7200,1.00266350991
62763,62770,66291,7,3521,2,7200,1.00198807157
62787,62794,66167,7,3373,2,7200,1.00207530388
62803,62808,66291,5,3483,2,7200,1.00143554407
62804,62816,66248,12,3432,2,7200,1.0034965035
62805,62821,66070,16,3249,2,7200,1.00492459218
62820,62827,66413,7,3586,2,7200,1.00195203569
62847,62853,66429,6,3576,2,7200,1.00167785235
62862,62868,66007,6,3139,2,7200,1.00191143676
62863,62874,66269,11,3395,2,7200,1.00324005891
62878,62884,66241,6,3357,2,7200,1.0017873101
62920,62926,66170,6,3244,2,7200,1.00184956843
62944,62950,66143,6,3193,2,7200,1.00187911055
62971,62978,66403,7,3425,2,7200,1.00204379562
62987,62993,66328,6,3335,2,7200,1.00179910045
62988,62999,66517,11,3518,2,7200,1.00312677658
63003,63010,66442,7,3432,2,7200,1.00203962704
63004,63017,66544,13,3527,2,7200,1.003685852
63028,63035,66445,7,3410,2,7200,1.00205278592
63030,63043,66510,13,3467,2,7200,1.00374963946
63099,63105,66670,6,3565,2,7200,1.00168302945
63165,63171,66486,6,3315,2,7200,1.00180995475
63192,63200,66557,8,3357,2,7200,1.00238308013
63207,63213,66415,6,3202,2,7200,1.00187382886
63255,63262,66667,7,3405,2,7200,1.00205580029
63298,63304,66789,6,3485,2,7200,1.00172166428
63412,63418,66953,6,3535,2,7200,1.00169731259
63433,63439,67047,6,3608,2,7200,1.00166297118
63457,63463,66781,6,3318,2,7200,1.00180831826
63487,63493,67107,6,3614,2,7200,1.00166021029
63614,63620,67050,6,3430,2,7200,1.00174927114
63628,63634,67144,6,3510,2,7200,1.00170940171
63719,63725,67188,6,3463,2,7200,1.00173260179
63755,63761,67250,6,3489,2,7200,1.00171969046
63779,63785,67112,6,3327,2,7200,1.00180342651
63800,63806,67247,6,3441,2,7200,1.00174367916
63830,63836,67387,6,3551,2,7200,1.00168966488
63866,63872,67020,6,3148,2,7200,1.00190597205
64304,64310,67964,6,3654,2,7200,1.00164203612
64334,64340,67441,6,3101,2,7200,1.00193485972
64512,64518,67803,6,3285,2,7200,1.00182648402
64618,64624,67925,6,3301,2,7200,1.00181763102
64793,64799,68249,6,3450,2,7200,1.00173913043
65364,65370,68936,6,3566,2,7200,1.00168255749
65581,65587,68835,6,3248,2,7200,1.00184729064
65603,65610,69013,7,3403,2,7200,1.00205700852
65621,65627,69060,6,3433,2,7200,1.0017477425
65675,65681,69176,6,3495,2,7200,1.0017167382
65690,65696,69043,6,3347,2,7200,1.00179265013
65750,65756,69402,6,3646,2,7200,1.00164563906
65765,65772,69218,7,3446,2,7200,1.00203134068
65767,65778,69209,11,3431,2,7200,1.00320606237
65782,65788,69355,6,3567,2,7200,1.00168208579
65803,65809,69445,6,3636,2,7200,1.00165016502
65817,65823,69339,6,3516,2,7200,1.00170648464
65911,65917,69440,6,3523,2,7200,1.00170309395
65971,65977,69453,6,3476,2,7200,1.00172612198
65989,65995,69412,6,3417,2,7200,1.00175592625
66010,66016,69421,6,3405,2,7200,1.00176211454
66025,66031,69275,6,3244,2,7200,1.00184956843
66026,66037,69501,11,3464,2,7200,1.00317551963
66028,66043,69391,15,3348,2,7200,1.00448028674
66067,66073,69517,6,3444,2,7200,1.00174216028
66082,66088,69503,6,3415,2,7200,1.00175695461
66096,66103,69681,7,3578,2,7200,1.00195640022
66111,66118,69694,7,3576,2,7200,1.00195749441
66126,66132,69599,6,3467,2,7200,1.00173060283
66141,66147,69347,6,3200,2,7200,1.001875
66142,66153,69623,11,3470,2,7200,1.00317002882
66144,66158,69402,14,3244,2,7200,1.00431565968
66159,66165,69398,6,3233,2,7200,1.00185586143
66160,66171,69483,11,3312,2,7200,1.00332125604
66176,66181,69937,5,3756,2,7200,1.00133120341
66177,66187,69504,10,3317,2,7200,1.00301477238
66192,66198,69941,6,3743,2,7200,1.00160299225
66207,66213,69565,6,3352,2,7200,1.00178997613
66243,66249,69567,6,3318,2,7200,1.00180831826
66244,66256,69638,12,3382,2,7200,1.00354819633
66259,66266,69704,7,3438,2,7200,1.00203606748
66274,66280,69505,6,3225,2,7200,1.00186046512
66275,66286,69706,11,3420,2,7200,1.00321637427
66293,66299,69911,6,3612,2,7200,1.00166112957
66295,66305,69736,10,3431,2,7200,1.00291460216
66309,66316,70096,7,3780,2,7200,1.00185185185
66324,66330,69813,6,3483,2,7200,1.00172265289
66339,66345,69809,6,3464,2,7200,1.00173210162
66405,66411,69456,6,3045,2,7200,1.00197044335
66420,66426,69457,6,3031,2,7200,1.0019795447
66422,66433,69897,11,3464,2,7200,1.00317551963
66437,66443,69840,6,3397,2,7200,1.00176626435
66452,66458,70225,6,3767,2,7200,1.0015927794
66453,66464,69941,11,3477,2,7200,1.00316364682
66489,66495,69736,6,3241,2,7200,1.00185128047
66510,66516,69881,6,3365,2,7200,1.00178306092
66525,66531,69755,6,3224,2,7200,1.00186104218
66546,66552,69926,6,3374,2,7200,1.00177830468
66561,66567,69921,6,3354,2,7200,1.00178890877
66670,66676,70199,6,3523,2,7200,1.00170309395
66685,66691,70232,6,3541,2,7200,1.0016944366
66781,66787,70443,6,3656,2,7200,1.00164113786
66796,66802,70086,6,3284,2,7200,1.00182704019
66953,66959,70406,6,3447,2,7200,1.00174064404
67024,67030,70440,6,3410,2,7200,1.00175953079
67047,67053,70531,6,3478,2,7200,1.00172512938
67061,67068,70567,7,3499,2,7200,1.00200057159
67110,67116,70333,6,3217,2,7200,1.0018650917
67111,67123,70461,12,3338,2,7200,1.00359496705
67144,67150,70475,6,3325,2,7200,1.00180451128
67189,67196,70510,7,3314,2,7200,1.00211225106
67250,67256,70682,6,3426,2,7200,1.00175131349
67264,67271,70818,7,3547,2,7200,1.00197349873
67388,67394,71118,6,3724,2,7200,1.00161117078
67441,67447,70898,6,3451,2,7200,1.00173862649
67803,67809,71404,6,3595,2,7200,1.0016689847
67926,67933,71573,7,3640,2,7200,1.00192307692
67965,67971,71325,6,3354,2,7200,1.00178890877
68250,68256,71793,6,3537,2,7200,1.00169635284
68835,68841,72300,6,3459,2,7200,1.00173460538
68937,68944,72443,7,3499,2,7200,1.00200057159
69013,69019,72454,6,3435,2,7200,1.00174672489
69046,69052,72394,6,3342,2,7200,1.00179533214
69061,69067,72502,6,3435,2,7200,1.00174672489
69178,69184,72769,6,3585,2,7200,1.00167364017
69211,69217,72825,6,3608,2,7200,1.00166297118
69226,69232,72635,6,3403,2,7200,1.00176315016
69274,69280,72586,6,3306,2,7200,1.00181488203
69345,69351,72839,6,3488,2,7200,1.00172018349
69360,69366,72782,6,3416,2,7200,1.00175644028
69362,69373,72780,11,3407,2,7200,1.0032286469
69392,69398,72753,6,3355,2,7200,1.00178837556
69407,69413,72954,6,3541,2,7200,1.0016944366
69408,69419,72675,11,3256,2,7200,1.00337837838
69410,69425,72776,15,3351,2,7200,1.00447627574
69440,69446,72909,6,3463,2,7200,1.00173260179
69442,69453,72866,11,3413,2,7200,1.00322297099
69457,69463,73018,6,3555,2,7200,1.00168776371
69459,69470,72832,11,3362,2,7200,1.00327186199
69460,69476,72763,16,3287,2,7200,1.00486766048
69461,69481,72751,20,3270,2,7200,1.00611620795
69463,69486,72702,23,3216,2,7200,1.00715174129
69483,69492,72997,9,3505,2,7200,1.00256776034
69504,69510,72938,6,3428,2,7200,1.00175029172
69505,69517,73064,12,3547,2,7200,1.00338314068
69506,69522,73130,16,3608,2,7200,1.0044345898
69521,69528,72906,7,3378,2,7200,1.00207223209
69523,69534,73197,11,3663,2,7200,1.003003003
69568,69575,72861,7,3286,2,7200,1.00213024954
69569,69581,72814,12,3233,2,7200,1.00371172286
69599,69605,73061,6,3456,2,7200,1.00173611111
69620,69627,73003,7,3376,2,7200,1.00207345972
69638,69645,73025,7,3380,2,7200,1.00207100592
69684,69690,73069,6,3379,2,7200,1.00177567328
69698,69704,73087,6,3383,2,7200,1.00177357375
69713,69719,73341,6,3622,2,7200,1.00165654335
69715,69725,73583,10,3858,2,7200,1.00259201659
69736,69742,73450,6,3708,2,7200,1.00161812298
69737,69750,73262,13,3512,2,7200,1.00370159453
69755,69761,73137,6,3376,2,7200,1.00177725118
69809,69815,73174,6,3359,2,7200,1.00178624591
69824,69830,73379,6,3549,2,7200,1.00169061708
69842,69848,73384,6,3536,2,7200,1.00169683258
69881,69887,73133,6,3246,2,7200,1.00184842884
69899,69905,73311,6,3406,2,7200,1.00176159718
69914,69920,73338,6,3418,2,7200,1.00175541252
69929,69935,73430,6,3495,2,7200,1.0017167382
69930,69941,73278,11,3337,2,7200,1.00329637399
69945,69951,73456,6,3505,2,7200,1.00171184023
69947,69958,73363,11,3405,2,7200,1.00323054332
69948,69964,73116,16,3152,2,7200,1.00507614213
70087,70093,73456,6,3363,2,7200,1.00178412132
70102,70108,73485,6,3377,2,7200,1.0017767249
70201,70207,73562,6,3355,2,7200,1.00178837556
70226,70232,73882,6,3650,2,7200,1.00164383562
70240,70247,73620,7,3373,2,7200,1.00207530388
70334,70340,73767,6,3427,2,7200,1.00175080245
70407,70414,73954,7,3540,2,7200,1.00197740113
70442,70448,74031,6,3583,2,7200,1.00167457438
70443,70455,74195,12,3740,2,7200,1.00320855615
70461,70467,73818,6,3351,2,7200,1.0017905103
70476,70482,73689,6,3207,2,7200,1.00187090739
70512,70519,74050,7,3531,2,7200,1.00198244123
70533,70539,73891,6,3352,2,7200,1.00178997613
70569,70575,73896,6,3321,2,7200,1.00180668473
70683,70689,74179,6,3490,2,7200,1.00171919771
70819,70825,74178,6,3353,2,7200,1.00178944229
70899,70905,74262,6,3357,2,7200,1.0017873101
71119,71126,74657,7,3531,2,7200,1.00198244123
71327,71333,74823,6,3490,2,7200,1.00171919771
71406,71412,74865,6,3453,2,7200,1.00173761946
71575,71581,74936,6,3355,2,7200,1.00178837556
71792,71798,75037,6,3239,2,7200,1.00185242359
72302,72309,75694,7,3385,2,7200,1.00206794682
72396,72402,75791,6,3389,2,7200,1.00177043376
72444,72451,75635,7,3184,2,7200,1.00219849246
72459,72465,76084,6,3619,2,7200,1.00165791655
72504,72511,75798,7,3287,2,7200,1.00212960146
72589,72595,76172,6,3577,2,7200,1.00167738328
72637,72643,75910,6,3267,2,7200,1.00183654729
72673,72679,76082,6,3403,2,7200,1.00176315016
72703,72710,76225,7,3515,2,7200,1.00199146515
72752,72758,76332,6,3574,2,7200,1.00167879127
72753,72765,76262,12,3497,2,7200,1.00343151273
72768,72774,76418,6,3644,2,7200,1.00164654226
72769,72780,76155,11,3375,2,7200,1.00325925926
72786,72792,76154,6,3362,2,7200,1.00178465199
72787,72798,76133,11,3335,2,7200,1.00329835082
72788,72804,76164,16,3360,2,7200,1.00476190476
72812,72819,76188,7,3369,2,7200,1.00207776788
72827,72833,76109,6,3276,2,7200,1.00183150183
72842,72848,76295,6,3447,2,7200,1.00174064404
72843,72854,76297,11,3443,2,7200,1.00319488818
72861,72868,76618,7,3750,2,7200,1.00186666667
72876,72882,76117,6,3235,2,7200,1.00185471406
72906,72912,76245,6,3333,2,7200,1.00180018002
72921,72927,76374,6,3447,2,7200,1.00174064404
72939,72945,76559,6,3614,2,7200,1.00166021029
72954,72960,76184,6,3224,2,7200,1.00186104218
72999,73005,76419,6,3414,2,7200,1.00175746924
73014,73020,76417,6,3397,2,7200,1.00176626435
73029,73035,76377,6,3342,2,7200,1.00179533214
73030,73042,76558,12,3516,2,7200,1.00341296928
73063,73070,76339,7,3269,2,7200,1.00214132762
73065,73076,76496,11,3420,2,7200,1.00321637427
73080,73086,76640,6,3554,2,7200,1.0016882386
73094,73101,76717,7,3616,2,7200,1.00193584071
73115,73122,76555,7,3433,2,7200,1.00203903292
73130,73137,76467,7,3330,2,7200,1.0021021021
73145,73152,76670,7,3518,2,7200,1.00198976691
73147,73158,76445,11,3287,2,7200,1.00334651658
73177,73183,76807,6,3624,2,7200,1.00165562914
73198,73204,76651,6,3447,2,7200,1.00174064404
73264,73270,76604,6,3334,2,7200,1.00179964007
73279,73285,76980,6,3695,2,7200,1.00162381597
73312,73318,76497,6,3179,2,7200,1.00188738597
73339,73345,76987,6,3642,2,7200,1.00164744646
73354,73360,76625,6,3265,2,7200,1.00183767228
73369,73375,76797,6,3422,2,7200,1.00175336061
73384,73390,76788,6,3398,2,7200,1.00176574456
73398,73404,76965,6,3561,2,7200,1.00168491997
73431,73438,76830,7,3392,2,7200,1.00206367925
73449,73456,76856,7,3400,2,7200,1.00205882353
73464,73470,77087,6,3617,2,7200,1.00165883329
73466,73476,76853,10,3377,2,7200,1.00296120817
73487,73493,76878,6,3385,2,7200,1.00177252585
73562,73568,76888,6,3320,2,7200,1.00180722892
73580,73586,77087,6,3501,2,7200,1.00171379606
73622,73628,77386,6,3758,2,7200,1.00159659393
73691,73697,77207,6,3510,2,7200,1.00170940171
73767,73773,77166,6,3393,2,7200,1.0017683466
73818,73824,77395,6,3571,2,7200,1.00168020162
73881,73887,77363,6,3476,2,7200,1.00172612198
73896,73904,77337,8,3433,2,7200,1.00233032333
73898,73909,77268,11,3359,2,7200,1.00327478416
73955,73962,77378,7,3416,2,7200,1.00204918033
74028,74036,77521,8,3485,2,7200,1.00229555237
74052,74058,77287,6,3229,2,7200,1.00185816042
74179,74185,77455,6,3270,2,7200,1.00183486239
74181,74191,77715,10,3524,2,7200,1.00283768445
74196,74202,77913,6,3711,2,7200,1.00161681487
74264,74270,77447,6,3177,2,7200,1.00188857413
74659,74666,77991,7,3325,2,7200,1.00210526316
74826,74832,78282,6,3450,2,7200,1.00173913043
74867,74873,78561,6,3688,2,7200,1.00162689805
74934,74940,78319,6,3379,2,7200,1.00177567328
75039,75045,78390,6,3345,2,7200,1.00179372197
75633,75639,79046,6,3407,2,7200,1.00176108013
75695,75701,79048,6,3347,2,7200,1.00179265013
75790,75796,79232,6,3436,2,7200,1.00174621653
75805,75811,79475,6,3664,2,7200,1.00163755459
75911,75917,79380,6,3463,2,7200,1.00173260179
76083,76090,79332,7,3242,2,7200,1.00215916101
76098,76104,79370,6,3266,2,7200,1.00183710961
76113,76119,79581,6,3462,2,7200,1.00173310225
76127,76133,79446,6,3313,2,7200,1.00181104739
76142,76148,79670,6,3522,2,7200,1.00170357751
76157,76163,79490,6,3327,2,7200,1.00180342651
76159,76170,79259,11,3089,2,7200,1.00356102298
76174,76180,79788,6,3608,2,7200,1.00166297118
76175,76186,79703,11,3517,2,7200,1.00312766562
76190,76196,79658,6,3462,2,7200,1.00173310225
76191,76202,79688,11,3486,2,7200,1.00315547906
76225,76231,79615,6,3384,2,7200,1.00177304965
76246,76252,79516,6,3264,2,7200,1.00183823529
76264,76271,79736,7,3465,2,7200,1.00202020202
76294,76300,79707,6,3407,2,7200,1.00176108013
76309,76315,79842,6,3527,2,7200,1.00170116246
76333,76339,79726,6,3387,2,7200,1.00177147919
76348,76354,79845,6,3491,2,7200,1.00171870524
76375,76381,79649,6,3268,2,7200,1.00183598531
76390,76396,79933,6,3537,2,7200,1.00169635284
76414,76420,79796,6,3376,2,7200,1.00177725118
76429,76435,80028,6,3593,2,7200,1.00166991372
76430,76441,79709,11,3268,2,7200,1.00336597307
76445,76451,79982,6,3531,2,7200,1.00169923534
76469,76475,80279,6,3804,2,7200,1.00157728707
76496,76502,80033,6,3531,2,7200,1.00169923534
76497,76508,79831,11,3323,2,7200,1.00331026181
76555,76561,79912,6,3351,2,7200,1.0017905103
76557,76567,80173,10,3606,2,7200,1.00277315585
76572,76578,80205,6,3627,2,7200,1.00165425972
76605,76611,80053,6,3442,2,7200,1.00174317257
76620,76626,80209,6,3583,2,7200,1.00167457438
76634,76641,80209,7,3568,2,7200,1.00196188341
76649,76655,80024,6,3369,2,7200,1.0017809439
76651,76661,80091,10,3430,2,7200,1.0029154519
76669,76675,79981,6,3306,2,7200,1.00181488203
76717,76723,80125,6,3402,2,7200,1.00176366843
76790,76796,80023,6,3227,2,7200,1.00185931205
76804,76811,80182,7,3371,2,7200,1.00207653515
76819,76825,80267,6,3442,2,7200,1.00174317257
76834,76840,80174,6,3334,2,7200,1.00179964007
76855,76861,80275,6,3414,2,7200,1.00175746924
76857,76867,80342,10,3475,2,7200,1.00287769784
76934,76940,80208,6,3268,2,7200,1.00183598531
76935,76946,80320,11,3374,2,7200,1.00326022525
76937,76952,80683,15,3731,2,7200,1.00402036987
76938,76957,80403,19,3446,2,7200,1.005513639
76939,76962,80421,23,3459,2,7200,1.00664932061
76940,76967,80443,27,3476,2,7200,1.00776754891
76942,76973,80293,31,3320,2,7200,1.0093373494
76943,76978,80413,35,3435,2,7200,1.01018922853
76944,76984,80426,40,3442,2,7200,1.01162115049
76946,76989,80471,43,3482,2,7200,1.01234922458
76947,76994,80516,47,3522,2,7200,1.01334469052
76948,76999,80450,51,3451,2,7200,1.01477832512
76950,77005,80444,55,3439,2,7200,1.01599302123
76951,77010,80509,59,3499,2,7200,1.01686196056
76952,77015,80392,63,3377,2,7200,1.01865561149
76954,77020,80665,66,3645,2,7200,1.01810699588
76955,77026,80400,71,3374,2,7200,1.02104327208
76956,77031,80527,75,3496,2,7200,1.02145308924
76958,77036,80316,78,3280,2,7200,1.0237804878
76959,77041,80420,82,3379,2,7200,1.02426753477
76960,77046,80506,86,3460,2,7200,1.02485549133
76962,77052,80451,90,3399,2,7200,1.02647837599
76963,77057,80523,94,3466,2,7200,1.02712060012
76964,77062,80468,98,3406,2,7200,1.02877275396
76966,77067,80374,101,3307,2,7200,1.03054127608
76967,77073,80547,106,3474,2,7200,1.03051237766
76968,77080,80338,112,3258,2,7200,1.03437691835
76970,77085,80336,115,3251,2,7200,1.03537373116
76971,77090,80540,119,3450,2,7200,1.03449275362
76972,77095,80478,123,3383,2,7200,1.0363582619
76974,77101,80409,127,3308,2,7200,1.03839177751
76975,77106,80565,131,3459,2,7200,1.0378722174
76990,77111,80535,121,3424,2,7200,1.03533878505
76992,77116,80361,124,3245,2,7200,1.03821263482
76993,77121,80762,128,3641,2,7200,1.03515517715
77087,77129,80611,42,3482,2,7200,1.01206203331
77088,77134,80704,46,3570,2,7200,1.01288515406
77168,77174,80571,6,3397,2,7200,1.00176626435
77207,77213,80599,6,3386,2,7200,1.00177200236
77270,77277,80656,7,3379,2,7200,1.00207161882
77288,77296,80888,8,3592,2,7200,1.00222717149
77340,77346,80850,6,3504,2,7200,1.00171232877
77364,77370,80393,6,3023,2,7200,1.00198478333
77379,77385,80923,6,3538,2,7200,1.00169587337
77394,77400,80646,6,3246,2,7200,1.00184842884
77409,77416,80674,7,3258,2,7200,1.0021485574
77450,77456,80909,6,3453,2,7200,1.00173761946
77457,77464,80692,7,3228,2,7200,1.0021685254
77523,77529,81091,6,3562,2,7200,1.00168444694
77716,77722,81356,6,3634,2,7200,1.0016510732
77913,77919,81412,6,3493,2,7200,1.00171772116
77992,77998,81584,6,3586,2,7200,1.00167317345
78285,78292,81737,7,3445,2,7200,1.00203193033
78320,78326,81719,6,3393,2,7200,1.0017683466
78392,78399,81666,7,3267,2,7200,1.00214263851
78561,78567,82154,6,3587,2,7200,1.001672707
79048,79054,82462,6,3408,2,7200,1.00176056338
79050,79060,82585,10,3525,2,7200,1.00283687943
79232,79239,82567,7,3328,2,7200,1.00210336538
79259,79266,82608,7,3342,2,7200,1.00209455416
79332,79338,82927,6,3589,2,7200,1.00167177487
79371,79377,82993,6,3616,2,7200,1.00165929204
79386,79392,82695,6,3303,2,7200,1.00181653043
79446,79453,82990,7,3537,2,7200,1.00197907831
79477,79483,82784,6,3301,2,7200,1.00181763102
79491,79499,83100,8,3601,2,7200,1.00222160511
79516,79523,83079,7,3556,2,7200,1.00196850394
79582,79588,83156,6,3568,2,7200,1.00168161435
79615,79621,82836,6,3215,2,7200,1.00186625194
79651,79658,83242,7,3584,2,7200,1.001953125
79666,79672,82862,6,3190,2,7200,1.00188087774
79681,79687,82961,6,3274,2,7200,1.00183262065
79696,79702,83056,6,3354,2,7200,1.00178890877
79712,79718,83289,6,3571,2,7200,1.00168020162
79713,79726,83176,13,3450,2,7200,1.00376811594
79714,79731,83333,17,3602,2,7200,1.00471960022
79729,79737,83555,8,3818,2,7200,1.00209533787
79744,79750,83139,6,3389,2,7200,1.00177043376
79789,79796,83143,7,3347,2,7200,1.00209142516
79804,79811,83194,7,3383,2,7200,1.00206916938
79831,79837,83145,6,3308,2,7200,1.00181378476
79846,79852,83457,6,3605,2,7200,1.00166435506
79848,79860,83202,12,3342,2,7200,1.00359066427
79914,79920,83440,6,3520,2,7200,1.00170454545
79935,79942,83134,7,3192,2,7200,1.00219298246
79981,79987,83482,6,3495,2,7200,1.0017167382
79982,79994,83366,12,3372,2,7200,1.00355871886
80025,80031,83596,6,3565,2,7200,1.00168302945
80026,80038,83438,12,3400,2,7200,1.00352941176
80028,80044,83309,16,3265,2,7200,1.00490045942
80043,80051,83283,8,3232,2,7200,1.00247524752
80058,80064,83381,6,3317,2,7200,1.00180886343
80091,80097,83652,6,3555,2,7200,1.00168776371
80127,80133,83577,6,3444,2,7200,1.00174216028
80175,80182,83508,7,3326,2,7200,1.00210463019
80177,80188,83655,11,3467,2,7200,1.00317277185
80192,80198,83600,6,3402,2,7200,1.00176366843
80207,80213,83468,6,3255,2,7200,1.00184331797
80222,80228,83582,6,3354,2,7200,1.00178890877
80223,80234,83918,11,3684,2,7200,1.00298588491
80225,80240,83738,15,3498,2,7200,1.00428816467
80270,80276,83642,6,3366,2,7200,1.00178253119
80285,80292,83764,7,3472,2,7200,1.00201612903
80286,80298,83556,12,3258,2,7200,1.00368324125
80301,80307,83738,6,3431,2,7200,1.00174876129
80316,80322,83731,6,3409,2,7200,1.00176004693
80331,80337,83489,6,3152,2,7200,1.0019035533
80346,80353,83886,7,3533,2,7200,1.00198131899
80348,80359,83905,11,3546,2,7200,1.00310208686
80349,80365,84074,16,3709,2,7200,1.00431383122
80364,80371,83919,7,3548,2,7200,1.0019729425
80379,80385,83815,6,3430,2,7200,1.00174927114
80394,80400,83974,6,3574,2,7200,1.00167879127
80395,80407,84038,12,3631,2,7200,1.00330487469
80411,80417,83980,6,3563,2,7200,1.00168397418
80412,80424,83855,12,3431,2,7200,1.00349752259
80414,80429,83952,15,3523,2,7200,1.00425773489
80429,80435,83777,6,3342,2,7200,1.00179533214
80430,80441,83710,11,3269,2,7200,1.00336494341
80432,80447,83751,15,3304,2,7200,1.00453995157
80433,80452,83851,19,3399,2,7200,1.00558987938
80449,80459,83859,10,3400,2,7200,1.00294117647
80450,80464,83746,14,3282,2,7200,1.00426569165
80465,80472,84019,7,3547,2,7200,1.00197349873
80466,80479,83813,13,3334,2,7200,1.00389922016
80482,80488,84096,6,3608,2,7200,1.00166297118
80483,80495,83706,12,3211,2,7200,1.00373715353
80484,80500,83744,16,3244,2,7200,1.00493218249
80508,80515,83992,7,3477,2,7200,1.0020132298
80510,80521,84038,11,3517,2,7200,1.00312766562
80525,80531,83890,6,3359,2,7200,1.00178624591
80526,80537,84035,11,3498,2,7200,1.00314465409
80542,80548,84002,6,3454,2,7200,1.00173711639
80543,80554,83932,11,3378,2,7200,1.00325636471
80544,80560,83880,16,3320,2,7200,1.00481927711
80559,80566,84007,7,3441,2,7200,1.00203429236
80574,80581,84056,7,3475,2,7200,1.00201438849
80576,80586,84173,10,3587,2,7200,1.002787845
80600,80606,83779,6,3173,2,7200,1.00189095493
80615,80621,83933,6,3312,2,7200,1.0018115942
80648,80654,83973,6,3319,2,7200,1.00180777343
80663,80669,84087,6,3418,2,7200,1.00175541252
80678,80684,84065,6,3381,2,7200,1.00177462289
80679,80691,84091,12,3400,2,7200,1.00352941176
80694,80701,84159,7,3458,2,7200,1.0020242915
80696,80708,84169,12,3461,2,7200,1.00346720601
80711,80717,83983,6,3266,2,7200,1.00183710961
80762,80768,83949,6,3181,2,7200,1.00188619931
80850,80856,84295,6,3439,2,7200,1.00174469322
80889,80895,84256,6,3361,2,7200,1.00178518298
80910,80916,84266,6,3350,2,7200,1.00179104478
80926,80932,84598,6,3666,2,7200,1.00163666121
81095,81102,84613,7,3511,2,7200,1.00199373398
81356,81363,84613,7,3250,2,7200,1.00215384615
81414,81420,84787,6,3367,2,7200,1.00178200178
81583,81589,85213,6,3624,2,7200,1.00165562914
81668,81674,85076,6,3402,2,7200,1.00176366843
81719,81725,85474,6,3749,2,7200,1.00160042678
81739,81745,85409,6,3664,2,7200,1.00163755459
82154,82160,85493,6,3333,2,7200,1.00180018002
82462,82469,85959,7,3490,2,7200,1.00200573066
82568,82574,85935,6,3361,2,7200,1.00178518298
82587,82593,85630,6,3037,2,7200,1.00197563385
82610,82617,86049,7,3432,2,7200,1.00203962704
82623,82629,84990,6,2361,1,7200,1.00254129606
82695,82701,86126,6,3425,2,7200,1.00175182482
82785,82792,86208,7,3416,2,7200,1.00204918033
82837,82843,85928,6,3085,2,7200,1.00194489465
82864,82870,86211,6,3341,2,7200,1.0017958695
82930,82937,86282,7,3345,2,7200,1.00209267564
82964,82970,86329,6,3359,2,7200,1.00178624591
82991,82997,86359,6,3362,2,7200,1.00178465199
83006,83013,86463,7,3450,2,7200,1.00202898551
83057,83063,86495,6,3432,2,7200,1.00174825175
83081,83087,86449,6,3362,2,7200,1.00178465199
83102,83108,86647,6,3539,2,7200,1.00169539418
83135,83142,86483,7,3341,2,7200,1.00209518108
83151,83157,86539,6,3382,2,7200,1.00177409817
83152,83163,86771,11,3608,2,7200,1.00304878049
83153,83169,86580,16,3411,2,7200,1.00469070654
83170,83176,86597,6,3421,2,7200,1.00175387314
83185,83191,86336,6,3145,2,7200,1.00190779014
83200,83206,86589,6,3383,2,7200,1.00177357375
83215,83221,86818,6,3597,2,7200,1.00166805671
83245,83252,86788,7,3536,2,7200,1.00197963801
83284,83290,86723,6,3433,2,7200,1.0017477425
83299,83305,86910,6,3605,2,7200,1.00166435506
83314,83320,86797,6,3477,2,7200,1.00172562554
83335,83341,86720,6,3379,2,7200,1.00177567328
83368,83374,86813,6,3439,2,7200,1.00174469322
83383,83389,86695,6,3306,2,7200,1.00181488203
83438,83444,86894,6,3450,2,7200,1.00173913043
83453,83459,86938,6,3479,2,7200,1.00172463352
83468,83474,86853,6,3379,2,7200,1.00177567328
83469,83481,86837,12,3356,2,7200,1.00357568534
83485,83491,86859,6,3368,2,7200,1.00178147268
83499,83506,86975,7,3469,2,7200,1.00201787259
83514,83521,86955,7,3434,2,7200,1.00203843914
83557,83563,86860,6,3297,2,7200,1.00181983621
83559,83571,87009,12,3438,2,7200,1.0034904014
83577,83583,87202,6,3619,2,7200,1.00165791655
83591,83598,86996,7,3398,2,7200,1.00206003531
83607,83613,87214,6,3601,2,7200,1.00166620383
83608,83619,86999,11,3380,2,7200,1.00325443787
83644,83650,86963,6,3313,2,7200,1.00181104739
83659,83666,87159,7,3493,2,7200,1.00200400802
83661,83672,87313,11,3641,2,7200,1.00302114804
83707,83713,87065,6,3352,2,7200,1.00178997613
83722,83728,87188,6,3460,2,7200,1.00173410405
83737,83743,87172,6,3429,2,7200,1.00174978128
83752,83758,87336,6,3578,2,7200,1.00167691448
83753,83764,87174,11,3410,2,7200,1.00322580645
83755,83769,87144,14,3375,2,7200,1.00414814815
83756,83775,87116,19,3341,2,7200,1.00568692008
83757,83780,86979,23,3199,2,7200,1.0071897468
83773,83786,87313,13,3527,2,7200,1.003685852
83788,83793,87057,5,3264,2,7200,1.00153186275
83789,83801,87056,12,3255,2,7200,1.00368663594
83815,83822,87494,7,3672,2,7200,1.00190631808
83817,83828,87300,11,3472,2,7200,1.00316820276
83853,83859,87288,6,3429,2,7200,1.00174978128
83868,83874,87415,6,3541,2,7200,1.0016944366
83870,83880,87310,10,3430,2,7200,1.0029154519
83885,83891,87213,6,3322,2,7200,1.00180614088
83900,83906,87152,6,3246,2,7200,1.00184842884
83901,83913,87356,12,3443,2,7200,1.00348533256
83916,83923,87193,7,3270,2,7200,1.00214067278
83931,83937,87369,6,3432,2,7200,1.00174825175
83933,83943,87134,10,3191,2,7200,1.00313381385
83948,83954,87685,6,3731,2,7200,1.00160814795
83949,83960,87202,11,3242,2,7200,1.0033929673
83951,83966,87384,15,3418,2,7200,1.0043885313
83966,83972,87357,6,3385,2,7200,1.00177252585
83982,83988,87539,6,3551,2,7200,1.00168966488
83983,83994,87390,11,3396,2,7200,1.00323910483
83984,84000,87413,16,3413,2,7200,1.00468795781
83999,84007,87542,8,3535,2,7200,1.00226308345
84001,84013,87586,12,3573,2,7200,1.00335852225
84016,84022,87575,6,3553,2,7200,1.00168871376
84018,84029,87387,11,3358,2,7200,1.00327575938
84033,84039,87434,6,3395,2,7200,1.00176730486
84048,84054,87484,6,3430,2,7200,1.00174927114
84049,84061,87355,12,3294,2,7200,1.00364298725
84051,84066,87619,15,3553,2,7200,1.00422178441
84066,84073,87705,7,3632,2,7200,1.00192731278
84067,84079,87580,12,3501,2,7200,1.00342759212
84082,84088,87604,6,3516,2,7200,1.00170648464
84097,84104,87475,7,3371,2,7200,1.00207653515
84099,84110,87710,11,3600,2,7200,1.00305555556
84100,84117,87547,17,3430,2,7200,1.00495626822
84161,84167,87711,6,3544,2,7200,1.00169300226
84176,84182,87586,6,3404,2,7200,1.0017626322
84177,84188,87609,11,3421,2,7200,1.00321543408
84256,84262,87826,6,3564,2,7200,1.00168350168
84269,84275,87796,6,3521,2,7200,1.00170406135
84296,84302,87419,6,3117,2,7200,1.00192492782
84600,84607,87753,7,3146,2,7200,1.00222504768
84615,84628,88077,13,3449,2,7200,1.00376920847
84617,84622,88064,5,3442,2,7200,1.00145264381
84788,84796,88280,8,3484,2,7200,1.00229621125
85077,85083,88452,6,3369,2,7200,1.0017809439
85216,85222,88761,6,3539,2,7200,1.00169539418
85412,85418,88763,6,3345,2,7200,1.00179372197
85476,85482,88807,6,3325,2,7200,1.00180451128
85494,85500,88899,6,3399,2,7200,1.00176522507
85633,85639,89025,6,3386,2,7200,1.00177200236
85928,85934,89270,6,3336,2,7200,1.00179856115
85943,85949,89475,6,3526,2,7200,1.00170164492
85960,85967,89534,7,3567,2,7200,1.00196243342
86052,86059,89590,7,3531,2,7200,1.00198244123
86127,86134,89451,7,3317,2,7200,1.00211034067
86209,86215,89538,6,3323,2,7200,1.00180559735
86224,86230,89917,6,3687,2,7200,1.0016273393
86284,86290,89697,6,3407,2,7200,1.00176108013
86330,86336,89823,6,3487,2,7200,1.0017206768
86345,86351,89773,6,3422,2,7200,1.00175336061
86360,86366,89712,6,3346,2,7200,1.00179318589
86450,86458,90122,8,3664,2,7200,1.00218340611
86465,86471,89849,6,3378,2,7200,1.00177619893
86483,86490,90135,7,3645,2,7200,1.00192043896
86498,86505,89967,7,3462,2,7200,1.00202195263
86541,86548,89778,7,3230,2,7200,1.00216718266
86583,86589,89946,6,3357,2,7200,1.0017873101
86598,86605,90004,7,3399,2,7200,1.00205942924
86599,86612,90044,13,3432,2,7200,1.00378787879
86648,86654,90052,6,3398,2,7200,1.00176574456
86696,86702,90006,6,3304,2,7200,1.00181598063
86720,86726,90317,6,3591,2,7200,1.00167084378
86735,86742,90039,7,3297,2,7200,1.00212314225
86771,86777,90154,6,3377,2,7200,1.0017767249
86789,86795,90337,6,3542,2,7200,1.00169395822
86804,86811,90316,7,3505,2,7200,1.00199714693
86820,86826,90036,6,3210,2,7200,1.00186915888
86821,86833,90220,12,3387,2,7200,1.00354295837
86839,86845,90289,6,3444,2,7200,1.00174216028
86854,86860,90215,6,3355,2,7200,1.00178837556
86869,86875,90104,6,3229,2,7200,1.00185816042
86871,86882,90209,11,3327,2,7200,1.00330628194
86895,86901,90467,6,3566,2,7200,1.00168255749
86909,86916,90343,7,3427,2,7200,1.00204260286
86940,86946,90361,6,3415,2,7200,1.00175695461
86958,86964,90214,6,3250,2,7200,1.00184615385
86973,86980,90292,7,3312,2,7200,1.00211352657
86988,86994,90400,6,3406,2,7200,1.00176159718
86989,87000,90366,11,3366,2,7200,1.00326797386
87004,87010,90337,6,3327,2,7200,1.00180342651
87006,87016,90458,10,3442,2,7200,1.00290528762
87021,87027,90452,6,3425,2,7200,1.00175182482
87057,87064,90421,7,3357,2,7200,1.00208519511
87058,87071,90517,13,3446,2,7200,1.00377248984
87073,87079,90510,6,3431,2,7200,1.00174876129
87116,87122,90577,6,3455,2,7200,1.0017366136
87134,87140,90599,6,3459,2,7200,1.00173460538
87149,87155,90585,6,3430,2,7200,1.00174927114
87164,87171,90382,7,3211,2,7200,1.00218000623
87165,87178,90583,13,3405,2,7200,1.00381791483
87180,87187,90635,7,3448,2,7200,1.00203016241
87182,87193,90546,11,3353,2,7200,1.0032806442
87197,87203,90792,6,3589,2,7200,1.00167177487
87199,87209,90560,10,3351,2,7200,1.00298418383
87214,87220,90598,6,3378,2,7200,1.00177619893
87215,87227,90698,12,3471,2,7200,1.00345721694
87217,87232,90679,15,3447,2,7200,1.0043516101
87218,87237,90543,19,3306,2,7200,1.00574712644
87288,87294,90682,6,3388,2,7200,1.00177095632
87303,87309,90534,6,3225,2,7200,1.00186046512
87318,87324,90790,6,3466,2,7200,1.00173110214
87320,87330,90766,10,3436,2,7200,1.00291036088
87321,87336,90535,15,3199,2,7200,1.0046889653
87336,87342,90789,6,3447,2,7200,1.00174064404
87358,87364,90793,6,3429,2,7200,1.00174978128
87359,87370,90816,11,3446,2,7200,1.00319210679
87360,87376,90615,16,3239,2,7200,1.00493979623
87375,87383,90666,8,3283,2,7200,1.00243679561
87391,87398,90805,7,3407,2,7200,1.00205459348
87392,87404,90852,12,3448,2,7200,1.00348027842
87394,87410,90743,16,3333,2,7200,1.00480048005
87415,87421,90590,6,3169,2,7200,1.00189334175
87417,87428,90702,11,3274,2,7200,1.00335980452
87432,87438,90823,6,3385,2,7200,1.00177252585
87447,87453,90975,6,3522,2,7200,1.00170357751
87477,87483,91008,6,3525,2,7200,1.00170212766
87492,87498,90991,6,3493,2,7200,1.00171772116
87507,87514,91072,7,3558,2,7200,1.00196739741
87540,87547,91078,7,3531,2,7200,1.00198244123
87542,87554,91158,12,3604,2,7200,1.00332963374
87557,87563,90980,6,3417,2,7200,1.00175592625
87575,87581,90932,6,3351,2,7200,1.0017905103
87590,87597,90906,7,3309,2,7200,1.00211544273
87592,87603,90924,11,3321,2,7200,1.00331225534
87593,87609,91013,16,3404,2,7200,1.00470035253
87608,87615,91097,7,3482,2,7200,1.00201033889
87623,87629,91162,6,3533,2,7200,1.00169827342
87625,87636,91165,11,3529,2,7200,1.00311703032
87685,87691,90912,6,3221,2,7200,1.00186277554
87706,87712,90890,6,3178,2,7200,1.00188797986
87721,87728,91136,7,3408,2,7200,1.00205399061
87723,87734,91135,11,3401,2,7200,1.00323434284
87753,87759,91227,6,3468,2,7200,1.00173010381
87799,87805,91209,6,3404,2,7200,1.0017626322
87829,87835,91159,6,3324,2,7200,1.00180505415
88065,88071,91525,6,3454,2,7200,1.00173711639
88078,88084,91711,6,3627,2,7200,1.00165425972
88281,88288,91748,7,3460,2,7200,1.00202312139
88453,88459,91669,6,3210,2,7200,1.00186915888
88761,88767,92269,6,3502,2,7200,1.00171330668
88765,88774,92183,9,3409,2,7200,1.0026400704
88809,88816,92307,7,3491,2,7200,1.00200515612
88900,88906,92396,6,3490,2,7200,1.00171919771
89028,89034,92350,6,3316,2,7200,1.00180940893
89272,89278,92785,6,3507,2,7200,1.00171086399
89453,89459,92906,6,3447,2,7200,1.00174064404
89477,89484,92740,7,3256,2,7200,1.00214987715
89535,89541,92978,6,3437,2,7200,1.00174570847
89550,89556,92898,6,3342,2,7200,1.00179533214
89592,89598,93186,6,3588,2,7200,1.0016722408
89698,89704,93046,6,3342,2,7200,1.00179533214
89713,89721,93237,8,3516,2,7200,1.00227531286
89774,89780,93284,6,3504,2,7200,1.00171232877
89789,89795,93181,6,3386,2,7200,1.00177200236
89825,89832,93280,7,3448,2,7200,1.00203016241
89849,89856,93255,7,3399,2,7200,1.00205942924
89919,89925,93331,6,3406,2,7200,1.00176159718
89946,89952,93238,6,3286,2,7200,1.00182592818
89967,89974,93336,7,3362,2,7200,1.00208209399
90007,90013,93601,6,3588,2,7200,1.0016722408
90008,90020,93587,12,3567,2,7200,1.00336417157
90039,90045,93318,6,3273,2,7200,1.00183318057
90040,90052,93634,12,3582,2,7200,1.00335008375
90055,90061,93477,6,3416,2,7200,1.00175644028
90056,90067,93311,11,3244,2,7200,1.00339087546
90105,90111,93694,6,3583,2,7200,1.00167457438
90123,90130,93464,7,3334,2,7200,1.00209958008
90138,90145,93489,7,3344,2,7200,1.00209330144
90156,90163,93365,7,3202,2,7200,1.00218613367
90211,90217,93487,6,3270,2,7200,1.00183486239
90226,90232,93594,6,3362,2,7200,1.00178465199
90227,90238,93665,11,3427,2,7200,1.00320980449
90229,90244,93650,15,3406,2,7200,1.00440399295
90290,90296,93505,6,3209,2,7200,1.00186974135
90304,90311,93616,7,3305,2,7200,1.00211800303
90320,90326,93685,6,3359,2,7200,1.00178624591
90321,90334,93739,13,3405,2,7200,1.00381791483
90339,90345,93680,6,3335,2,7200,1.00179910045
90340,90352,93938,12,3586,2,7200,1.0033463469
90355,90361,93679,6,3318,2,7200,1.00180831826
90370,90376,93957,6,3581,2,7200,1.00167550963
90372,90383,93882,11,3499,2,7200,1.00314375536
90387,90394,93960,7,3566,2,7200,1.00196298374
90401,90408,93893,7,3485,2,7200,1.00200860832
90422,90429,93883,7,3454,2,7200,1.00202663578
90453,90459,93892,6,3433,2,7200,1.0017477425
90468,90474,93784,6,3310,2,7200,1.00181268882
90469,90481,93890,12,3409,2,7200,1.00352009387
90511,90518,93975,7,3457,2,7200,1.00202487706
90526,90532,93807,6,3275,2,7200,1.00183206107
90541,90548,93902,7,3354,2,7200,1.00208706023
90543,90555,94158,12,3603,2,7200,1.00333055787
90558,90565,93937,7,3372,2,7200,1.00207591934
90559,90571,94022,12,3451,2,7200,1.00347725297
90574,90580,93853,6,3273,2,7200,1.00183318057
90590,90596,94040,6,3444,2,7200,1.00174216028
90591,90603,94008,12,3405,2,7200,1.00352422907
90592,90608,94007,16,3399,2,7200,1.00470726684
90594,90613,94063,19,3450,2,7200,1.00550724638
90609,90619,94046,10,3427,2,7200,1.00291800409
90610,90625,94074,15,3449,2,7200,1.00434908669
90625,90631,94058,6,3427,2,7200,1.00175080245
90640,90647,94216,7,3569,2,7200,1.00196133371
90667,90673,93947,6,3274,2,7200,1.00183262065
90682,90688,94003,6,3315,2,7200,1.00180995475
90684,90694,94186,10,3492,2,7200,1.00286368843
90699,90705,94095,6,3390,2,7200,1.0017699115
90714,90720,94135,6,3415,2,7200,1.00175695461
90744,90750,94198,6,3448,2,7200,1.00174013921
90765,90772,94217,7,3445,2,7200,1.00203193033
90790,90797,94392,7,3595,2,7200,1.00194714882
90792,90803,94255,11,3452,2,7200,1.00318655852
90793,90808,94346,15,3538,2,7200,1.00423968344
90794,90813,94277,19,3464,2,7200,1.00548498845
90809,90820,94389,11,3569,2,7200,1.00308209583
90824,90831,94136,7,3305,2,7200,1.00211800303
90826,90839,94301,13,3462,2,7200,1.00375505488
90853,90859,94560,6,3701,2,7200,1.00162118346
90892,90898,94310,6,3412,2,7200,1.00175849941
90907,90913,94291,6,3378,2,7200,1.00177619893
90922,90928,94491,6,3563,2,7200,1.00168397418
90937,90943,94391,6,3448,2,7200,1.00174013921
90939,90949,94252,10,3303,2,7200,1.00302755071
90978,90984,94248,6,3264,2,7200,1.00183823529
90993,91000,94258,7,3258,2,7200,1.0021485574
90994,91007,94400,13,3393,2,7200,1.00383141762
91009,91016,94618,7,3602,2,7200,1.0019433648
91024,91030,94442,6,3412,2,7200,1.00175849941
91073,91079,94615,6,3536,2,7200,1.00169683258
91088,91094,94785,6,3691,2,7200,1.00162557572
91103,91109,94667,6,3558,2,7200,1.00168634064
91136,91142,94485,6,3343,2,7200,1.00179479509
91151,91157,94591,6,3434,2,7200,1.00174723355
91167,91174,94470,7,3296,2,7200,1.00212378641
91168,91180,94627,12,3447,2,7200,1.00348128808
91169,91186,95016,17,3830,2,7200,1.0044386423
91170,91191,94596,21,3405,2,7200,1.00616740088
91213,91219,94650,6,3431,2,7200,1.00174876129
91228,91234,94883,6,3649,2,7200,1.00164428611
91527,91534,95016,7,3482,2,7200,1.00201033889
91671,91678,95254,7,3576,2,7200,1.00195749441
91713,91720,95304,7,3584,2,7200,1.001953125
91750,91756,95210,6,3454,2,7200,1.00173711639
92184,92189,95753,5,3564,2,7200,1.00140291807
92270,92276,95649,6,3373,2,7200,1.0017788319
92309,92315,95626,6,3311,2,7200,1.00181214135
92353,92359,95855,6,3496,2,7200,1.00171624714
92397,92403,95827,6,3424,2,7200,1.00175233645
92741,92748,96553,7,3805,2,7200,1.00183968463
92786,92792,96273,6,3481,2,7200,1.00172364263
92898,92904,96391,6,3487,2,7200,1.0017206768
92913,92919,96250,6,3331,2,7200,1.00180126088
92979,92985,96316,6,3331,2,7200,1.00180126088
93046,93052,96316,6,3264,2,7200,1.00183823529
93182,93188,96773,6,3585,2,7200,1.00167364017
93196,93204,96577,8,3373,2,7200,1.00237177587
93239,93246,96614,7,3368,2,7200,1.0020783848
93240,93253,96691,13,3438,2,7200,1.00378126818
93255,93262,96632,7,3370,2,7200,1.00207715134
93280,93286,96672,6,3386,2,7200,1.00177200236
93294,93301,96711,7,3410,2,7200,1.00205278592
93313,93319,96636,6,3317,2,7200,1.00180886343
93328,93334,96816,6,3482,2,7200,1.00172314762
93343,93349,96804,6,3455,2,7200,1.0017366136
93344,93355,96700,11,3345,2,7200,1.00328849028
93365,93371,96789,6,3418,2,7200,1.00175541252
93465,93472,96913,7,3441,2,7200,1.00203429236
93480,93486,96879,6,3393,2,7200,1.0017683466
93495,93501,96784,6,3283,2,7200,1.00182759671
93496,93507,96992,11,3485,2,7200,1.00315638451
93511,93518,97216,7,3698,2,7200,1.00189291509
93587,93594,97124,7,3530,2,7200,1.00198300283
93602,93608,97033,6,3425,2,7200,1.00175182482
93604,93614,97236,10,3622,2,7200,1.00276090558
93619,93626,96949,7,3323,2,7200,1.00210653024
93637,93643,97179,6,3536,2,7200,1.00169683258
93652,93659,96750,7,3091,2,7200,1.00226463928
93667,93674,96996,7,3322,2,7200,1.00210716436
93682,93688,97084,6,3396,2,7200,1.00176678445
93683,93695,97196,12,3501,2,7200,1.00342759212
93699,93705,97139,6,3434,2,7200,1.00174723355
93700,93713,97035,13,3322,2,7200,1.00391330524
93740,93747,96926,7,3179,2,7200,1.0022019503
93785,93792,97310,7,3518,2,7200,1.00198976691
93809,93815,97205,6,3390,2,7200,1.0017699115
93855,93861,97517,6,3656,2,7200,1.00164113786
93882,93889,97319,7,3430,2,7200,1.00204081633
93883,93895,97406,12,3511,2,7200,1.00341782968
93899,93905,97102,6,3197,2,7200,1.00187675946
93900,93912,97204,12,3292,2,7200,1.00364520049
93901,93918,97399,17,3481,2,7200,1.00488365412
93916,93924,97332,8,3408,2,7200,1.00234741784
93934,93942,97534,8,3592,2,7200,1.00222717149
93936,93947,97503,11,3556,2,7200,1.00309336333
93951,93957,97341,6,3384,2,7200,1.00177304965
93966,93972,97355,6,3383,2,7200,1.00177357375
93968,93979,97358,11,3379,2,7200,1.00325540101
93982,93989,97621,7,3632,2,7200,1.00192731278
94004,94010,97442,6,3432,2,7200,1.00174825175
94019,94025,97285,6,3260,2,7200,1.0018404908
94020,94031,97346,11,3315,2,7200,1.00331825038
94035,94041,97460,6,3419,2,7200,1.00175489909
94050,94057,97407,7,3350,2,7200,1.00208955224
94052,94063,97386,11,3323,2,7200,1.00331026181
94067,94074,97490,7,3416,2,7200,1.00204918033
94069,94080,97546,11,3466,2,7200,1.00317368725
94083,94090,97508,7,3418,2,7200,1.00204798128
94098,94105,97539,7,3434,2,7200,1.00203843914
94135,94141,97623,6,3482,2,7200,1.00172314762
94136,94147,97382,11,3235,2,7200,1.00340030912
94160,94166,97561,6,3395,2,7200,1.00176730486
94188,94194,97599,6,3405,2,7200,1.00176211454
94203,94209,97677,6,3468,2,7200,1.00173010381
94218,94225,97660,7,3435,2,7200,1.00203784571
94220,94232,97606,12,3374,2,7200,1.00355660937
94250,94256,97602,6,3346,2,7200,1.00179318589
94265,94271,97872,6,3601,2,7200,1.00166620383
94267,94279,97676,12,3397,2,7200,1.0035325287
94268,94284,97827,16,3543,2,7200,1.00451594694
94283,94290,97557,7,3267,2,7200,1.00214263851
94298,94304,98001,6,3697,2,7200,1.00162293752
94313,94319,97903,6,3584,2,7200,1.00167410714
94315,94326,97823,11,3497,2,7200,1.00314555333
94348,94354,97904,6,3550,2,7200,1.00169014085
94384,94390,97758,6,3368,2,7200,1.00178147268
94400,94406,98021,6,3615,2,7200,1.00165975104
94401,94414,98006,13,3592,2,7200,1.00361915367
94402,94419,97969,17,3550,2,7200,1.00478873239
94445,94451,97786,6,3335,2,7200,1.00179910045
94472,94478,97824,6,3346,2,7200,1.00179318589
94487,94493,97832,6,3339,2,7200,1.00179694519
94502,94508,97882,6,3374,2,7200,1.00177830468
94562,94569,98060,7,3491,2,7200,1.00200515612
94593,94599,98116,6,3517,2,7200,1.00170599943
94608,94614,98045,6,3431,2,7200,1.00174876129
94623,94629,98229,6,3600,2,7200,1.00166666667
94624,94635,98047,11,3412,2,7200,1.00322391559
94639,94645,98281,6,3636,2,7200,1.00165016502
94654,94660,97966,6,3306,2,7200,1.00181488203
94669,94675,97950,6,3275,2,7200,1.00183206107
94785,94791,98211,6,3420,2,7200,1.00175438596
94809,94815,99059,6,4244,1,14400,1.0014137606
94885,94891,98316,6,3425,2,7200,1.00175182482
95016,95022,98671,6,3649,2,7200,1.00164428611
95019,95028,98462,9,3434,2,7200,1.00262085032
95210,95216,98597,6,3381,2,7200,1.00177462289
95255,95261,98660,6,3399,2,7200,1.00176522507
95306,95313,98812,7,3499,2,7200,1.00200057159
95364,95370,95541,6,171,1,3600,1.0350877193
95628,95634,99248,6,3614,2,7200,1.00166021029
95649,95655,99238,6,3583,2,7200,1.00167457438
95751,95758,99017,7,3259,2,7200,1.00214789813
95828,95834,99256,6,3422,2,7200,1.00175336061
95857,95864,99454,7,3590,2,7200,1.00194986072
95925,95930,97726,5,1796,1,3600,1.00278396437
96252,96258,99802,6,3544,2,7200,1.00169300226
96273,96279,99497,6,3218,2,7200,1.00186451212
96318,96324,99635,6,3311,2,7200,1.00181214135
96320,96330,99772,10,3442,2,7200,1.00290528762
96392,96398,99674,6,3276,2,7200,1.00183150183
96553,96559,100117,6,3558,2,7200,1.00168634064
96577,96583,99920,6,3337,2,7200,1.00179802218
96617,96624,99987,7,3363,2,7200,1.00208147487
96635,96641,100059,6,3418,2,7200,1.00175541252
96650,96656,100034,6,3378,2,7200,1.00177619893
96674,96681,100282,7,3601,2,7200,1.00194390447
96692,96698,100016,6,3318,2,7200,1.00180831826
96707,96713,100307,6,3594,2,7200,1.00166944908
96722,96728,100272,6,3544,2,7200,1.00169300226
96749,96756,100214,7,3458,2,7200,1.0020242915
96773,96780,100391,7,3611,2,7200,1.00193852119
96789,96795,100110,6,3315,2,7200,1.00180995475
96790,96801,99984,11,3183,2,7200,1.00345585925
96805,96811,100169,6,3358,2,7200,1.00178677784
96820,96826,100517,6,3691,2,7200,1.00162557572
96880,96888,100131,8,3243,2,7200,1.00246685168
96914,96920,100239,6,3319,2,7200,1.00180777343
96929,96935,100444,6,3509,2,7200,1.00170988886
96950,96956,100322,6,3366,2,7200,1.00178253119
96992,96998,100374,6,3376,2,7200,1.00177725118
97007,97013,100439,6,3426,2,7200,1.00175131349
97035,97041,100447,6,3406,2,7200,1.00176159718
97036,97048,100516,12,3468,2,7200,1.00346020761
97085,97091,100342,6,3251,2,7200,1.00184558597
97103,97109,100563,6,3454,2,7200,1.00173711639
97124,97131,100382,7,3251,2,7200,1.00215318364
97142,97148,100595,6,3447,2,7200,1.00174064404
97181,97187,100714,6,3527,2,7200,1.00170116246
97199,97205,100557,6,3352,2,7200,1.00178997613
97216,97222,100630,6,3408,2,7200,1.00176056338
97217,97229,100746,12,3517,2,7200,1.00341199886
97218,97234,100641,16,3407,2,7200,1.00469621368
97237,97243,100695,6,3452,2,7200,1.00173812283
97285,97291,100721,6,3430,2,7200,1.00174927114
97312,97320,100884,8,3564,2,7200,1.00224466891
97327,97333,100684,6,3351,2,7200,1.0017905103
97342,97350,100585,8,3235,2,7200,1.00247295209
97344,97356,100705,12,3349,2,7200,1.00358315915
97359,97367,100664,8,3297,2,7200,1.00242644829
97361,97372,100869,11,3497,2,7200,1.00314555333
97362,97378,100817,16,3439,2,7200,1.00465251527
97383,97389,100607,6,3218,2,7200,1.00186451212
97398,97404,100814,6,3410,2,7200,1.00175953079
97400,97410,100871,10,3461,2,7200,1.00288933834
97415,97421,100976,6,3555,2,7200,1.00168776371
97417,97428,100853,11,3425,2,7200,1.00321167883
97444,97450,100971,6,3521,2,7200,1.00170406135
97462,97468,101200,6,3732,2,7200,1.00160771704
97492,97498,101210,6,3712,2,7200,1.00161637931
97507,97513,101063,6,3550,2,7200,1.00169014085
97508,97519,101328,11,3809,2,7200,1.00288789709
97524,97530,101073,6,3543,2,7200,1.0016934801
97539,97546,100939,7,3393,2,7200,1.00206307103
97540,97553,101063,13,3510,2,7200,1.0037037037
97555,97561,101182,6,3621,2,7200,1.00165700083
97570,97577,100999,7,3422,2,7200,1.00204558738
97572,97583,101011,11,3428,2,7200,1.00320886814
97599,97605,100882,6,3277,2,7200,1.00183094294
97614,97620,100894,6,3274,2,7200,1.00183262065
97616,97626,101233,10,3607,2,7200,1.00277238703
97631,97637,101035,6,3398,2,7200,1.00176574456
97632,97643,101118,11,3475,2,7200,1.00316546763
97659,97665,101256,6,3591,2,7200,1.00167084378
97678,97684,100858,6,3174,2,7200,1.00189035917
97679,97691,101011,12,3320,2,7200,1.00361445783
97758,97764,101306,6,3542,2,7200,1.00169395822
97788,97794,101392,6,3598,2,7200,1.00166759311
97822,97829,101112,7,3283,2,7200,1.00213219616
97823,97836,101311,13,3475,2,7200,1.00374100719
97838,97844,101303,6,3459,2,7200,1.00173460538
97840,97852,101177,12,3325,2,7200,1.00360902256
97873,97879,101198,6,3319,2,7200,1.00180777343
97888,97895,101267,7,3372,2,7200,1.00207591934
97906,97912,101263,6,3351,2,7200,1.0017905103
97908,97919,101198,11,3279,2,7200,1.00335468131
97950,97956,101395,6,3439,2,7200,1.00174469322
97970,97976,101590,6,3614,2,7200,1.00166021029
97971,97984,101383,13,3399,2,7200,1.00382465431
98001,98007,101454,6,3447,2,7200,1.00174064404
98016,98022,101435,6,3413,2,7200,1.00175798418
98031,98037,101569,6,3532,2,7200,1.00169875425
98046,98052,101312,6,3260,2,7200,1.0018404908
98048,98059,101263,11,3204,2,7200,1.00343320849
98063,98070,101446,7,3376,2,7200,1.00207345972
98087,98093,100556,6,2463,1,3600,1.00243605359
98117,98123,101457,6,3334,2,7200,1.00179964007
98211,98217,101549,6,3332,2,7200,1.00180072029
98229,98235,101634,6,3399,2,7200,1.00176522507
98284,98290,101631,6,3341,2,7200,1.0017958695
98317,98323,101547,6,3224,2,7200,1.00186104218
98463,98469,101681,6,3212,2,7200,1.00186799502
98599,98606,101962,7,3356,2,7200,1.00208581645
98659,98666,101919,7,3253,2,7200,1.00215185982
98674,98681,101988,7,3307,2,7200,1.0021167221
98814,98821,102318,7,3497,2,7200,1.00200171576
99019,99026,102570,7,3544,2,7200,1.0019751693
99240,99246,103049,6,3803,2,7200,1.00157770181
99255,99262,102766,7,3504,2,7200,1.00199771689
99257,99269,102706,12,3437,2,7200,1.00349141693
99456,99463,103144,7,3681,2,7200,1.00190165716
99499,99505,103016,6,3511,2,7200,1.00170891484
99638,99644,103043,6,3399,2,7200,1.00176522507
99674,99680,103070,6,3390,2,7200,1.0017699115
99773,99780,103287,7,3507,2,7200,1.00199600798
99804,99810,102898,6,3088,2,7200,1.00194300518
99921,99929,103268,8,3339,2,7200,1.00239592692
99985,99991,103402,6,3411,2,7200,1.00175901495
100000,100006,103479,6,3473,2,7200,1.00172761301
100015,100021,103575,6,3554,2,7200,1.0016882386
100036,100043,103388,7,3345,2,7200,1.00209267564
100047,100054,100869,7,815,1,3600,1.00858895706
100060,100066,103464,6,3398,2,7200,1.00176574456
100111,100117,103477,6,3360,2,7200,1.00178571429
100126,100132,103495,6,3363,2,7200,1.00178412132
100141,100147,103546,6,3399,2,7200,1.00176522507
100168,100175,103821,7,3646,2,7200,1.00191991223
100214,100221,103705,7,3484,2,7200,1.00200918485
100241,100247,103401,6,3154,2,7200,1.00190234623
100274,100280,103685,6,3405,2,7200,1.00176211454
100289,100295,103863,6,3568,2,7200,1.00168161435
100307,100314,103649,7,3335,2,7200,1.00209895052
100322,100328,103866,6,3538,2,7200,1.00169587337
100343,100349,103896,6,3547,2,7200,1.00169157034
100377,100383,103769,6,3386,2,7200,1.00177200236
100392,100398,103921,6,3523,2,7200,1.00170309395
100394,100404,104009,10,3605,2,7200,1.0027739251
100442,100448,103773,6,3325,2,7200,1.00180451128
100512,100517,103908,5,3391,2,7200,1.0014744913
100513,100523,103900,10,3377,2,7200,1.00296120817
100528,100534,103935,6,3401,2,7200,1.001764187
100529,100540,103968,11,3428,2,7200,1.00320886814
100560,100566,104155,6,3589,2,7200,1.00167177487
100575,100581,104078,6,3497,2,7200,1.00171575636
100590,100596,104267,6,3671,2,7200,1.00163443203
100605,100611,104295,6,3684,2,7200,1.0016286645
100619,100626,104048,7,3422,2,7200,1.00204558738
100635,100641,104086,6,3445,2,7200,1.00174165457
100650,100656,104058,6,3402,2,7200,1.00176366843
100665,100671,104164,6,3493,2,7200,1.00171772116
100686,100692,104421,6,3729,2,7200,1.00160901046
100701,100706,104270,5,3564,2,7200,1.00140291807
100716,100722,104143,6,3421,2,7200,1.00175387314
100717,100730,104026,13,3296,2,7200,1.00394417476
100732,100738,104103,6,3365,2,7200,1.00178306092
100747,100753,104272,6,3519,2,7200,1.00170502984
100814,100820,104201,6,3381,2,7200,1.00177462289
100829,100835,104246,6,3411,2,7200,1.00175901495
100856,100863,104292,7,3429,2,7200,1.00204141149
100872,100879,104310,7,3431,2,7200,1.00204022151
100873,100886,104428,13,3542,2,7200,1.0036702428
100875,100891,104516,16,3625,2,7200,1.0044137931
100890,100898,104250,8,3352,2,7200,1.00238663484
100891,100903,104312,12,3409,2,7200,1.00352009387
100906,100914,104251,8,3337,2,7200,1.0023973629
100940,100947,104428,7,3481,2,7200,1.0020109164
100973,100980,104313,7,3333,2,7200,1.00210021002
100988,100994,104382,6,3388,2,7200,1.00177095632
101004,101010,104411,6,3401,2,7200,1.001764187
101005,101016,104489,11,3473,2,7200,1.00316729053
101006,101022,104559,16,3537,2,7200,1.00452360758
101038,101044,104654,6,3610,2,7200,1.00166204986
101062,101069,104631,7,3562,2,7200,1.0019651881
101064,101076,104499,12,3423,2,7200,1.00350569676
101079,101085,104497,6,3412,2,7200,1.00175849941
101112,101118,104502,6,3384,2,7200,1.00177304965
101127,101133,104521,6,3388,2,7200,1.00177095632
101177,101183,104672,6,3489,2,7200,1.00171969046
101192,101199,104568,7,3369,2,7200,1.00207776788
101208,101215,104416,7,3201,2,7200,1.00218681662
101209,101221,104664,12,3443,2,7200,1.00348533256
101210,101227,104621,17,3394,2,7200,1.00500883913
101225,101234,104674,9,3440,2,7200,1.00261627907
101241,101248,104639,7,3391,2,7200,1.00206428782
101259,101265,104536,6,3271,2,7200,1.00183430144
101274,101280,104694,6,3414,2,7200,1.00175746924
101275,101286,104850,11,3564,2,7200,1.00308641975
101277,101292,104590,15,3298,2,7200,1.00454821104
101304,101311,104840,7,3529,2,7200,1.00198356475
101319,101326,104748,7,3422,2,7200,1.00204558738
101321,101332,105029,11,3697,2,7200,1.00297538545
101322,101338,104789,16,3451,2,7200,1.00463633729
101337,101344,104831,7,3487,2,7200,1.00200745627
101383,101389,104627,6,3238,2,7200,1.00185299568
101395,101401,102632,6,1231,1,3600,1.00487408611
101398,101407,105042,9,3635,2,7200,1.00247592847
101399,101413,104864,14,3451,2,7200,1.00405679513
101436,101442,104924,6,3482,2,7200,1.00172314762
101451,101457,105023,6,3566,2,7200,1.00168255749
101466,101473,104886,7,3413,2,7200,1.00205098154
101468,101479,104926,11,3447,2,7200,1.00319118074
101550,101556,104957,6,3401,2,7200,1.001764187
101551,101563,104896,12,3333,2,7200,1.00360036004
101569,101576,104937,7,3361,2,7200,1.00208271348
101595,101601,104973,6,3372,2,7200,1.00177935943
101633,101639,105174,6,3535,2,7200,1.00169731259
101648,101654,105250,6,3596,2,7200,1.00166852058
101683,101689,105248,6,3559,2,7200,1.00168586682
101919,101925,105459,6,3534,2,7200,1.00169779287
101965,101971,105302,6,3331,2,7200,1.00180126088
101989,101995,105381,6,3386,2,7200,1.00177200236
102321,102328,105730,7,3402,2,7200,1.00205761317
102571,102578,106078,7,3500,2,7200,1.002
102709,102715,106586,6,3871,2,7200,1.00154998708
102766,102773,106329,7,3556,2,7200,1.00196850394
102899,102905,106252,6,3347,2,7200,1.00179265013
103018,103024,106398,6,3374,2,7200,1.00177830468
103042,103048,106473,6,3425,2,7200,1.00175182482
103057,103063,106447,6,3384,2,7200,1.00177304965
103072,103078,106555,6,3477,2,7200,1.00172562554
103147,103153,106698,6,3545,2,7200,1.00169252468
103268,103274,106488,6,3214,2,7200,1.00186683261
103289,103295,106951,6,3656,2,7200,1.00164113786
103389,103396,106834,7,3438,2,7200,1.00203606748
103404,103411,106740,7,3329,2,7200,1.00210273355
103406,103417,106762,11,3345,2,7200,1.00328849028
103463,103470,106982,7,3512,2,7200,1.00199316629
103479,103485,106923,6,3438,2,7200,1.0017452007
103481,103493,106985,12,3492,2,7200,1.00343642612
103496,103502,106954,6,3452,2,7200,1.00173812283
103547,103553,106924,6,3371,2,7200,1.00177988727
103577,103583,106922,6,3339,2,7200,1.00179694519
103650,103656,106928,6,3272,2,7200,1.00183374083
103686,103692,107020,6,3328,2,7200,1.00180288462
103707,103713,107255,6,3542,2,7200,1.00169395822
103771,103777,107329,6,3552,2,7200,1.00168918919
103786,103792,107303,6,3511,2,7200,1.00170891484
103822,103828,107064,6,3236,2,7200,1.00185414091
103864,103870,107495,6,3625,2,7200,1.00165517241
103879,103885,107436,6,3551,2,7200,1.00168966488
103897,103903,107316,6,3413,2,7200,1.00175798418
103899,103910,107185,11,3275,2,7200,1.00335877863
103914,103921,107345,7,3424,2,7200,1.00204439252
103929,103935,107519,6,3584,2,7200,1.00167410714
103943,103950,107272,7,3322,2,7200,1.00210716436
103970,103982,105304,12,1322,1,3600,1.00907715582
103971,103976,107406,5,3430,2,7200,1.00145772595
104010,104016,107477,6,3461,2,7200,1.001733603
104028,104035,107624,7,3589,2,7200,1.00195040401
104049,104055,107552,6,3497,2,7200,1.00171575636
104064,104070,107559,6,3489,2,7200,1.00171969046
104079,104085,107451,6,3366,2,7200,1.00178253119
104094,104100,107403,6,3303,2,7200,1.00181653043
104109,104115,107537,6,3422,2,7200,1.00175336061
104142,104148,107492,6,3344,2,7200,1.00179425837
104157,104163,107722,6,3559,2,7200,1.00168586682
104171,104178,107865,7,3687,2,7200,1.00189856252
104202,104208,107473,6,3265,2,7200,1.00183767228
104247,104253,107636,6,3383,2,7200,1.00177357375
104262,104268,107810,6,3542,2,7200,1.00169395822
104264,104275,107514,11,3239,2,7200,1.00339610991
104279,104285,107684,6,3399,2,7200,1.00176522507
104280,104291,107833,11,3542,2,7200,1.00310559006
104282,104296,107988,14,3692,2,7200,1.00379198267
104297,104303,107980,6,3677,2,7200,1.00163176503
104298,104310,107630,12,3320,2,7200,1.00361445783
104314,104320,107725,6,3405,2,7200,1.00176211454
104315,104326,107765,11,3439,2,7200,1.00319860425
104317,104332,107926,15,3594,2,7200,1.0041736227
104383,104390,107476,7,3086,2,7200,1.00226830849
104414,104420,108148,6,3728,2,7200,1.00160944206
104429,104436,107847,7,3411,2,7200,1.00205218411
104431,104442,107710,11,3268,2,7200,1.00336597307
104432,104448,108198,16,3750,2,7200,1.00426666667
104433,104453,108114,20,3661,2,7200,1.00546298825
104491,104497,108117,6,3620,2,7200,1.00165745856
104506,104512,108121,6,3609,2,7200,1.00166251039
104507,104518,108123,11,3605,2,7200,1.00305131761
104509,104524,108147,15,3623,2,7200,1.00414021529
104524,104530,108178,6,3648,2,7200,1.00164473684
104525,104537,107808,12,3271,2,7200,1.00366860287
104541,104547,107816,6,3269,2,7200,1.00183542368
104559,104565,107866,6,3301,2,7200,1.00181763102
104574,104581,108229,7,3648,2,7200,1.00191885965
104592,104598,108120,6,3522,2,7200,1.00170357751
104622,104629,108298,7,3669,2,7200,1.00190787681
104638,104645,108119,7,3474,2,7200,1.00201496834
104639,104651,107966,12,3315,2,7200,1.0036199095
104654,104661,107965,7,3304,2,7200,1.00211864407
104656,104667,107983,11,3316,2,7200,1.0033172497
104671,104678,108118,7,3440,2,7200,1.00203488372
104686,104692,108132,6,3440,2,7200,1.00174418605
104687,104699,108117,12,3418,2,7200,1.00351082504
104702,104708,108119,6,3411,2,7200,1.00175901495
104751,104757,108118,6,3361,2,7200,1.00178518298
104790,104797,107867,7,3070,2,7200,1.00228013029
104832,104839,108128,7,3289,2,7200,1.00212830648
104847,104854,108187,7,3333,2,7200,1.00210021002
104862,104869,108121,7,3252,2,7200,1.00215252153
104864,104875,108299,11,3424,2,7200,1.00321261682
104888,104894,108516,6,3622,2,7200,1.00165654335
104903,104910,108436,7,3526,2,7200,1.00198525241
104925,104931,108431,6,3500,2,7200,1.00171428571
104940,104946,108344,6,3398,2,7200,1.00176574456
104941,104952,108213,11,3261,2,7200,1.00337319841
104960,104966,108314,6,3348,2,7200,1.0017921147
104970,104976,105094,6,118,1,1800,1.05084745763
104975,104983,108463,8,3480,2,7200,1.00229885057
104980,104991,105102,11,111,1,3600,1.0990990991
105026,105033,108518,7,3485,2,7200,1.00200860832
105042,105048,108481,6,3433,2,7200,1.0017477425
105043,105056,108528,13,3472,2,7200,1.00374423963
105177,105183,108522,6,3339,2,7200,1.00179694519
105251,105257,108657,6,3400,2,7200,1.00176470588
105252,105265,108582,13,3317,2,7200,1.0039192041
105278,105284,106310,6,1026,1,3600,1.00584795322
105304,105310,108778,6,3468,2,7200,1.00173010381
105382,105388,108811,6,3423,2,7200,1.00175284838
105461,105467,108882,6,3415,2,7200,1.00175695461
105474,105480,106732,6,1252,1,1800,1.00479233227
105730,105736,109106,6,3370,2,7200,1.00178041543
106078,106085,109467,7,3382,2,7200,1.00206978119
106254,106260,109868,6,3608,2,7200,1.00166297118
106332,106338,109845,6,3507,2,7200,1.00171086399
106399,106406,110021,7,3615,2,7200,1.00193637621
106447,106454,109969,7,3515,2,7200,1.00199146515
106475,106481,110132,6,3651,2,7200,1.00164338537
106490,106496,109709,6,3213,2,7200,1.00186741363
106556,106562,110304,6,3742,2,7200,1.00160342063
106586,106593,109874,7,3281,2,7200,1.00213349589
106700,106706,110274,6,3568,2,7200,1.00168161435
106741,106747,110233,6,3486,2,7200,1.0017211704
106765,106771,110833,6,4062,2,7200,1.00147710487
106834,106841,110251,7,3410,2,7200,1.00205278592
106923,106929,110404,6,3475,2,7200,1.00172661871
106924,106935,110268,11,3333,2,7200,1.00330033003
106926,106941,110052,15,3111,2,7200,1.00482160077
106927,106946,110346,19,3400,2,7200,1.00558823529
106952,106958,110312,6,3354,2,7200,1.00178890877
106966,106973,110237,7,3264,2,7200,1.00214460784
106985,106991,110402,6,3411,2,7200,1.00175901495
106986,106998,110591,12,3593,2,7200,1.00333982744
107019,107026,110286,7,3260,2,7200,1.00214723926
107065,107071,110417,6,3346,2,7200,1.00179318589
107186,107192,110559,6,3367,2,7200,1.00178200178
107258,107265,110678,7,3413,2,7200,1.00205098154
107273,107279,110686,6,3407,2,7200,1.00176108013
107303,107310,110780,7,3470,2,7200,1.00201729107
107319,107325,110668,6,3343,2,7200,1.00179479509
107334,107340,110858,6,3518,2,7200,1.0017055145
107348,107355,110971,7,3616,2,7200,1.00193584071
107403,107409,110788,6,3379,2,7200,1.00177567328
107418,107424,110901,6,3477,2,7200,1.00172562554
107436,107442,111037,6,3595,2,7200,1.0016689847
107451,107457,110821,6,3364,2,7200,1.00178359096
107476,107482,110872,6,3390,2,7200,1.0017699115
107477,107489,110955,12,3466,2,7200,1.00346220427
107492,107498,110985,6,3487,2,7200,1.0017206768
107493,107505,111056,12,3551,2,7200,1.00337932977
107508,107515,110956,7,3441,2,7200,1.00203429236
107524,107530,111031,6,3501,2,7200,1.00171379606
107525,107536,111078,11,3542,2,7200,1.00310559006
107540,107546,111088,6,3542,2,7200,1.00169395822
107555,107561,111219,6,3658,2,7200,1.00164024057
107570,107576,111157,6,3581,2,7200,1.00167550963
107604,107610,109703,6,2093,1,3600,1.00286669852
107624,107630,111101,6,3471,2,7200,1.00172860847
107639,107646,110998,7,3352,2,7200,1.00208830549
107642,107652,111104,10,3452,2,7200,1.00289687138
107684,107690,111217,6,3527,2,7200,1.00170116246
107711,107717,111259,6,3542,2,7200,1.00169395822
107726,107733,111254,7,3521,2,7200,1.00198807157
107728,107739,111068,11,3329,2,7200,1.00330429558
107767,107773,111323,6,3550,2,7200,1.00169014085
107810,107816,111175,6,3359,2,7200,1.00178624591
107811,107824,111199,13,3375,2,7200,1.00385185185
107826,107832,111384,6,3552,2,7200,1.00168918919
107841,107847,111308,6,3461,2,7200,1.001733603
107856,107862,111415,6,3553,2,7200,1.00168871376
107872,107878,111622,6,3744,2,7200,1.0016025641
107873,107884,111338,11,3454,2,7200,1.00318471338
107874,107890,111344,16,3454,2,7200,1.00463231036
107926,107932,111280,6,3348,2,7200,1.0017921147
107966,107972,111506,6,3534,2,7200,1.00169779287
107967,107978,111203,11,3225,2,7200,1.00341085271
107982,107988,111628,6,3640,2,7200,1.00164835165
107984,107996,111533,12,3537,2,7200,1.00339270568
108112,108118,111576,6,3458,2,7200,1.001735107
108160,108166,111567,6,3401,2,7200,1.001764187
108161,108173,111526,12,3353,2,7200,1.00357888458
108163,108178,111737,15,3559,2,7200,1.00421466704
108164,108183,111590,19,3407,2,7200,1.00557675374
108165,108189,111632,24,3443,2,7200,1.00697066512
108167,108194,111717,27,3523,2,7200,1.00766392279
108168,108200,111222,32,3022,2,7200,1.0105890139
108169,108206,111660,37,3454,2,7200,1.01071221772
108171,108211,111442,40,3231,2,7200,1.01238006809
108172,108216,111732,44,3516,2,7200,1.01251422071
108173,108222,111520,49,3298,2,7200,1.01485748939
108175,108227,111758,52,3531,2,7200,1.01472670632
108191,108232,111754,41,3522,2,7200,1.011641113
108192,108237,111640,45,3403,2,7200,1.01322362621
108193,108243,111771,50,3528,2,7200,1.0141723356
108195,108248,111507,53,3259,2,7200,1.01626265726
108196,108255,111517,59,3262,2,7200,1.01808706315
108211,108260,111805,49,3545,2,7200,1.01382228491
108226,108265,111812,39,3547,2,7200,1.01099520722
108241,108271,111694,30,3423,2,7200,1.00876424189
108299,108305,111789,6,3484,2,7200,1.00172215844
108301,108312,111645,11,3333,2,7200,1.00330033003
108316,108323,111633,7,3310,2,7200,1.00211480363
108346,108353,111743,7,3390,2,7200,1.00206489676
108434,108441,111668,7,3227,2,7200,1.0021691974
108449,108455,111802,6,3347,2,7200,1.00179265013
108465,108471,111892,6,3421,2,7200,1.00175387314
108482,108488,111918,6,3430,2,7200,1.00174927114
108519,108526,111893,7,3367,2,7200,1.00207900208
108520,108533,112061,13,3528,2,7200,1.00368480726
108535,108542,112020,7,3478,2,7200,1.00201265095
108537,108548,111870,11,3322,2,7200,1.00331125828
108585,108591,111996,6,3405,2,7200,1.00176211454
108659,108665,112170,6,3505,2,7200,1.00171184023
108779,108786,112154,7,3368,2,7200,1.0020783848
108813,108819,112258,6,3439,2,7200,1.00174469322
108882,108889,112145,7,3256,2,7200,1.00214987715
109056,109062,109976,6,914,1,3600,1.00656455142
109107,109114,112432,7,3318,2,7200,1.00210970464
109223,109482,111413,259,1931,1,1800,1.13412739513
109470,109476,112823,6,3347,2,7200,1.00179265013
109711,109719,113669,8,3950,2,7200,1.00202531646
109934,109941,113553,7,3612,2,7200,1.0019379845
109949,109955,113289,6,3334,2,7200,1.00179964007
109950,109961,113584,11,3623,2,7200,1.00303615788
109971,109979,113324,8,3345,2,7200,1.0023916293
110023,110029,113575,6,3546,2,7200,1.00169204738
110053,110059,113416,6,3357,2,7200,1.0017873101
110132,110138,113436,6,3298,2,7200,1.00181928441
110235,110241,113474,6,3233,2,7200,1.00185586143
110250,110256,113464,6,3208,2,7200,1.00187032419
110265,110271,113762,6,3491,2,7200,1.00171870524
110275,110281,113495,6,3214,2,7200,1.00186683261
110280,110287,113900,7,3613,2,7200,1.0019374481
110295,110301,114020,6,3719,2,7200,1.00161333692
110310,110316,113645,6,3329,2,7200,1.00180234305
110325,110331,113806,6,3475,2,7200,1.00172661871
110346,110352,113755,6,3403,2,7200,1.00176315016
110403,110410,113904,7,3494,2,7200,1.00200343446
110419,110425,113807,6,3382,2,7200,1.00177409817
110420,110431,113702,11,3271,2,7200,1.00336288597
110559,110565,113965,6,3400,2,7200,1.00176470588
110592,110600,113845,8,3245,2,7200,1.00246533128
110671,110677,114047,6,3370,2,7200,1.00178041543
110686,110693,114281,7,3588,2,7200,1.0019509476
110688,110699,114061,11,3362,2,7200,1.00327186199
110745,110751,111517,6,766,1,3600,1.00783289817
110782,110788,114230,6,3442,2,7200,1.00174317257
110797,110803,114368,6,3565,2,7200,1.00168302945
110824,110830,114182,6,3352,2,7200,1.00178997613
110839,110845,114262,6,3417,2,7200,1.00175592625
110860,110866,114469,6,3603,2,7200,1.00166527893
110875,110881,114639,6,3758,2,7200,1.00159659393
110902,110909,114339,7,3430,2,7200,1.00204081633
110957,110963,114633,6,3670,2,7200,1.00163487738
110958,110971,114275,13,3304,2,7200,1.0039346247
110973,110979,114518,6,3539,2,7200,1.00169539418
110988,110994,114674,6,3680,2,7200,1.00163043478
111003,111009,114636,6,3627,2,7200,1.00165425972
111033,111040,114490,7,3450,2,7200,1.00202898551
111041,111048,113258,7,2210,2,14400,1.00316742081
111048,111054,114451,6,3397,2,7200,1.00176626435
111064,111070,114550,6,3480,2,7200,1.00172413793
111079,111085,114354,6,3269,2,7200,1.00183542368
111080,111092,114519,12,3427,2,7200,1.0035016049
111095,111101,114634,6,3533,2,7200,1.00169827342
111110,111116,114432,6,3316,2,7200,1.00180940893
111112,111123,114639,11,3516,2,7200,1.00312855518
111157,111164,114306,7,3142,2,7200,1.00222788033
111175,111181,114632,6,3451,2,7200,1.00173862649
111199,111206,114637,7,3431,2,7200,1.00204022151
111214,111221,114683,7,3462,2,7200,1.00202195263
111230,111236,114631,6,3395,2,7200,1.00176730486
111231,111242,114541,11,3299,2,7200,1.00333434374
111233,111247,114769,14,3522,2,7200,1.0039750142
111257,111263,114703,6,3440,2,7200,1.00174418605
111272,111278,114896,6,3618,2,7200,1.00165837479
111287,111293,114715,6,3422,2,7200,1.00175336061
111308,111314,114824,6,3510,2,7200,1.00170940171
111323,111330,115018,7,3688,2,7200,1.00189804772
111338,111345,115197,7,3852,2,7200,1.0018172378
111353,111360,114713,7,3353,2,7200,1.00208768267
111384,111390,114755,6,3365,2,7200,1.00178306092
111417,111423,114884,6,3461,2,7200,1.001733603
111444,111450,114800,6,3350,2,7200,1.00179104478
111508,111514,114902,6,3388,2,7200,1.00177095632
111509,111522,114903,13,3381,2,7200,1.00384501627
111524,111532,114780,8,3248,2,7200,1.00246305419
111526,111538,114884,12,3346,2,7200,1.00358637179
111527,111544,114893,17,3349,2,7200,1.00507614213
111542,111551,114654,9,3103,2,7200,1.00290041895
111570,111576,114806,6,3230,2,7200,1.00185758514
111584,111591,115044,7,3453,2,7200,1.0020272227
111599,111606,114891,7,3285,2,7200,1.00213089802
111624,111631,115197,7,3566,2,7200,1.00196298374
111639,111646,114697,7,3051,2,7200,1.00229432973
111641,111652,115015,11,3363,2,7200,1.00327088909
111642,111658,115020,16,3362,2,7200,1.00475907198
111643,111663,115197,20,3534,2,7200,1.00565930956
111659,111669,115318,10,3649,2,7200,1.00274047684
111675,111681,115271,6,3590,2,7200,1.00167130919
111676,111688,115304,12,3616,2,7200,1.00331858407
111697,111703,115273,6,3570,2,7200,1.00168067227
111718,111725,115198,7,3473,2,7200,1.00201554852
111734,111740,115197,6,3457,2,7200,1.00173560891
111749,111755,115035,6,3280,2,7200,1.00182926829
111750,111762,115046,12,3284,2,7200,1.00365408039
111766,111772,115271,6,3499,2,7200,1.00171477565
111767,111784,115197,17,3413,2,7200,1.00498095517
111782,111791,115292,9,3501,2,7200,1.00257069409
111797,111804,115197,7,3393,2,7200,1.00206307103
111812,111819,115197,7,3378,2,7200,1.00207223209
111814,111825,115014,11,3189,2,7200,1.00344935717
111815,111831,115197,16,3366,2,7200,1.00475341652
111870,111877,115198,7,3321,2,7200,1.00210779886
111873,111884,111992,11,108,1,1800,1.10185185185
111894,111900,115228,6,3328,2,7200,1.00180288462
111895,111906,115357,11,3451,2,7200,1.00318748189
111907,112002,113630,95,1628,1,3600,1.05835380835
111918,111926,115387,8,3461,2,7200,1.00231147067
111997,112010,115245,13,3235,2,7200,1.00401854714
112018,112025,115483,7,3458,2,7200,1.0020242915
112064,112070,115564,6,3494,2,7200,1.00171722954
112146,112152,115479,6,3327,2,7200,1.00180342651
112161,112167,115521,6,3354,2,7200,1.00178890877
112174,112180,115588,6,3408,2,7200,1.00176056338
112261,112267,115666,6,3399,2,7200,1.00176522507
112309,112443,113971,134,1528,1,1800,1.08769633508
112431,112437,115874,6,3437,2,7200,1.00174570847
112691,113268,113986,577,718,1,1800,1.80362116992
112825,112832,116165,7,3333,2,7200,1.00210021002
113235,114643,115588,1408,945,6,28800,2.48994708995
113235,115594,117368,2359,1774,6,28800,2.3297632469
113236,117374,117714,4138,340,6,28800,13.1705882353
113251,141186,141338,27935,152,6,28800,184.782894737
113251,114650,141180,1399,26530,6,28800,1.05273275537
113252,141344,141463,28092,119,6,28800,237.067226891
113253,141496,141498,28243,2,6,28800,2824.5
113253,141478,141480,28225,2,6,28800,2822.7
113254,141513,141515,28259,2,6,28800,2826.1
113255,141531,141532,28276,1,6,28800,2827.7
113255,141547,141638,28292,91,6,28800,311.901098901
113256,141653,141655,28397,2,6,28800,2839.9
113257,141670,141672,28413,2,6,28800,2841.5
113287,113294,116621,7,3327,2,7200,1.0021039976
113324,113330,116581,6,3251,2,7200,1.00184558597
113417,113424,116638,7,3214,2,7200,1.00217797138
113439,113445,117026,6,3581,2,7200,1.00167550963
113466,113472,116872,6,3400,2,7200,1.00176470588
113481,113488,117106,7,3618,2,7200,1.00193477059
113497,113504,116856,7,3352,2,7200,1.00208830549
113557,113563,116975,6,3412,2,7200,1.00175849941
113575,113581,116963,6,3382,2,7200,1.00177409817
113590,113596,116987,6,3391,2,7200,1.00176938956
113644,113650,117520,6,3870,2,7200,1.0015503876
113671,113678,116889,7,3211,2,7200,1.00218000623
113703,113709,116937,6,3228,2,7200,1.00185873606
113758,113765,117098,7,3333,2,7200,1.00210021002
113773,113780,117264,7,3484,2,7200,1.00200918485
113807,113813,117308,6,3495,2,7200,1.0017167382
113808,113820,117276,12,3456,2,7200,1.00347222222
113848,113855,117273,7,3418,2,7200,1.00204798128
113902,113909,117199,7,3290,2,7200,1.00212765957
113903,113915,117412,12,3497,2,7200,1.00343151273
113968,113974,117482,6,3508,2,7200,1.00171037628
114022,114028,117331,6,3303,2,7200,1.00181653043
114049,114055,117685,6,3630,2,7200,1.00165289256
114064,114070,117664,6,3594,2,7200,1.00166944908
114182,114188,117674,6,3486,2,7200,1.0017211704
114231,114237,117474,6,3237,2,7200,1.00185356812
114264,114271,117688,7,3417,2,7200,1.00204858063
114279,114285,117940,6,3655,2,7200,1.00164158687
114294,114300,117727,6,3427,2,7200,1.00175080245
114309,114316,117542,7,3226,2,7200,1.00216986981
114340,114346,117766,6,3420,2,7200,1.00175438596
114355,114361,117947,6,3586,2,7200,1.00167317345
114370,114376,118140,6,3764,2,7200,1.00159404888
114434,114440,117981,6,3541,2,7200,1.0016944366
114452,114458,117940,6,3482,2,7200,1.00172314762
114470,114476,118049,6,3573,2,7200,1.00167926113
114491,114497,118087,6,3590,2,7200,1.00167130919
114521,114528,118062,7,3534,2,7200,1.00198075835
114523,114535,118052,12,3517,2,7200,1.00341199886
114544,114550,117980,6,3430,2,7200,1.00174927114
114626,114632,117969,6,3337,2,7200,1.00179802218
114643,114655,117948,12,3293,2,7200,1.00364409353
114644,114661,118065,17,3404,2,7200,1.00499412456
114645,114667,118248,22,3581,2,7200,1.00614353533
114647,114672,118169,25,3497,2,7200,1.00714898484
114648,114677,118391,29,3714,2,7200,1.00780829295
114649,114682,118190,33,3508,2,7200,1.00940706956
114650,114688,117992,38,3304,2,7200,1.01150121065
114652,114693,118053,41,3360,2,7200,1.01220238095
114667,114700,118284,33,3584,2,7200,1.00920758929
114682,114705,118331,23,3626,2,7200,1.00634307777
114698,114712,118068,14,3356,2,7200,1.0041716329
114699,114717,118081,18,3364,2,7200,1.00535077289
114714,114723,118225,9,3502,2,7200,1.00256996002
114716,114728,118351,12,3623,2,7200,1.00331217223
114717,114733,118020,16,3287,2,7200,1.00486766048
114757,114763,118145,6,3382,2,7200,1.00177409817
114772,114778,118325,6,3547,2,7200,1.00169157034
114787,114793,118452,6,3659,2,7200,1.00163979229
114802,114809,118287,7,3478,2,7200,1.00201265095
114817,114823,118342,6,3519,2,7200,1.00170502984
114832,114839,118270,7,3431,2,7200,1.00204022151
114887,114893,118399,6,3506,2,7200,1.00171135197
114888,114900,118261,12,3361,2,7200,1.00357036596
114904,114910,118479,6,3569,2,7200,1.00168114318
114905,114918,118612,13,3694,2,7200,1.00351922036
114907,114923,118546,16,3623,2,7200,1.00441622964
114908,114928,118477,20,3549,2,7200,1.00563539025
115011,115016,118615,5,3599,2,7200,1.0013892748
115026,115032,118520,6,3488,2,7200,1.00172018349
115028,115039,118739,11,3700,2,7200,1.00297297297
115029,115045,118427,16,3382,2,7200,1.00473092844
115030,115050,118416,20,3366,2,7200,1.00594177065
115046,115057,118449,11,3392,2,7200,1.00324292453
115047,115062,118334,15,3272,2,7200,1.00458435208
115048,115067,118464,19,3397,2,7200,1.00559317044
115201,115207,118730,6,3523,2,7200,1.00170309395
115203,115215,118745,12,3530,2,7200,1.00339943343
115204,115220,118720,16,3500,2,7200,1.00457142857
115205,115226,118593,21,3367,2,7200,1.00623700624
115207,115231,118736,24,3505,2,7200,1.00684736091
115208,115236,118734,28,3498,2,7200,1.00800457404
115210,115243,118567,33,3324,2,7200,1.00992779783
115211,115248,118724,37,3476,2,7200,1.01064441887
115212,115253,118740,41,3487,2,7200,1.01175795813
115214,115258,118762,44,3504,2,7200,1.01255707763
115229,115264,118770,35,3506,2,7200,1.00998288648
115247,115271,119076,24,3805,2,7200,1.00630749014
115272,115278,118859,6,3581,2,7200,1.00167550963
115273,115284,118743,11,3459,2,7200,1.00318010986
115288,115294,118725,6,3431,2,7200,1.00174876129
115303,115310,118727,7,3417,2,7200,1.00204858063
115318,115324,118544,6,3220,2,7200,1.00186335404
115319,115330,118577,11,3247,2,7200,1.00338774253
115361,115367,118864,6,3497,2,7200,1.00171575636
115497,115503,116428,6,925,1,1800,1.00648648649
115589,115601,119485,12,3884,2,7200,1.00308959835
116167,116174,120170,7,3996,2,7200,1.00175175175
116857,116863,120869,6,4006,2,7200,1.00149775337
117244,117251,149759,7,32508,4,32400,1.00021533161
118473,118479,121953,6,3474,2,7200,1.00172711572
118475,118486,122032,11,3546,2,7200,1.00310208686
118476,118491,122032,15,3541,2,7200,1.0042360915
118477,118497,122032,20,3535,2,7200,1.00565770863
118479,118502,122032,23,3530,2,7200,1.00651558074
118480,118507,122032,27,3525,2,7200,1.00765957447
118481,118513,121694,32,3181,2,7200,1.01005972964
118483,118519,122032,36,3513,2,7200,1.01024765158
118484,118524,121739,40,3215,2,7200,1.01244167963
118485,118529,122032,44,3503,2,7200,1.01256066229
118503,118535,121903,32,3368,2,7200,1.00950118765
118505,118540,122000,35,3460,2,7200,1.01011560694
118506,118545,121988,39,3443,2,7200,1.01132733082
118507,118550,122030,43,3480,2,7200,1.01235632184
118509,118558,122032,49,3474,2,7200,1.01410477835
118510,118563,122032,53,3469,2,7200,1.01527817815
118511,118568,121873,57,3305,2,7200,1.01724659607
118526,118574,121981,48,3407,2,7200,1.01408864103
118545,118579,122032,34,3453,2,7200,1.00984651028
118546,118584,121931,38,3347,2,7200,1.01135345085
118564,118591,122032,27,3441,2,7200,1.00784655623
118579,118596,121889,17,3293,2,7200,1.00516246584
118594,118602,121835,8,3233,2,7200,1.00247448191
118612,118618,121958,6,3340,2,7200,1.00179640719
118614,118625,122032,11,3407,2,7200,1.0032286469
118727,118732,122032,5,3300,2,7200,1.00151515152
118728,118740,122030,12,3290,2,7200,1.00364741641
118729,118745,122032,16,3287,2,7200,1.00486766048
118731,118750,122018,19,3268,2,7200,1.00581395349
118732,118756,122032,24,3276,2,7200,1.00732600733
118733,118761,122032,28,3271,2,7200,1.00856007337
118735,118768,122032,33,3264,2,7200,1.01011029412
118736,118773,122032,37,3259,2,7200,1.01135317582
118738,118778,122032,40,3254,2,7200,1.012292563
118739,118784,122032,45,3248,2,7200,1.0138546798
118740,118789,122032,49,3243,2,7200,1.01510946654
118761,118794,122032,33,3238,2,7200,1.01019147622
118776,118801,122032,25,3231,2,7200,1.00773754256
118833,118840,119363,7,523,1,1800,1.01338432122
118855,118861,122032,6,3171,2,7200,1.00189214759
118867,118874,122589,7,3715,2,7200,1.00188425303
119074,119080,122032,6,2952,2,7200,1.00203252033
119488,119494,122950,6,3456,2,7200,1.00173611111
119782,119788,121689,6,1901,1,1800,1.00315623356
120172,120178,123853,6,3675,2,7200,1.00163265306
120871,120877,124203,6,3326,2,7200,1.00180396873
121397,121403,125153,6,3750,2,21600,1.0016
121690,121699,122032,9,333,2,7200,1.02702702703
121736,121742,122032,6,290,2,7200,1.02068965517
121835,121841,122032,6,191,2,7200,1.03141361257
121872,121878,122032,6,154,2,7200,1.03896103896
121887,121893,122032,6,139,2,7200,1.04316546763
121905,121911,122032,6,121,2,7200,1.04958677686
121929,121935,122032,6,97,2,7200,1.0618556701
121956,121962,122032,6,70,2,7200,1.08571428571
121957,121968,122032,11,64,2,7200,1.171875
121978,121984,122032,6,48,2,7200,1.125
121993,121999,122032,6,33,2,7200,1.18181818182
122008,122014,122032,6,18,2,7200,1.33333333333
122023,122030,122061,7,31,2,7200,1.22580645161
122470,122476,125270,6,2794,2,21600,1.00214745884
122622,122628,125931,6,3303,2,7200,1.00181653043
122704,122711,126313,7,3602,25,3599,1.0019433648
122788,122794,123239,6,445,25,7199,1.01348314607
122951,122957,126733,6,3776,2,7200,1.00158898305
123351,123357,124799,6,1442,2,3600,1.00416088766
123518,123524,125840,6,2316,2,14400,1.00259067358
123856,123863,127370,7,3507,2,7200,1.00199600798
123915,123921,127013,6,3092,2,7200,1.00194049159
123917,123927,127452,10,3525,2,7200,1.00283687943
123918,123933,127377,15,3444,2,7200,1.0043554007
123919,123938,127113,19,3175,2,7200,1.00598425197
123921,123943,127174,22,3231,2,7200,1.00680903745
123922,123949,127318,27,3369,2,7200,1.00801424755
123923,123955,127343,32,3388,2,7200,1.00944510035
123925,123960,127601,35,3641,2,7200,1.00961274375
123926,123965,127021,39,3056,2,7200,1.0127617801
123927,123970,127410,43,3440,2,7200,1.0125
123929,123976,127438,47,3462,2,7200,1.01357596765
123930,123981,127555,51,3574,2,7200,1.0142697258
123931,123986,127122,55,3136,2,7200,1.01753826531
123933,123992,127316,59,3324,2,7200,1.01774969916
123934,123997,127650,63,3653,2,7200,1.0172460991
123936,124002,127358,66,3356,2,7200,1.01966626937
123937,124007,127321,70,3314,2,7200,1.02112251056
123938,124013,127328,75,3315,2,7200,1.02262443439
123940,124018,127313,78,3295,2,7200,1.02367223065
123941,124023,127591,82,3568,2,7200,1.02298206278
123942,124028,127334,86,3306,2,7200,1.02601330913
123946,124035,127601,89,3566,2,7200,1.02495793606
123947,124040,127381,93,3341,2,7200,1.02783597725
123948,124046,127459,98,3413,2,7200,1.02871374158
123949,124051,127615,102,3564,2,7200,1.02861952862
123951,124056,128297,105,4241,2,7200,1.02475831172
123952,124061,127525,109,3464,2,7200,1.0314665127
123954,124067,127592,113,3525,2,7200,1.03205673759
123955,124072,127766,117,3694,2,7200,1.03167298322
123956,124077,127458,121,3381,2,7200,1.03578822833
123958,124082,127603,124,3521,2,7200,1.03521726782
123959,124088,127582,129,3494,2,7200,1.03692043503
123960,124093,127548,133,3455,2,7200,1.03849493488
123962,124098,127559,136,3461,2,7200,1.03929500144
123963,124103,127318,140,3215,2,7200,1.04354587869
123965,124109,127316,144,3207,2,7200,1.04490177736
123966,124114,127637,148,3523,2,7200,1.04200965087
123967,124119,127400,152,3281,2,7200,1.04632733923
123969,124124,127847,155,3723,2,7200,1.04163309159
123970,124130,127635,160,3505,2,7200,1.04564907275
123971,124135,127341,164,3206,2,7200,1.05115408609
123973,124140,127491,167,3351,2,7200,1.04983586989
123974,124145,127443,171,3298,2,7200,1.05184960582
123976,124151,127553,175,3402,2,7200,1.05144032922
123977,124156,127432,179,3276,2,7200,1.05463980464
123978,124161,127796,183,3635,2,7200,1.05034387895
123980,124166,127471,186,3305,2,7200,1.05627836611
123981,124171,127645,190,3474,2,7200,1.0546919977
123982,124177,127547,195,3370,2,7200,1.05786350148
123984,124182,127325,198,3143,2,7200,1.06299713649
123985,124187,127571,202,3384,2,7200,1.05969267139
123987,124193,127763,206,3570,2,7200,1.05770308123
123988,124198,127479,210,3281,2,7200,1.06400487656
123989,124203,127366,214,3163,2,7200,1.06765728739
123991,124208,127722,217,3514,2,7200,1.06175298805
123992,124214,127715,222,3501,2,7200,1.06341045416
123993,124219,127519,226,3300,2,7200,1.06848484848
123995,124224,127718,229,3494,2,7200,1.0655409273
123996,124229,127728,233,3499,2,7200,1.06659045442
123997,124235,127530,238,3295,2,7200,1.0722306525
123999,124240,127713,241,3473,2,7200,1.06939245609
124000,124245,127648,245,3403,2,7200,1.07199529827
124001,124250,127463,249,3213,2,7200,1.07749766573
124003,124256,127540,253,3284,2,7200,1.07704019488
124004,124261,127773,257,3512,2,7200,1.07317767654
124006,124266,127793,260,3527,2,7200,1.07371703998
124007,124271,127462,264,3191,2,7200,1.08273268568
124009,124277,127748,268,3471,2,7200,1.07721117833
124010,124282,127559,272,3277,2,7200,1.08300274641
124011,124287,127569,276,3282,2,7200,1.08409506399
124013,124292,127595,279,3303,2,7200,1.08446866485
124014,124298,127730,284,3432,2,7200,1.08275058275
124015,124303,127613,288,3310,2,7200,1.08700906344
124017,124308,127844,291,3536,2,7200,1.08229638009
124018,124313,127499,295,3186,2,7200,1.09259259259
124205,124320,127808,115,3488,2,7200,1.03297018349
124322,124328,125925,6,1597,2,14400,1.00375704446
125307,125349,125595,42,246,16,3600,1.17073170732
125329,125335,125567,6,232,1,1800,1.02586206897
125352,125607,125823,255,216,16,3600,2.18055555556
125373,125834,126154,461,320,16,3600,2.440625
125389,125937,126240,548,303,16,3600,2.80858085809
125402,126166,126534,764,368,16,3600,3.07608695652
125571,126325,126789,754,464,32,3600,2.625
125600,126826,129456,1226,2630,32,3600,1.46615969582
125753,127261,130345,1508,3084,32,3600,1.48897535668
125770,127564,130258,1794,2694,32,3600,1.66592427617
125785,129468,131652,3683,2184,32,3600,2.68635531136
125919,131020,133016,5101,1996,64,3600,3.55561122244
125932,125943,129440,11,3497,2,7200,1.00314555333
125985,125991,126531,6,540,1,1800,1.01111111111
126135,133034,135366,6899,2332,64,3600,3.95840480274
126158,135378,138010,9220,2632,64,3600,4.50303951368
126172,138022,139906,11850,1884,64,3600,7.2898089172
126189,139917,142203,13728,2286,64,3600,7.00524934383
126279,146244,147701,19965,1457,128,3600,14.7028140014
126298,147717,149039,21419,1322,128,3600,17.2019667171
126313,149052,150028,22739,976,128,3600,24.2981557377
126329,150040,150968,23711,928,128,3600,26.5506465517
126342,150980,151924,24638,944,128,3600,27.0995762712
126530,244834,244839,118304,5,256,3600,11830.9
126736,126742,130540,6,3798,2,7200,1.00157977883
127099,127105,127249,6,144,3,36000,1.04166666667
127294,127370,127740,76,370,25,7199,1.20540540541
127299,127306,127593,7,287,2,50400,1.0243902439
127373,127379,130781,6,3402,2,7200,1.00176366843
127527,127534,131442,7,3908,2,7200,1.00179119754
127542,127549,130947,7,3398,2,7200,1.00206003531
127544,127556,131033,12,3477,2,7200,1.00345125108
127559,127570,130838,11,3268,2,7200,1.00336597307
127560,127577,130830,17,3253,2,7200,1.00522594528
127561,127582,130995,21,3413,2,7200,1.00615294462
127563,127587,131216,24,3629,2,7200,1.00661339212
127564,127592,131104,28,3512,2,7200,1.00797266515
127566,127598,131178,32,3580,2,7200,1.00893854749
127581,127605,130958,24,3353,2,7200,1.00715776916
127582,127610,131115,28,3505,2,7200,1.00798858773
127584,127615,130921,31,3306,2,7200,1.0093768905
127599,127622,131100,23,3478,2,7200,1.00661299597
127600,127627,130995,27,3368,2,7200,1.00801662708
127601,127632,130889,31,3257,2,7200,1.00951796131
127603,127637,131106,34,3469,2,7200,1.00980109542
127604,127643,131037,39,3394,2,7200,1.01149086623
127605,127648,130901,43,3253,2,7200,1.01321856748
127607,127653,130964,46,3311,2,7200,1.01389308366
127621,127660,131172,39,3512,2,7200,1.0111047836
127636,127665,130911,29,3246,2,7200,1.0089340727
127637,127670,131063,33,3393,2,7200,1.00972590628
127653,127675,131086,22,3411,2,7200,1.00644972149
127654,127686,131167,32,3481,2,7200,1.0091927607
127655,127692,131008,37,3316,2,7200,1.01115802171
127672,127681,128582,9,901,3,36000,1.00998890122
127707,127713,131005,6,3292,2,7200,1.00182260024
127721,127729,131213,8,3484,2,7200,1.00229621125
127723,127736,131016,13,3280,2,7200,1.00396341463
127724,127741,131274,17,3533,2,7200,1.0048117747
127739,127748,131399,9,3651,2,7200,1.00246507806
127740,127753,131353,13,3600,2,7200,1.00361111111
127755,128117,131706,362,3589,2,7200,1.10086375035
127772,127778,131198,6,3420,2,7200,1.00175438596
127773,127785,130919,12,3134,2,7200,1.00382897256
127788,127795,131297,7,3502,2,7200,1.0019988578
127803,127810,131280,7,3470,2,7200,1.00201729107
127805,127817,131073,12,3256,2,7200,1.00368550369
127814,127824,131388,10,3564,2,7200,1.00280583614
127841,127848,131548,7,3700,2,7200,1.00189189189
127855,127862,131064,7,3202,2,7200,1.00218613367
127864,127871,128051,7,180,2,50400,1.03888888889
128103,130270,131008,2167,738,25,7199,3.93631436314
128296,128303,131644,7,3341,2,7200,1.00209518108
128503,128510,130729,7,2219,2,3600,1.00315457413
128593,128600,128605,7,5,3,36000,1.2
128806,128813,128814,7,1,3,36000,1.0
128850,128856,130856,6,2000,2,3600,1.003
129004,129010,129013,6,3,3,36000,1.0
129173,129179,129180,6,1,3,36000,1.0
129441,129447,132763,6,3316,2,7200,1.00180940893
129573,129580,129729,7,149,3,36000,1.04697986577
129918,129924,130341,6,417,2,3540,1.01438848921
130222,130228,132257,6,2029,2,3600,1.00295712173
130655,130662,134169,7,3507,2,7200,1.00199600798
130782,130788,134945,6,4157,2,7200,1.00144334857
130833,130839,135045,6,4206,2,7200,1.00142653352
130848,130854,135706,6,4852,2,7200,1.00123660346
130890,130896,135980,6,5084,2,7200,1.00118017309
130905,130912,135579,7,4667,2,7200,1.00149989286
130920,130927,135950,7,5023,2,7200,1.00139358949
130921,130934,135726,13,4792,2,7200,1.00271285476
130936,130943,135388,7,4445,2,7200,1.00157480315
130951,130957,135396,6,4439,2,7200,1.00135165578
130966,130973,135012,7,4039,2,7200,1.00173310225
130967,130980,134976,13,3996,2,7200,1.00325325325
130998,131004,135082,6,4078,2,7200,1.00147130947
130999,131011,134897,12,3886,2,7200,1.00308800823
131014,131027,134768,13,3741,2,7200,1.00347500668
131015,131032,135720,17,4688,2,7200,1.00362627986
131030,131039,134702,9,3663,2,7200,1.00245700246
131031,131044,134635,13,3591,2,7200,1.00362016151
131046,131052,134450,6,3398,2,7200,1.00176574456
131051,131712,138923,661,7211,25,7199,1.09166551102
131064,131070,134453,6,3383,2,7200,1.00177357375
131065,131077,134274,12,3197,2,7200,1.00375351892
131080,131087,134331,7,3244,2,7200,1.00215782984
131095,131101,134099,6,2998,2,7200,1.00200133422
131110,131116,134563,6,3447,2,7200,1.00174064404
131111,131123,134551,12,3428,2,7200,1.00350058343
131113,131128,134721,15,3593,2,7200,1.0041747843
131127,131134,134474,7,3340,2,7200,1.00209580838
131167,131173,134802,6,3629,2,7200,1.00165334803
131182,131188,134656,6,3468,2,7200,1.00173010381
131183,131195,134726,12,3531,2,7200,1.00339847069
131198,131205,134321,7,3116,2,7200,1.00224646983
131212,131220,134800,8,3580,2,7200,1.00223463687
131227,131233,134143,6,2910,2,7200,1.00206185567
131242,131248,131270,6,22,3,36000,1.27272727273
131275,131281,134697,6,3416,2,7200,1.00175644028
131277,131288,134866,11,3578,2,7200,1.00307434321
131295,131302,134779,7,3477,2,7200,1.0020132298
131341,131347,131430,6,83,3,36000,1.07228915663
131355,131361,134773,6,3412,2,7200,1.00175849941
131391,131398,134974,7,3576,2,7200,1.00195749441
131397,131405,134683,8,3278,2,7200,1.00244051251
131443,131450,135054,7,3604,2,7200,1.00194228635
131479,131486,132287,7,801,3,36000,1.00873907615
131549,131556,134932,7,3376,2,7200,1.00207345972
131642,131649,135147,7,3498,2,7200,1.00200114351
131706,131717,136351,11,4634,2,7200,1.00237375917
131756,131762,131910,6,148,6,36000,1.04054054054
132284,132290,136125,6,3835,16,3600,1.00156453716
132411,132418,132527,7,109,3,36000,1.06422018349
132456,136138,139917,3682,3779,16,3600,1.97433183382
132504,245338,245342,112834,4,16,3600,11283.8
132766,132772,136152,6,3380,2,7200,1.00177514793
134097,134103,137508,6,3405,2,7200,1.00176211454
134142,134149,137587,7,3438,2,7200,1.00203606748
134171,134177,138755,6,4578,2,7200,1.00131061599
134276,134282,137571,6,3289,2,7200,1.00182426269
134321,134327,137521,6,3194,2,7200,1.00187852223
134336,134342,137856,6,3514,2,7200,1.00170745589
134447,134454,137925,7,3471,2,7200,1.00201670988
134448,134461,137635,13,3174,2,7200,1.0040957782
134475,134483,137921,8,3438,2,7200,1.00232693426
134551,134558,137925,7,3367,2,7200,1.00207900208
134566,134573,137911,7,3338,2,7200,1.00209706411
134635,134641,137825,6,3184,2,7200,1.00188442211
134656,134662,138217,6,3555,2,7200,1.00168776371
134680,134686,137913,6,3227,2,7200,1.00185931205
134698,134704,137832,6,3128,2,7200,1.00191815857
134712,134720,138060,8,3340,2,7200,1.00239520958
134727,134734,137930,7,3196,2,7200,1.0021902378
134729,134741,137962,12,3221,2,7200,1.00372555107
134762,134768,137756,6,2988,2,7200,1.00200803213
134763,134776,138212,13,3436,2,7200,1.00378346915
134781,134787,138285,6,3498,2,7200,1.00171526587
134799,134805,138140,6,3335,2,7200,1.00179910045
134814,134820,138022,6,3202,2,7200,1.00187382886
134865,134872,138178,7,3306,2,7200,1.00211736237
134895,134902,138488,7,3586,2,7200,1.00195203569
134931,134938,138208,7,3270,2,7200,1.00214067278
134947,134954,138232,7,3278,2,7200,1.00213544844
134975,134982,138357,7,3375,2,7200,1.00207407407
134976,134989,138284,13,3295,2,7200,1.00394537178
135009,135016,138459,7,3443,2,7200,1.00203311066
135045,135051,138390,6,3339,2,7200,1.00179694519
135060,135067,138431,7,3364,2,7200,1.00208085612
135081,135088,138245,7,3157,2,7200,1.0022172949
135144,135150,138346,6,3196,2,7200,1.00187734668
135384,135390,139832,6,4442,2,7200,1.00135074291
135399,135405,138878,6,3473,2,7200,1.00172761301
135580,135587,138894,7,3307,2,7200,1.0021167221
135705,135711,139240,6,3529,2,7200,1.00170019836
135706,135719,139032,13,3313,2,7200,1.00392393601
135707,135724,139041,17,3317,2,7200,1.00512511305
135949,135957,139178,8,3221,2,7200,1.00248370071
135979,135985,139382,6,3397,2,7200,1.00176626435
136102,245348,245352,109246,4,32,3600,10925.0
136147,136165,139377,18,3212,2,3600,1.00560398506
136153,136159,140730,6,4571,2,7200,1.00131262306
136348,136355,141237,7,4882,2,7200,1.00143383859
136844,136850,137596,6,746,3,36000,1.00804289544
136971,136978,138898,7,1920,1,1800,1.00364583333
137511,137517,140856,6,3339,2,7200,1.00179694519
137526,137532,141007,6,3475,2,7200,1.00172661871
137568,137574,140887,6,3313,2,7200,1.00181104739
137589,137595,140775,6,3180,2,7200,1.00188679245
137637,137643,141072,6,3429,2,7200,1.00174978128
137758,137764,141215,6,3451,2,7200,1.00173862649
137771,137836,138264,65,428,3,36000,1.15186915888
137824,137830,141315,6,3485,2,7200,1.00172166428
137839,137845,141262,6,3417,2,7200,1.00175592625
137856,137863,141652,7,3789,2,7200,1.00184745315
137895,137901,141050,6,3149,2,7200,1.00190536678
137910,137916,141548,6,3632,2,7200,1.00165198238
137926,137932,141474,6,3542,2,7200,1.00169395822
137927,137938,141338,11,3400,2,7200,1.00323529412
137928,137944,141329,16,3385,2,7200,1.0047267356
137943,137950,141133,7,3183,2,7200,1.00219918316
137961,137967,141379,6,3412,2,7200,1.00175849941
138021,138028,141617,7,3589,2,7200,1.00195040401
138057,138063,141563,6,3500,2,7200,1.00171428571
138142,138148,141600,6,3452,2,7200,1.00173812283
138178,138184,141785,6,3601,2,7200,1.00166620383
138208,138214,141631,6,3417,2,7200,1.00175592625
138223,138230,141419,7,3189,2,7200,1.00219504547
138224,138236,141320,12,3084,2,7200,1.00389105058
138231,138243,141698,12,3455,2,7200,1.00347322721
138245,138251,141728,6,3477,2,7200,1.00172562554
138284,138291,141783,7,3492,2,7200,1.0020045819
138286,138297,141790,11,3493,2,7200,1.00314915545
138331,138337,138896,6,559,3,36000,1.01073345259
138346,138352,141707,6,3355,2,7200,1.00178837556
138358,138364,141768,6,3404,2,7200,1.0017626322
138389,138395,141615,6,3220,2,7200,1.00186335404
138431,138437,141926,6,3489,2,7200,1.00171969046
138460,138467,141678,7,3211,2,7200,1.00218000623
138468,138508,141069,40,2561,2,3600,1.01561889887
138487,138494,141790,7,3296,2,7200,1.00212378641
138758,138764,142403,6,3639,2,7200,1.00164880462
138879,138885,142243,6,3358,2,7200,1.00178677784
138887,138935,146232,48,7297,25,7199,1.00657804577
138894,138900,142467,6,3567,2,7200,1.00168208579
139033,139039,142598,6,3559,2,7200,1.00168586682
139048,139054,142585,6,3531,2,7200,1.00169923534
139180,139187,142640,7,3453,2,7200,1.0020272227
139241,139247,142086,6,2839,2,7200,1.00211342022
139382,139388,142922,6,3534,2,7200,1.00169779287
139673,139679,141951,6,2272,2,3600,1.00264084507
139797,139803,139995,6,192,3,36000,1.03125
139832,139840,143367,8,3527,2,7200,1.00226821661
140305,140311,140584,6,273,3,36000,1.02197802198
140547,140553,142784,6,2231,2,3600,1.00268937696
140732,140738,144964,6,4226,2,7200,1.0014197823
140774,140780,164891,6,24111,16,36000,1.00024884907
140774,140785,144155,11,3370,2,7200,1.00326409496
140829,140836,181186,7,40350,1,54000,1.00017348203
140840,151557,164891,10717,13334,16,36000,1.80373481326
140859,140865,144437,6,3572,2,7200,1.00167973124
140889,140895,144371,6,3476,2,7200,1.00172612198
140904,140910,180731,6,39821,1,54000,1.00015067427
141007,141013,144554,6,3541,2,7200,1.0016944366
141049,141055,144637,6,3582,2,7200,1.00167504188
141070,141076,144497,6,3421,2,7200,1.00175387314
141133,141139,144316,6,3177,2,7200,1.00188857413
141215,141221,144946,6,3725,2,7200,1.00161073826
141235,141242,144922,7,3680,2,7200,1.00190217391
141262,141268,144895,6,3627,2,7200,1.00165425972
141266,141275,175853,9,34578,1,54000,1.0002602811
141317,141323,144756,6,3433,2,7200,1.0017477425
141432,141438,144757,6,3319,2,7200,1.00180777343
141447,141453,144901,6,3448,2,7200,1.00174013921
141448,141459,144880,11,3421,2,7200,1.00321543408
141450,141464,144678,14,3214,2,7200,1.00435594275
141451,141470,145103,19,3633,2,7200,1.0052298376
141476,141485,144811,9,3326,2,7200,1.0027059531
141496,141503,143268,7,1765,2,3600,1.00396600567
141549,141555,145014,6,3459,2,7200,1.00173460538
141563,141569,144946,6,3377,2,7200,1.0017767249
141600,141606,144939,6,3333,2,7200,1.00180018002
141614,141620,144951,6,3331,2,7200,1.00180126088
141629,141635,145052,6,3417,2,7200,1.00175592625
141630,141641,144658,11,3017,2,7200,1.00364600597
141648,141659,145198,11,3539,2,7200,1.00310822266
141679,141685,145014,6,3329,2,7200,1.00180234305
141701,141707,145185,6,3478,2,7200,1.00172512938
141709,141715,145335,6,3620,2,7200,1.00165745856
141730,141736,144993,6,3257,2,7200,1.00184218606
141771,141777,145129,6,3352,2,7200,1.00178997613
141781,141787,145445,6,3658,2,7200,1.00164024057
141796,141803,145300,7,3497,2,7200,1.00200171576
141798,141809,145319,11,3510,2,7200,1.00313390313
141799,141814,145030,15,3216,2,7200,1.0046641791
141929,141935,145166,6,3231,2,7200,1.00185701021
142086,142092,145653,6,3561,2,7200,1.00168491997
142241,142248,145590,7,3342,2,7200,1.00209455416
142382,144822,150065,2440,5243,2,21600,1.46538241465
142405,142412,145843,7,3431,2,7200,1.00204022151
142413,151947,151985,9534,38,16,36000,251.894736842
142467,142474,145436,7,2962,2,7200,1.00236326806
142585,142592,145996,7,3404,2,7200,1.00205640423
142600,142607,145841,7,3234,2,7200,1.00216450216
142639,142645,145945,6,3300,2,7200,1.00181818182
142651,151936,155952,9285,4016,25,7199,3.31200199203
142846,142853,143102,7,249,2,3540,1.0281124498
142924,142930,146535,6,3605,2,7200,1.00166435506
143239,143245,143939,6,694,3,3600,1.00864553314
143366,143372,146991,6,3619,2,7200,1.00165791655
144091,144097,144356,6,259,3,3600,1.02316602317
144398,144404,147718,6,3314,2,7200,1.00181050091
144399,144410,147930,11,3520,2,7200,1.003125
144414,144421,147706,7,3285,2,7200,1.00213089802
144438,144445,147845,7,3400,2,7200,1.00205882353
144499,144505,147681,6,3176,2,7200,1.00188916877
144556,144563,148211,7,3648,2,7200,1.00191885965
144637,144643,148092,6,3449,2,7200,1.00173963468
144658,144664,147977,6,3313,2,7200,1.00181104739
144679,144685,148122,6,3437,2,7200,1.00174570847
144749,144755,148364,6,3609,2,7200,1.00166251039
144750,144762,148175,12,3413,2,7200,1.00351596836
144808,144814,148196,6,3382,2,7200,1.00177409817
144880,144886,148266,6,3380,2,7200,1.00177514793
144895,144901,148028,6,3127,2,7200,1.00191877199
144910,144916,148409,6,3493,2,7200,1.00171772116
144925,144931,148464,6,3533,2,7200,1.00169827342
144940,144946,148615,6,3669,2,7200,1.00163532298
144955,144961,148875,6,3914,2,7200,1.00153295861
144956,144967,148841,11,3874,2,7200,1.00283944244
144957,144973,148340,16,3367,2,7200,1.00475200475
144966,144979,148611,13,3632,2,7200,1.00357929515
144980,144987,145550,7,563,3,3600,1.01243339254
144984,144994,148622,10,3628,2,7200,1.00275633958
144986,145000,148621,14,3621,2,7200,1.00386633527
145000,145006,148839,6,3833,2,7200,1.00156535351
145031,145037,148615,6,3578,2,7200,1.00167691448
145055,145061,148616,6,3555,2,7200,1.00168776371
145103,145109,148895,6,3786,2,7200,1.00158478605
145130,145136,148835,6,3699,2,7200,1.00162206002
145154,145160,148621,6,3461,2,7200,1.001733603
145185,145191,148850,6,3659,2,7200,1.00163979229
145199,145205,148925,6,3720,2,7200,1.00161290323
145302,145308,149030,6,3722,2,7200,1.00161203654
145320,145326,148856,6,3530,2,7200,1.00169971671
145335,145341,148915,6,3574,2,7200,1.00167879127
145438,145444,149139,6,3695,2,7200,1.00162381597
145453,145459,148788,6,3329,2,7200,1.00180234305
145477,145666,153250,189,7584,2,21600,1.02492088608
145542,145549,183793,7,38244,1,54000,1.00018303525
145583,145589,148926,6,3337,2,7200,1.00179802218
145652,145659,149208,7,3549,2,7200,1.00197238659
145661,146462,152387,801,5925,3,36000,1.13518987342
145834,145840,149385,6,3545,2,7200,1.00169252468
145845,145851,149320,6,3469,2,7200,1.00172960507
145925,145932,149319,7,3387,2,7200,1.00206672572
145988,145994,149422,6,3428,2,7200,1.00175029172
146144,148420,156591,2276,8171,2,21600,1.27854607759
146535,146542,149811,7,3269,2,7200,1.00214132762
146972,148631,149919,1659,1288,2,3600,2.28804347826
147254,147261,150428,7,3167,2,7200,1.00221029365
147319,148636,149931,1317,1295,2,3600,2.01698841699
147681,147687,150786,6,3099,2,7200,1.00193610842
147705,147711,151206,6,3495,2,7200,1.0017167382
147706,148821,149931,1115,1110,2,3600,2.0045045045
147720,147726,151111,6,3385,2,7200,1.00177252585
147844,147850,151156,6,3306,2,7200,1.00181488203
147931,147937,151673,6,3736,2,7200,1.00160599572
147970,147976,151507,6,3531,2,7200,1.00169923534
148027,148034,151543,7,3509,2,7200,1.00199487033
148095,148101,151247,6,3146,2,7200,1.00190718373
148122,148128,151433,6,3305,2,7200,1.00181543116
148171,148855,149935,684,1080,2,3600,1.63333333333
148176,148182,151594,6,3412,2,7200,1.00175849941
148197,148204,151773,7,3569,2,7200,1.00196133371
148212,148218,151683,6,3465,2,7200,1.00173160173
148266,148273,151348,7,3075,2,7200,1.00227642276
148339,148345,151790,6,3445,2,7200,1.00174165457
148366,148372,151690,6,3318,2,7200,1.00180831826
148405,148411,152013,6,3602,2,7200,1.00166574125
148466,148472,152090,6,3618,2,7200,1.00165837479
148611,148618,152390,7,3772,2,7200,1.00185577943
148615,148624,151952,9,3328,2,7200,1.00270432692
148627,148643,151957,16,3314,2,7200,1.00482800241
148629,148648,152043,19,3395,2,7200,1.00559646539
148630,148653,151881,23,3228,2,7200,1.00712515489
148631,148658,151897,27,3239,2,7200,1.00833590614
148633,148663,152103,30,3440,2,7200,1.00872093023
148815,148826,152415,11,3589,2,7200,1.00306492059
148836,148842,152133,6,3291,2,7200,1.00182315406
148836,148848,151862,12,3014,2,7200,1.00398142004
148851,148866,152311,15,3445,2,7200,1.00435413643
148851,148861,152318,10,3457,2,7200,1.00289268152
148866,148873,152388,7,3515,2,7200,1.00199146515
148881,148887,152310,6,3423,2,7200,1.00175284838
148896,148902,152418,6,3516,2,7200,1.00170648464
148917,148923,152270,6,3347,2,7200,1.00179265013
148932,148938,152450,6,3512,2,7200,1.00170842825
148933,148944,152159,11,3215,2,7200,1.0034214619
148974,149041,149961,67,920,2,3600,1.07282608696
149000,149006,152607,6,3601,2,7200,1.00166620383
149088,151952,171482,2864,19530,16,36000,1.14664618536
149140,149146,152551,6,3405,2,7200,1.00176211454
149153,149172,150042,19,870,2,3600,1.02183908046
149206,149213,152362,7,3149,2,7200,1.00222292791
149303,149309,152432,6,3123,2,7200,1.00192122959
149322,149328,152803,6,3475,2,7200,1.00172661871
149385,149391,152826,6,3435,2,7200,1.00174672489
149424,149430,152993,6,3563,2,7200,1.00168397418
149468,149769,150771,301,1002,2,3600,1.3003992016
149812,149818,153000,6,3182,2,7200,1.00188560654
149882,151942,159193,2060,7251,25,7199,1.284098745
149967,149974,150063,7,89,2,3600,1.07865168539
150315,150322,150409,7,87,2,3600,1.08045977011
150428,150434,153838,6,3404,2,7200,1.0017626322
150620,150626,150826,6,200,2,3600,1.03
150787,150793,154715,6,3922,2,7200,1.00152983172
151110,151117,154555,7,3438,2,7200,1.00203606748
151144,151150,154799,6,3649,2,7200,1.00164428611
151205,151211,154678,6,3467,2,7200,1.00173060283
151247,151253,154876,6,3623,2,7200,1.00165608612
151350,151356,154830,6,3474,2,7200,1.00172711572
151434,151440,154837,6,3397,2,7200,1.00176626435
151509,151516,155019,7,3503,2,7200,1.00199828718
151543,151549,154856,6,3307,2,7200,1.00181433323
151597,151604,155163,7,3559,2,7200,1.00196684462
151675,151681,154986,6,3305,2,7200,1.00181543116
151690,151696,155095,6,3399,2,7200,1.00176522507
151691,151702,154997,11,3295,2,7200,1.0033383915
151770,151776,155015,6,3239,2,7200,1.00185242359
151791,151797,155442,6,3645,2,7200,1.00164609053
151863,151870,155033,7,3163,2,7200,1.00221308884
151878,151884,155180,6,3296,2,7200,1.00182038835
151893,151899,155412,6,3513,2,7200,1.00170794193
151948,151963,155347,15,3384,2,7200,1.00443262411
151952,151958,155522,6,3564,2,7200,1.00168350168
151987,151993,155634,6,3641,2,7200,1.00164789893
152044,152050,155552,6,3502,2,7200,1.00171330668
152090,152096,155383,6,3287,2,7200,1.00182537268
152105,152111,155783,6,3672,2,7200,1.00163398693
152134,152140,155574,6,3434,2,7200,1.00174723355
152160,152166,155600,6,3434,2,7200,1.00174723355
152271,152278,155811,7,3533,2,7200,1.00198131899
152310,152317,155960,7,3643,2,7200,1.00192149327
152312,152323,155757,11,3434,2,7200,1.0032032615
152320,152329,156079,9,3750,2,7200,1.0024
152360,152366,155575,6,3209,2,7200,1.00186974135
152387,152393,155762,6,3369,2,7200,1.0017809439
152402,152408,155491,6,3083,2,7200,1.00194615634
152417,152423,155741,6,3318,2,7200,1.00180831826
152419,152430,156005,11,3575,2,7200,1.00307692308
152433,152439,155867,6,3428,2,7200,1.00175029172
152451,152458,156052,7,3594,2,7200,1.0019476906
152525,152532,152579,7,47,16,36000,1.14893617021
152546,152552,156109,6,3557,2,7200,1.00168681473
152610,152616,156012,6,3396,2,7200,1.00176678445
152617,152623,153609,6,986,3,36000,1.0060851927
152805,152811,156488,6,3677,2,7200,1.00163176503
152826,152832,156521,6,3689,2,7200,1.00162645703
152996,153002,156779,6,3777,2,7200,1.00158856235
153011,153017,156376,6,3359,2,7200,1.00178624591
153132,153138,153325,6,187,16,36000,1.0320855615
153475,153481,153666,6,185,16,36000,1.03243243243
153814,153820,157241,6,3421,2,7200,1.00175387314
153918,153925,153996,7,71,1,1800,1.0985915493
153926,153932,153989,6,57,1,1800,1.10526315789
154047,154053,155018,6,965,3,36000,1.00621761658
154129,154135,154197,6,62,16,36000,1.09677419355
154372,154380,155270,8,890,1,1800,1.00898876404
154378,154386,156212,8,1826,1,1800,1.00438116101
154384,154394,154658,10,264,1,1800,1.03787878788
154467,245014,245015,90547,1,16,72000,9054.8
154497,245069,245070,90572,1,16,72000,9057.3
154513,245118,245119,90605,1,16,72000,9060.6
154544,154550,158445,6,3895,2,7200,1.00154043646
154675,154681,158721,6,4040,2,7200,1.00148514851
154717,154724,158479,7,3755,2,7200,1.00186418109
154799,154805,158504,6,3699,2,7200,1.00162206002
154827,154834,158522,7,3688,2,7200,1.00189804772
154842,154848,158219,6,3371,2,7200,1.00177988727
154857,154863,158125,6,3262,2,7200,1.00183936235
154875,154881,158332,6,3451,2,7200,1.00173862649
154930,154936,155000,6,64,16,36000,1.09375
154987,154993,158519,6,3526,2,7200,1.00170164492
155002,155008,158365,6,3357,2,7200,1.0017873101
155017,155023,158469,6,3446,2,7200,1.00174114916
155019,155029,158393,10,3364,2,7200,1.00297265161
155033,155040,158303,7,3263,2,7200,1.00214526509
155094,155100,158538,6,3438,2,7200,1.0017452007
155161,155166,158578,5,3412,2,7200,1.00146541618
155181,155187,158613,6,3426,2,7200,1.00175131349
155348,155355,158790,7,3435,2,7200,1.00203784571
155378,155386,158653,8,3267,2,7200,1.00244872972
155415,155421,158773,6,3352,2,7200,1.00178997613
155445,155451,159139,6,3688,2,7200,1.00162689805
155491,155497,158834,6,3337,2,7200,1.00179802218
155524,155530,159122,6,3592,2,7200,1.00167037862
155551,155559,159106,8,3547,2,7200,1.00225542712
155570,155576,159068,6,3492,2,7200,1.00171821306
155575,155582,159068,7,3486,2,7200,1.00200803213
155600,155606,158961,6,3355,2,7200,1.00178837556
155633,155639,158977,6,3338,2,7200,1.00179748352
155673,155966,156150,293,184,16,36000,2.59239130435
155740,155746,159064,6,3318,2,7200,1.00180831826
155754,155760,159155,6,3395,2,7200,1.00176730486
155769,155775,159118,6,3343,2,7200,1.00179479509
155784,155790,159307,6,3517,2,7200,1.00170599943
155812,155818,159530,6,3712,2,7200,1.00161637931
155869,155875,159144,6,3269,2,7200,1.00183542368
155952,155958,159280,6,3322,2,7200,1.00180614088
156003,156010,159691,7,3681,2,7200,1.00190165716
156019,156026,159967,7,3941,2,7200,1.00177619893
156052,156058,159583,6,3525,2,7200,1.00170212766
156080,156086,159765,6,3679,2,7200,1.00163087796
156113,156119,159979,6,3860,2,7200,1.00155440415
156211,156220,157027,9,807,3,36000,1.01115241636
156377,156384,159545,7,3161,2,7200,1.00221448909
156488,156495,159938,7,3443,2,7200,1.00203311066
156520,156526,159954,6,3428,2,7200,1.00175029172
156555,156561,156761,6,200,16,36000,1.03
156782,156788,160250,6,3462,2,7200,1.00173310225
157205,157212,157367,7,155,3,36000,1.04516129032
157233,157239,157352,6,113,16,36000,1.05309734513
157239,157246,160484,7,3238,2,7200,1.00216182829
157472,157479,157480,7,1,1,3600,1.0
157556,157562,158761,6,1199,1,3600,1.00500417014
158129,158135,161705,6,3570,2,7200,1.00168067227
158220,158227,161726,7,3499,2,7200,1.00200057159
158302,158308,161593,6,3285,2,7200,1.00182648402
158332,158338,161681,6,3343,2,7200,1.00179479509
158365,158371,161919,6,3548,2,7200,1.00169109357
158393,158399,161794,6,3395,2,7200,1.00176730486
158444,158451,161772,7,3321,2,7200,1.00210779886
158459,158465,161927,6,3462,2,7200,1.00173310225
158477,158484,161807,7,3323,2,7200,1.00210653024
158505,158511,162105,6,3594,2,7200,1.00166944908
158520,158526,161760,6,3234,2,7200,1.00185528757
158521,158532,161736,11,3204,2,7200,1.00343320849
158536,158542,161899,6,3357,2,7200,1.0017873101
158575,158582,162137,7,3555,2,7200,1.00196905767
158615,158621,161818,6,3197,2,7200,1.00187675946
158651,158657,162112,6,3455,2,7200,1.0017366136
158718,158724,161891,6,3167,2,7200,1.00189453742
158763,158769,158771,6,2,1,3600,1.0
158775,158781,162086,6,3305,2,7200,1.00181543116
158790,158797,162156,7,3359,2,7200,1.00208395356
158818,158824,160139,6,1315,1,3600,1.00456273764
158836,158842,162554,6,3712,2,7200,1.00161637931
158960,158966,162132,6,3166,2,7200,1.00189513582
158978,158984,162643,6,3659,2,7200,1.00163979229
159066,159072,162355,6,3283,2,7200,1.00182759671
159070,159078,162594,8,3516,2,7200,1.00227531286
159080,159087,162447,7,3360,2,7200,1.00208333333
159104,159110,162490,6,3380,2,7200,1.00177514793
159119,159126,162590,7,3464,2,7200,1.00202078522
159122,159132,162398,10,3266,2,7200,1.00306184936
159138,159144,162371,6,3227,2,7200,1.00185931205
159152,159159,162792,7,3633,2,7200,1.00192678227
159167,159174,162187,7,3013,2,7200,1.00232326585
159280,159286,162691,6,3405,2,7200,1.00176211454
159307,159313,162301,6,2988,2,7200,1.00200803213
159528,159534,162954,6,3420,2,7200,1.00175438596
159543,159549,162902,6,3353,2,7200,1.00178944229
159573,159579,162692,6,3113,2,7200,1.00192740122
159692,159698,162787,6,3089,2,7200,1.00194237617
159767,159774,163261,7,3487,2,7200,1.00200745627
159939,159945,163520,6,3575,2,7200,1.00167832168
159955,159962,163232,7,3270,2,7200,1.00214067278
159971,159977,163491,6,3514,2,7200,1.00170745589
159985,159992,163556,7,3564,2,7200,1.0019640853
160251,160257,163812,6,3555,2,7200,1.00168776371
160484,160490,163940,6,3450,2,7200,1.00173913043
160981,160987,161126,6,139,16,36000,1.04316546763
161270,161276,161711,6,435,3,36000,1.01379310345
161727,161734,165039,7,3305,2,7200,1.00211800303
161729,161740,164910,11,3170,2,7200,1.00347003155
161730,161746,165148,16,3402,2,7200,1.00470311581
161745,161752,165058,7,3306,2,7200,1.00211736237
161747,161759,164796,12,3037,2,7200,1.0039512677
161762,161768,165178,6,3410,2,7200,1.00175953079
161777,161783,165309,6,3526,2,7200,1.00170164492
161795,161801,165154,6,3353,2,7200,1.00178944229
161810,161816,165191,6,3375,2,7200,1.00177777778
161825,161831,165192,6,3361,2,7200,1.00178518298
161892,161898,165253,6,3355,2,7200,1.00178837556
161907,161913,165276,6,3363,2,7200,1.00178412132
161922,161929,165182,7,3253,2,7200,1.00215185982
161937,161943,165447,6,3504,2,7200,1.00171232877
162086,162093,165487,7,3394,2,7200,1.00206246317
162105,162112,165560,7,3448,2,7200,1.00203016241
162120,162126,165534,6,3408,2,7200,1.00176056338
162137,162143,165457,6,3314,2,7200,1.00181050091
162152,162158,165606,6,3448,2,7200,1.00174013921
162167,162173,165694,6,3521,2,7200,1.00170406135
162185,162191,165912,6,3721,2,7200,1.00161246977
162260,162267,169475,7,7208,25,7199,1.00097114317
162297,162304,165758,7,3454,2,7200,1.00202663578
162355,162362,165781,7,3419,2,7200,1.00204738228
162371,162377,165811,6,3434,2,7200,1.00174723355
162401,162407,165993,6,3586,2,7200,1.00167317345
162403,162414,169636,11,7222,25,7199,1.00152312379
162447,162453,165908,6,3455,2,7200,1.0017366136
162489,162495,165989,6,3494,2,7200,1.00171722954
162553,162559,166100,6,3541,2,7200,1.0016944366
162592,162598,165751,6,3153,2,7200,1.00190294957
162597,162604,165725,7,3121,2,7200,1.00224287087
162643,162649,166341,6,3692,2,7200,1.00162513543
162688,162694,166068,6,3374,2,7200,1.00177830468
162703,162709,166060,6,3351,2,7200,1.0017905103
162785,162791,166214,6,3423,2,7200,1.00175284838
162800,162806,166192,6,3386,2,7200,1.00177200236
162905,162912,166244,7,3332,2,7200,1.00210084034
162951,162957,166392,6,3435,2,7200,1.00174672489
163231,163238,166554,7,3316,2,7200,1.00211097708
163265,163271,166648,6,3377,2,7200,1.0017767249
163494,163500,166698,6,3198,2,7200,1.00187617261
163524,163530,166742,6,3212,2,7200,1.00186799502
163557,163563,166769,6,3206,2,7200,1.00187149095
163818,163824,167277,6,3453,2,7200,1.00173761946
163939,163945,167552,6,3607,2,7200,1.00166343222
164800,164810,168254,10,3444,2,7200,1.00290360046
164910,164916,168275,6,3359,2,7200,1.00178624591
165040,165046,168330,6,3284,2,7200,1.00182704019
165061,165067,168320,6,3253,2,7200,1.00184445128
165149,165155,168601,6,3446,2,7200,1.00174114916
165163,165170,168515,7,3345,2,7200,1.00209267564
165178,165185,168690,7,3505,2,7200,1.00199714693
165184,165191,199239,7,34048,16,36000,1.00020559211
165193,165199,168342,6,3143,2,7200,1.00190900414
165195,165205,168961,10,3756,2,7200,1.00266240682
165196,165211,168621,15,3410,2,7200,1.00439882698
165253,165261,168671,8,3410,2,7200,1.00234604106
165278,165284,168992,6,3708,2,7200,1.00161812298
165308,165314,168741,6,3427,2,7200,1.00175080245
165447,165454,168941,7,3487,2,7200,1.00200745627
165462,165469,168909,7,3440,2,7200,1.00203488372
165487,165493,168832,6,3339,2,7200,1.00179694519
165532,165539,168863,7,3324,2,7200,1.00210589651
165559,165566,168704,7,3138,2,7200,1.0022307202
165608,165616,169004,8,3388,2,7200,1.00236127509
165689,165696,169175,7,3479,2,7200,1.00201207243
165730,165736,169296,6,3560,2,7200,1.00168539326
165753,165759,169167,6,3408,2,7200,1.00176056338
165768,165774,169110,6,3336,2,7200,1.00179856115
165783,165789,169086,6,3297,2,7200,1.00181983621
165815,165822,169255,7,3433,2,7200,1.00203903292
165910,165916,169258,6,3342,2,7200,1.00179533214
165925,165931,169222,6,3291,2,7200,1.00182315406
165992,165998,169604,6,3606,2,7200,1.00166389351
165995,166005,169688,10,3683,2,7200,1.00271517784
166062,166068,169477,6,3409,2,7200,1.00176004693
166076,166083,169330,7,3247,2,7200,1.00215583616
166101,166107,169550,6,3443,2,7200,1.00174266628
166192,166198,169622,6,3424,2,7200,1.00175233645
166216,166222,169774,6,3552,2,7200,1.00168918919
166246,166253,169790,7,3537,2,7200,1.00197907831
166341,166347,169654,6,3307,2,7200,1.00181433323
166393,166399,169449,6,3050,2,7200,1.00196721311
166567,166573,170078,6,3505,2,7200,1.00171184023
166652,166659,170219,7,3560,2,7200,1.00196629213
166697,166703,170241,6,3538,2,7200,1.00169587337
166743,166749,170108,6,3359,2,7200,1.00178624591
166769,166776,169835,7,3059,2,7200,1.00228832952
167277,167283,170945,6,3662,2,7200,1.00163844894
167553,167559,170856,6,3297,2,7200,1.00181983621
168293,168299,171868,6,3569,2,7200,1.00168114318
168294,168306,171789,12,3483,2,7200,1.00344530577
168322,168328,171698,6,3370,2,7200,1.00178041543
168337,168343,171676,6,3333,2,7200,1.00180018002
168352,168359,171516,7,3157,2,7200,1.0022172949
168514,168520,172066,6,3546,2,7200,1.00169204738
168602,168608,172035,6,3427,2,7200,1.00175080245
168624,168630,171755,6,3125,2,7200,1.00192
168669,168676,171818,7,3142,2,7200,1.00222788033
168691,168698,172200,7,3502,2,7200,1.0019988578
168705,168711,172166,6,3455,2,7200,1.0017366136
168742,168748,172132,6,3384,2,7200,1.00177304965
168833,168839,172307,6,3468,2,7200,1.00173010381
168863,168869,172193,6,3324,2,7200,1.00180505415
168911,168918,172242,7,3324,2,7200,1.00210589651
168942,168948,172257,6,3309,2,7200,1.00181323663
168963,168969,172486,6,3517,2,7200,1.00170599943
168990,168996,172373,6,3377,2,7200,1.0017767249
169005,169011,172276,6,3265,2,7200,1.00183767228
169084,169090,172364,6,3274,2,7200,1.00183262065
169111,169117,172569,6,3452,2,7200,1.00173812283
169166,169172,172686,6,3514,2,7200,1.00170745589
169181,169187,172623,6,3436,2,7200,1.00174621653
169222,169228,172437,6,3209,2,7200,1.00186974135
169255,169262,172709,7,3447,2,7200,1.00203075138
169257,169268,172704,11,3436,2,7200,1.00320139697
169301,169308,172980,7,3672,2,7200,1.00190631808
169333,169340,172778,7,3438,2,7200,1.00203606748
169453,169460,172692,7,3232,2,7200,1.00216584158
169477,169483,173013,6,3530,2,7200,1.00169971671
169550,169556,172877,6,3321,2,7200,1.00180668473
169605,169611,172972,6,3361,2,7200,1.00178518298
169620,169626,172832,6,3206,2,7200,1.00187149095
169656,169662,173095,6,3433,2,7200,1.0017477425
169692,169698,173107,6,3409,2,7200,1.00176004693
169776,169783,173118,7,3335,2,7200,1.00209895052
169791,169797,173393,6,3596,2,7200,1.00166852058
169837,169843,173405,6,3562,2,7200,1.00168444694
170078,170084,173558,6,3474,2,7200,1.00172711572
170111,170117,173593,6,3476,2,7200,1.00172612198
170217,170224,173604,7,3380,2,7200,1.00207100592
170239,170245,173561,6,3316,2,7200,1.00180940893
170860,170866,174375,6,3509,2,7200,1.00170988886
170944,170951,174549,7,3598,2,7200,1.00194552529
171520,171526,174841,6,3315,2,7200,1.00180995475
171678,171684,174949,6,3265,2,7200,1.00183767228
171699,171705,175188,6,3483,2,7200,1.00172265289
171756,171762,175325,6,3563,2,7200,1.00168397418
171784,171790,175136,6,3346,2,7200,1.00179318589
171820,171826,175367,6,3541,2,7200,1.0016944366
171865,171871,175381,6,3510,2,7200,1.00170940171
172035,172043,175490,8,3447,2,7200,1.00232085872
172066,172072,175554,6,3482,2,7200,1.00172314762
172133,172138,175565,5,3427,2,7200,1.00145900204
172169,172175,175645,6,3470,2,7200,1.00172910663
172193,172199,175686,6,3487,2,7200,1.0017206768
172208,172214,175653,6,3439,2,7200,1.00174469322
172238,172245,175442,7,3197,2,7200,1.00218955271
172259,172265,175784,6,3519,2,7200,1.00170502984
172274,172280,176126,6,3846,2,7200,1.0015600624
172310,172317,175665,7,3348,2,7200,1.00209080048
172365,172371,175766,6,3395,2,7200,1.00176730486
172380,172386,175774,6,3388,2,7200,1.00177095632
172435,172441,175901,6,3460,2,7200,1.00173410405
172487,172495,176039,8,3544,2,7200,1.00225733634
172569,172576,175732,7,3156,2,7200,1.00221799747
172624,172630,176117,6,3487,2,7200,1.0017206768
172685,172691,175875,6,3184,2,7200,1.00188442211
172699,172706,176058,7,3352,2,7200,1.00208830549
172715,172721,175988,6,3267,2,7200,1.00183654729
172716,172727,175874,11,3147,2,7200,1.00349539244
172777,172783,175991,6,3208,2,7200,1.00187032419
172831,172838,176230,7,3392,2,7200,1.00206367925
172877,172883,176291,6,3408,2,7200,1.00176056338
172976,172982,176399,6,3417,2,7200,1.00175592625
172981,172989,176308,8,3319,2,7200,1.00241036457
173015,173021,176339,6,3318,2,7200,1.00180831826
173097,173103,176356,6,3253,2,7200,1.00184445128
173109,173115,176597,6,3482,2,7200,1.00172314762
173118,173124,176574,6,3450,2,7200,1.00173913043
173393,173399,176454,6,3055,2,7200,1.00196399345
173408,173414,176704,6,3290,2,7200,1.00182370821
173559,173566,177236,7,3670,2,7200,1.00190735695
173574,173581,176959,7,3378,2,7200,1.00207223209
173596,173602,177245,6,3643,2,7200,1.00164699424
173611,173617,177123,6,3506,2,7200,1.00171135197
174378,174384,177761,6,3377,2,7200,1.0017767249
174550,174556,177714,6,3158,2,7200,1.00189993667
174842,174848,178228,6,3380,2,7200,1.00177514793
174950,174957,178551,7,3594,2,7200,1.0019476906
175140,175146,178433,6,3287,2,7200,1.00182537268
175192,175198,178528,6,3330,2,7200,1.0018018018
175322,175329,178843,7,3514,2,7200,1.00199203187
175368,175374,178654,6,3280,2,7200,1.00182926829
175383,175389,178420,6,3031,2,7200,1.0019795447
175440,175446,178878,6,3432,2,7200,1.00174825175
175491,175498,178743,7,3245,2,7200,1.00215716487
175555,175561,178951,6,3390,2,7200,1.0017699115
175570,175576,178939,6,3363,2,7200,1.00178412132
175646,175652,179063,6,3411,2,7200,1.00175901495
175661,175667,179031,6,3364,2,7200,1.00178359096
175676,175682,179196,6,3514,2,7200,1.00170745589
175691,175697,179060,6,3363,2,7200,1.00178412132
175733,175739,178880,6,3141,2,7200,1.00191021968
175767,175773,178949,6,3176,2,7200,1.00188916877
175782,175788,179423,6,3635,2,7200,1.00165061898
175783,175794,178901,11,3107,2,7200,1.00354039266
175875,175882,179116,7,3234,2,7200,1.00216450216
175876,175888,179316,12,3428,2,7200,1.00350058343
175900,175907,179276,7,3369,2,7200,1.00207776788
175988,175994,179166,6,3172,2,7200,1.00189155107
175990,176000,179072,10,3072,2,7200,1.00325520833
176038,176044,179373,6,3329,2,7200,1.00180234305
176061,176067,179277,6,3210,2,7200,1.00186915888
176116,176122,179664,6,3542,2,7200,1.00169395822
176131,176137,179298,6,3161,2,7200,1.0018981335
176230,176237,179644,7,3407,2,7200,1.00205459348
176291,176297,179827,6,3530,2,7200,1.00169971671
176310,176317,179822,7,3505,2,7200,1.00199714693
176337,176343,179519,6,3176,2,7200,1.00188916877
176355,176361,180023,6,3662,2,7200,1.00163844894
176400,176407,179795,7,3388,2,7200,1.0020661157
176455,176461,179674,6,3213,2,7200,1.00186741363
176576,176582,179991,6,3409,2,7200,1.00176004693
176597,176603,180132,6,3529,2,7200,1.00170019836
176704,176710,180177,6,3467,2,7200,1.00173060283
176961,176967,180315,6,3348,2,7200,1.0017921147
177123,177129,180443,6,3314,2,7200,1.00181050091
177237,177243,180656,6,3413,2,7200,1.00175798418
177247,177254,180741,7,3487,2,7200,1.00200745627
177715,177722,180926,7,3204,2,7200,1.00218476904
177761,177767,181053,6,3286,2,7200,1.00182592818
178231,178237,181782,6,3545,2,7200,1.00169252468
178420,178425,181984,5,3559,2,7200,1.00140488901
178435,178441,181768,6,3327,2,7200,1.00180342651
178529,178535,181773,6,3238,2,7200,1.00185299568
178544,178550,182023,6,3473,2,7200,1.00172761301
178653,178659,182120,6,3461,2,7200,1.001733603
178743,178750,182202,7,3452,2,7200,1.00202780997
178847,178853,182365,6,3512,2,7200,1.00170842825
178880,178886,182353,6,3467,2,7200,1.00173060283
178882,178893,182234,11,3341,2,7200,1.00329242742
178903,178909,182270,6,3361,2,7200,1.00178518298
178939,178945,182221,6,3276,2,7200,1.00183150183
178954,178960,182367,6,3407,2,7200,1.00176108013
178955,178967,182398,12,3431,2,7200,1.00349752259
179028,179034,182279,6,3245,2,7200,1.00184899846
179061,179067,182602,6,3535,2,7200,1.00169731259
179076,179082,182587,6,3505,2,7200,1.00171184023
179077,179089,182541,12,3452,2,7200,1.00347624565
179117,179123,182496,6,3373,2,7200,1.0017788319
179169,179175,182168,6,2993,2,7200,1.00200467758
179199,179205,182451,6,3246,2,7200,1.00184842884
179278,179284,182505,6,3221,2,7200,1.00186277554
179279,179290,182545,11,3255,2,7200,1.00337941628
179297,179303,182713,6,3410,2,7200,1.00175953079
179319,179325,182520,6,3195,2,7200,1.00187793427
179373,179379,182777,6,3398,2,7200,1.00176574456
179422,179428,182823,6,3395,2,7200,1.00176730486
179516,179522,182932,6,3410,2,7200,1.00175953079
179643,179649,183083,6,3434,2,7200,1.00174723355
179664,179671,182990,7,3319,2,7200,1.002109069
179680,179686,183207,6,3521,2,7200,1.00170406135
179798,179804,183276,6,3472,2,7200,1.0017281106
179822,179828,183240,6,3412,2,7200,1.00175849941
179828,179834,183219,6,3385,2,7200,1.00177252585
179992,179998,183288,6,3290,2,7200,1.00182370821
180023,180030,183400,7,3370,2,7200,1.00207715134
180135,180141,183683,6,3542,2,7200,1.00169395822
180176,180183,183339,7,3156,2,7200,1.00221799747
180315,180321,183758,6,3437,2,7200,1.00174570847
180445,180451,184021,6,3570,2,7200,1.00168067227
180659,180665,184175,6,3510,2,7200,1.00170940171
180742,180748,183926,6,3178,2,7200,1.00188797986
180928,180934,184289,6,3355,2,7200,1.00178837556
181053,181059,184706,6,3647,2,7200,1.00164518783
181754,181760,181933,6,173,1,3600,1.03468208092
181771,181777,185076,6,3299,2,7200,1.00181873295
181772,181783,184946,11,3163,2,7200,1.00347771103
181787,181793,185124,6,3331,2,7200,1.00180126088
181983,181989,185375,6,3386,2,7200,1.00177200236
182025,182031,185493,6,3462,2,7200,1.00173310225
182111,182117,182469,6,352,1,3600,1.01704545455
182122,182128,185517,6,3389,2,7200,1.00177043376
182168,182174,185456,6,3282,2,7200,1.00182815356
182204,182210,185564,6,3354,2,7200,1.00178890877
182224,182230,185635,6,3405,2,7200,1.00176211454
182239,182245,185561,6,3316,2,7200,1.00180940893
182273,182279,185582,6,3303,2,7200,1.00181653043
182287,182294,185759,7,3465,2,7200,1.00202020202
182354,182360,185605,6,3245,2,7200,1.00184899846
182370,182376,185747,6,3371,2,7200,1.00177988727
182371,182382,185677,11,3295,2,7200,1.0033383915
182401,182407,185600,6,3193,2,7200,1.00187911055
182454,182460,185909,6,3449,2,7200,1.00173963468
182496,182502,186058,6,3556,2,7200,1.00168728909
182511,182517,185975,6,3458,2,7200,1.001735107
182526,182532,186076,6,3544,2,7200,1.00169300226
182541,182548,185990,7,3442,2,7200,1.00203370134
182556,182562,185893,6,3331,2,7200,1.00180126088
182589,182595,185976,6,3381,2,7200,1.00177462289
182604,182610,185941,6,3331,2,7200,1.00180126088
182713,182719,185937,6,3218,2,7200,1.00186451212
182777,182783,185873,6,3090,2,7200,1.00194174757
182825,182831,185720,6,2889,2,7200,1.0020768432
182839,182845,183697,6,852,1,3600,1.00704225352
182935,182941,186224,6,3283,2,7200,1.00182759671
182992,182998,186296,6,3298,2,7200,1.00181928441
183081,183087,186683,6,3596,2,7200,1.00166852058
183209,183215,186396,6,3181,2,7200,1.00188619931
183224,183230,186435,6,3205,2,7200,1.00187207488
183242,183248,186637,6,3389,2,7200,1.00177043376
183278,183284,186659,6,3375,2,7200,1.00177777778
183293,183300,186824,7,3524,2,7200,1.00198637911
183339,183345,186505,6,3160,2,7200,1.00189873418
183402,183409,186912,7,3503,2,7200,1.00199828718
183685,183692,187194,7,3502,2,7200,1.0019988578
183760,183767,187206,7,3439,2,7200,1.00203547543
183928,183934,187324,6,3390,2,7200,1.0017699115
184022,184029,187446,7,3417,2,7200,1.00204858063
184179,184185,187429,6,3244,2,7200,1.00184956843
184291,184298,187698,7,3400,2,7200,1.00205882353
184555,184562,184677,7,115,1,3600,1.06086956522
184706,184712,188201,6,3489,2,7200,1.00171969046
184861,184867,185192,6,325,1,3600,1.01846153846
184947,184953,188230,6,3277,2,7200,1.00183094294
185078,185084,188379,6,3295,2,7200,1.00182094082
185127,185133,188343,6,3210,2,7200,1.00186915888
185373,185379,188678,6,3299,2,7200,1.00181873295
185456,185462,188821,6,3359,2,7200,1.00178624591
185495,185501,188997,6,3496,2,7200,1.00171624714
185519,185525,188998,6,3473,2,7200,1.00172761301
185562,185568,188861,6,3293,2,7200,1.00182204677
185577,185583,188870,6,3287,2,7200,1.00182537268
185592,185598,189055,6,3457,2,7200,1.00173560891
185607,185613,188747,6,3134,2,7200,1.00191448628
185609,185619,188796,10,3177,2,7200,1.00314762354
185630,185636,189043,6,3407,2,7200,1.00176108013
185667,185674,186320,7,646,1,3600,1.01083591331
185678,185685,189092,7,3407,2,7200,1.00205459348
185692,185698,185870,6,172,1,3600,1.03488372093
185723,185729,189138,6,3409,2,7200,1.00176004693
185744,185750,189355,6,3605,2,7200,1.00166435506
185759,185765,188934,6,3169,2,7200,1.00189334175
185871,185880,189110,9,3230,2,7200,1.00278637771
185890,185896,189405,6,3509,2,7200,1.00170988886
185911,185917,189538,6,3621,2,7200,1.00165700083
185938,185944,189333,6,3389,2,7200,1.00177043376
185953,185959,189087,6,3128,2,7200,1.00191815857
185974,185980,189093,6,3113,2,7200,1.00192740122
185989,185995,189473,6,3478,2,7200,1.00172512938
185991,186002,189443,11,3441,2,7200,1.00319674513
186034,186040,186452,6,412,1,3600,1.0145631068
186061,186067,189460,6,3393,2,7200,1.0017683466
186076,186083,189162,7,3079,2,7200,1.00227346541
186222,186228,189574,6,3346,2,7200,1.00179318589
186298,186304,189502,6,3198,2,7200,1.00187617261
186398,186404,189867,6,3463,2,7200,1.00173260179
186437,186443,189571,6,3128,2,7200,1.00191815857
186507,186515,190129,8,3614,2,7200,1.00221361372
186641,186647,190031,6,3384,2,7200,1.00177304965
186654,186660,189815,6,3155,2,7200,1.00190174326
186681,186687,190034,6,3347,2,7200,1.00179265013
186820,186826,187799,6,973,1,3600,1.00616649538
186824,186832,190153,8,3321,2,7200,1.00240891298
186912,186918,190369,6,3451,2,7200,1.00173862649
187198,187204,190695,6,3491,2,7200,1.00171870524
187207,187213,190622,6,3409,2,7200,1.00176004693
187325,187331,190791,6,3460,2,7200,1.00173410405
187431,187437,190957,6,3520,2,7200,1.00170454545
187449,187455,191093,6,3638,2,7200,1.00164925783
187700,187706,190922,6,3216,2,7200,1.00186567164
188202,188209,191634,7,3425,2,7200,1.00204379562
188230,188236,191499,6,3263,2,7200,1.00183879865
188345,188351,191532,6,3181,2,7200,1.00188619931
188381,188387,191646,6,3259,2,7200,1.00184105554
188680,188686,192200,6,3514,2,7200,1.00170745589
188747,188753,192142,6,3389,2,7200,1.00177043376
188796,188802,192607,6,3805,2,7200,1.00157687254
188820,188826,192062,6,3236,2,7200,1.00185414091
188862,188869,192198,7,3329,2,7200,1.00210273355
188877,188884,192000,7,3116,2,7200,1.00224646983
188932,188938,192443,6,3505,2,7200,1.00171184023
188998,189005,192643,7,3638,2,7200,1.00192413414
189000,189013,192841,13,3828,2,7200,1.00339602926
189046,189052,192309,6,3257,2,7200,1.00184218606
189061,189066,192396,5,3330,2,7200,1.0015015015
189088,189095,192436,7,3341,2,7200,1.00209518108
189103,189111,192300,8,3189,2,7200,1.00250862339
189105,189117,192435,12,3318,2,7200,1.00361663653
189120,189126,192410,6,3284,2,7200,1.00182704019
189138,189145,192493,7,3348,2,7200,1.00209080048
189162,189169,192640,7,3471,2,7200,1.00201670988
189335,189341,192693,6,3352,2,7200,1.00178997613
189356,189362,192914,6,3552,2,7200,1.00168918919
189405,189411,193021,6,3610,2,7200,1.00166204986
189444,189451,192896,7,3445,2,7200,1.00203193033
189459,189466,192590,7,3124,2,7200,1.00224071703
189474,189480,192935,6,3455,2,7200,1.0017366136
189475,189487,189833,12,346,1,3600,1.03468208092
189502,189508,193046,6,3538,2,7200,1.00169587337
189538,189544,193069,6,3525,2,7200,1.00170212766
189571,189578,192748,7,3170,2,7200,1.00220820189
189587,189593,193011,6,3418,2,7200,1.00175541252
189816,189823,193333,7,3510,2,7200,1.00199430199
189868,189874,193111,6,3237,2,7200,1.00185356812
190032,190039,193512,7,3473,2,7200,1.00201554852
190035,190046,193336,11,3290,2,7200,1.00334346505
190084,190091,190695,7,604,1,3600,1.01158940397
190091,190099,190326,8,227,1,1800,1.03524229075
190129,190135,193579,6,3444,2,7200,1.00174216028
190153,190159,193476,6,3317,2,7200,1.00180886343
190369,190375,193859,6,3484,2,7200,1.00172215844
190621,190627,194182,6,3555,2,7200,1.00168776371
190679,190685,190847,6,162,1,1800,1.03703703704
190697,190705,194140,8,3435,2,7200,1.00232896652
190794,190800,194281,6,3481,2,7200,1.00172364263
190925,190931,194136,6,3205,2,7200,1.00187207488
190958,190964,194261,6,3297,2,7200,1.00181983621
191093,191101,194538,8,3437,2,7200,1.00232761129
191246,191252,191870,6,618,1,3600,1.00970873786
191501,191508,195029,7,3521,2,7200,1.00198807157
191532,191538,194922,6,3384,2,7200,1.00177304965
191597,191603,192110,6,507,1,1800,1.01183431953
191635,191641,194952,6,3311,2,7200,1.00181214135
191650,191657,194944,7,3287,2,7200,1.00212960146
191998,192004,195202,6,3198,2,7200,1.00187617261
192062,192068,195436,6,3368,2,7200,1.00178147268
192141,192147,195296,6,3149,2,7200,1.00190536678
192199,192205,195813,6,3608,2,7200,1.00166297118
192214,192220,195612,6,3392,2,7200,1.00176886792
192302,192308,195786,6,3478,2,7200,1.00172512938
192317,192323,195544,6,3221,2,7200,1.00186277554
192396,192402,195997,6,3595,2,7200,1.0016689847
192411,192417,195821,6,3404,2,7200,1.0017626322
192435,192442,195919,7,3477,2,7200,1.0020132298
192437,192447,195549,10,3102,2,7200,1.00322372663
192452,192458,195838,6,3380,2,7200,1.00177514793
192491,192498,195916,7,3418,2,7200,1.00204798128
192591,192597,195953,6,3356,2,7200,1.00178784267
192607,192613,196050,6,3437,2,7200,1.00174570847
192641,192647,195891,6,3244,2,7200,1.00184956843
192656,192662,196065,6,3403,2,7200,1.00176315016
192695,192701,196138,6,3437,2,7200,1.00174570847
192750,192756,196182,6,3426,2,7200,1.00175131349
192844,192850,196161,6,3311,2,7200,1.00181214135
192896,192902,196243,6,3341,2,7200,1.0017958695
192914,192920,196179,6,3259,2,7200,1.00184105554
192935,192941,196401,6,3460,2,7200,1.00173410405
193014,193021,196600,7,3579,2,7200,1.00195585359
193030,193036,196307,6,3271,2,7200,1.00183430144
193048,193054,196470,6,3416,2,7200,1.00175644028
193067,193073,193194,6,121,1,1800,1.04958677686
193069,193080,196275,11,3195,2,7200,1.0034428795
193111,193117,196413,6,3296,2,7200,1.00182038835
193287,193294,193344,7,50,1,1800,1.14
193335,193342,196711,7,3369,2,7200,1.00207776788
193337,193348,196861,11,3513,2,7200,1.00313122687
193477,193483,197008,6,3525,2,7200,1.00170212766
193514,193520,197195,6,3675,2,7200,1.00163265306
193520,193526,193641,6,115,1,1800,1.05217391304
193580,193586,196832,6,3246,2,7200,1.00184842884
193660,193666,193747,6,81,1,1800,1.07407407407
193859,193865,197294,6,3429,2,7200,1.00174978128
194138,194144,197700,6,3556,2,7200,1.00168728909
194141,194150,197622,9,3472,2,7200,1.0025921659
194184,194190,197579,6,3389,2,7200,1.00177043376
194260,194266,197854,6,3588,2,7200,1.0016722408
194284,194290,197746,6,3456,2,7200,1.00173611111
194343,194349,194943,6,594,1,1800,1.0101010101
194462,194469,194472,7,3,2,3540,1.0
194659,194665,194670,6,5,2,3540,1.1
194748,194754,195053,6,299,1,1800,1.02006688963
195023,195030,195049,7,19,2,3540,1.36842105263
195742,195748,199298,6,3550,2,3540,1.00169014085
196838,196844,196894,6,50,1,1800,1.12
197234,197242,197314,8,72,1,1800,1.11111111111
197624,244991,244992,47367,1,2,7200,4736.8
198350,198356,198636,6,280,1,1800,1.02142857143
199722,199729,201548,7,1819,2,1800,1.00384826828
200508,200514,200517,6,3,4,600,1.0
200582,200588,201223,6,635,4,600,1.0094488189
202686,245111,245112,42425,1,2,7200,4242.6
202690,245155,245157,42465,2,2,7200,4246.7
202720,245277,245278,42557,1,2,7200,4255.8
202725,245298,245299,42573,1,2,7200,4257.4
274536,274542,734537,6,459995,16,540000,1.00001304362
274679,274685,634719,6,360034,8,360000,1.00001666509
276962,276969,276971,7,2,2,43200,1.0
277283,277289,277290,6,1,2,43200,1.0
277553,277559,277756,6,197,2,43200,1.03045685279
277594,277611,277617,17,6,6,28800,2.3
277594,277600,277605,6,5,6,28800,1.1
277595,277623,277626,28,3,6,28800,3.1
277596,277633,277640,37,7,6,28800,4.4
277596,277646,277650,50,4,6,28800,5.4
277597,277656,277659,59,3,6,28800,6.2
277598,277666,277670,68,4,6,28800,7.2
277599,277686,277690,87,4,6,28800,9.1
277599,277676,277680,77,4,6,28800,8.1
277600,277696,277699,96,3,6,28800,9.9
277601,277706,277710,105,4,6,28800,10.9
277602,277726,277729,124,3,6,28800,12.7
277602,277716,277719,114,3,6,28800,11.7
277603,277736,277740,133,4,6,28800,13.7
277604,277746,277749,142,3,6,28800,14.5
277604,277756,277759,152,3,6,28800,15.5
277605,277766,277767,161,1,6,28800,16.2
278074,278080,278257,6,177,2,43200,1.03389830508
278163,278169,278171,6,2,6,28800,1.0
278377,278383,309722,6,31339,2,43200,1.00019145474
279811,279817,301456,6,21639,11,21600,1.00027727714
280244,280250,280272,6,22,6,28800,1.27272727273
280245,280303,280312,58,9,6,28800,6.7
280245,280283,280292,38,9,6,28800,4.7
280246,280323,280331,77,8,6,28800,8.5
280247,280343,280353,96,10,6,28800,10.6
280248,280385,280395,137,10,6,28800,14.7
280248,280364,280374,116,10,6,28800,12.6
280249,280406,280416,157,10,6,28800,16.7
280250,280427,280441,177,14,6,28800,13.6428571429
280251,280452,280461,201,9,6,28800,21.0
280500,280506,280526,6,20,32,900,1.3
280539,280545,281465,6,920,32,900,1.00652173913
280780,280785,309615,5,28830,6,28800,1.00017343045
282513,336350,348227,53837,11877,4,360000,5.53287867307
282925,282931,290154,6,7223,32,7200,1.00083067977
283018,283024,285800,6,2776,2,7200,1.00216138329
283019,283030,285967,11,2937,2,7200,1.00374531835
283021,283035,286140,14,3105,2,7200,1.00450885668
283022,283041,286223,19,3182,2,7200,1.00597108737
283023,283046,285830,23,2784,2,7200,1.00826149425
283025,283051,285816,26,2765,2,7200,1.00940325497
283026,283057,286243,31,3186,2,7200,1.00973006905
283027,283062,286022,35,2960,2,7200,1.01182432432
283029,283068,286079,39,3011,2,7200,1.01295250747
283030,283073,286071,43,2998,2,7200,1.01434289526
283031,283078,286025,47,2947,2,7200,1.01594842212
283032,283083,285955,51,2872,2,7200,1.01775766017
283033,320433,919394,37400,598961,3,604800,1.06244146113
283034,283089,286209,55,3120,2,7200,1.01762820513
283035,283094,285974,59,2880,2,7200,1.02048611111
283036,283099,286084,63,2985,2,7200,1.02110552764
283038,283104,285906,66,2802,2,7200,1.02355460385
283039,283110,286090,71,2980,2,7200,1.02382550336
283040,283115,286119,75,3004,2,7200,1.02496671105
283042,283120,286151,78,3031,2,7200,1.02573408116
283043,283125,286165,82,3040,2,7200,1.02697368421
283044,283131,286032,87,2901,2,7200,1.02998965874
283046,283136,286105,90,2969,2,7200,1.03031323678
283047,283141,286000,94,2859,2,7200,1.03287862889
283048,283146,286021,98,2875,2,7200,1.03408695652
283049,326919,919398,43870,592479,3,604800,1.07404481847
283050,283152,286037,102,2885,2,7200,1.03535528596
283051,283157,286120,106,2963,2,7200,1.03577455282
283052,283163,286138,111,2975,2,7200,1.03731092437
283054,283168,286270,114,3102,2,7200,1.03675048356
283055,283174,286094,119,2920,2,7200,1.04075342466
283056,283179,286015,123,2836,2,7200,1.04337094499
283057,283184,286156,127,2972,2,7200,1.04273216689
283059,283189,286179,130,2990,2,7200,1.04347826087
283060,283195,286146,135,2951,2,7200,1.04574720434
283061,283200,286076,139,2876,2,7200,1.0483310153
283063,283205,286185,142,2980,2,7200,1.04765100671
283064,283211,286329,147,3118,2,7200,1.04714560616
283065,283216,286332,151,3116,2,7200,1.04845956354
283067,283221,286025,154,2804,2,7200,1.05492154066
283068,283226,286067,158,2841,2,7200,1.05561422034
283069,283232,286454,163,3222,2,7200,1.05058969584
283083,326925,557639,43842,230714,3,604800,1.19002747991
283100,326961,920116,43861,593155,3,604800,1.07394525883
284628,326619,380774,41991,54155,16,72000,1.77538546764
284710,326624,380774,41914,54150,16,288000,1.77403508772
285163,285170,285185,7,15,1,172800,1.46666666667
285801,301478,304434,15677,2956,2,7200,6.30345060893
285819,301491,304367,15672,2876,2,7200,6.44923504868
285834,301496,304314,15662,2818,2,7200,6.55784244145
285909,301501,304425,15592,2924,2,7200,6.33242134063
285957,301506,304390,15549,2884,2,7200,6.39147018031
285971,304325,306970,18354,2645,2,7200,7.93913043478
285986,304378,307133,18392,2755,2,7200,7.67586206897
286001,304402,307329,18401,2927,2,7200,7.28664161257
286018,304437,307372,18419,2935,2,7200,7.27563884157
286034,304445,307361,18411,2916,2,7200,7.31378600823
286035,306982,309701,20947,2719,2,7200,8.70393527032
286036,307144,309819,21108,2675,2,7200,8.8908411215
286038,307341,310141,21303,2800,2,7200,8.60821428571
286039,307373,310450,21334,3077,2,7200,7.93337666558
286054,307383,310370,21329,2987,2,7200,8.140609307
286068,309627,312540,23559,2913,2,7200,9.08753861998
286084,309632,312650,23548,3018,2,7200,8.80251822399
286085,309638,312689,23553,3051,2,7200,8.7197640118
286086,309713,312600,23627,2887,2,7200,9.18392795289
286101,309735,312617,23634,2882,2,7200,9.20055517002
286103,317586,320770,31483,3184,2,7200,10.8878768844
286104,320782,323577,34678,2795,2,7200,13.4071556351
286119,323588,326396,37469,2808,2,7200,14.3436609687
286120,326407,329213,40287,2806,2,7200,15.357448325
286135,326641,329622,40506,2981,2,7200,14.5880576988
286150,326646,329523,40496,2877,2,7200,15.075773375
286151,326651,329544,40500,2893,2,7200,14.9993086761
286153,326656,329438,40503,2782,2,7200,15.5589503954
286168,326662,329714,40494,3052,2,7200,14.2680209699
286169,326667,329595,40498,2928,2,7200,14.831284153
286170,326672,329488,40502,2816,2,7200,15.3828125
286185,326677,329663,40492,2986,2,7200,14.560616209
286187,326683,329745,40496,3062,2,7200,14.2253429131
286210,326688,329688,40478,3000,2,7200,14.4926666667
286225,326693,329689,40468,2996,2,7200,14.5073431242
286246,326699,329601,40453,2902,2,7200,14.9396967609
286270,326704,329712,40434,3008,2,7200,14.4421542553
286298,326598,333824,40300,7226,32,7200,6.57708275671
286330,326709,329552,40379,2843,2,7200,15.2029546254
286345,326714,329638,40369,2924,2,7200,14.8060875513
286456,326720,329402,40264,2682,2,7200,16.0126771066
286694,286701,337968,7,51267,1,86400,1.00013654007
289118,301515,302587,12397,1072,1,3600,12.5643656716
289137,302599,303667,13462,1068,1,3600,13.6048689139
289148,303679,304750,14531,1071,1,3600,14.5676937442
289161,304762,305828,15601,1066,1,3600,15.6350844278
289889,326725,339469,36836,12744,2,21600,3.89045825487
289940,326968,340026,37028,13058,2,21600,3.83565630265
289980,329229,337976,39249,8747,2,21600,5.48713844747
290111,333836,335139,43725,1303,2,14400,34.5571757483
290227,333842,334903,43615,1061,2,14400,42.1074458058
290305,333847,335883,43542,2036,2,21600,22.3860510806
290779,333852,335841,43073,1989,2,21600,22.6556058321
290807,333857,335594,43050,1737,2,21600,25.7841105354
291295,333863,335903,42568,2040,2,21600,21.8666666667
291398,333868,335076,42470,1208,2,21600,36.1572847682
291501,333874,334888,42373,1014,2,21600,42.7879684418
291610,333879,336053,42269,2174,2,21600,20.4429622815
291754,333885,335968,42131,2083,2,21600,21.2261161786
291866,333890,340241,42024,6351,2,21600,7.61691072272
291919,335970,372002,44051,36032,3,36000,2.22255217584
291937,335975,372006,44038,36031,3,36000,2.22222530599
291946,335981,372001,44035,36020,3,36000,2.22251526929
291952,335986,372007,44034,36021,3,36000,2.22245356875
291959,335992,372001,44033,36009,3,36000,2.22283318059
291976,333895,340178,41919,6283,2,21600,7.67181282827
292170,292177,292725,7,548,256,3600,1.01277372263
292217,333901,339911,41684,6010,2,21600,7.93577371048
292336,333906,340066,41570,6160,2,21600,7.74837662338
292438,333911,340226,41473,6315,2,21600,7.56737925574
292593,292599,292601,6,2,1,15,1.0
292685,333916,340417,41231,6501,2,21600,7.34225503769
292829,333922,333955,41093,33,2,21600,1246.24242424
292875,292882,292883,7,1,1,10,1.0
292916,326891,443742,33975,116851,8,172800,1.29075489298
292941,333937,411853,40996,77916,2,180000,1.52615637353
292958,333927,333959,40969,32,2,21600,1281.28125
292976,292983,292985,7,2,1,10,1.0
293053,333932,336339,40879,2407,2,21600,17.9833818031
293169,293177,293178,8,1,1,10,1.0
293188,333943,335851,40755,1908,2,72000,22.3600628931
293348,317558,317575,24210,17,2,1200,1425.11764706
293414,293420,294656,6,1236,256,3600,1.00485436893
293427,293434,293435,7,1,1,10,1.0
293456,326868,326950,33412,82,2,3600,408.463414634
293591,326874,326954,33283,80,2,3600,417.0375
293651,293658,293660,7,2,2,10,1.0
293691,333948,334030,40257,82,2,3600,491.93902439
293825,333953,334034,40128,81,2,3600,496.407407407
293950,333966,334044,40016,78,2,3600,514.025641026
294055,294062,294063,7,1,2,10,1.0
294061,333974,334051,39913,77,2,3600,519.350649351
294149,334042,334121,39893,79,2,3600,505.974683544
294207,294213,294214,6,1,1,10,1.0
294442,294449,294450,7,1,2,10,1.0
294694,294700,294702,6,2,2,10,1.0
294721,326914,931731,32193,604817,8,604800,1.05322767052
295000,326603,326608,31603,5,20,432000,3160.8
295156,326609,333105,31453,6496,25,7199,5.84190270936
295208,326614,333819,31406,7205,25,7199,5.35891741846
295781,326630,326634,30849,4,20,432000,3085.3
295985,314192,350222,18207,36030,16,36000,1.50532889259
296087,296095,296103,8,8,1,60,1.6
296139,296146,296771,7,625,16,600,1.0112
296232,296238,296876,6,638,32,600,1.00940438871
296322,296328,297543,6,1215,32,1200,1.0049382716
296440,296446,296459,6,13,2,60,1.46153846154
296482,296490,296500,8,10,4,60,1.8
296583,326635,326639,30052,4,20,432000,3005.6
296667,296674,296691,7,17,4,60,1.41176470588
296724,296731,296748,7,17,4,60,1.41176470588
297072,297079,297720,7,641,1,600,1.01092043682
297089,326852,326854,29763,2,20,259200,2976.5
297118,297126,297769,8,643,2,600,1.01244167963
297139,297146,297766,7,620,4,600,1.01129032258
297152,297160,297774,8,614,8,600,1.01302931596
297281,297287,297327,6,40,64,300,1.15
297337,297343,299171,6,1828,32,1800,1.00328227571
297520,297527,297542,7,15,1,300,1.46666666667
297644,297651,298264,7,613,1,600,1.01141924959
297784,338470,341579,40686,3109,2,14400,14.0865229977
298050,326858,326859,28808,1,20,432000,2880.9
298054,338476,341463,40422,2987,2,14400,14.5326414463
298180,301484,301490,3304,6,1,1800,331.0
298317,298324,298935,7,611,1,600,1.01145662848
298358,301467,301473,3109,6,4,7200,311.5
298394,298406,298425,12,19,1,300,1.63157894737
298394,298401,298418,7,17,1,300,1.41176470588
298395,298411,298425,16,14,1,300,2.14285714286
298395,298419,298433,24,14,1,300,2.71428571429
298407,326863,326872,28456,9,16,72000,2846.5
298414,326880,326896,28466,16,16,72000,1780.125
298418,326885,326903,28467,18,16,72000,1582.5
298427,326897,362920,28470,36023,16,72000,1.7903284013
298433,326907,397687,28474,70780,16,72000,1.40228878214
298441,298448,299662,7,1214,64,1200,1.0057660626
298549,298555,299782,6,1227,64,1200,1.00488997555
298613,298620,298635,7,15,1,300,1.46666666667
298613,298631,298651,18,20,1,300,1.9
298613,298626,298641,13,15,1,300,1.86666666667
298613,298681,298697,68,16,1,300,5.25
298614,298700,298716,86,16,1,300,6.375
298614,298724,298737,110,13,1,300,9.46153846154
298614,298741,298755,127,14,1,300,10.0714285714
298615,298770,298783,155,13,1,300,12.9230769231
298615,298782,298797,167,15,1,300,12.1333333333
298615,298829,298842,214,13,1,300,17.4615384615
298615,298811,298824,196,13,1,300,16.0769230769
298616,298878,298896,262,18,1,300,15.5555555556
298616,298861,298876,245,15,1,300,17.3333333333
298616,298675,298700,59,25,2,300,3.36
298616,298846,298864,230,18,1,300,13.7777777778
298616,298870,298886,254,16,1,300,16.875
298617,298695,298731,78,36,2,300,3.16666666667
298617,298758,298786,141,28,2,300,6.03571428571
298617,298719,298743,102,24,2,300,5.25
298617,298764,298796,147,32,2,300,5.59375
298618,298823,298858,205,35,2,300,6.85714285714
298618,298949,298985,331,36,2,300,10.1944444444
298618,298805,298832,187,27,2,300,7.92592592593
298618,298898,298933,280,35,2,300,9.0
298619,299145,299182,526,37,2,300,15.2162162162
298619,298996,299033,377,37,2,300,11.1891891892
298619,299098,299133,479,35,2,300,14.6857142857
298619,299049,299086,430,37,2,300,12.6216216216
298620,299238,299267,618,29,2,300,22.3103448276
298620,299194,299227,574,33,2,300,18.3939393939
298620,298670,298696,50,26,4,300,2.92307692308
298621,298841,298856,220,15,4,300,15.6666666667
298621,299463,299480,842,17,4,300,50.5294117647
298621,298799,298816,178,17,4,300,11.4705882353
298621,298713,298734,92,21,4,300,5.38095238095
298621,298753,298771,132,18,4,300,8.33333333333
298622,299469,299487,847,18,4,300,48.0555555556
298622,299474,299493,852,19,4,300,45.8421052632
298622,299484,299503,862,19,4,300,46.3684210526
298622,299479,299498,857,19,4,300,46.1052631579
298623,299500,299520,877,20,4,300,44.85
298623,299495,299513,872,18,4,300,49.4444444444
298623,299490,299505,867,15,4,300,58.8
298624,299505,299524,881,19,4,300,47.3684210526
298624,298736,298772,112,36,8,300,4.11111111111
298624,299511,299529,887,18,4,300,50.2777777778
298624,298664,298706,40,42,8,300,1.95238095238
298626,299402,299438,776,36,8,300,22.5555555556
298626,298794,298830,168,36,8,300,5.66666666667
298626,299397,299432,771,35,8,300,23.0285714286
298626,299409,299443,783,34,8,300,24.0294117647
298627,299414,299450,787,36,8,300,22.8611111111
298627,299419,299456,792,37,8,300,22.4054054054
298627,299430,299466,803,36,8,300,23.3055555556
298627,299424,299461,797,37,8,300,22.5405405405
298628,299440,299476,812,36,8,300,23.5555555556
298628,299453,299490,825,37,8,300,23.2972972973
298628,299445,299484,817,39,8,300,21.9487179487
298628,299458,299496,830,38,8,300,22.8421052632
298628,299435,299472,807,37,8,300,22.8108108108
298629,298648,298669,19,21,16,300,1.90476190476
298629,298653,298677,24,24,16,300,2.0
298629,298637,298659,8,22,16,300,1.36363636364
298629,298643,298666,14,23,16,300,1.60869565217
298630,298747,298767,117,20,16,300,6.85
298630,298789,298814,159,25,16,300,7.36
298630,298706,298735,76,29,16,300,3.62068965517
298630,298659,298685,29,26,16,300,2.11538461538
298631,299366,299385,735,19,16,300,39.6842105263
298631,299361,299379,730,18,16,300,41.5555555556
298631,299373,299392,742,19,16,300,40.0526315789
298631,298836,298855,205,19,16,300,11.7894736842
298632,299378,299398,746,20,16,300,38.3
298632,299385,299404,753,19,16,300,40.6315789474
298632,299390,299409,758,19,16,300,40.8947368421
298633,299172,299209,539,37,32,300,15.5675675676
298633,299183,299219,550,36,32,300,16.2777777778
298633,299200,299235,567,35,32,300,17.2
298633,299206,299242,573,36,32,300,16.9166666667
298634,299221,299257,587,36,32,300,17.3055555556
298634,299230,299265,596,35,32,300,18.0285714286
298634,299246,299282,612,36,32,300,18.0
298634,299254,299290,620,36,32,300,18.2222222222
298635,299276,299314,641,38,32,300,17.8684210526
298635,299293,299337,658,44,32,300,15.9545454545
298635,299301,299338,666,37,32,300,19.0
298635,299268,299305,633,37,32,300,18.1081081081
298636,299316,299356,680,40,32,300,18.0
298636,299325,299364,689,39,32,300,18.6666666667
298636,299348,299392,712,44,32,300,17.1818181818
298636,298689,298711,53,22,64,300,3.40909090909
298637,298776,298795,139,19,64,300,8.31578947368
298637,298730,298761,93,31,64,300,4.0
298637,298817,298836,180,19,64,300,10.4736842105
298637,298853,298872,216,19,64,300,12.3684210526
298637,298884,298903,247,19,64,300,14.0
298638,298914,298933,276,19,64,300,15.5263157895
298638,298944,298964,306,20,64,300,16.3
298638,298975,299000,337,25,64,300,14.48
298639,299011,299031,372,20,64,300,19.6
298639,299042,299061,403,19,64,300,22.2105263158
298639,299073,299093,434,20,64,300,22.7
298639,299104,299124,465,20,64,300,24.25
298640,299135,299154,495,19,64,300,27.0526315789
298640,299166,299186,526,20,64,300,27.3
299722,338481,348894,38759,10413,2,21600,4.72217420532
300169,300176,300178,7,2,2,3600,1.0
300181,338486,351081,38305,12595,2,21600,4.04128622469
300218,300225,300228,7,3,2,3600,1.0
300422,300430,300466,8,36,1,300,1.22222222222
300423,300435,300473,12,38,1,300,1.31578947368
300424,300443,300482,19,39,1,300,1.48717948718
300675,300682,300687,7,5,2,3600,1.2
300684,300691,300724,7,33,1,300,1.21212121212
300685,300698,300734,13,36,1,300,1.36111111111
300720,301473,301476,753,3,4,10800,75.6
300726,339301,350891,38575,11590,2,21600,4.32830025884
301308,339480,350743,38172,11263,2,21600,4.38915031519
301640,301647,302276,7,629,16,600,1.01112877583
301641,301655,302276,14,621,16,600,1.02254428341
301642,301661,302304,19,643,16,600,1.02954898911
301643,301666,302313,23,647,16,600,1.03554868624
301643,301671,302300,28,629,16,600,1.04451510334
301990,301997,302620,7,623,2,600,1.01123595506
302232,339922,350058,37690,10136,2,21600,4.71842936069
303594,303602,304085,8,483,2,600,1.016563147
304314,326793,329866,22479,3073,2,7200,8.31500162707
304368,326798,329740,22430,2942,2,7200,8.62406526173
304392,326804,329736,22412,2932,2,7200,8.64392905866
304425,326809,329514,22384,2705,2,7200,9.27504621072
304440,326814,329934,22374,3120,2,7200,8.17115384615
305417,305841,306371,424,530,1,7200,1.8
306972,326819,329764,19847,2945,2,7200,7.73921901528
307134,326825,329873,19691,3048,2,7200,7.46030183727
307195,344893,348234,37698,3341,4,43200,12.2834480694
307329,314759,317547,7430,2788,2,7200,3.6649928264
307362,326730,329545,19368,2815,2,7200,7.88028419183
307377,326735,329735,19358,3000,2,7200,7.45266666667
307751,333116,496956,25365,163840,18,216000,1.15481567383
307782,333831,479961,26049,146130,18,198000,1.17825908438
307783,337820,337835,30037,15,6,180000,2003.46666667
307784,310222,310709,2438,487,2,600,6.00616016427
307988,312934,314181,4946,1247,16,1200,4.966319166
308331,308340,309091,9,751,1,3600,1.0119840213
308790,314198,314747,5408,549,2,21600,10.8506375228
309701,326741,329744,17040,3003,2,7200,6.67432567433
309822,310150,313196,328,3046,2,7200,1.10768220617
310143,326746,329742,16603,2996,2,7200,6.5417222964
310210,310217,310219,7,2,1,300,1.0
310333,310340,310341,7,1,1,300,1.0
310334,310353,310354,19,1,1,300,2.0
310336,310366,310367,30,1,1,300,3.1
310337,310378,310379,41,1,1,300,4.2
310372,326751,329983,16379,3232,2,7200,6.06775990099
310450,326756,329703,16306,2947,2,7200,6.5330844927
311011,311017,312922,6,1905,2,21600,1.0031496063
311618,311624,311625,6,1,1,300,1.0
311750,311756,311758,6,2,1,300,1.0
312100,337987,338456,25887,469,8,7200,56.1961620469
312121,312127,312128,6,1,1,300,1.0
312297,312303,312307,6,4,1,300,1.0
312543,326762,329588,14219,2826,2,7200,6.03149327672
312600,326767,329686,14167,2919,2,7200,5.8533744433
312618,326772,329663,14154,2891,2,7200,5.89588377724
312651,326777,329694,14126,2917,2,7200,5.84264655468
312690,326783,329548,14093,2765,2,7200,6.09692585895
312720,312726,312731,6,5,1,300,1.1
312846,312852,312856,6,4,1,300,1.0
312955,312961,312971,6,10,1,300,1.6
312956,312983,312986,27,3,1,300,3.0
312957,312998,313002,41,4,1,300,4.5
312958,313014,313017,56,3,1,300,5.9
312959,313028,313032,69,4,1,300,7.3
313122,313129,316779,7,3650,128,3600,1.00191780822
313198,326788,329549,13590,2761,2,7200,5.92212966317
313799,338139,339289,24340,1150,2,21600,22.1652173913
314156,340038,342194,25882,2156,2,21600,13.0046382189
315000,351338,956146,36338,604808,3,604800,1.06008187722
315402,315409,646620,7,331211,1,331200,1.00002113456
315419,329235,660454,13816,331219,1,331200,1.04171258291
315432,315439,315443,7,4,2,3600,1.1
315694,345434,348236,29740,2802,4,43200,11.613847252
315715,345439,348233,29724,2794,4,43200,11.6385110952
316650,341477,341484,24827,7,1,18000,2483.4
316714,341496,341501,24782,5,1,18000,2478.7
316762,341513,341518,24751,5,1,18000,2475.6
317035,317042,319043,7,2001,128,3600,1.00349825087
317265,334055,344881,16790,10826,4,10800,2.55089599113
317306,326974,326976,9668,2,1,3600,967.0
317549,326830,329794,9281,2964,2,7200,4.13124156545
319076,319082,321912,6,2830,256,3600,1.00212014134
319878,335894,335959,16016,65,12,7200,247.4
320772,326835,329704,6063,2869,2,7200,3.11327988846
321146,348252,348258,27106,6,3,36000,2711.2
321991,321997,322024,6,27,256,3540,1.22222222222
322093,322099,322120,6,21,256,3540,1.28571428571
322407,322414,322438,7,24,256,3540,1.29166666667
322477,322483,322509,6,26,256,3540,1.23076923077
322596,322602,323783,6,1181,256,1800,1.0050804403
323578,326840,329870,3262,3030,2,7200,2.07656765677
326399,326846,329658,447,2812,2,7200,1.15896159317
327512,383031,397110,55519,14079,11,187200,4.94339086583
329216,329223,331948,7,2725,2,7200,1.00256880734
329403,329413,332453,10,3040,2,7200,1.00328947368
329438,329452,332128,14,2676,2,7200,1.00523168909
329489,329500,332667,11,3167,2,7200,1.0034733186
329516,329525,332184,9,2659,2,7200,1.0033847311
329531,329537,332213,6,2676,2,7200,1.00224215247
329546,329556,332482,10,2926,2,7200,1.003417635
329547,329563,332446,16,2883,2,7200,1.00554977454
329562,329570,332659,8,3089,2,7200,1.0025898349
329564,329575,332427,11,2852,2,7200,1.0038569425
329565,329582,332423,17,2841,2,7200,1.00598380852
329589,329599,332330,10,2731,2,7200,1.00366166239
329604,329611,332414,7,2803,2,7200,1.0024973243
329605,329618,332611,13,2993,2,7200,1.00434346809
329623,329634,332511,11,2877,2,7200,1.00382342718
329641,329649,332736,8,3087,2,7200,1.0025915128
329659,329669,332648,10,2979,2,7200,1.00335683115
329674,329680,332702,6,3022,2,7200,1.00198544011
329675,329688,332532,13,2844,2,7200,1.00457102672
329690,329697,332559,7,2862,2,7200,1.00244584207
329692,329704,332747,12,3043,2,7200,1.00394347683
329693,329709,332693,16,2984,2,7200,1.00536193029
329708,329716,332781,8,3065,2,7200,1.00261011419
329710,329722,332684,12,2962,2,7200,1.00405131668
329711,329727,332899,16,3172,2,7200,1.00504413619
329726,329734,332556,8,2822,2,7200,1.00283486889
329727,329740,332626,13,2886,2,7200,1.0045045045
329743,329750,332727,7,2977,2,7200,1.00235136043
329744,329757,332730,13,2973,2,7200,1.00437268752
329745,329762,332589,17,2827,2,7200,1.00601344181
329747,329767,332779,20,3012,2,7200,1.00664010624
329762,329773,332488,11,2715,2,7200,1.00405156538
329763,329779,332597,16,2818,2,7200,1.00567778566
329778,329785,332738,7,2953,2,7200,1.00237047071
329796,329805,332724,9,2919,2,7200,1.00308324769
329868,329878,332754,10,2876,2,7200,1.00347705146
329883,329889,332880,6,2991,2,7200,1.00200601805
329884,329895,332636,11,2741,2,7200,1.00401313389
329935,329945,332803,10,2858,2,7200,1.00349895031
329983,329994,332942,11,2948,2,7200,1.00373134328
330420,341529,341530,11109,1,1,18000,1111.0
330545,344558,351326,14013,6768,1,18000,3.0704787234
330626,351022,351023,20396,1,1,432000,2039.7
330718,348258,352648,17540,4390,1,18000,4.99544419134
330839,348265,352575,17426,4310,1,18000,5.04315545244
331950,331960,334802,10,2842,2,7200,1.00351864884
332131,332140,334950,9,2810,2,7200,1.00320284698
332185,332195,335063,10,2868,2,7200,1.00348675035
332215,332224,335320,9,3096,2,7200,1.00290697674
332332,332342,335081,10,2739,2,7200,1.00365096751
332416,332426,335245,10,2819,2,7200,1.00354735722
332431,332438,335348,7,2910,2,7200,1.00240549828
332432,332445,335176,13,2731,2,7200,1.00476016111
332447,332459,335467,12,3008,2,7200,1.0039893617
332461,332468,335181,7,2713,2,7200,1.00258016955
332485,332494,335279,9,2785,2,7200,1.00323159785
332500,332506,335356,6,2850,2,7200,1.00210526316
332515,332522,335345,7,2823,2,7200,1.0024796316
332533,332545,335409,12,2864,2,7200,1.00418994413
332557,332567,335446,10,2879,2,7200,1.00347342827
332571,332578,335563,7,2985,2,7200,1.00234505863
332589,332601,335525,12,2924,2,7200,1.00410396717
332604,332610,335617,6,3007,2,7200,1.0019953442
332619,332625,335733,6,3108,2,7200,1.00193050193
332633,332641,335758,8,3117,2,7200,1.00256657042
332648,332654,335717,6,3063,2,7200,1.00195886386
332650,332661,335469,11,2808,2,7200,1.00391737892
332664,332670,335732,6,3062,2,7200,1.00195950359
332679,332685,335460,6,2775,2,7200,1.00216216216
332694,332700,335619,6,2919,2,7200,1.00205549846
332695,332707,335676,12,2969,2,7200,1.0040417649
332710,332716,335679,6,2963,2,7200,1.00202497469
332725,332735,335849,10,3114,2,7200,1.00321130379
332741,332747,335788,6,3041,2,7200,1.00197303519
332742,332753,335714,11,2961,2,7200,1.00371496116
332743,332759,335413,16,2654,2,7200,1.00602863602
332745,332764,335926,19,3162,2,7200,1.00600885515
332760,332770,335814,10,3044,2,7200,1.00328515112
332761,332776,335618,15,2842,2,7200,1.00527797326
332782,332791,335804,9,3013,2,7200,1.00298705609
332783,332798,335636,15,2838,2,7200,1.00528541226
332804,332814,335764,10,2950,2,7200,1.00338983051
332882,332891,335873,9,2982,2,7200,1.00301810865
332900,332911,335919,11,3008,2,7200,1.00365691489
332945,332954,335766,9,2812,2,7200,1.00320056899
334804,334811,337671,7,2860,2,7200,1.00244755245
334951,334959,337633,8,2674,2,7200,1.00299177263
335066,335072,338128,6,3056,2,7200,1.00196335079
335080,335086,337808,6,2722,2,7200,1.00220426157
335176,335183,338025,7,2842,2,7200,1.00246305419
335191,335197,338297,6,3100,2,7200,1.00193548387
335248,335255,338269,7,3014,2,7200,1.00232249502
335281,335287,338129,6,2842,2,7200,1.0021111893
335320,335327,338120,7,2793,2,7200,1.00250626566
335347,335353,338494,6,3141,2,7200,1.00191021968
335362,335368,338324,6,2956,2,7200,1.00202976996
335363,335374,338182,11,2808,2,7200,1.00391737892
335411,335419,338511,8,3092,2,7200,1.00258732212
335426,335433,338343,7,2910,2,7200,1.00240549828
335447,335453,338489,6,3036,2,7200,1.00197628458
335462,335468,338380,6,2912,2,7200,1.00206043956
335476,335482,338509,6,3027,2,7200,1.00198216056
335478,335488,338452,10,2964,2,7200,1.00337381916
335526,335532,338608,6,3076,2,7200,1.00195058518
335565,335572,338313,7,2741,2,7200,1.00255381248
335619,335626,338615,7,2989,2,7200,1.00234192037
335621,335633,338505,12,2872,2,7200,1.00417827298
335622,335638,338636,16,2998,2,7200,1.00533689126
335637,335644,338511,7,2867,2,7200,1.00244157656
335679,335686,338713,7,3027,2,7200,1.00231252065
335680,335693,338630,13,2937,2,7200,1.00442628533
335715,335722,338632,7,2910,2,7200,1.00240549828
335730,335736,338544,6,2808,2,7200,1.00213675214
335744,335751,338601,7,2850,2,7200,1.00245614035
335746,335758,338954,12,3196,2,7200,1.00375469337
335761,335767,338614,6,2847,2,7200,1.00210748156
335776,335782,338788,6,3006,2,7200,1.00199600798
335777,335789,338881,12,3092,2,7200,1.00388098318
335792,335802,338712,10,2910,2,7200,1.00343642612
335806,335814,338661,8,2847,2,7200,1.00280997541
335821,335827,338716,6,2889,2,7200,1.0020768432
335851,335857,338768,6,2911,2,7200,1.00206114737
335875,335882,339090,7,3208,2,7200,1.00218204489
335920,335927,338904,7,2977,2,7200,1.00235136043
335935,335942,338804,7,2862,2,7200,1.00244584207
336884,345388,345421,8504,33,8,14400,258.696969697
337634,337641,340784,7,3143,2,7200,1.00222717149
337673,337680,340730,7,3050,2,7200,1.00229508197
337808,337814,340650,6,2836,2,7200,1.00211565585
337987,340079,340482,2092,403,2,600,6.19106699752
338028,338034,340762,6,2728,2,7200,1.00219941349
338121,338127,340971,6,2844,2,7200,1.00210970464
338136,338147,341032,11,2885,2,7200,1.00381282496
338137,338152,341137,15,2985,2,7200,1.00502512563
338182,338194,341029,12,2835,2,7200,1.00423280423
338269,338281,341118,12,2837,2,7200,1.00422982023
338300,338308,341019,8,2711,2,7200,1.00295094061
338314,338325,341196,11,2871,2,7200,1.00383141762
338329,338336,341177,7,2841,2,7200,1.00246392115
338344,338355,341325,11,2970,2,7200,1.0037037037
338383,338392,341167,9,2775,2,7200,1.00324324324
338452,338464,341402,12,2938,2,7200,1.00408441116
338491,338500,341282,9,2782,2,7200,1.00323508267
338494,345446,349705,6952,4259,4,36000,2.63230805353
338503,345451,351659,6948,6208,4,36000,2.11920103093
338506,338513,341212,7,2699,2,7200,1.00259355317
338507,338520,341539,13,3019,2,7200,1.00430606161
338512,348240,362331,9728,14091,4,36000,1.69036973955
338517,351016,351151,12499,135,16,1800,93.5851851852
338523,338530,341458,7,2928,2,7200,1.00239071038
338524,338537,341345,13,2808,2,7200,1.00462962963
338526,338542,341313,16,2771,2,7200,1.00577408878
338546,338556,341676,10,3120,2,7200,1.00320512821
338601,338612,341800,11,3188,2,7200,1.00345043915
338616,338622,341563,6,2941,2,7200,1.00204012241
338618,338630,341666,12,3036,2,7200,1.00395256917
338619,338635,341533,16,2898,2,7200,1.005521049
338634,338643,341578,9,2935,2,7200,1.00306643952
338635,338649,341752,14,3103,2,7200,1.00451176281
338650,338656,341582,6,2926,2,7200,1.002050581
338665,338672,341411,7,2739,2,7200,1.00255567725
338713,338729,341588,16,2859,2,7200,1.00559636236
338716,338722,338725,6,3,1,5400,1.0
338728,338735,341565,7,2830,2,7200,1.00247349823
338729,338740,341922,11,3182,2,7200,1.00345694532
338771,338781,341648,10,2867,2,7200,1.00348796652
338789,338801,341733,12,2932,2,7200,1.00409276944
338807,338816,341725,9,2909,2,7200,1.00309384668
338882,338893,341811,11,2918,2,7200,1.00376970528
338906,338916,341919,10,3003,2,7200,1.00333000333
338954,338966,342107,12,3141,2,7200,1.00382043935
339092,339103,341936,11,2833,2,7200,1.00388280974
339453,340044,340570,591,526,1,5400,2.12357414449
339528,340190,340712,662,522,1,5400,2.26819923372
340457,367370,439409,26913,72039,16,72000,1.37358930579
340465,367375,387054,26910,19679,16,72000,2.3674475329
340469,367381,383014,26912,15633,16,72000,2.72148659886
340653,340663,343700,10,3037,2,7200,1.00329272308
340731,340742,343625,11,2883,2,7200,1.00381547
340764,340774,343882,10,3108,2,7200,1.00321750322
340784,340796,343428,12,2632,2,7200,1.00455927052
340967,470377,536426,129410,66049,6,180000,2.95930294176
340971,340983,343873,12,2890,2,7200,1.00415224913
341012,342206,342237,1194,31,16,7200,39.5161290323
341019,341031,344099,12,3068,2,7200,1.00391134289
341034,341041,343942,7,2901,2,7200,1.00241296105
341036,341047,343885,11,2838,2,7200,1.00387596899
341041,480245,488825,139204,8580,6,180000,17.2242424242
341120,341129,344091,9,2962,2,7200,1.00303848751
341138,341149,344027,11,2878,2,7200,1.00382209868
341167,341179,343846,12,2667,2,7200,1.00449943757
341180,345393,345426,4213,33,8,28800,128.666666667
341182,341189,344162,7,2973,2,7200,1.00235452405
341197,341207,344000,10,2793,2,7200,1.00358037952
341212,341224,343898,12,2674,2,7200,1.00448765894
341284,341294,344165,10,2871,2,7200,1.00348310693
341314,341325,344028,11,2703,2,7200,1.00406955235
341329,341337,344380,8,3043,2,7200,1.00262898455
341347,341357,344266,10,2909,2,7200,1.00343760743
341405,341413,344098,8,2685,2,7200,1.00297951583
341420,341427,344453,7,3026,2,7200,1.00231328486
341459,341470,344432,11,2962,2,7200,1.00371370695
341534,341543,344535,9,2992,2,7200,1.00300802139
341549,341555,344347,6,2792,2,7200,1.00214899713
341566,341573,344519,7,2946,2,7200,1.00237610319
341567,341580,344400,13,2820,2,7200,1.00460992908
341582,341588,344524,6,2936,2,7200,1.00204359673
341584,341595,344516,11,2921,2,7200,1.00376583362
341599,341606,344674,7,3068,2,7200,1.00228161669
341650,341657,344438,7,2781,2,7200,1.00251708019
341668,341674,344335,6,2661,2,7200,1.00225479143
341682,341689,344337,7,2648,2,7200,1.00264350453
341727,341734,344509,7,2775,2,7200,1.00252252252
341742,341748,344750,6,3002,2,7200,1.00199866755
341757,341764,344671,7,2907,2,7200,1.00240798074
341802,341808,344831,6,3023,2,7200,1.00198478333
341816,341823,344770,7,2947,2,7200,1.00237529691
341919,341925,345006,6,3081,2,7200,1.00194741967
341934,341941,344806,7,2865,2,7200,1.00244328098
341948,341954,344809,6,2855,2,7200,1.00210157618
342108,342115,345100,7,2985,2,7200,1.00234505863
342171,365363,365540,23192,177,64,1800,132.028248588
342180,367386,369578,25206,2192,16,72000,12.4990875912
342220,365551,367359,23331,1808,64,1800,13.9043141593
342239,343150,345376,911,2226,16,7200,1.40925426774
342263,348270,348330,6007,60,2,600,101.116666667
342351,348281,348437,5930,156,1,3600,39.0128205128
342832,348247,348252,5415,5,4,7200,542.0
342870,348275,348296,5405,21,2,600,258.380952381
343431,343438,346442,7,3004,2,7200,1.00233022636
343626,343633,346544,7,2911,2,7200,1.00240467193
343701,343708,346384,7,2676,2,7200,1.00261584454
343848,343856,346865,8,3009,2,7200,1.00265869059
343875,343883,346886,8,3003,2,7200,1.00266400266
343890,343897,346478,7,2581,2,7200,1.00271212708
343892,343903,346931,11,3028,2,7200,1.0036327609
343906,343914,346813,8,2899,2,7200,1.00275957227
343942,343949,346841,7,2892,2,7200,1.00242047026
343999,344007,346985,8,2978,2,7200,1.00268636669
344026,344034,347192,8,3158,2,7200,1.00253324889
344041,344048,347129,7,3081,2,7200,1.00227198961
344092,344099,346818,7,2719,2,7200,1.00257447591
344107,344114,347137,7,3023,2,7200,1.00231558055
344108,344120,347008,12,2888,2,7200,1.00415512465
344114,350234,351003,6120,769,16,7200,8.95838751625
344162,344169,346953,7,2784,2,7200,1.00251436782
344177,344183,347132,6,2949,2,7200,1.002034588
344267,344274,347141,7,2867,2,7200,1.00244157656
344336,344344,347345,8,3001,2,7200,1.00266577807
344351,344357,347394,6,3037,2,7200,1.00197563385
344353,344364,347301,11,2937,2,7200,1.00374531835
344383,344389,347337,6,2948,2,7200,1.00203527815
344401,344407,347499,6,3092,2,7200,1.00194049159
344434,344441,347456,7,3015,2,7200,1.00232172471
344448,344455,347487,7,3032,2,7200,1.00230870712
344463,344469,347340,6,2871,2,7200,1.00208986416
344512,344518,347483,6,2965,2,7200,1.00202360877
344527,344534,347306,7,2772,2,7200,1.00252525253
344528,344541,347743,13,3202,2,7200,1.00405996252
344529,344546,347089,17,2543,2,7200,1.0066850177
344544,344553,347511,9,2958,2,7200,1.00304259635
344674,344684,347487,10,2803,2,7200,1.00356760614
344688,344694,347501,6,2807,2,7200,1.00213751336
344751,344762,347756,11,2994,2,7200,1.0036740147
344772,344782,347657,10,2875,2,7200,1.00347826087
344808,344818,347668,10,2850,2,7200,1.00350877193
344823,344829,347581,6,2752,2,7200,1.00218023256
344838,344845,347626,7,2781,2,7200,1.00251708019
345007,345018,348002,11,2984,2,7200,1.00368632708
345103,345112,347858,9,2746,2,7200,1.00327749454
346386,346396,349215,10,2819,2,7200,1.00354735722
346446,346455,349324,9,2869,2,7200,1.00313698153
346479,346490,349476,11,2986,2,7200,1.003683858
346545,346556,349378,11,2822,2,7200,1.00389794472
346813,346825,349455,12,2630,2,7200,1.00456273764
346828,346835,349665,7,2830,2,7200,1.00247349823
346842,346853,349632,11,2779,2,7200,1.00395825837
346866,346877,349614,11,2737,2,7200,1.0040189989
346887,346898,349748,11,2850,2,7200,1.00385964912
346932,346944,349904,12,2960,2,7200,1.00405405405
346956,346966,349976,10,3010,2,7200,1.00332225914
346986,346997,349824,11,2827,2,7200,1.00389105058
347010,347021,349988,11,2967,2,7200,1.0037074486
347091,347101,349822,10,2721,2,7200,1.00367511944
347130,347142,350179,12,3037,2,7200,1.0039512677
347145,347152,350042,7,2890,2,7200,1.00242214533
347146,347159,349936,13,2777,2,7200,1.00468131077
347148,347164,350151,16,2987,2,7200,1.00535654503
347193,347204,350099,11,2895,2,7200,1.00379965458
347301,347313,350373,12,3060,2,7200,1.00392156863
347316,347322,350191,6,2869,2,7200,1.00209132102
347340,347349,350319,9,2970,2,7200,1.00303030303
347341,347356,350020,15,2664,2,7200,1.00563063063
347356,347363,350406,7,3043,2,7200,1.00230036149
347395,347406,350335,11,2929,2,7200,1.00375554797
347458,347469,350363,11,2894,2,7200,1.00380096752
347485,347495,350469,10,2974,2,7200,1.00336247478
347501,347508,350427,7,2919,2,7200,1.00239808153
347502,347515,350483,13,2968,2,7200,1.00438005391
347504,347520,350452,16,2932,2,7200,1.00545702592
347505,347526,350621,21,3095,2,7200,1.00678513732
347520,347533,350397,13,2864,2,7200,1.00453910615
347583,347593,350476,10,2883,2,7200,1.00346860909
347622,347638,350613,16,2975,2,7200,1.00537815126
347658,347669,350513,11,2844,2,7200,1.00386779184
347673,347680,350722,7,3042,2,7200,1.00230111769
347745,347755,350659,10,2904,2,7200,1.00344352617
347760,347768,350470,8,2702,2,7200,1.0029607698
347859,347870,350795,11,2925,2,7200,1.00376068376
348004,348015,350916,11,2901,2,7200,1.00379179593
348379,565290,738132,216911,172842,4,172800,2.25496696405
349215,349222,352171,7,2949,2,7200,1.002373686
349326,349333,352232,7,2899,2,7200,1.00241462573
349380,349387,352136,7,2749,2,7200,1.0025463805
349455,349462,352284,7,2822,2,7200,1.00248051028
349476,349483,352355,7,2872,2,7200,1.00243732591
349615,349621,352592,6,2971,2,7200,1.00201952205
349632,349640,352669,8,3029,2,7200,1.00264113569
349665,349671,352648,6,2977,2,7200,1.0020154518
349749,349757,352619,8,2862,2,7200,1.00279524808
349825,349831,352846,6,3015,2,7200,1.00199004975
349826,349839,352876,13,3037,2,7200,1.00428054001
349904,349912,352802,8,2890,2,7200,1.00276816609
349937,349943,353046,6,3103,2,7200,1.00193361263
349976,349983,352926,7,2943,2,7200,1.00237852531
349991,349998,352972,7,2974,2,7200,1.00235373235
350021,350028,352574,7,2546,2,7200,1.00274941084
350042,350049,352769,7,2720,2,7200,1.00257352941
350102,350109,352994,7,2885,2,7200,1.00242634315
350153,350160,353034,7,2874,2,7200,1.00243562978
350180,350187,352917,7,2730,2,7200,1.00256410256
350194,350201,352739,7,2538,2,7200,1.00275807723
350321,350328,353246,7,2918,2,7200,1.00239890336
350336,350342,353374,6,3032,2,7200,1.00197889182
350366,350373,353411,7,3038,2,7200,1.00230414747
350380,350386,353246,6,2860,2,7200,1.0020979021
350398,350404,353447,6,3043,2,7200,1.00197173842
350413,350420,353128,7,2708,2,7200,1.00258493353
350427,350434,353472,7,3038,2,7200,1.00230414747
350454,350461,353391,7,2930,2,7200,1.0023890785
350472,350480,353539,8,3059,2,7200,1.00261523374
350474,350487,353477,13,2990,2,7200,1.00434782609
350489,350496,353350,7,2854,2,7200,1.00245269797
350490,350501,353456,11,2955,2,7200,1.00372250423
350514,350520,353528,6,3008,2,7200,1.00199468085
350613,350620,353512,7,2892,2,7200,1.00242047026
350628,350635,353806,7,3171,2,7200,1.00220750552
350661,350668,353494,7,2826,2,7200,1.00247699929
350724,350731,353935,7,3204,2,7200,1.00218476904
350796,350803,353770,7,2967,2,7200,1.00235928547
350917,350924,353825,7,2901,2,7200,1.00241296105
352140,352147,355031,7,2884,2,7200,1.00242718447
352173,352180,355366,7,3186,2,7200,1.00219711237
352233,352240,355147,7,2907,2,7200,1.00240798074
352287,352294,355100,7,2806,2,7200,1.00249465431
352356,352362,355108,6,2746,2,7200,1.00218499636
352575,352583,355495,8,2912,2,7200,1.00274725275
352593,352599,355240,6,2641,2,7200,1.00227186672
352620,352626,355486,6,2860,2,7200,1.0020979021
352650,352657,355763,7,3106,2,7200,1.00225370251
352671,352678,355576,7,2898,2,7200,1.00241545894
352740,352746,355579,6,2833,2,7200,1.00211789622
352770,352776,355744,6,2968,2,7200,1.00202156334
352803,352809,355709,6,2900,2,7200,1.00206896552
352848,352854,355613,6,2759,2,7200,1.00217470098
352878,352884,355633,6,2749,2,7200,1.00218261186
352917,352924,355610,7,2686,2,7200,1.00260610573
352932,352939,356149,7,3210,2,7200,1.00218068536
352974,352981,355872,7,2891,2,7200,1.00242130751
352995,353002,355862,7,2860,2,7200,1.00244755245
353037,353044,355970,7,2926,2,7200,1.0023923445
353052,353058,355908,6,2850,2,7200,1.00210526316
353130,353137,355881,7,2744,2,7200,1.00255102041
353247,353255,356062,8,2807,2,7200,1.00285001781
353249,353260,356017,11,2757,2,7200,1.00398984403
353351,353358,356156,7,2798,2,7200,1.00250178699
353375,353382,356090,7,2708,2,7200,1.00258493353
353393,353400,356286,7,2886,2,7200,1.00242550243
353414,353421,356423,7,3002,2,7200,1.00233177881
353449,353457,356485,8,3028,2,7200,1.00264200793
353464,353471,356606,7,3135,2,7200,1.00223285486
353479,353486,356167,7,2681,2,7200,1.00261096606
353480,353493,356132,13,2639,2,7200,1.00492610837
353495,353501,356450,6,2949,2,7200,1.002034588
353513,353519,356441,6,2922,2,7200,1.00205338809
353528,353534,356545,6,3011,2,7200,1.00199269346
353542,353549,356247,7,2698,2,7200,1.00259451446
353554,353561,353691,7,130,1,14400,1.05384615385
353771,353778,356623,7,2845,2,7200,1.00246045694
353807,353814,356714,7,2900,2,7200,1.0024137931
353825,353831,356727,6,2896,2,7200,1.0020718232
353937,353944,356889,7,2945,2,7200,1.00237691002
355033,355040,358014,7,2974,2,7200,1.00235373235
355102,355108,358069,6,2961,2,7200,1.00202634245
355117,355123,358183,6,3060,2,7200,1.00196078431
355150,355157,357966,7,2809,2,7200,1.00249199003
355243,355249,358413,6,3164,2,7200,1.00189633375
355366,355372,358312,6,2940,2,7200,1.00204081633
355486,355493,358457,7,2964,2,7200,1.00236167341
355501,355509,358216,8,2707,2,7200,1.00295530107
355577,355583,358446,6,2863,2,7200,1.00209570381
355591,355598,358598,7,3000,2,7200,1.00233333333
355612,355620,358519,8,2899,2,7200,1.00275957227
355614,355625,358271,11,2646,2,7200,1.00415721844
355635,355642,358507,7,2865,2,7200,1.00244328098
355710,355717,358500,7,2783,2,7200,1.00251527129
355746,355752,358649,6,2897,2,7200,1.00207110804
355764,355771,358596,7,2825,2,7200,1.00247787611
355863,355870,358774,7,2904,2,7200,1.00241046832
355878,355884,358757,6,2873,2,7200,1.00208840933
355892,355899,358983,7,3084,2,7200,1.00226977951
355910,355917,359149,7,3232,2,7200,1.00216584158
355970,355977,358693,7,2716,2,7200,1.00257731959
356018,356026,358931,8,2905,2,7200,1.00275387263
356064,356071,358882,7,2811,2,7200,1.002490217
356091,356098,358940,7,2842,2,7200,1.00246305419
356133,356140,358866,7,2726,2,7200,1.002567865
356151,356158,359141,7,2983,2,7200,1.00234663091
356165,356173,358928,8,2755,2,7200,1.00290381125
356180,356186,359001,6,2815,2,7200,1.00213143872
356249,356257,359292,8,3035,2,7200,1.00263591433
356288,356295,359324,7,3029,2,7200,1.00231099373
356424,356431,359367,7,2936,2,7200,1.00238419619
356442,356449,359371,7,2922,2,7200,1.00239561944
356456,356463,359392,7,2929,2,7200,1.00238989416
356486,356492,359192,6,2700,2,7200,1.00222222222
356546,356554,359253,8,2699,2,7200,1.00296406076
356607,356614,359774,7,3160,2,7200,1.00221518987
356624,356631,359419,7,2788,2,7200,1.0025107604
356715,356722,359773,7,3051,2,7200,1.00229432973
356729,356737,359544,8,2807,2,7200,1.00285001781
356889,356896,359814,7,2918,2,7200,1.00239890336
357967,357974,360570,7,2596,2,7200,1.00269645609
358015,358022,361042,7,3020,2,7200,1.00231788079
358069,358076,360875,7,2799,2,7200,1.00250089318
358183,358190,361127,7,2937,2,7200,1.00238338441
358216,358223,361179,7,2956,2,7200,1.00236806495
358273,358280,361198,7,2918,2,7200,1.00239890336
358312,358318,361242,6,2924,2,7200,1.00205198358
358415,358422,361204,7,2782,2,7200,1.00251617541
358448,358454,361396,6,2942,2,7200,1.00203942896
358462,358469,361285,7,2816,2,7200,1.00248579545
358501,358508,361412,7,2904,2,7200,1.00241046832
358516,358522,361262,6,2740,2,7200,1.00218978102
358530,358538,361493,8,2955,2,7200,1.0027072758
358594,358601,361495,7,2894,2,7200,1.00241879751
358608,358615,361798,7,3183,2,7200,1.00219918316
358650,358657,361601,7,2944,2,7200,1.00237771739
358695,358701,361715,6,3014,2,7200,1.00199071002
358758,358764,361647,6,2883,2,7200,1.00208116545
358767,369589,417743,10822,48154,4,86400,1.22473730116
358776,358783,361658,7,2875,2,7200,1.00243478261
358863,372014,631251,13151,259237,20,259200,1.05072964122
358866,358873,362008,7,3135,2,7200,1.00223285486
358876,381686,381689,22810,3,20,432000,2281.3
358884,358890,361792,6,2902,2,7200,1.00206753963
358910,381700,813724,22790,432024,20,432000,1.05275169898
358929,358936,361585,7,2649,2,7200,1.00264250661
358944,358951,361961,7,3010,2,7200,1.0023255814
358946,358958,361958,12,3000,2,7200,1.004
358985,358992,361843,7,2851,2,7200,1.00245527885
359002,359010,362053,8,3043,2,7200,1.00262898455
359049,443242,479251,84193,36009,4,36000,3.33810991697
359141,359147,362247,6,3100,2,7200,1.00193548387
359156,359163,361931,7,2768,2,7200,1.00252890173
359192,359199,362138,7,2939,2,7200,1.0023817625
359255,359262,362188,7,2926,2,7200,1.0023923445
359294,359301,362224,7,2923,2,7200,1.00239479986
359306,383026,815034,23720,432008,20,432000,1.05490639062
359324,359331,362160,7,2829,2,7200,1.00247437257
359326,397122,829128,37796,432006,20,432000,1.08748952561
359369,359376,362347,7,2971,2,7200,1.00235610905
359384,359390,362243,6,2853,2,7200,1.00210304942
359399,359406,362524,7,3118,2,7200,1.00224502886
359420,359427,362263,7,2836,2,7200,1.00246826516
359546,359553,362138,7,2585,2,7200,1.00270793037
359775,359782,362646,7,2864,2,7200,1.00244413408
359777,359789,362631,12,2842,2,7200,1.00422237861
359816,359823,362553,7,2730,2,7200,1.00256410256
360572,360578,363625,6,3047,2,7200,1.00196914998
360876,360883,363984,7,3101,2,7200,1.00225733634
361045,361052,363829,7,2777,2,7200,1.0025207058
361129,361135,363792,6,2657,2,7200,1.00225818592
361179,361187,363966,8,2779,2,7200,1.00287873336
361200,361208,364257,8,3049,2,7200,1.00262381109
361215,361222,364274,7,3052,2,7200,1.00229357798
361242,361249,364077,7,2828,2,7200,1.00247524752
361263,361269,364359,6,3090,2,7200,1.00194174757
361287,361294,363985,7,2691,2,7200,1.00260126347
361398,361404,364398,6,2994,2,7200,1.00200400802
361413,361420,364418,7,2998,2,7200,1.00233488993
361495,361501,364566,6,3065,2,7200,1.00195758564
361509,361515,364465,6,2950,2,7200,1.00203389831
361587,361593,364525,6,2932,2,7200,1.00204638472
361602,361608,364386,6,2778,2,7200,1.00215982721
361647,361654,364549,7,2895,2,7200,1.002417962
361662,361669,364439,7,2770,2,7200,1.00252707581
361716,361723,364795,7,3072,2,7200,1.00227864583
361794,361801,365014,7,3213,2,7200,1.00217864924
361809,361815,364839,6,3024,2,7200,1.00198412698
361845,361852,364904,7,3052,2,7200,1.00229357798
361932,361939,364697,7,2758,2,7200,1.00253807107
361959,361965,364836,6,2871,2,7200,1.00208986416
361974,361980,364748,6,2768,2,7200,1.00216763006
362010,362017,365095,7,3078,2,7200,1.00227420403
362055,362062,365035,7,2973,2,7200,1.00235452405
362139,362146,365099,7,2953,2,7200,1.00237047071
362141,362153,365278,12,3125,2,7200,1.00384
362161,362167,364898,6,2731,2,7200,1.00219699744
362191,362197,365247,6,3050,2,7200,1.00196721311
362224,362231,365117,7,2886,2,7200,1.00242550243
362245,362252,365230,7,2978,2,7200,1.00235057085
362260,362267,365253,7,2986,2,7200,1.00234427328
362274,362281,365180,7,2899,2,7200,1.00241462573
362350,362356,365158,6,2802,2,7200,1.00214132762
362525,362533,365352,8,2819,2,7200,1.00283788578
362555,362563,365348,8,2785,2,7200,1.00287253142
362634,362641,365508,7,2867,2,7200,1.00244157656
362649,362656,365723,7,3067,2,7200,1.00228236061
363625,363632,366350,7,2718,2,7200,1.00257542311
363793,363800,366550,7,2750,2,7200,1.00254545455
363829,363836,366656,7,2820,2,7200,1.0024822695
363968,363974,367010,6,3036,2,7200,1.00197628458
363985,363993,366876,8,2883,2,7200,1.00277488727
363987,364000,366858,13,2858,2,7200,1.00454863541
364080,364086,366922,6,2836,2,7200,1.00211565585
364258,364264,367349,6,3085,2,7200,1.00194489465
364276,364282,367319,6,3037,2,7200,1.00197563385
364360,364367,367263,7,2896,2,7200,1.00241712707
364386,364393,367423,7,3030,2,7200,1.00231023102
364401,364407,367527,6,3120,2,7200,1.00192307692
364419,364425,367626,6,3201,2,7200,1.00187441425
364440,364446,367644,6,3198,2,7200,1.00187617261
364467,364473,367550,6,3077,2,7200,1.00194995125
364527,364533,367423,6,2890,2,7200,1.00207612457
364551,364558,367366,7,2808,2,7200,1.00249287749
364569,364575,367293,6,2718,2,7200,1.00220750552
364698,364705,367795,7,3090,2,7200,1.00226537217
364749,364757,367837,8,3080,2,7200,1.0025974026
364797,364804,367705,7,2901,2,7200,1.00241296105
364837,364844,367857,7,3013,2,7200,1.00232326585
364851,364858,368015,7,3157,2,7200,1.0022172949
364899,364905,367843,6,2938,2,7200,1.00204220558
364914,364920,367872,6,2952,2,7200,1.00203252033
365016,365024,367970,8,2946,2,7200,1.0027155465
365037,365044,367645,7,2601,2,7200,1.00269127259
365097,365105,367787,8,2682,2,7200,1.00298284862
365112,365119,368071,7,2952,2,7200,1.00237127371
365127,365133,368107,6,2974,2,7200,1.00201748487
365160,365166,368357,6,3191,2,7200,1.00188028831
365181,365188,368127,7,2939,2,7200,1.0023817625
365232,365238,368285,6,3047,2,7200,1.00196914998
365250,365256,368127,6,2871,2,7200,1.00208986416
365265,365271,368086,6,2815,2,7200,1.00213143872
365279,365287,368106,8,2819,2,7200,1.00283788578
365348,365354,368339,6,2985,2,7200,1.00201005025
365363,365370,367908,7,2538,2,7200,1.00275807723
365511,365520,368462,9,2942,2,7200,1.00305914344
365725,365735,368498,10,2763,2,7200,1.00361925443
366351,366362,369231,11,2869,2,7200,1.00383408853
366553,366561,369604,8,3043,2,7200,1.00262898455
366658,366667,369734,9,3067,2,7200,1.00293446365
366860,366870,369821,10,2951,2,7200,1.0033886818
366878,366887,369732,9,2845,2,7200,1.00316344464
366923,366933,369832,10,2899,2,7200,1.00344946533
367010,367022,370054,12,3032,2,7200,1.00395778364
367266,367275,370193,9,2918,2,7200,1.00308430432
367293,367305,370373,12,3068,2,7200,1.00391134289
367320,367332,370238,12,2906,2,7200,1.00412938747
367350,367361,370356,11,2995,2,7200,1.00367278798
367368,367392,370339,24,2947,2,7200,1.00814387513
367426,367435,370401,9,2966,2,7200,1.00303438975
367427,367440,370211,13,2771,2,7200,1.00469144713
367529,367540,370739,11,3199,2,7200,1.00343857455
367553,367563,370540,10,2977,2,7200,1.00335908633
367628,367637,370338,9,2701,2,7200,1.00333209922
367646,367656,370665,10,3009,2,7200,1.00332336324
367647,367661,370512,14,2851,2,7200,1.0049105577
367708,367717,370795,9,3078,2,7200,1.00292397661
367789,367799,370644,10,2845,2,7200,1.00351493849
367804,367810,370641,6,2831,2,7200,1.00211939244
367837,367849,370805,12,2956,2,7200,1.00405953992
367852,367858,370861,6,3003,2,7200,1.001998002
367866,367873,370779,7,2906,2,7200,1.00240880936
367881,367888,371053,7,3165,2,7200,1.00221169036
367908,367919,370749,11,2830,2,7200,1.0038869258
367971,367983,370756,12,2773,2,7200,1.0043274432
368016,368027,371122,11,3095,2,7200,1.00355411955
368073,368084,371104,11,3020,2,7200,1.00364238411
368088,368098,370866,10,2768,2,7200,1.00361271676
368106,368118,371082,12,2964,2,7200,1.004048583
368108,368125,371057,17,2932,2,7200,1.00579809004
368129,368140,371369,11,3229,2,7200,1.00340662744
368130,368145,371015,15,2870,2,7200,1.00522648084
368287,368297,371041,10,2744,2,7200,1.00364431487
368341,368351,371193,10,2842,2,7200,1.00351864884
368359,368369,371338,10,2969,2,7200,1.00336813742
368464,368473,371617,9,3144,2,7200,1.00286259542
368500,368509,371662,9,3153,2,7200,1.00285442436
369227,369243,372233,16,2990,2,7200,1.00535117057
369606,369612,372582,6,2970,2,7200,1.00202020202
369736,369742,372758,6,3016,2,7200,1.00198938992
369737,369749,372715,12,2966,2,7200,1.004045853
369821,369827,372849,6,3022,2,7200,1.00198544011
369836,369843,372859,7,3016,2,7200,1.00232095491
370056,370063,373041,7,2978,2,7200,1.00235057085
370194,370201,373084,7,2883,2,7200,1.00242802636
370212,370218,373172,6,2954,2,7200,1.00203114421
370239,370246,373161,7,2915,2,7200,1.00240137221
370341,370348,373476,7,3128,2,7200,1.00223785166
370343,370355,373256,12,2901,2,7200,1.00413650465
370358,370365,373079,7,2714,2,7200,1.00257921887
370376,370382,373396,6,3014,2,7200,1.00199071002
370403,370409,373119,6,2710,2,7200,1.00221402214
370514,370521,373528,7,3007,2,7200,1.00232790156
370541,370547,373478,6,2931,2,7200,1.00204708291
370643,370651,373608,8,2957,2,7200,1.00270544471
370658,370664,373702,6,3038,2,7200,1.00197498354
370673,370679,373474,6,2795,2,7200,1.00214669052
370739,370745,373860,6,3115,2,7200,1.00192616372
370754,370760,373622,6,2862,2,7200,1.00209643606
370769,370776,373607,7,2831,2,7200,1.00247262451
370783,370790,373812,7,3022,2,7200,1.00231634679
370798,370805,373713,7,2908,2,7200,1.00240715268
370813,370819,373985,6,3166,2,7200,1.00189513582
370861,370868,373984,7,3116,2,7200,1.00224646983
370876,370882,373899,6,3017,2,7200,1.00198873053
371017,371024,374033,7,3009,2,7200,1.00232635427
371041,371048,374037,7,2989,2,7200,1.00234192037
371056,371062,373892,6,2830,2,7200,1.00212014134
371057,371069,373720,12,2651,2,7200,1.00452659374
371085,371091,373763,6,2672,2,7200,1.00224550898
371106,371112,374245,6,3133,2,7200,1.00191509735
371124,371131,373985,7,2854,2,7200,1.00245269797
371196,371203,374128,7,2925,2,7200,1.00239316239
371341,371348,374233,7,2885,2,7200,1.00242634315
371371,371377,374193,6,2816,2,7200,1.00213068182
371618,371624,374555,6,2931,2,7200,1.00204708291
371663,371670,374301,7,2631,2,7200,1.00266058533
372235,372241,375128,6,2887,2,7200,1.00207828195
372584,372590,375467,6,2877,2,7200,1.00208550574
372714,372721,375779,7,3058,2,7200,1.00228907783
372759,372766,376015,7,3249,2,7200,1.00215450908
372852,372858,375661,6,2803,2,7200,1.00214056368
372867,372874,375625,7,2751,2,7200,1.00254452926
373021,373028,379092,7,6064,1,18000,1.00115435356
373041,373048,376047,7,2999,2,7200,1.00233411137
373061,373067,378813,6,5746,1,18000,1.00104420466
373080,373087,376049,7,2962,2,7200,1.00236326806
373095,373102,376054,7,2952,2,7200,1.00237127371
373103,375141,380897,2038,5756,1,18000,1.35406532314
373122,373128,376074,6,2946,2,7200,1.00203665988
373164,373170,376150,6,2980,2,7200,1.00201342282
373179,373184,376102,5,2918,2,7200,1.0017135024
373257,373264,376137,7,2873,2,7200,1.00243647755
373398,373404,376391,6,2987,2,7200,1.00200870439
373477,373484,376368,7,2884,2,7200,1.00242718447
373478,373491,376450,13,2959,2,7200,1.00439337614
373485,375147,381330,1662,6183,1,18000,1.26880155264
373493,373499,376340,6,2841,2,7200,1.00211193242
373529,373535,376195,6,2660,2,7200,1.0022556391
373608,373615,376674,7,3059,2,7200,1.00228832952
373609,373622,376459,13,2837,2,7200,1.00458230525
373624,373630,376548,6,2918,2,7200,1.00205620288
373705,373712,376488,7,2776,2,7200,1.00252161383
373720,373726,376652,6,2926,2,7200,1.002050581
373721,373734,376598,13,2864,2,7200,1.00453910615
373763,373770,376588,7,2818,2,7200,1.00248403123
373765,375483,379833,1718,4350,1,18000,1.39494252874
373811,373818,376629,7,2811,2,7200,1.002490217
373860,373866,376834,6,2968,2,7200,1.00202156334
373893,373899,376956,6,3057,2,7200,1.00196270854
373907,373913,376956,6,3043,2,7200,1.00197173842
373986,373992,376881,6,2889,2,7200,1.0020768432
373987,373999,376823,12,2824,2,7200,1.00424929178
373989,374004,376906,15,2902,2,7200,1.00516884907
374034,374041,376848,7,2807,2,7200,1.00249376559
374049,374055,377020,6,2965,2,7200,1.00202360877
374130,374137,377011,7,2874,2,7200,1.00243562978
374195,374202,377112,7,2910,2,7200,1.00240549828
374234,374242,376939,8,2697,2,7200,1.00296625881
374249,374255,377108,6,2853,2,7200,1.00210304942
374303,374310,377587,7,3277,2,7200,1.00213610009
374556,374564,377334,8,2770,2,7200,1.00288808664
375129,375135,378131,6,2996,2,7200,1.00200267023
375469,375476,378423,7,2947,2,7200,1.00237529691
375547,430207,862249,54660,432042,20,432000,1.12651547766
375625,375631,378548,6,2917,2,7200,1.00205690778
375661,375667,378573,6,2906,2,7200,1.00206469374
375782,375788,378831,6,3043,2,7200,1.00197173842
376017,376024,379021,7,2997,2,7200,1.002335669
376046,480239,912258,104193,432019,20,432000,1.24117689268
376048,381692,381754,5644,62,12,7200,92.0322580645
376050,376057,379076,7,3019,2,7200,1.00231864856
376051,376064,379149,13,3085,2,7200,1.00421393841
376066,376072,378865,6,2793,2,7200,1.00214822771
376081,376088,379148,7,3060,2,7200,1.0022875817
376093,381766,382829,5673,1063,8,7200,6.3367826905
376102,376108,378852,6,2744,2,7200,1.00218658892
376138,376144,379112,6,2968,2,7200,1.00202156334
376153,376159,378962,6,2803,2,7200,1.00214056368
376198,376204,379082,6,2878,2,7200,1.0020847811
376335,481825,913862,105490,432037,20,432000,1.2441689022
376342,376348,379345,6,2997,2,7200,1.002002002
376369,376376,379039,7,2663,2,7200,1.00262861434
376378,397699,430201,21321,32502,8,32400,1.65599040059
376393,376400,379006,7,2606,2,7200,1.00268610898
376450,376456,379363,6,2907,2,7200,1.00206398349
376465,376471,379555,6,3084,2,7200,1.00194552529
376489,376495,379602,6,3107,2,7200,1.00193112327
376549,376556,379267,7,2711,2,7200,1.00258207304
376588,376594,379523,6,2929,2,7200,1.00204848071
376603,376609,379429,6,2820,2,7200,1.00212765957
376630,376636,379428,6,2792,2,7200,1.00214899713
376654,376660,379406,6,2746,2,7200,1.00218499636
376675,376682,379672,7,2990,2,7200,1.00234113712
376826,376832,379870,6,3038,2,7200,1.00197498354
376840,376846,379711,6,2865,2,7200,1.00209424084
376855,376862,379645,7,2783,2,7200,1.00251527129
376882,376889,379693,7,2804,2,7200,1.00249643367
376906,376912,379929,6,3017,2,7200,1.00198873053
376939,376945,379809,6,2864,2,7200,1.00209497207
376957,376964,379888,7,2924,2,7200,1.00239398085
376959,376971,379756,12,2785,2,7200,1.00430879713
377013,377019,380005,6,2986,2,7200,1.00200937709
377028,377034,380128,6,3094,2,7200,1.00193923723
377109,377115,380111,6,2996,2,7200,1.00200267023
377124,377130,380091,6,2961,2,7200,1.00202634245
377180,379038,379396,1858,358,2,14400,6.18994413408
377335,377342,380166,7,2824,2,7200,1.00247875354
377362,379409,379762,2047,353,2,14400,6.79886685552
377588,377595,380532,7,2937,2,7200,1.00238338441
378133,378140,381295,7,3155,2,7200,1.00221870048
378425,378432,381446,7,3014,2,7200,1.00232249502
378549,378556,381701,7,3145,2,7200,1.00222575517
378576,378582,381561,6,2979,2,7200,1.00201409869
378831,378838,381805,7,2967,2,7200,1.00235928547
378852,378859,381896,7,3037,2,7200,1.00230490616
378867,378873,381818,6,2945,2,7200,1.00203735144
378933,387470,388570,8537,1100,2,21600,8.76090909091
378964,378970,382024,6,3054,2,7200,1.00196463654
379009,379016,381853,7,2837,2,7200,1.00246739514
379024,379031,382056,7,3025,2,7200,1.00231404959
379042,379049,381923,7,2874,2,7200,1.00243562978
379077,379084,381941,7,2857,2,7200,1.00245012251
379092,379098,382045,6,2947,2,7200,1.00203596878
379113,379120,382243,7,3123,2,7200,1.00224143452
379150,379156,382073,6,2917,2,7200,1.00205690778
379151,379163,382074,12,2911,2,7200,1.00412229474
379268,379276,382213,8,2937,2,7200,1.00272386789
379347,379354,382421,7,3067,2,7200,1.00228236061
379365,379372,382432,7,3060,2,7200,1.0022875817
379407,379416,382378,9,2962,2,7200,1.00303848751
379431,379437,382307,6,2870,2,7200,1.00209059233
379432,379444,382294,12,2850,2,7200,1.00421052632
379523,379529,382373,6,2844,2,7200,1.00210970464
379556,379563,382412,7,2849,2,7200,1.00245700246
379604,379611,382627,7,3016,2,7200,1.00232095491
379646,379652,382578,6,2926,2,7200,1.002050581
379673,379680,382686,7,3006,2,7200,1.00232867598
379694,379700,382556,6,2856,2,7200,1.00210084034
379712,379718,382576,6,2858,2,7200,1.00209937019
379757,379764,382732,7,2968,2,7200,1.00235849057
379811,379818,382710,7,2892,2,7200,1.00242047026
379871,379878,382849,7,2971,2,7200,1.00235610905
379889,379897,382757,8,2860,2,7200,1.0027972028
379931,379938,382919,7,2981,2,7200,1.0023482053
380007,380014,382999,7,2985,2,7200,1.00234505863
380043,388582,390534,8539,1952,2,21600,5.37448770492
380091,380097,383029,6,2932,2,7200,1.00204638472
380112,380119,382989,7,2870,2,7200,1.00243902439
380130,380136,382897,6,2761,2,7200,1.00217312568
380169,380175,383119,6,2944,2,7200,1.00203804348
380384,382841,382899,2457,58,16,1200,43.3620689655
380531,380538,383394,7,2856,2,7200,1.00245098039
380758,380909,381889,151,980,2,14400,1.15408163265
380916,517669,523952,136753,6283,25,7199,22.7655578545
380980,391160,393956,10180,2796,16,7200,4.64091559371
381022,523963,530139,142941,6176,25,7199,24.1445919689
381296,381303,384006,7,2703,2,7200,1.00258971513
381326,466267,469148,84941,2881,16,7200,30.4831655675
381449,381457,384503,8,3046,2,7200,1.00262639527
381564,381570,384262,6,2692,2,7200,1.00222882615
381702,381709,384481,7,2772,2,7200,1.00252525253
381807,381815,384777,8,2962,2,7200,1.00270087779
381822,381828,384880,6,3052,2,7200,1.00196592398
381855,381861,384823,6,2962,2,7200,1.00202565834
381897,381904,384891,7,2987,2,7200,1.00234348845
381924,381932,384890,8,2958,2,7200,1.00270453009
381942,381949,384852,7,2903,2,7200,1.00241129866
382027,382034,384835,7,2801,2,7200,1.00249910746
382048,382054,384866,6,2812,2,7200,1.00213371266
382062,382069,384991,7,2922,2,7200,1.00239561944
382077,382084,385192,7,3108,2,7200,1.00225225225
382079,382090,384814,11,2724,2,7200,1.00403817915
382214,382220,385042,6,2822,2,7200,1.00212615167
382244,382250,384915,6,2665,2,7200,1.00225140713
382295,382302,385108,7,2806,2,7200,1.00249465431
382310,382317,385271,7,2954,2,7200,1.00236966825
382373,382381,385321,8,2940,2,7200,1.00272108844
382388,382394,385270,6,2876,2,7200,1.00208623088
382412,382419,385361,7,2942,2,7200,1.00237933379
382427,382434,385363,7,2929,2,7200,1.00238989416
382442,382448,385400,6,2952,2,7200,1.00203252033
382446,530150,530153,147704,3,20,432000,14770.7
382556,382563,385275,7,2712,2,7200,1.00258112094
382574,382580,385710,6,3130,2,7200,1.00191693291
382589,382595,385392,6,2797,2,7200,1.00214515552
382628,382635,385391,7,2756,2,7200,1.00253991292
382688,382694,385447,6,2753,2,7200,1.00217944061
382712,382719,385716,7,2997,2,7200,1.002335669
382733,382739,385632,6,2893,2,7200,1.00207397166
382760,382767,385607,7,2840,2,7200,1.00246478873
382850,382858,385566,8,2708,2,7200,1.00295420975
382899,382908,385943,9,3035,2,7200,1.00296540362
382919,382930,385771,11,2841,2,7200,1.0038718761
382989,383001,385855,12,2854,2,7200,1.00420462509
383004,383010,385937,6,2927,2,7200,1.00204988042
383031,383038,385639,7,2601,2,7200,1.00269127259
383044,397704,400677,14660,2973,7,18000,5.9310460814
383121,383127,386174,6,3047,2,7200,1.00196914998
383395,383402,386171,7,2769,2,7200,1.00252798844
384006,384014,386904,8,2890,2,7200,1.00276816609
384262,384268,387099,6,2831,2,7200,1.00211939244
384297,496968,499352,112671,2384,12,14400,48.2613255034
384330,499364,503329,115034,3965,12,14400,30.0123581337
384482,387537,390634,3055,3097,2,7200,1.98643848886
384503,387542,390722,3039,3180,2,7200,1.95566037736
384712,384718,385549,6,831,3,72000,1.00722021661
384723,559916,631921,175193,72005,3,72000,3.43306714811
384736,560412,632425,175676,72013,3,72000,3.43950397845
384747,631263,691357,246516,60094,3,72000,5.10217326189
384766,634764,706809,249998,72045,3,72000,4.4700256784
384776,393968,465355,9192,71387,6,72000,1.12876294003
384780,384786,387600,6,2814,2,7200,1.00213219616
384816,384822,387617,6,2795,2,7200,1.00214669052
384831,384837,387547,6,2710,2,7200,1.00221402214
384846,384852,387990,6,3138,2,7200,1.00191204589
384860,384868,387849,8,2981,2,7200,1.0026836632
384875,384882,387699,7,2817,2,7200,1.00248491303
384891,384897,387640,6,2743,2,7200,1.00218738607
384892,384904,388044,12,3140,2,7200,1.00382165605
384907,384913,387922,6,3009,2,7200,1.00199401795
384922,384928,387714,6,2786,2,7200,1.00215362527
384981,386465,454905,1484,68440,3,68400,1.02168322618
384994,385000,388003,6,3003,2,7200,1.001998002
385003,387065,390242,2062,3177,16,288000,1.64903997482
385042,385048,387971,6,2923,2,7200,1.0020526856
385108,385116,388162,8,3046,2,7200,1.00262639527
385192,385199,388032,7,2833,2,7200,1.00247087893
385271,385277,388518,6,3241,2,7200,1.00185128047
385272,385284,388110,12,2826,2,7200,1.0042462845
385288,385294,388130,6,2836,2,7200,1.00211565585
385321,385327,388276,6,2949,2,7200,1.002034588
385363,385369,388268,6,2899,2,7200,1.0020696792
385364,385376,388253,12,2877,2,7200,1.00417101147
385392,385399,388365,7,2966,2,7200,1.00236008092
385407,385413,388284,6,2871,2,7200,1.00208986416
385408,385419,388260,11,2841,2,7200,1.0038718761
385447,385453,388644,6,3191,2,7200,1.00188028831
385547,634769,706808,249222,72039,3,72000,4.45954274768
385567,385573,388449,6,2876,2,7200,1.00208623088
385609,385616,388807,7,3191,2,7200,1.0021936697
385633,385640,388552,7,2912,2,7200,1.00240384615
385648,385655,388690,7,3035,2,7200,1.00230642504
385702,553284,555459,167582,2175,12,21600,78.0491954023
385711,385722,388334,11,2612,2,7200,1.00421133231
385726,385732,388676,6,2944,2,7200,1.00203804348
385755,555470,556428,169715,958,12,21600,178.155532359
385771,385778,388754,7,2976,2,7200,1.00235215054
385855,385862,388816,7,2954,2,7200,1.00236966825
385940,385946,389024,6,3078,2,7200,1.00194931774
385954,385960,388936,6,2976,2,7200,1.00201612903
386171,386178,389124,7,2946,2,7200,1.00237610319
386186,386193,389158,7,2965,2,7200,1.0023608769
386906,386912,389927,6,3015,2,7200,1.00199004975
387279,387286,387291,7,5,2,3600,1.2
387625,391033,391191,3408,158,1,3600,22.5696202532
387732,391038,391268,3306,230,1,3600,15.3739130435
387911,387919,391037,8,3118,2,7200,1.00256574727
387913,387926,390847,13,2921,2,7200,1.00445053064
387914,387931,390768,17,2837,2,7200,1.00599224533
387915,387936,390878,21,2942,2,7200,1.00713800136
387917,387941,390965,24,3024,2,7200,1.00793650794
387918,387946,390601,28,2655,2,7200,1.01054613936
387919,387952,390815,33,2863,2,7200,1.01152637094
387921,387958,390953,37,2995,2,7200,1.01235392321
387936,387964,390728,28,2764,2,7200,1.01013024602
387972,387983,390941,11,2958,2,7200,1.00371872887
387993,388003,390944,10,2941,2,7200,1.00340020401
388008,388014,390787,6,2773,2,7200,1.0021637216
388034,388044,390966,10,2922,2,7200,1.00342231348
388049,388055,390993,6,2938,2,7200,1.00204220558
388112,388122,391141,10,3019,2,7200,1.00331235508
388130,388141,390965,11,2824,2,7200,1.00389518414
388163,388175,391321,12,3146,2,7200,1.00381436745
388253,388265,391195,12,2930,2,7200,1.00409556314
388268,388275,391245,7,2970,2,7200,1.00235690236
388270,388282,391194,12,2912,2,7200,1.00412087912
388285,388291,391108,6,2817,2,7200,1.00212992545
388286,388298,391413,12,3115,2,7200,1.00385232745
388301,530167,553273,141866,23106,16,259200,7.1397905306
388334,388346,391076,12,2730,2,7200,1.0043956044
388364,388377,391370,13,2993,2,7200,1.00434346809
388449,388461,391154,12,2693,2,7200,1.00445599703
388518,388530,391475,12,2945,2,7200,1.00407470289
388554,388565,391630,11,3065,2,7200,1.00358890701
388645,388656,391787,11,3131,2,7200,1.00351325455
388678,388688,391760,10,3072,2,7200,1.00325520833
388693,388702,391712,9,3010,2,7200,1.00299003322
388756,388766,391654,10,2888,2,7200,1.00346260388
388807,388819,391834,12,3015,2,7200,1.0039800995
388822,388829,391814,7,2985,2,7200,1.00234505863
388936,388948,391950,12,3002,2,7200,1.00399733511
389027,389036,391725,9,2689,2,7200,1.00334696913
389126,389136,392016,10,2880,2,7200,1.00347222222
389159,389169,391815,10,2646,2,7200,1.00377928949
389446,390546,391020,1100,474,2,10800,3.32067510549
389929,389939,392853,10,2914,2,7200,1.00343170899
390346,634774,697733,244428,62959,3,68400,4.88233612351
390601,390613,393544,12,2931,2,7200,1.00409416581
390637,390646,393400,9,2754,2,7200,1.00326797386
390724,390734,393603,10,2869,2,7200,1.00348553503
390739,390745,393946,6,3201,2,7200,1.00187441425
390769,390780,393700,11,2920,2,7200,1.00376712329
390790,390799,393835,9,3036,2,7200,1.00296442688
390817,390827,393659,10,2832,2,7200,1.00353107345
390850,390859,393864,9,3005,2,7200,1.00299500832
390880,390890,393843,10,2953,2,7200,1.00338638673
390943,390953,393688,10,2735,2,7200,1.00365630713
390958,390965,393775,7,2810,2,7200,1.0024911032
390959,390972,393839,13,2867,2,7200,1.00453435647
390974,390981,393923,7,2942,2,7200,1.00237933379
390976,390988,393930,12,2942,2,7200,1.00407885792
390977,390993,393970,16,2977,2,7200,1.00537453813
390995,391006,393747,11,2741,2,7200,1.00401313389
391040,391049,394065,9,3016,2,7200,1.00298408488
391079,391088,394054,9,2966,2,7200,1.00303438975
391106,391121,394150,15,3029,2,7200,1.00495212942
391142,391153,394003,11,2850,2,7200,1.00385964912
391156,391166,394173,10,3007,2,7200,1.00332557366
391196,391205,394188,9,2983,2,7200,1.00301709688
391197,391213,394264,16,3051,2,7200,1.00524418224
391245,391257,394159,12,2902,2,7200,1.00413507926
391321,391328,394435,7,3107,2,7200,1.00225297715
391373,391379,394306,6,2927,2,7200,1.00204988042
391415,391421,394476,6,3055,2,7200,1.00196399345
391433,634747,730698,243314,95951,16,288000,3.53581515565
391475,391481,394479,6,2998,2,7200,1.00200133422
391575,394451,422518,2876,28067,1,54000,1.10246909182
391632,391638,394875,6,3237,2,7200,1.00185356812
391655,391662,394362,7,2700,2,7200,1.00259259259
391673,394457,422717,2784,28260,1,54000,1.09851380042
391712,391720,394565,8,2845,2,7200,1.00281195079
391727,391734,394529,7,2795,2,7200,1.00250447227
391739,397128,424943,5389,27815,1,54000,1.19374438253
391760,391766,394826,6,3060,2,7200,1.00196078431
391787,391794,394444,7,2650,2,7200,1.00264150943
391814,391820,394537,6,2717,2,7200,1.002208318
391816,391827,394748,11,2921,2,7200,1.00376583362
391837,391844,394940,7,3096,2,7200,1.00226098191
391905,400695,428793,8790,28098,1,54000,1.31283365364
391939,634753,730680,242814,95927,16,288000,3.53123729503
391951,391957,394952,6,2995,2,7200,1.0020033389
392014,392021,394964,7,2943,2,7200,1.00237852531
392150,428807,431224,36657,2417,1,54000,16.1663218866
392855,392862,395524,7,2662,2,7200,1.0026296018
393070,397709,404508,4639,6799,1,18000,1.6823062215
393114,404519,411392,11405,6873,1,18000,2.65939182308
393401,393407,396495,6,3088,2,7200,1.00194300518
393546,393552,396524,6,2972,2,7200,1.00201884253
393606,393612,396830,6,3218,2,7200,1.00186451212
393660,393667,396354,7,2687,2,7200,1.00260513584
393687,393694,396503,7,2809,2,7200,1.00249199003
393701,393709,396606,8,2897,2,7200,1.00276147739
393749,393756,396686,7,2930,2,7200,1.0023890785
393776,393783,396598,7,2815,2,7200,1.00248667851
393837,393843,396804,6,2961,2,7200,1.00202634245
393852,393859,396782,7,2923,2,7200,1.00239479986
393853,393865,396989,12,3124,2,7200,1.00384122919
393868,393874,396988,6,3114,2,7200,1.00192678227
393925,393931,396800,6,2869,2,7200,1.00209132102
393940,393947,397058,7,3111,2,7200,1.00225008036
393955,393961,396992,6,3031,2,7200,1.0019795447
393972,393980,397015,8,3035,2,7200,1.00263591433
394005,394012,396958,7,2946,2,7200,1.00237610319
394056,394064,396856,8,2792,2,7200,1.00286532951
394071,394079,396861,8,2782,2,7200,1.00287562904
394153,394160,396945,7,2785,2,7200,1.00251346499
394167,394174,397142,7,2968,2,7200,1.00235849057
394182,394189,397163,7,2974,2,7200,1.00235373235
394197,394204,396900,7,2696,2,7200,1.00259643917
394266,394272,397193,6,2921,2,7200,1.00205409106
394308,394315,397061,7,2746,2,7200,1.00254916242
394362,394368,397252,6,2884,2,7200,1.00208044383
394427,394434,394594,7,160,1,3600,1.04375
394437,394445,397261,8,2816,2,7200,1.00284090909
394452,394464,397306,12,2842,2,7200,1.00422237861
394480,394487,397418,7,2931,2,7200,1.00238826339
394481,394500,397287,19,2787,2,7200,1.00681736634
394483,394495,394726,12,231,1,3600,1.05194805195
394532,394542,397604,10,3062,2,7200,1.00326583932
394547,394554,397616,7,3062,2,7200,1.00228608752
394568,394577,397492,9,2915,2,7200,1.00308747856
394698,394705,394858,7,153,1,3600,1.04575163399
394709,411863,412673,17154,810,2,10800,22.1777777778
394749,394761,397672,12,2911,2,7200,1.00412229474
394827,394838,397550,11,2712,2,7200,1.0040560472
394878,394888,397878,10,2990,2,7200,1.00334448161
394941,394951,397894,10,2943,2,7200,1.00339789331
394956,394965,397577,9,2612,2,7200,1.00344563553
394971,394978,398061,7,3083,2,7200,1.00227051573
395527,395537,398187,10,2650,2,7200,1.00377358491
395886,431235,459322,35349,28087,1,86400,2.25855377933
396189,479859,480228,83670,369,32,28800,227.74796748
396356,396366,399281,10,2915,2,7200,1.00343053173
396498,396506,399371,8,2865,2,7200,1.00279232112
396512,396520,399384,8,2864,2,7200,1.00279329609
396527,396536,399574,9,3038,2,7200,1.00296247531
396599,396609,399271,10,2662,2,7200,1.003756574
396614,396620,399548,6,2928,2,7200,1.00204918033
396686,396698,399611,12,2913,2,7200,1.00411946447
396783,396793,399649,10,2856,2,7200,1.00350140056
396801,396811,399807,10,2996,2,7200,1.00333778371
396815,396822,399497,7,2675,2,7200,1.00261682243
396830,396841,399578,11,2737,2,7200,1.0040189989
396857,396868,399917,11,3049,2,7200,1.00360774024
396872,396879,399381,7,2502,2,7200,1.00279776179
396902,396912,399896,10,2984,2,7200,1.00335120643
396947,396957,400094,10,3137,2,7200,1.00318775901
396962,396969,399722,7,2753,2,7200,1.00254268071
396989,397001,400214,12,3213,2,7200,1.00373482726
396990,397006,400075,16,3069,2,7200,1.00521342457
397006,397013,399964,7,2951,2,7200,1.00237207726
397020,397026,400003,6,2977,2,7200,1.0020154518
397060,397070,400064,10,2994,2,7200,1.00334001336
397074,397081,400050,7,2969,2,7200,1.00235769619
397143,397153,400140,10,2987,2,7200,1.00334784064
397164,397175,400186,11,3011,2,7200,1.00365327134
397194,397205,400046,11,2841,2,7200,1.0038718761
397254,397264,400109,10,2845,2,7200,1.00351493849
397269,397276,400091,7,2815,2,7200,1.00248667851
397287,397299,400083,12,2784,2,7200,1.00431034483
397308,397317,400176,9,2859,2,7200,1.00314795383
397420,397429,400038,9,2609,2,7200,1.00344959755
397495,397505,400371,10,2866,2,7200,1.00348918353
397549,397562,400318,13,2756,2,7200,1.00471698113
397579,397589,400377,10,2788,2,7200,1.00358680057
397606,397617,400567,11,2950,2,7200,1.00372881356
397621,397628,400612,7,2984,2,7200,1.0023458445
397682,397689,400508,7,2819,2,7200,1.00248315005
397879,397889,400698,10,2809,2,7200,1.00355998576
397897,397905,400703,8,2798,2,7200,1.00285918513
398063,398073,401145,10,3072,2,7200,1.00325520833
398186,398198,401016,12,2818,2,7200,1.00425833925
398362,730005,738541,331643,8536,16,14400,39.8522727273
398496,439422,441400,40926,1978,16,7200,21.6905965622
399284,399292,402212,8,2920,2,7200,1.00273972603
399286,399299,402041,13,2742,2,7200,1.00474106492
399377,399383,402390,6,3007,2,7200,1.0019953442
399395,399401,402379,6,2978,2,7200,1.00201477502
399396,399409,402295,13,2886,2,7200,1.0045045045
399502,399509,402610,7,3101,2,7200,1.00225733634
399550,399561,402516,11,2955,2,7200,1.00372250423
399574,399585,402320,11,2735,2,7200,1.00402193784
399589,399595,402461,6,2866,2,7200,1.00209351012
399613,399624,402455,11,2831,2,7200,1.00388555281
399649,399661,402705,12,3044,2,7200,1.00394218134
399725,399734,402566,9,2832,2,7200,1.0031779661
399809,399819,402825,10,3006,2,7200,1.00332667997
399871,411404,411408,11533,4,1,1810,1153.7
399896,399908,402617,12,2709,2,7200,1.00442967885
399917,399929,402886,12,2957,2,7200,1.00405816706
399965,399975,402779,10,2804,2,7200,1.00356633381
400004,400014,403002,10,2988,2,7200,1.00334672021
400040,400050,402821,10,2771,2,7200,1.00360880549
400055,400062,402980,7,2918,2,7200,1.00239890336
400057,400069,402947,12,2878,2,7200,1.0041695622
400072,400078,403272,6,3194,2,7200,1.00187852223
400073,400086,403118,13,3032,2,7200,1.00428759894
400088,400094,402888,6,2794,2,7200,1.00214745884
400103,400109,403077,6,2968,2,7200,1.00202156334
400104,400115,403070,11,2955,2,7200,1.00372250423
400119,400125,402789,6,2664,2,7200,1.00225225225
400140,400152,402831,12,2679,2,7200,1.00447928331
400176,400188,403070,12,2882,2,7200,1.00416377516
400191,400197,403042,6,2845,2,7200,1.00210896309
400215,400226,403207,11,2981,2,7200,1.0036900369
400299,557650,570499,157351,12849,16,72000,13.2461670169
400317,634758,645209,234441,10451,16,72000,23.4323988135
400321,400330,403209,9,2879,2,7200,1.00312608545
400323,645220,682822,244897,37602,16,72000,7.51287165576
400331,682839,729093,282508,46254,16,72000,7.107752843
400372,400383,403404,11,3021,2,7200,1.00364117842
400387,400393,403261,6,2868,2,7200,1.00209205021
400511,400521,403462,10,2941,2,7200,1.00340020401
400539,536436,565279,135897,28843,6,28800,5.71161113615
400539,400689,429536,150,28847,6,28800,1.00519984747
400540,602715,631548,202175,28833,6,28800,8.01193077377
400541,745827,774665,345286,28838,6,28800,12.9732991192
400562,740872,769702,340310,28830,6,28800,12.8040235865
400562,488835,517658,88273,28823,6,28800,4.06258890469
400562,573896,602704,173334,28808,6,28800,7.0168703138
400563,769713,798547,369150,28834,6,28800,13.8025941597
400568,400579,403451,11,2872,2,7200,1.00383008357
400613,400624,403579,11,2955,2,7200,1.00372250423
400701,400710,403600,9,2890,2,7200,1.00311418685
400716,400722,403826,6,3104,2,7200,1.00193298969
400874,441412,443208,40538,1796,16,7200,23.5712694878
400978,417755,420920,16777,3165,4,7200,6.30078988942
401016,401029,404221,13,3192,2,7200,1.0040726817
401146,401157,404189,11,3032,2,7200,1.00362796834
401470,443220,443225,41750,5,16,7200,4175.5
401777,411420,411671,9643,251,1,3600,39.4183266932
401816,443237,478947,41421,35710,12,36000,2.15992719126
402041,402053,404887,12,2834,2,7200,1.00423429781
402212,402223,405331,11,3108,2,7200,1.00353925354
402297,402306,405254,9,2948,2,7200,1.00305291723
402321,402332,405264,11,2932,2,7200,1.00375170532
402381,402392,405457,11,3065,2,7200,1.00358890701
402396,402402,405118,6,2716,2,7200,1.00220913108
402456,402467,405025,11,2558,2,7200,1.00430023456
402471,402478,405424,7,2946,2,7200,1.00237610319
402519,402529,405521,10,2992,2,7200,1.00334224599
402567,402578,405588,11,3010,2,7200,1.00365448505
402612,402622,405421,10,2799,2,7200,1.00357270454
402627,402633,405468,6,2835,2,7200,1.00211640212
402708,402717,405713,9,2996,2,7200,1.00300400534
402780,402791,405852,11,3061,2,7200,1.00359359686
402795,402802,405813,7,3011,2,7200,1.00232480903
402822,402833,405725,11,2892,2,7200,1.00380359613
402837,402844,405697,7,2853,2,7200,1.00245355766
402839,402850,405577,11,2727,2,7200,1.00403373671
402887,402898,405702,11,2804,2,7200,1.00392296719
402902,402908,405850,6,2942,2,7200,1.00203942896
402947,402959,405921,12,2962,2,7200,1.00405131668
402980,402992,406139,12,3147,2,7200,1.00381315539
403004,403015,406240,11,3225,2,7200,1.00341085271
403043,403055,405780,12,2725,2,7200,1.00440366972
403073,403082,405772,9,2690,2,7200,1.00334572491
403075,403087,406168,12,3081,2,7200,1.00389483934
403089,403096,405886,7,2790,2,7200,1.00250896057
403119,403130,406068,11,2938,2,7200,1.00374404357
403210,403220,406147,10,2927,2,7200,1.00341646737
403211,403227,406202,16,2975,2,7200,1.00537815126
403263,403274,406277,11,3003,2,7200,1.00366300366
403277,403284,406086,7,2802,2,7200,1.00249821556
403404,403416,406379,12,2963,2,7200,1.00404994938
403452,403463,406125,11,2662,2,7200,1.0041322314
403467,403473,406462,6,2989,2,7200,1.00200736032
403579,403591,406562,12,2971,2,7200,1.00403904409
403603,403612,406371,9,2759,2,7200,1.00326205147
403826,403838,406790,12,2952,2,7200,1.00406504065
404191,404200,407009,9,2809,2,7200,1.00320398718
404224,404234,406998,10,2764,2,7200,1.00361794501
404765,412685,415224,7920,2539,2,21600,4.11933832217
404888,404899,407210,11,2311,2,7200,1.00475984422
405026,405036,407210,10,2174,2,7200,1.00459981601
405120,405130,407210,10,2080,2,7200,1.00480769231
405255,405266,407210,11,1944,2,7200,1.00565843621
405270,405277,407210,7,1933,2,7200,1.00362131402
405333,405347,407210,14,1863,2,7200,1.00751476114
405421,405433,407210,12,1777,2,7200,1.00675295442
405436,405442,407210,6,1768,2,7200,1.00339366516
405459,405469,407210,10,1741,2,7200,1.00574382539
405474,405481,407210,7,1729,2,7200,1.004048583
405522,405533,407210,11,1677,2,7200,1.00655933214
405579,405590,407210,11,1620,2,7200,1.00679012346
405594,405601,407210,7,1609,2,7200,1.00435052828
405700,405713,407210,13,1497,2,7200,1.00868403474
405715,405721,407210,6,1489,2,7200,1.00402955003
405716,405727,407210,11,1483,2,7200,1.00741739717
405731,405738,407210,7,1472,2,7200,1.00475543478
405773,405784,407210,11,1426,2,7200,1.00771388499
405788,405795,407210,7,1415,2,7200,1.00494699647
405815,405826,407211,11,1385,2,7200,1.00794223827
405851,405862,407211,11,1349,2,7200,1.00815418829
405866,405873,407211,7,1338,2,7200,1.00523168909
405887,405898,407211,11,1313,2,7200,1.00837776085
405923,405933,407211,10,1278,2,7200,1.00782472613
406070,406080,407211,10,1131,2,7200,1.00884173298
406088,406099,407211,11,1112,2,7200,1.00989208633
406127,406137,407211,10,1074,2,7200,1.00931098696
406142,406150,407211,8,1061,2,7200,1.00754005655
406157,406163,407211,6,1048,2,7200,1.00572519084
406172,406180,407211,8,1031,2,7200,1.00775945684
406205,406215,407211,10,996,2,7200,1.01004016064
406241,415237,415720,8996,483,2,14400,19.6252587992
406241,406252,407211,11,959,2,7200,1.01147028154
406277,406289,407211,12,922,2,7200,1.01301518438
406317,443754,461788,37437,18034,7,18000,3.07591216591
406373,406384,407211,11,827,2,7200,1.01330108827
406388,406394,407211,6,817,2,7200,1.00734394125
406463,406474,407211,11,737,2,7200,1.01492537313
406483,415731,416938,9248,1207,2,10800,8.66197183099
406563,406574,407211,11,637,2,7200,1.01726844584
406792,406802,407211,10,409,2,7200,1.02444987775
406894,416949,417614,10055,665,2,21600,16.1203007519
407000,407010,407211,10,201,2,7200,1.04975124378
407015,407021,407211,6,190,2,7200,1.03157894737
407328,407336,407369,8,33,2,7200,1.24242424242
407330,407341,407374,11,33,2,7200,1.33333333333
407331,407348,407381,17,33,2,7200,1.51515151515
407332,407353,407386,21,33,2,7200,1.63636363636
407334,407358,407391,24,33,2,7200,1.72727272727
407335,407364,407396,29,32,2,7200,1.90625
407336,407369,407402,33,33,2,7200,2.0
407338,407374,407407,36,33,2,7200,2.09090909091
407339,407380,407413,41,33,2,7200,2.24242424242
407341,407385,407418,44,33,2,7200,2.33333333333
407342,407392,407424,50,32,2,7200,2.5625
407343,407397,407429,54,32,2,7200,2.6875
407345,407402,407435,57,33,2,7200,2.72727272727
407346,407408,407441,62,33,2,7200,2.87878787879
407347,407413,407446,66,33,2,7200,3.0
407349,407418,407451,69,33,2,7200,3.09090909091
407350,407423,407456,73,33,2,7200,3.21212121212
407352,407429,407462,77,33,2,7200,3.33333333333
407353,407434,407467,81,33,2,7200,3.45454545455
407354,407439,407472,85,33,2,7200,3.57575757576
407356,407444,407477,88,33,2,7200,3.66666666667
407357,407450,407482,93,32,2,7200,3.90625
407358,407455,407488,97,33,2,7200,3.93939393939
407360,407460,407494,100,34,2,7200,3.94117647059
407361,407465,407498,104,33,2,7200,4.15151515152
407362,407471,407503,109,32,2,7200,4.40625
407364,407476,407509,112,33,2,7200,4.39393939394
407365,407481,407514,116,33,2,7200,4.51515151515
407366,407486,407519,120,33,2,7200,4.63636363636
407368,407492,407524,124,32,2,7200,4.875
407369,407497,407526,128,29,2,7200,5.41379310345
407370,407502,407526,132,24,2,7200,6.5
407372,407507,407526,135,19,2,7200,8.10526315789
407373,407512,407526,139,14,2,7200,10.9285714286
407374,407518,407526,144,8,2,7200,15.2
407376,407523,407526,147,3,2,7200,15.0
407377,407528,407529,151,1,2,7200,15.2
407378,407533,407534,155,1,2,7200,15.6
407418,417626,418299,10208,673,2,21600,16.1679049034
407570,407577,410699,7,3122,2,7200,1.00224215247
407571,407584,410419,13,2835,2,7200,1.00458553792
407572,407589,410477,17,2888,2,7200,1.00588642659
407574,407594,410587,20,2993,2,7200,1.0066822586
407575,407600,410264,25,2664,2,7200,1.00938438438
407576,407605,410648,29,3043,2,7200,1.00953006901
407578,407610,410663,32,3053,2,7200,1.01048149361
407579,407616,410408,37,2792,2,7200,1.013252149
407580,407622,410651,42,3029,2,7200,1.01386596236
407582,407627,410675,45,3048,2,7200,1.01476377953
407583,407632,410685,49,3053,2,7200,1.01604978709
407584,407637,410616,53,2979,2,7200,1.0177912051
407586,407643,410354,57,2711,2,7200,1.02102545186
407587,407648,410493,61,2845,2,7200,1.02144112478
407588,407653,410476,65,2823,2,7200,1.02302515055
407589,407658,410895,69,3237,2,7200,1.02131603336
407591,407663,410709,72,3046,2,7200,1.02363755745
407592,407669,410727,77,3058,2,7200,1.02517985612
407593,407674,410663,81,2989,2,7200,1.02709936434
407595,407679,410669,84,2990,2,7200,1.02809364548
407596,407684,410635,88,2951,2,7200,1.02982039986
407597,407690,410811,93,3121,2,7200,1.02979814162
407599,407695,410733,96,3038,2,7200,1.03159973667
407600,407700,410581,100,2881,2,7200,1.03471017008
407601,407705,410778,104,3073,2,7200,1.03384315002
407603,407711,410885,108,3174,2,7200,1.03402646503
407604,407716,410849,112,3133,2,7200,1.03574848388
407605,407721,410844,116,3123,2,7200,1.03714377201
407607,407726,410919,119,3193,2,7200,1.03726902599
407608,407732,410717,124,2985,2,7200,1.04154103853
407609,407737,410579,128,2842,2,7200,1.04503870514
407611,407744,410749,133,3005,2,7200,1.04425956739
407612,407749,410647,137,2898,2,7200,1.04727398206
407613,407754,410718,141,2964,2,7200,1.0475708502
407615,407759,410871,144,3112,2,7200,1.04627249357
407616,407765,410702,149,2937,2,7200,1.0507320395
407617,407770,410574,153,2804,2,7200,1.05456490728
407619,407775,410687,156,2912,2,7200,1.05357142857
407620,407780,410825,160,3045,2,7200,1.05254515599
407622,407786,410845,164,3059,2,7200,1.0536122916
407815,422532,423147,14717,615,2,21600,24.9300813008
408770,423159,424076,14389,917,2,21600,16.6913849509
409412,424087,424947,14675,860,2,21600,18.0639534884
410263,410276,413336,13,3060,2,7200,1.00424836601
410356,410366,413469,10,3103,2,7200,1.00322268772
410410,410420,413629,10,3209,2,7200,1.00311623559
410425,410432,413620,7,3188,2,7200,1.002195734
410476,410488,413297,12,2809,2,7200,1.00427198291
410491,410498,413391,7,2893,2,7200,1.0024196336
410505,410512,413348,7,2836,2,7200,1.00246826516
410577,410586,413589,9,3003,2,7200,1.002997003
410592,410599,413655,7,3056,2,7200,1.00229057592
410593,410605,413596,12,2991,2,7200,1.00401203611
410594,410610,413593,16,2983,2,7200,1.00536372779
410618,410628,413680,10,3052,2,7200,1.00327653997
410636,410647,413570,11,2923,2,7200,1.00376325693
410651,410659,413705,8,3046,2,7200,1.00262639527
410652,410666,413725,14,3059,2,7200,1.00457665904
410653,410671,413732,18,3061,2,7200,1.00588043123
410669,410678,413422,9,2744,2,7200,1.00327988338
410670,410683,413715,13,3032,2,7200,1.00428759894
410685,410692,413820,7,3128,2,7200,1.00223785166
410687,410699,413892,12,3193,2,7200,1.00375822111
410688,410704,413627,16,2923,2,7200,1.00547382826
410703,410710,413786,7,3076,2,7200,1.0022756827
410704,410716,413781,12,3065,2,7200,1.00391517129
410706,410723,413576,17,2853,2,7200,1.00595864003
410721,410730,413700,9,2970,2,7200,1.00303030303
410722,410735,413799,13,3064,2,7200,1.00424281984
410723,410740,413825,17,3085,2,7200,1.00551053485
410738,410747,413501,9,2754,2,7200,1.00326797386
410739,410752,413607,13,2855,2,7200,1.00455341506
410754,410760,413643,6,2883,2,7200,1.00208116545
410780,410790,413675,10,2885,2,7200,1.00346620451
410813,410823,413603,10,2780,2,7200,1.0035971223
410828,410837,414056,9,3219,2,7200,1.00279589935
410846,410856,413705,10,2849,2,7200,1.00351000351
410847,410861,413847,14,2986,2,7200,1.00468854655
410862,410868,413963,6,3095,2,7200,1.00193861066
410876,410883,413820,7,2937,2,7200,1.00238338441
410891,410898,413677,7,2779,2,7200,1.00251889169
410906,410913,413953,7,3040,2,7200,1.00230263158
410920,410932,413995,12,3063,2,7200,1.00391772772
413298,413309,416235,11,2926,2,7200,1.0037593985
413337,413347,416458,10,3111,2,7200,1.00321440051
413351,413361,416471,10,3110,2,7200,1.00321543408
413393,413403,416230,10,2827,2,7200,1.00353731871
413423,413434,416424,11,2990,2,7200,1.00367892977
413471,413481,416611,10,3130,2,7200,1.00319488818
413501,413513,416449,12,2936,2,7200,1.00408719346
413573,413582,416471,9,2889,2,7200,1.0031152648
413587,413595,416721,8,3126,2,7200,1.00255918106
413603,413609,416623,6,3014,2,7200,1.00199071002
413604,413616,416575,12,2959,2,7200,1.00405542413
413605,413622,416493,17,2871,2,7200,1.00592128178
413621,413628,416725,7,3097,2,7200,1.00226025186
413622,413634,416674,12,3040,2,7200,1.00394736842
413623,413641,416447,18,2806,2,7200,1.00641482537
413638,413647,416616,9,2969,2,7200,1.00303132368
413640,413652,416688,12,3036,2,7200,1.00395256917
413654,413661,416544,7,2883,2,7200,1.00242802636
413669,413675,416700,6,3025,2,7200,1.00198347107
413684,413691,416632,7,2941,2,7200,1.00238014281
413686,413698,416721,12,3023,2,7200,1.00396956666
413687,413703,416659,16,2956,2,7200,1.00541271989
413702,413712,416811,10,3099,2,7200,1.00322684737
413717,413723,416615,6,2892,2,7200,1.0020746888
413718,413731,416898,13,3167,2,7200,1.00410483107
413719,413736,416739,17,3003,2,7200,1.00566100566
413734,413743,416587,9,2844,2,7200,1.00316455696
413735,413750,416786,15,3036,2,7200,1.00494071146
413781,413793,416662,12,2869,2,7200,1.00418264204
413796,413802,416720,6,2918,2,7200,1.00205620288
413810,413816,416887,6,3071,2,7200,1.00195376099
413825,413832,417026,7,3194,2,7200,1.00219160927
413826,413839,416779,13,2940,2,7200,1.00442176871
413828,413844,416815,16,2971,2,7200,1.00538539212
413849,413859,416880,10,3021,2,7200,1.0033101622
413893,413904,416978,11,3074,2,7200,1.00357839948
413953,413965,416751,12,2786,2,7200,1.00430725054
413968,413975,416991,7,3016,2,7200,1.00232095491
413995,414007,416928,12,2921,2,7200,1.00410818213
414058,414067,416732,9,2665,2,7200,1.00337711069
416230,416242,419381,12,3139,2,7200,1.00382287353
416245,416252,419306,7,3054,2,7200,1.00229207597
416425,416436,419509,11,3073,2,7200,1.00357956394
416449,416459,419286,10,2827,2,7200,1.00353731871
416464,416470,419320,6,2850,2,7200,1.00210526316
416466,416477,419273,11,2796,2,7200,1.0039341917
416480,416488,419490,8,3002,2,7200,1.00266489007
416482,416493,419286,11,2793,2,7200,1.00393841747
416496,416506,419254,10,2748,2,7200,1.00363901019
416544,416556,419459,12,2903,2,7200,1.00413365484
416577,416587,419689,10,3102,2,7200,1.00322372663
416592,416598,419464,6,2866,2,7200,1.00209351012
416613,416623,419789,10,3166,2,7200,1.0031585597
416628,416634,419689,6,3055,2,7200,1.00196399345
416630,416642,419934,12,3292,2,7200,1.00364520049
416631,416647,419991,16,3344,2,7200,1.004784689
416645,416654,419370,9,2716,2,7200,1.00331369661
416660,416672,419606,12,2934,2,7200,1.00408997955
416675,416682,419516,7,2834,2,7200,1.00247000706
416676,416689,419587,13,2898,2,7200,1.00448585231
416691,416700,419937,9,3237,2,7200,1.00278035218
416706,416714,419674,8,2960,2,7200,1.0027027027
416721,416732,419618,11,2886,2,7200,1.00381150381
416736,416742,419857,6,3115,2,7200,1.00192616372
416737,416750,419638,13,2888,2,7200,1.00450138504
416739,416755,419752,16,2997,2,7200,1.00533867201
416740,416760,419949,20,3189,2,7200,1.00627155848
416755,416767,419734,12,2967,2,7200,1.00404448938
416756,416772,419611,16,2839,2,7200,1.00563578725
416780,416791,419574,11,2783,2,7200,1.00395256917
416795,416802,419847,7,3045,2,7200,1.00229885057
416812,416824,419852,12,3028,2,7200,1.00396301189
416827,416834,419711,7,2877,2,7200,1.00243309002
416881,416892,419842,11,2950,2,7200,1.00372881356
416896,416903,420006,7,3103,2,7200,1.00225588141
416911,416917,419863,6,2946,2,7200,1.00203665988
416928,416941,419626,13,2685,2,7200,1.00484171322
416979,416991,419930,12,2939,2,7200,1.00408302144
416994,417004,419823,10,2819,2,7200,1.00354735722
417027,417038,419905,11,2867,2,7200,1.00383676317
417763,418311,418546,548,235,1,1800,3.33191489362
419257,419264,422084,7,2820,2,7200,1.0024822695
419275,419281,422315,6,3034,2,7200,1.00197758734
419290,419296,422311,6,3015,2,7200,1.00199004975
419291,419303,422471,12,3168,2,7200,1.00378787879
419306,419313,422219,7,2906,2,7200,1.00240880936
419320,419328,422333,8,3005,2,7200,1.00266222962
419371,419378,422377,7,2999,2,7200,1.00233411137
419386,419392,422661,6,3269,2,7200,1.00183542368
419461,419467,422706,6,3239,2,7200,1.00185242359
419476,419482,422262,6,2780,2,7200,1.00215827338
419490,419496,422411,6,2915,2,7200,1.00205831904
419511,419517,422447,6,2930,2,7200,1.00204778157
419526,419532,422376,6,2844,2,7200,1.00210970464
419577,419583,422430,6,2847,2,7200,1.00210748156
419591,419598,422598,7,3000,2,7200,1.00233333333
419606,419614,422727,8,3113,2,7200,1.00256986829
419621,419628,422560,7,2932,2,7200,1.00238744884
419622,419635,422519,13,2884,2,7200,1.00450762829
419637,419644,422554,7,2910,2,7200,1.00240549828
419652,419658,422682,6,3024,2,7200,1.00198412698
419678,419685,422600,7,2915,2,7200,1.00240137221
419693,419700,422579,7,2879,2,7200,1.00243139979
419694,419706,422627,12,2921,2,7200,1.00410818213
419712,419719,422617,7,2898,2,7200,1.00241545894
419736,419743,422716,7,2973,2,7200,1.00235452405
419754,419760,422913,6,3153,2,7200,1.00190294957
419790,419797,422668,7,2871,2,7200,1.00243817485
419823,419829,422961,6,3132,2,7200,1.00191570881
419843,419851,422881,8,3030,2,7200,1.00264026403
419858,419866,422775,8,2909,2,7200,1.00275008594
419860,419871,423054,11,3183,2,7200,1.00345585925
419861,419878,422904,17,3026,2,7200,1.00561797753
419876,419885,422989,9,3104,2,7200,1.00289948454
419906,419912,422931,6,3019,2,7200,1.00198741305
419933,419939,422864,6,2925,2,7200,1.00205128205
419948,419955,422883,7,2928,2,7200,1.00239071038
419949,419962,423063,13,3101,2,7200,1.00419219607
419964,419971,423036,7,3065,2,7200,1.00228384992
419994,420001,423052,7,3051,2,7200,1.00229432973
420008,420015,422893,7,2878,2,7200,1.00243224461
421029,421035,421281,6,246,1,1800,1.0243902439
422084,422091,424976,7,2885,2,7200,1.00242634315
422220,422226,425060,6,2834,2,7200,1.00211714891
422264,422271,425287,7,3016,2,7200,1.00232095491
422312,422319,425584,7,3265,2,7200,1.002143951
422327,422334,425437,7,3103,2,7200,1.00225588141
422342,422349,425191,7,2842,2,7200,1.00246305419
422378,422384,425448,6,3064,2,7200,1.00195822454
422379,422392,425467,13,3075,2,7200,1.00422764228
422412,422418,425518,6,3100,2,7200,1.00193548387
422433,422440,425540,7,3100,2,7200,1.00225806452
422447,422455,425596,8,3141,2,7200,1.00254695957
422471,422478,425322,7,2844,2,7200,1.00246132208
422519,422526,425478,7,2952,2,7200,1.00237127371
422555,422562,425658,7,3096,2,7200,1.00226098191
422570,422576,425672,6,3096,2,7200,1.0019379845
422584,422591,425642,7,3051,2,7200,1.00229432973
422599,422606,425728,7,3122,2,7200,1.00224215247
422614,422620,425683,6,3063,2,7200,1.00195886386
422628,422635,425606,7,2971,2,7200,1.00235610905
422630,422642,425499,12,2857,2,7200,1.00420021001
422663,422668,425250,5,2582,2,7200,1.00193648335
422677,422685,425504,8,2819,2,7200,1.00283788578
422692,422699,425650,7,2951,2,7200,1.00237207726
422707,422714,425624,7,2910,2,7200,1.00240549828
422721,422728,425401,7,2673,2,7200,1.0026187804
422736,422742,425681,6,2939,2,7200,1.00204151072
422775,422781,425692,6,2911,2,7200,1.00206114737
422862,422868,425664,6,2796,2,7200,1.00214592275
422883,422889,425725,6,2836,2,7200,1.00211565585
422885,422895,425953,10,3058,2,7200,1.00327011118
422899,422906,425823,7,2917,2,7200,1.00239972575
422904,422912,423045,8,133,2,900,1.06015037594
422914,422921,425684,7,2763,2,7200,1.0025334781
422916,422928,425981,12,3053,2,7200,1.0039305601
422931,422938,426069,7,3131,2,7200,1.00223570744
422964,422970,426123,6,3153,2,7200,1.00190294957
422990,422998,425851,8,2853,2,7200,1.0028040659
423038,423046,425792,8,2746,2,7200,1.00291332848
423053,423061,426050,8,2989,2,7200,1.00267648043
423068,423075,426060,7,2985,2,7200,1.00234505863
423070,423082,426140,12,3058,2,7200,1.00392413342
423495,423501,423523,6,22,2,900,1.27272727273
424181,424188,424417,7,229,1,1800,1.03056768559
424665,424672,424710,7,38,2,3600,1.18421052632
424679,424686,424920,7,234,1,900,1.02991452991
424739,424746,424951,7,205,2,3600,1.03414634146
424979,424985,427858,6,2873,2,7200,1.00208840933
425063,425070,428030,7,2960,2,7200,1.00236486486
425192,425199,427986,7,2787,2,7200,1.00251166128
425219,425225,426406,6,1181,2,3600,1.0050804403
425252,425258,428211,6,2953,2,7200,1.00203183204
425288,425295,428218,7,2923,2,7200,1.00239479986
425323,425330,428346,7,3016,2,7200,1.00232095491
425402,425408,428481,6,3073,2,7200,1.00195248942
425437,425443,428386,6,2943,2,7200,1.00203873598
425452,425459,428607,7,3148,2,7200,1.00222363405
425470,425477,428301,7,2824,2,7200,1.00247875354
425485,425492,428543,7,3051,2,7200,1.00229432973
425503,425509,428450,6,2941,2,7200,1.00204012241
425517,425524,428675,7,3151,2,7200,1.00222151698
425519,425530,428308,11,2778,2,7200,1.00395968323
425543,425550,428438,7,2888,2,7200,1.00242382271
425584,425592,428492,8,2900,2,7200,1.00275862069
425599,425605,428403,6,2798,2,7200,1.00214438885
425614,425620,428714,6,3094,2,7200,1.00193923723
425629,425635,428475,6,2840,2,7200,1.00211267606
425643,425650,428686,7,3036,2,7200,1.00230566535
425658,425665,428592,7,2927,2,7200,1.00239152716
425660,425671,428652,11,2981,2,7200,1.0036900369
425675,425681,428474,6,2793,2,7200,1.00214822771
425676,425687,428682,11,2995,2,7200,1.00367278798
425691,425697,428792,6,3095,2,7200,1.00193861066
425693,425704,428628,11,2924,2,7200,1.0037619699
425694,425709,428728,15,3019,2,7200,1.00496853263
425709,425716,428812,7,3096,2,7200,1.00226098191
425727,425734,428605,7,2871,2,7200,1.00243817485
425729,425741,425975,12,234,1,900,1.05128205128
425741,425748,429022,7,3274,2,7200,1.00213805742
425795,425802,428465,7,2663,2,7200,1.00262861434
425825,425831,428739,6,2908,2,7200,1.00206327373
425852,425858,428934,6,3076,2,7200,1.00195058518
425954,425960,428806,6,2846,2,7200,1.00210822207
425984,425990,429014,6,3024,2,7200,1.00198412698
426050,426057,429173,7,3116,2,7200,1.00224646983
426065,426072,429111,7,3039,2,7200,1.00230338927
426080,426087,429048,7,2961,2,7200,1.00236406619
426125,426131,429270,6,3139,2,7200,1.00191143676
426142,426150,429018,8,2868,2,7200,1.00278940028
426327,426333,426562,6,229,1,900,1.02620087336
427860,427866,430762,6,2896,2,7200,1.0020718232
427986,427992,431069,6,3077,2,7200,1.00194995125
428031,428037,431071,6,3034,2,7200,1.00197758734
428214,428220,431459,6,3239,2,7200,1.00185242359
428229,428235,431300,6,3065,2,7200,1.00195758564
428304,428311,431289,7,2978,2,7200,1.00235057085
428319,428326,431035,7,2709,2,7200,1.00258397933
428349,428355,431264,6,2909,2,7200,1.00206256446
428387,428394,431334,7,2940,2,7200,1.00238095238
428406,428412,431155,6,2743,2,7200,1.00218738607
428439,428445,431508,6,3063,2,7200,1.00195886386
428454,428460,431353,6,2893,2,7200,1.00207397166
428469,428475,431482,6,3007,2,7200,1.0019953442
428484,428490,431474,6,2984,2,7200,1.00201072386
428486,428498,431701,12,3203,2,7200,1.00374648767
428487,428503,431187,16,2684,2,7200,1.00596125186
428502,428510,431247,8,2737,2,7200,1.00292290829
428544,428551,431417,7,2866,2,7200,1.00244242847
428592,428598,431604,6,3006,2,7200,1.00199600798
428607,428614,431583,7,2969,2,7200,1.00235769619
428622,428629,431472,7,2843,2,7200,1.00246218783
428637,428644,431540,7,2896,2,7200,1.00241712707
428652,428658,431736,6,3078,2,7200,1.00194931774
428676,428683,431563,7,2880,2,7200,1.00243055556
428691,428697,431845,6,3148,2,7200,1.00190597205
428692,428703,431678,11,2975,2,7200,1.00369747899
428716,428722,431598,6,2876,2,7200,1.00208623088
428731,428737,431604,6,2867,2,7200,1.00209277991
428745,428751,431822,6,3071,2,7200,1.00195376099
428793,428800,431727,7,2927,2,7200,1.00239152716
428808,428815,431747,7,2932,2,7200,1.00238744884
428823,428829,431887,6,3058,2,7200,1.00196206671
428934,428940,431836,6,2896,2,7200,1.0020718232
429016,429022,431953,6,2931,2,7200,1.00204708291
429030,429038,432027,8,2989,2,7200,1.00267648043
429032,429045,432055,13,3010,2,7200,1.00431893688
429050,429057,432033,7,2976,2,7200,1.00235215054
429113,429120,432187,7,3067,2,7200,1.00228236061
429176,429182,432074,6,2892,2,7200,1.0020746888
429272,429279,432300,7,3021,2,7200,1.00231711354
429939,570511,573884,140572,3373,11,43200,42.6756596502
430488,430494,430495,6,1,1,3600,1.0
430764,430771,433708,7,2937,2,7200,1.00238338441
430789,430796,431027,7,231,1,900,1.0303030303
430826,430834,430835,8,1,1,3600,1.0
430913,430919,431159,6,240,1,900,1.025
430917,431039,431224,122,185,1,3600,1.65945945946
430962,431090,431224,128,134,1,3600,1.9552238806
431038,431045,434001,7,2956,2,7200,1.00236806495
431071,431078,433804,7,2726,2,7200,1.002567865
431072,431084,434056,12,2972,2,7200,1.00403768506
431156,431167,433970,11,2803,2,7200,1.00392436675
431189,431196,434471,7,3275,2,7200,1.00213740458
431249,431256,434143,7,2887,2,7200,1.00242466228
431266,431273,434235,7,2962,2,7200,1.00236326806
431290,431297,434037,7,2740,2,7200,1.00255474453
431305,431311,434285,6,2974,2,7200,1.00201748487
431335,431341,434350,6,3009,2,7200,1.00199401795
431354,432929,468079,1575,35150,1,54000,1.04480796586
431356,431363,434220,7,2857,2,7200,1.00245012251
431419,431425,434050,6,2625,2,7200,1.00228571429
431419,432935,467764,1516,34829,1,54000,1.04352694594
431461,431467,434453,6,2986,2,7200,1.00200937709
431470,434367,470024,2897,35657,1,54000,1.0812463191
431475,431482,434511,7,3029,2,7200,1.00231099373
431477,431488,434541,11,3053,2,7200,1.00360301343
431492,431498,434378,6,2880,2,7200,1.00208333333
431509,431516,434524,7,3008,2,7200,1.00232712766
431542,431549,434537,7,2988,2,7200,1.00234270415
431545,434488,470038,2943,35550,1,54000,1.08278481013
431563,431569,434491,6,2922,2,7200,1.00205338809
431584,431590,434705,6,3115,2,7200,1.00192616372
431599,431605,434430,6,2825,2,7200,1.00212389381
431614,431620,434436,6,2816,2,7200,1.00213068182
431615,431627,434773,12,3146,2,7200,1.00381436745
431627,431633,431866,6,233,1,900,1.02575107296
431633,486901,522597,55268,35696,1,54000,2.54829672792
431678,431684,434596,6,2912,2,7200,1.00206043956
431701,523969,559966,92268,35997,1,54000,3.56321360113
431702,431708,434542,6,2834,2,7200,1.00211714891
431729,431736,434574,7,2838,2,7200,1.00246652572
431743,431750,434926,7,3176,2,7200,1.00220403023
431758,431766,434700,8,2934,2,7200,1.00272665303
431775,530161,565460,98386,35299,1,54000,3.78721776821
431811,556108,592815,124297,36707,1,54000,4.38619336911
431824,431830,434721,6,2891,2,7200,1.00207540643
431839,431845,434777,6,2932,2,7200,1.00204638472
431851,559978,595149,128127,35171,1,54000,4.64297290381
431854,431861,434708,7,2847,2,7200,1.00245872849
431887,431894,434889,7,2995,2,7200,1.00233722871
431956,431961,435015,5,3054,2,7200,1.00163719712
432028,432035,434856,7,2821,2,7200,1.00248138958
432043,432049,435083,6,3034,2,7200,1.00197758734
432057,432064,435277,7,3213,2,7200,1.00217864924
432075,432082,434960,7,2878,2,7200,1.00243224461
432189,432197,435231,8,3034,2,7200,1.00263678312
432279,565301,600100,133022,34799,1,54000,4.82258110865
432286,565306,600237,133020,34931,1,54000,4.80807878389
432301,432307,435233,6,2926,2,7200,1.002050581
432333,432340,432579,7,239,1,900,1.02928870293
432340,565474,600408,133134,34934,1,54000,4.81101505696
432406,570521,606811,138115,36290,1,54000,4.80586938551
432456,570526,600372,138070,29846,1,54000,5.62608054681
432508,573906,601792,141398,27886,1,54000,6.07057304741
433708,433714,436378,6,2664,2,7200,1.00225225225
433804,433812,436955,8,3143,2,7200,1.00254533885
433973,433980,436697,7,2717,2,7200,1.002576371
434003,434009,437049,6,3040,2,7200,1.00197368421
434039,434046,437005,7,2959,2,7200,1.00236566408
434053,434060,437003,7,2943,2,7200,1.00237852531
434068,434074,436806,6,2732,2,7200,1.00219619327
434143,434149,437079,6,2930,2,7200,1.00204778157
434221,434227,437297,6,3070,2,7200,1.00195439739
434236,434243,437360,7,3117,2,7200,1.00224574912
434287,434293,437250,6,2957,2,7200,1.00202908353
434353,434360,437361,7,3001,2,7200,1.00233255581
434379,434391,437329,12,2938,2,7200,1.00408441116
434430,434441,437565,11,3124,2,7200,1.00352112676
434445,434451,437348,6,2897,2,7200,1.00207110804
434460,434466,437207,6,2741,2,7200,1.00218898212
434475,434483,437594,8,3111,2,7200,1.00257152041
434492,434503,437521,11,3018,2,7200,1.00364479788
434513,434523,437559,10,3036,2,7200,1.00329380764
434528,434535,437553,7,3018,2,7200,1.00231941683
434543,434551,437485,8,2934,2,7200,1.00272665303
434544,434558,437677,14,3119,2,7200,1.00448861815
434546,434563,437620,17,3057,2,7200,1.00556100752
434576,434586,437419,10,2833,2,7200,1.00352982704
434597,434608,437581,11,2973,2,7200,1.00369996636
434702,434712,437636,10,2924,2,7200,1.00341997264
434717,434724,437975,7,3251,2,7200,1.00215318364
434718,434731,437643,13,2912,2,7200,1.00446428571
434733,434739,437803,6,3064,2,7200,1.00195822454
434775,434785,437433,10,2648,2,7200,1.00377643505
434790,434796,438143,6,3347,2,7200,1.00179265013
434859,434868,437677,9,2809,2,7200,1.00320398718
434892,434901,438157,9,3256,2,7200,1.00276412776
434928,434937,438208,9,3271,2,7200,1.00275145216
434960,434972,437963,12,2991,2,7200,1.00401203611
435018,435027,438369,9,3342,2,7200,1.0026929982
435084,435096,438242,12,3146,2,7200,1.00381436745
435234,435243,438201,9,2958,2,7200,1.00304259635
435236,435249,438072,13,2823,2,7200,1.00460503011
435278,435288,438196,10,2908,2,7200,1.00343878955
436379,436389,439429,10,3040,2,7200,1.00328947368
436698,436709,439528,11,2819,2,7200,1.00390209294
436806,436817,439587,11,2770,2,7200,1.00397111913
436957,436967,439782,10,2815,2,7200,1.00355239787
437005,437015,440207,10,3192,2,7200,1.00313283208
437006,437022,439895,16,2873,2,7200,1.00556909154
437051,437061,439991,10,2930,2,7200,1.00341296928
437081,437092,439894,11,2802,2,7200,1.00392576731
437207,437219,439871,12,2652,2,7200,1.00452488688
437252,437262,440253,10,2991,2,7200,1.00334336342
437297,437308,440241,11,2933,2,7200,1.00375042618
437330,437342,440228,12,2886,2,7200,1.00415800416
437345,437360,440210,15,2850,2,7200,1.00526315789
437363,437372,440296,9,2924,2,7200,1.00307797538
437364,437378,440266,14,2888,2,7200,1.00484764543
437421,437431,440258,10,2827,2,7200,1.00353731871
437436,437445,440208,9,2763,2,7200,1.00325732899
437487,437498,440561,11,3063,2,7200,1.00359125041
437523,437532,440756,9,3224,2,7200,1.00279156328
437553,437564,440560,11,2996,2,7200,1.00367156208
437568,437579,440552,11,2973,2,7200,1.00369996636
437569,437584,440569,15,2985,2,7200,1.00502512563
437584,437594,440485,10,2891,2,7200,1.00345901072
437599,437606,440565,7,2959,2,7200,1.00236566408
437623,437633,440585,10,2952,2,7200,1.00338753388
437637,437648,440725,11,3077,2,7200,1.00357491063
437652,437658,440653,6,2995,2,7200,1.0020033389
437679,437689,440788,10,3099,2,7200,1.00322684737
437681,437694,440530,13,2836,2,7200,1.00458392102
437804,437815,440681,11,2866,2,7200,1.00383810188
437963,437975,440934,12,2959,2,7200,1.00405542413
437978,437987,440852,9,2865,2,7200,1.00314136126
438072,438083,441052,11,2969,2,7200,1.00370495116
438144,438156,441145,12,2989,2,7200,1.00401472064
438158,438169,441131,11,2962,2,7200,1.00371370695
438197,438208,441028,11,2820,2,7200,1.00390070922
438212,438219,441125,7,2906,2,7200,1.00240880936
438214,438225,441268,11,3043,2,7200,1.00361485376
438244,438255,441231,11,2976,2,7200,1.00369623656
438370,438382,441457,12,3075,2,7200,1.00390243902
439431,439441,442326,10,2885,2,7200,1.00346620451
439530,439540,442617,10,3077,2,7200,1.00324991875
439587,439599,442721,12,3122,2,7200,1.00384368994
439783,439794,442678,11,2884,2,7200,1.00381414702
439873,439884,442847,11,2963,2,7200,1.00371245359
439897,439906,442904,9,2998,2,7200,1.00300200133
439898,439913,442889,15,2976,2,7200,1.00504032258
439991,440003,442879,12,2876,2,7200,1.00417246175
440208,440220,443293,12,3073,2,7200,1.00390497885
440223,440229,443012,6,2783,2,7200,1.00215594682
440224,440236,443186,12,2950,2,7200,1.00406779661
440239,440245,443295,6,3050,2,7200,1.00196721311
440254,440261,443053,7,2792,2,7200,1.00250716332
440256,440268,443330,12,3062,2,7200,1.00391900718
440271,440278,443336,7,3058,2,7200,1.00228907783
440272,440285,443225,13,2940,2,7200,1.00442176871
440299,440309,443239,10,2930,2,7200,1.00341296928
440485,440497,443352,12,2855,2,7200,1.00420315236
440530,440542,443476,12,2934,2,7200,1.00408997955
440554,440563,443654,9,3091,2,7200,1.00291167907
440570,440576,443531,6,2955,2,7200,1.00203045685
440571,440584,443534,13,2950,2,7200,1.00440677966
440572,440589,443461,17,2872,2,7200,1.00591922006
440573,440594,443707,21,3113,2,7200,1.00674590427
440588,440601,443438,13,2837,2,7200,1.00458230525
440654,440665,443363,11,2698,2,7200,1.00407709414
440681,440693,443447,12,2754,2,7200,1.00435729847
440726,440737,443793,11,3056,2,7200,1.00359947644
440759,440767,443605,8,2838,2,7200,1.00281888654
440789,440800,443650,11,2850,2,7200,1.00385964912
440852,440864,443728,12,2864,2,7200,1.00418994413
440936,440946,443998,10,3052,2,7200,1.00327653997
441030,441040,443939,10,2899,2,7200,1.00344946533
441054,441065,443943,11,2878,2,7200,1.00382209868
441126,441137,444110,11,2973,2,7200,1.00369996636
441141,441147,444010,6,2863,2,7200,1.00209570381
441155,441162,444279,7,3117,2,7200,1.00224574912
441233,441244,444237,11,2993,2,7200,1.00367524223
441269,441280,444169,11,2889,2,7200,1.00380754586
441459,441469,444208,10,2739,2,7200,1.00365096751
442326,442338,445138,12,2800,2,7200,1.00428571429
442618,442629,445464,11,2835,2,7200,1.00388007055
442681,442689,445894,8,3205,2,7200,1.00249609984
442723,442733,445818,10,3085,2,7200,1.00324149109
442849,442859,445679,10,2820,2,7200,1.00354609929
442879,442891,445912,12,3021,2,7200,1.00397219464
442894,442901,446034,7,3133,2,7200,1.00223428024
442909,442916,445796,7,2880,2,7200,1.00243055556
443014,443024,446091,10,3067,2,7200,1.00326051516
443056,443065,445922,9,2857,2,7200,1.00315015751
443188,443199,446078,11,2879,2,7200,1.0038207711
443227,443247,446185,20,2938,2,7200,1.00680735194
443242,443254,446239,12,2985,2,7200,1.0040201005
443296,443305,446183,9,2878,2,7200,1.00312717165
443297,443313,446206,16,2893,2,7200,1.00553059108
443330,443342,446166,12,2824,2,7200,1.00424929178
443345,443351,446417,6,3066,2,7200,1.00195694716
443360,443366,446182,6,2816,2,7200,1.00213068182
443361,443375,446439,14,3064,2,7200,1.0045691906
443439,443449,446661,10,3212,2,7200,1.00311332503
443454,443460,446445,6,2985,2,7200,1.00201005025
443469,443476,446445,7,2969,2,7200,1.00235769619
443483,443490,446302,7,2812,2,7200,1.00248933144
443531,443543,446319,12,2776,2,7200,1.00432276657
443546,443552,446646,6,3094,2,7200,1.00193923723
443606,443616,446515,10,2899,2,7200,1.00344946533
443651,443666,446782,15,3116,2,7200,1.00481386393
443666,443672,446712,6,3040,2,7200,1.00197368421
443708,443719,446678,11,2959,2,7200,1.00371747212
443728,443740,446487,12,2747,2,7200,1.00436840189
443795,443804,446845,9,3041,2,7200,1.00295955278
443939,443950,446867,11,2917,2,7200,1.0037709976
443954,443960,447018,6,3058,2,7200,1.00196206671
443999,444009,447084,10,3075,2,7200,1.00325203252
444014,444022,447007,8,2985,2,7200,1.002680067
444110,444121,447193,11,3072,2,7200,1.00358072917
444170,444180,447213,10,3033,2,7200,1.00329706561
444209,444220,447036,11,2816,2,7200,1.00390625
444239,444249,447142,10,2893,2,7200,1.00345661943
444281,444291,446875,10,2584,2,7200,1.00386996904
445139,445150,448007,11,2857,2,7200,1.00385019251
445466,445475,448540,9,3065,2,7200,1.00293637847
445680,445690,448461,10,2771,2,7200,1.00360880549
445797,445808,448708,11,2900,2,7200,1.00379310345
445818,445830,448887,12,3057,2,7200,1.00392541708
445896,445906,448980,10,3074,2,7200,1.00325309044
445914,445925,448956,11,3031,2,7200,1.00362916529
445929,445935,448937,6,3002,2,7200,1.00199866755
446034,446046,448993,12,2947,2,7200,1.00407193756
446079,446090,449052,11,2962,2,7200,1.00371370695
446094,446102,449061,8,2959,2,7200,1.00270361609
446166,446178,449073,12,2895,2,7200,1.00414507772
446184,446195,449290,11,3095,2,7200,1.00355411955
446185,446200,449082,15,2882,2,7200,1.00520471895
446200,446206,449214,6,3008,2,7200,1.00199468085
446215,446221,449074,6,2853,2,7200,1.00210304942
446242,446252,449121,10,2869,2,7200,1.00348553503
446302,446314,449144,12,2830,2,7200,1.00424028269
446320,446330,449641,10,3311,2,7200,1.00302023558
446419,446429,449178,10,2749,2,7200,1.00363768643
446440,446450,449427,10,2977,2,7200,1.00335908633
446455,446463,449121,8,2658,2,7200,1.00300978179
446456,446468,449251,12,2783,2,7200,1.00431189364
446490,446498,449734,8,3236,2,7200,1.00247218789
446513,446526,449406,13,2880,2,7200,1.00451388889
446646,446658,449683,12,3025,2,7200,1.00396694215
446664,446672,449679,8,3007,2,7200,1.00266045893
446679,446690,449636,11,2946,2,7200,1.00373387644
446711,446724,449583,13,2859,2,7200,1.00454704442
446784,446794,449662,10,2868,2,7200,1.00348675035
446846,446857,450009,11,3152,2,7200,1.00348984772
446867,446879,449994,12,3115,2,7200,1.00385232745
446882,446889,450099,7,3210,2,7200,1.00218068536
447008,447018,450072,10,3054,2,7200,1.00327439424
447023,447029,450097,6,3068,2,7200,1.00195567145
447038,447047,449909,9,2862,2,7200,1.00314465409
447086,447096,450169,10,3073,2,7200,1.00325414904
447143,447154,450158,11,3004,2,7200,1.00366178429
447194,447204,450028,10,2824,2,7200,1.00354107649
447215,447224,450294,9,3070,2,7200,1.00293159609
448007,448019,450953,12,2934,2,7200,1.00408997955
448461,448473,451572,12,3099,2,7200,1.00387221684
448543,448552,451715,9,3163,2,7200,1.00284539994
448708,448720,451703,12,2983,2,7200,1.00402279584
448888,448900,451812,12,2912,2,7200,1.00412087912
448939,448950,451953,11,3003,2,7200,1.00366300366
448957,448968,452211,11,3243,2,7200,1.00339192106
448981,448993,452171,12,3178,2,7200,1.00377595972
448996,449005,452062,9,3057,2,7200,1.00294406281
449053,449064,452029,11,2965,2,7200,1.00370994941
449067,449074,451856,7,2782,2,7200,1.00251617541
449082,449089,452119,7,3030,2,7200,1.00231023102
449084,449095,452100,11,3005,2,7200,1.00366056572
449085,449102,452022,17,2920,2,7200,1.00582191781
449124,449133,452154,9,3021,2,7200,1.00297914598
449126,449138,452273,12,3135,2,7200,1.0038277512
449147,449156,452137,9,2981,2,7200,1.0030191211
449179,449189,452153,10,2964,2,7200,1.00337381916
449215,449226,452062,11,2836,2,7200,1.0038787024
449251,449263,452245,12,2982,2,7200,1.00402414487
449290,449302,452179,12,2877,2,7200,1.00417101147
449408,449417,452286,9,2869,2,7200,1.00313698153
449429,449439,452450,10,3011,2,7200,1.00332115576
449585,449596,452413,11,2817,2,7200,1.00390486333
449637,449647,452637,10,2990,2,7200,1.00334448161
449651,449657,452405,6,2748,2,7200,1.00218340611
449666,449675,452599,9,2924,2,7200,1.00307797538
449681,449690,452752,9,3062,2,7200,1.00293925539
449695,449703,452654,8,2951,2,7200,1.00271094544
449734,449746,452625,12,2879,2,7200,1.00416811393
449909,449922,452824,13,2902,2,7200,1.00447966919
449996,450006,452916,10,2910,2,7200,1.00343642612
450011,450021,453082,10,3061,2,7200,1.00326690624
450029,450040,452964,11,2924,2,7200,1.0037619699
450075,450084,453079,9,2995,2,7200,1.00300500835
450099,450110,453228,11,3118,2,7200,1.0035279025
450100,450117,453088,17,2971,2,7200,1.00572197913
450161,450170,453028,9,2858,2,7200,1.00314905528
450176,450182,453050,6,2868,2,7200,1.00209205021
450296,450306,453301,10,2995,2,7200,1.00333889816
450956,450966,453779,10,2813,2,7200,1.00355492357
451572,451584,454347,12,2763,2,7200,1.00434310532
451705,451715,454860,10,3145,2,7200,1.00317965024
451719,451727,454782,8,3055,2,7200,1.00261865794
451813,451824,454897,11,3073,2,7200,1.00357956394
451857,451868,454840,11,2972,2,7200,1.00370121131
451954,451964,454848,10,2884,2,7200,1.00346740638
452023,452034,454745,11,2711,2,7200,1.00405754334
452037,452045,455244,8,3199,2,7200,1.00250078149
452064,452074,455081,10,3007,2,7200,1.00332557366
452066,452079,455407,13,3328,2,7200,1.00390625
452102,452111,455277,9,3166,2,7200,1.00284270373
452119,452132,455064,13,2932,2,7200,1.00443383356
452137,452149,455109,12,2960,2,7200,1.00405405405
452155,452164,455279,9,3115,2,7200,1.00288924559
452157,452171,455142,14,2971,2,7200,1.00471221811
452171,452183,455215,12,3032,2,7200,1.00395778364
452186,452192,455231,6,3039,2,7200,1.00197433366
452213,452224,455319,11,3095,2,7200,1.00355411955
452246,452256,455308,10,3052,2,7200,1.00327653997
452276,452285,455391,9,3106,2,7200,1.00289761751
452290,452297,455384,7,3087,2,7200,1.0022675737
452408,452416,455285,8,2869,2,7200,1.00278842802
452422,452429,455168,7,2739,2,7200,1.00255567725
452452,452462,455254,10,2792,2,7200,1.00358166189
452600,452610,455486,10,2876,2,7200,1.00347705146
452627,452637,455688,10,3051,2,7200,1.0032776139
452642,452649,455605,7,2956,2,7200,1.00236806495
452657,452666,455728,9,3062,2,7200,1.00293925539
452753,452764,455691,11,2927,2,7200,1.00375811411
452825,452837,455558,12,2721,2,7200,1.00441014333
452918,452928,455874,10,2946,2,7200,1.00339443313
452963,452975,455719,12,2744,2,7200,1.00437317784
453029,453040,456131,11,3091,2,7200,1.00355871886
453050,453061,455835,11,2774,2,7200,1.00396539293
453080,453092,455812,12,2720,2,7200,1.00441176471
453095,453102,455882,7,2780,2,7200,1.00251798561
453096,453108,456018,12,2910,2,7200,1.00412371134
453229,453240,456085,11,2845,2,7200,1.00386643234
453301,453313,456139,12,2826,2,7200,1.0042462845
453780,453791,456755,11,2964,2,7200,1.00371120108
454349,454359,457430,10,3071,2,7200,1.00325626832
454746,454757,457715,11,2958,2,7200,1.00371872887
454782,454795,457882,13,3087,2,7200,1.00421120829
454839,454851,457904,12,3053,2,7200,1.0039305601
454854,454860,457972,6,3112,2,7200,1.00192802057
454869,454876,457864,7,2988,2,7200,1.00234270415
454899,454909,457925,10,3016,2,7200,1.00331564987
455064,455071,458024,7,2953,2,7200,1.00237047071
455082,455089,458372,7,3283,2,7200,1.00213219616
455109,455115,458102,6,2987,2,7200,1.00200870439
455145,455152,458089,7,2937,2,7200,1.00238338441
455169,455176,458354,7,3178,2,7200,1.00220264317
455217,455224,457943,7,2719,2,7200,1.00257447591
455231,455239,458135,8,2896,2,7200,1.00276243094
455246,455253,458465,7,3212,2,7200,1.00217932752
455261,455267,458209,6,2942,2,7200,1.00203942896
455279,455285,458015,6,2730,2,7200,1.0021978022
455280,455292,458460,12,3168,2,7200,1.00378787879
455295,455301,458200,6,2899,2,7200,1.0020696792
455310,455316,458361,6,3045,2,7200,1.00197044335
455325,455332,458214,7,2882,2,7200,1.00242886884
455385,455392,458296,7,2904,2,7200,1.00241046832
455400,455407,458302,7,2895,2,7200,1.002417962
455414,455421,458765,7,3344,2,7200,1.00209330144
455487,455494,458349,7,2855,2,7200,1.00245183888
455559,455565,458352,6,2787,2,7200,1.00215285253
455607,455613,458606,6,2993,2,7200,1.00200467758
455691,455697,458479,6,2782,2,7200,1.00215672178
455692,455703,458879,11,3176,2,7200,1.00346347607
455719,455727,458577,8,2850,2,7200,1.00280701754
455734,455740,458767,6,3027,2,7200,1.00198216056
455812,455819,458757,7,2938,2,7200,1.00238257318
455836,455843,458774,7,2931,2,7200,1.00238826339
455875,455882,459119,7,3237,2,7200,1.00216249614
455890,455896,458819,6,2923,2,7200,1.0020526856
456019,456025,458797,6,2772,2,7200,1.00216450216
456085,456092,459007,7,2915,2,7200,1.00240137221
456133,456139,459010,6,2871,2,7200,1.00208986416
456148,456155,459234,7,3079,2,7200,1.00227346541
456756,456762,459743,6,2981,2,7200,1.0020127474
457430,457437,460502,7,3065,2,7200,1.00228384992
457716,457722,460694,6,2972,2,7200,1.00201884253
457866,457872,461002,6,3130,2,7200,1.00191693291
457884,457891,460938,7,3047,2,7200,1.00229734165
457905,457911,460840,6,2929,2,7200,1.00204848071
457926,457933,460927,7,2994,2,7200,1.00233800935
457943,457951,461243,8,3292,2,7200,1.00243013366
457973,457980,460830,7,2850,2,7200,1.00245614035
458015,458023,460897,8,2874,2,7200,1.0027835769
458030,458038,460827,8,2789,2,7200,1.00286841162
458090,458097,461017,7,2920,2,7200,1.00239726027
458105,458111,460978,6,2867,2,7200,1.00209277991
458138,458144,461139,6,2995,2,7200,1.0020033389
458201,458208,461129,7,2921,2,7200,1.00239643958
458216,458222,461193,6,2971,2,7200,1.00201952205
458217,458228,461118,11,2890,2,7200,1.00380622837
458298,458306,461187,8,2881,2,7200,1.00277681361
458313,458319,461110,6,2791,2,7200,1.00214976711
458349,458355,461192,6,2837,2,7200,1.00211491012
458364,458370,461204,6,2834,2,7200,1.00211714891
458366,458377,461296,11,2919,2,7200,1.00376841384
458367,458382,461194,15,2812,2,7200,1.00533428165
458382,458389,461334,7,2945,2,7200,1.00237691002
458463,458469,461507,6,3038,2,7200,1.00197498354
458478,458485,461334,7,2849,2,7200,1.00245700246
458493,458499,461445,6,2946,2,7200,1.00203665988
458577,458583,461671,6,3088,2,7200,1.00194300518
458607,458613,461476,6,2863,2,7200,1.00209570381
458757,458764,461782,7,3018,2,7200,1.00231941683
458773,458779,461692,6,2913,2,7200,1.00205973223
458774,458785,461890,11,3105,2,7200,1.00354267311
458789,458796,461930,7,3134,2,7200,1.00223356733
458804,458810,461743,6,2933,2,7200,1.00204568701
458821,458829,461804,8,2975,2,7200,1.00268907563
458881,458888,461725,7,2837,2,7200,1.00246739514
459008,459014,461939,6,2925,2,7200,1.00205128205
459023,459029,461952,6,2923,2,7200,1.0020526856
459122,459128,461961,6,2833,2,7200,1.00211789622
459236,459244,462175,8,2931,2,7200,1.00272944388
459744,459750,462786,6,3036,2,7200,1.00197628458
460503,460509,463519,6,3010,2,7200,1.00199335548
460696,460702,463746,6,3044,2,7200,1.00197109067
460828,460834,463745,6,2911,2,7200,1.00206114737
460843,460849,463731,6,2882,2,7200,1.00208188758
460844,460855,463912,11,3057,2,7200,1.00359829899
460899,460905,463917,6,3012,2,7200,1.00199203187
460928,460936,463925,8,2989,2,7200,1.00267648043
460943,460949,464020,6,3071,2,7200,1.00195376099
460979,460985,463737,6,2752,2,7200,1.00218023256
461003,461009,464227,6,3218,2,7200,1.00186451212
461018,461024,464011,6,2987,2,7200,1.00200870439
461105,461111,464149,6,3038,2,7200,1.00197498354
461120,461126,463963,6,2837,2,7200,1.00211491012
461135,461141,464201,6,3060,2,7200,1.00196078431
461150,461156,464210,6,3054,2,7200,1.00196463654
461189,461196,463869,7,2673,2,7200,1.0026187804
461204,461211,463998,7,2787,2,7200,1.00251166128
461205,461218,464255,13,3037,2,7200,1.00428054001
461207,461223,464400,16,3177,2,7200,1.00503619767
461221,461229,464472,8,3243,2,7200,1.00246685168
461245,461251,464273,6,3022,2,7200,1.00198544011
461299,461306,464051,7,2745,2,7200,1.00255009107
461332,461339,464243,7,2904,2,7200,1.00241046832
461347,461353,464466,6,3113,2,7200,1.00192740122
461446,461452,464633,6,3181,2,7200,1.00188619931
461476,461482,464466,6,2984,2,7200,1.00201072386
461509,461515,464286,6,2771,2,7200,1.00216528329
461672,461679,464660,7,2981,2,7200,1.0023482053
461693,461700,464465,7,2765,2,7200,1.00253164557
461726,461733,464709,7,2976,2,7200,1.00235215054
461744,461750,464720,6,2970,2,7200,1.00202020202
461783,461789,464660,6,2871,2,7200,1.00208986416
461807,461814,464844,7,3030,2,7200,1.00231023102
461891,461898,464842,7,2944,2,7200,1.00237771739
461930,461936,464922,6,2986,2,7200,1.00200937709
461945,461951,465005,6,3054,2,7200,1.00196463654
461960,461967,465254,7,3287,2,7200,1.00212960146
461974,461981,464815,7,2834,2,7200,1.00247000706
462176,462183,465200,7,3017,2,7200,1.00232018561
462788,462794,465772,6,2978,2,7200,1.00201477502
463520,463527,466569,7,3042,2,7200,1.00230111769
463734,463741,466559,7,2818,2,7200,1.00248403123
463749,463755,466719,6,2964,2,7200,1.0020242915
463750,463762,466765,12,3003,2,7200,1.003996004
463752,463767,466630,15,2863,2,7200,1.00523925952
463866,463872,467070,6,3198,2,7200,1.00187617261
463914,463920,466818,6,2898,2,7200,1.00207039337
463929,463936,466979,7,3043,2,7200,1.00230036149
463930,463942,466798,12,2856,2,7200,1.00420168067
463964,463970,466897,6,2927,2,7200,1.00204988042
464000,464006,467133,6,3127,2,7200,1.00191877199
464015,464022,467018,7,2996,2,7200,1.0023364486
464030,464037,467082,7,3045,2,7200,1.00229885057
464054,464060,466847,6,2787,2,7200,1.00215285253
464150,464162,467080,12,2918,2,7200,1.00411240576
464204,464210,467241,6,3031,2,7200,1.0019795447
464219,464225,466957,6,2732,2,7200,1.00219619327
464234,464240,467002,6,2762,2,7200,1.00217233888
464249,464255,467271,6,3016,2,7200,1.00198938992
464263,464270,467135,7,2865,2,7200,1.00244328098
464278,464284,467088,6,2804,2,7200,1.00213980029
464293,464299,466935,6,2636,2,7200,1.00227617602
464402,464408,467164,6,2756,2,7200,1.00217706821
464468,464476,467359,8,2883,2,7200,1.00277488727
464470,464483,467565,13,3082,2,7200,1.00421804023
464471,464488,467253,17,2765,2,7200,1.0061482821
464486,464495,467652,9,3157,2,7200,1.00285080773
464634,464641,467662,7,3021,2,7200,1.00231711354
464661,464668,467601,7,2933,2,7200,1.00238663484
464662,464675,467833,13,3158,2,7200,1.00411652945
464710,464716,467781,6,3065,2,7200,1.00195758564
464725,464731,467696,6,2965,2,7200,1.00202360877
464815,464821,468046,6,3225,2,7200,1.00186046512
464842,464849,467988,7,3139,2,7200,1.00223000956
464857,464863,467804,6,2941,2,7200,1.00204012241
464923,464929,467888,6,2959,2,7200,1.00202771206
465007,465014,468014,7,3000,2,7200,1.00233333333
465200,465211,468024,11,2813,2,7200,1.00391041593
465257,465263,468288,6,3025,2,7200,1.00198347107
465367,730715,801804,265348,71089,6,72000,4.73261686056
465772,465778,468829,6,3051,2,7200,1.00196656834
466561,466567,469504,6,2937,2,7200,1.00204290092
466576,466583,469762,7,3179,2,7200,1.0022019503
466630,466636,469855,6,3219,2,7200,1.0018639329
466720,466727,469461,7,2734,2,7200,1.00256035113
466765,466771,469578,6,2807,2,7200,1.00213751336
466801,466807,469798,6,2991,2,7200,1.00200601805
466818,466826,469847,8,3021,2,7200,1.00264812976
466848,466855,469602,7,2747,2,7200,1.00254823444
466899,466907,469968,8,3061,2,7200,1.00261352499
466938,466946,469816,8,2870,2,7200,1.00278745645
466959,466965,470017,6,3052,2,7200,1.00196592398
466980,466988,469706,8,2718,2,7200,1.00294334069
467004,467011,469946,7,2935,2,7200,1.00238500852
467019,467025,469841,6,2816,2,7200,1.00213068182
467070,467077,470218,7,3141,2,7200,1.00222858962
467085,467091,470044,6,2953,2,7200,1.00203183204
467087,467099,469998,12,2899,2,7200,1.0041393584
467101,467108,470077,7,2969,2,7200,1.00235769619
467134,467141,470203,7,3062,2,7200,1.00228608752
467136,467148,469930,12,2782,2,7200,1.00431344357
467166,467172,470426,6,3254,2,7200,1.00184388445
467241,467248,470214,7,2966,2,7200,1.00236008092
467256,467262,470267,6,3005,2,7200,1.00199667221
467274,467281,470383,7,3102,2,7200,1.00225660864
467361,467368,470615,7,3247,2,7200,1.00215583616
467566,467572,470510,6,2938,2,7200,1.00204220558
467602,467609,470272,7,2663,2,7200,1.00262861434
467653,467660,470707,7,3047,2,7200,1.00229734165
467668,467674,470713,6,3039,2,7200,1.00197433366
467698,467705,470680,7,2975,2,7200,1.00235294118
467782,467788,470441,6,2653,2,7200,1.00226159065
467806,467813,470814,7,3001,2,7200,1.00233255581
467836,467842,470593,6,2751,2,7200,1.00218102508
467890,467897,471041,7,3144,2,7200,1.0022264631
467989,467995,470923,6,2928,2,7200,1.00204918033
468016,468022,470829,6,2807,2,7200,1.00213751336
468031,468039,470815,8,2776,2,7200,1.00288184438
468049,468056,471264,7,3208,2,7200,1.00218204489
468289,468297,471174,8,2877,2,7200,1.00278067431
468831,468837,471800,6,2963,2,7200,1.00202497469
469014,730921,730932,261907,11,2,180000,23810.7272727
469192,469199,469781,7,582,2,14400,1.01202749141
469462,469468,472344,6,2876,2,7200,1.00208623088
469504,469510,472440,6,2930,2,7200,1.00204778157
469579,469586,472797,7,3211,2,7200,1.00218000623
469603,469609,472752,6,3143,2,7200,1.00190900414
469708,469714,472924,6,3210,2,7200,1.00186915888
469762,469768,472844,6,3076,2,7200,1.00195058518
469766,469775,470365,9,590,2,14400,1.01525423729
469798,469804,472732,6,2928,2,7200,1.00204918033
469819,469825,472913,6,3088,2,7200,1.00194300518
469843,469849,472731,6,2882,2,7200,1.00208188758
469858,469864,473131,6,3267,2,7200,1.00183654729
469860,469871,472674,11,2803,2,7200,1.00392436675
469933,469940,473030,7,3090,2,7200,1.00226537217
469948,469955,473219,7,3264,2,7200,1.00214460784
469969,469975,472988,6,3013,2,7200,1.00199137073
469999,470006,472816,7,2810,2,7200,1.0024911032
470020,470027,473125,7,3098,2,7200,1.00225952227
470047,470053,472742,6,2689,2,7200,1.00223131276
470080,470087,473034,7,2947,2,7200,1.00237529691
470203,470210,473074,7,2864,2,7200,1.00244413408
470218,470225,473051,7,2826,2,7200,1.00247699929
470219,470232,473144,13,2912,2,7200,1.00446428571
470270,470277,473452,7,3175,2,7200,1.00220472441
470285,470291,473290,6,2999,2,7200,1.00200066689
470384,470390,473259,6,2869,2,7200,1.00209132102
470426,470433,473516,7,3083,2,7200,1.00227051573
470441,470447,473303,6,2856,2,7200,1.00210084034
470510,470516,473467,6,2951,2,7200,1.00203320908
470594,470601,473451,7,2850,2,7200,1.00245614035
470615,470621,473645,6,3024,2,7200,1.00198412698
470681,470688,473829,7,3141,2,7200,1.00222858962
470708,470715,473622,7,2907,2,7200,1.00240798074
470723,470729,473588,6,2859,2,7200,1.00209863589
470817,470823,473788,6,2965,2,7200,1.00202360877
470818,470830,473841,12,3011,2,7200,1.00398538691
470833,470840,473777,7,2937,2,7200,1.00238338441
470923,470931,473936,8,3005,2,7200,1.00266222962
471041,471047,474134,6,3087,2,7200,1.0019436346
471176,471184,474103,8,2919,2,7200,1.00274066461
471267,471273,474439,6,3166,2,7200,1.00189513582
471775,480250,481056,8475,806,2,28800,11.5148883375
471801,471807,474800,6,2993,2,7200,1.00200467758
471892,471898,475604,6,3706,4,3600,1.00161899622
472348,472354,475590,6,3236,2,7200,1.00185414091
472441,472447,475244,6,2797,2,7200,1.00214515552
472553,472559,472802,6,243,1,900,1.02469135802
472676,472686,475671,10,2985,2,7200,1.00335008375
472733,472743,475582,10,2839,2,7200,1.00352236703
472734,472749,475703,15,2954,2,7200,1.00507786053
472749,472760,475618,11,2858,2,7200,1.00384884535
472757,472768,473004,11,236,1,900,1.04661016949
472764,472774,475548,10,2774,2,7200,1.00360490267
472800,472809,475842,9,3033,2,7200,1.00296735905
472818,472828,475759,10,2931,2,7200,1.00341180484
472845,472855,475676,10,2821,2,7200,1.00354484225
472914,472925,475919,11,2994,2,7200,1.0036740147
472929,472935,475775,6,2840,2,7200,1.00211267606
472989,472999,475849,10,2850,2,7200,1.00350877193
473034,473042,476044,8,3002,2,7200,1.00266489007
473049,473056,476194,7,3138,2,7200,1.0022307202
473063,473069,475970,6,2901,2,7200,1.00206825233
473078,473085,476136,7,3051,2,7200,1.00229432973
473126,473137,476000,11,2863,2,7200,1.00384212365
473141,473147,475873,6,2726,2,7200,1.00220102715
473156,473162,476038,6,2876,2,7200,1.00208623088
473222,473231,476078,9,2847,2,7200,1.00316122234
473261,473272,476184,11,2912,2,7200,1.00377747253
473291,473302,476249,11,2947,2,7200,1.00373260943
473299,473308,474391,9,1083,1,3600,1.00831024931
473306,473316,476247,10,2931,2,7200,1.00341180484
473332,473338,474404,6,1066,1,3600,1.00562851782
473391,473397,474441,6,1044,1,3600,1.00574712644
473450,473457,474533,7,1076,1,3600,1.00650557621
473451,473464,476393,13,2929,2,7200,1.00443837487
473466,473473,476495,7,3022,2,7200,1.00231634679
473480,473487,476366,7,2879,2,7200,1.00243139979
473516,473527,476238,11,2711,2,7200,1.00405754334
473589,473600,476513,11,2913,2,7200,1.00377617576
473622,473633,476671,11,3038,2,7200,1.00362080316
473645,473657,476485,12,2828,2,7200,1.00424328147
473778,473788,476577,10,2789,2,7200,1.00358551452
473793,473799,476753,6,2954,2,7200,1.00203114421
473829,473840,476956,11,3116,2,7200,1.00353016688
473844,473853,476814,9,2961,2,7200,1.00303951368
473937,473947,476894,10,2947,2,7200,1.0033932813
474106,474114,477049,8,2935,2,7200,1.00272572402
474136,474146,476913,10,2767,2,7200,1.00361402241
474440,474452,477461,12,3009,2,7200,1.00398803589
474621,474632,474714,11,82,2,1800,1.13414634146
474621,474627,474710,6,83,2,1800,1.07228915663
474622,474638,474720,16,82,2,1800,1.19512195122
474622,474650,474724,28,74,2,1800,1.37837837838
474622,474645,474729,23,84,2,1800,1.27380952381
474622,474655,474731,33,76,2,1800,1.43421052632
474623,474745,474826,122,81,2,1800,2.50617283951
474623,474740,474821,117,81,2,1800,2.44444444444
474623,474727,474808,104,81,2,1800,2.28395061728
474623,474721,474802,98,81,2,1800,2.20987654321
474623,474733,474815,110,82,2,1800,2.34146341463
474624,474812,474904,188,92,2,1800,3.04347826087
474624,474819,474920,195,101,2,1800,2.93069306931
474624,474826,474928,202,102,2,1800,2.98039215686
474624,474832,474933,208,101,2,1800,3.05940594059
474624,474752,474833,128,81,2,1800,2.58024691358
474625,474916,474967,291,51,2,1800,6.70588235294
474625,474850,474943,225,93,2,1800,3.41935483871
474625,474845,474938,220,93,2,1800,3.36559139785
474625,474838,474941,213,103,2,1800,3.06796116505
474802,474978,477907,176,2929,2,7200,1.0600887675
475245,475256,478138,11,2882,2,7200,1.00381679389
475277,475283,478897,6,3614,8,3600,1.00166021029
475549,475560,478524,11,2964,2,7200,1.00371120108
475582,475593,478548,11,2955,2,7200,1.00372250423
475596,475603,478483,7,2880,2,7200,1.00243055556
475620,475630,478576,10,2946,2,7200,1.00339443313
475671,475682,478616,11,2934,2,7200,1.00374914792
475686,475692,478646,6,2954,2,7200,1.00203114421
475704,475714,478559,10,2845,2,7200,1.00351493849
475761,475770,478641,9,2871,2,7200,1.00313479624
475776,475786,478611,10,2825,2,7200,1.00353982301
475842,475854,478675,12,2821,2,7200,1.00425381071
475857,475863,478731,6,2868,2,7200,1.00209205021
475875,475884,478904,9,3020,2,7200,1.00298013245
475920,475930,478916,10,2986,2,7200,1.00334896182
475971,475981,479025,10,3044,2,7200,1.00328515112
476001,476011,478961,10,2950,2,7200,1.00338983051
476040,476049,478997,9,2948,2,7200,1.00305291723
476055,476061,478929,6,2868,2,7200,1.00209205021
476078,476089,479007,11,2918,2,7200,1.00376970528
476139,476147,478932,8,2785,2,7200,1.00287253142
476187,476195,479072,8,2877,2,7200,1.00278067431
476201,476208,479309,7,3101,2,7200,1.00225733634
476240,476249,479298,9,3049,2,7200,1.00295178747
476255,476262,479268,7,3006,2,7200,1.00232867598
476257,476269,479529,12,3260,2,7200,1.0036809816
476368,476377,479230,9,2853,2,7200,1.00315457413
476395,476405,479607,10,3202,2,7200,1.00312304809
476485,476496,479565,11,3069,2,7200,1.00358422939
476500,476506,479473,6,2967,2,7200,1.00202224469
476515,476525,479443,10,2918,2,7200,1.0034270048
476578,476589,479346,11,2757,2,7200,1.00398984403
476671,476683,479664,12,2981,2,7200,1.0040254948
476755,476764,479594,9,2830,2,7200,1.00318021201
476816,476826,479617,10,2791,2,7200,1.00358294518
476894,476905,480098,11,3193,2,7200,1.00344503602
476914,476926,480018,12,3092,2,7200,1.00388098318
476956,476969,479771,13,2802,2,7200,1.00463954318
477050,477060,480154,10,3094,2,7200,1.00323206206
477085,481068,531450,3983,50382,2,86400,1.07905601207
477463,477473,480430,10,2957,2,7200,1.00338180588
477637,479973,481814,2336,1841,16,1800,2.26887561108
477909,477919,480932,10,3013,2,7200,1.00331895121
478141,478150,481241,9,3091,2,7200,1.00291167907
478484,478494,481548,10,3054,2,7200,1.00327439424
478526,478536,481436,10,2900,2,7200,1.00344827586
478550,478560,481476,10,2916,2,7200,1.00342935528
478564,478570,481713,6,3143,2,7200,1.00190900414
478579,478588,481606,9,3018,2,7200,1.00298210736
478612,478623,481516,11,2893,2,7200,1.00380228137
478627,478633,481637,6,3004,2,7200,1.00199733688
478642,478652,481351,10,2699,2,7200,1.00370507595
478657,478663,481597,6,2934,2,7200,1.00204498978
478678,478686,481613,8,2927,2,7200,1.0027331739
478732,478743,481661,11,2918,2,7200,1.00376970528
478906,478915,481896,9,2981,2,7200,1.0030191211
478921,478927,481969,6,3042,2,7200,1.00197238659
478936,478943,481924,7,2981,2,7200,1.0023482053
478937,478949,481918,12,2969,2,7200,1.0040417649
478947,479978,484410,1031,4432,1,18000,1.23262635379
478961,478972,481968,11,2996,2,7200,1.00367156208
478997,479014,481955,17,2941,2,7200,1.00578034682
479012,479020,481730,8,2710,2,7200,1.00295202952
479027,479037,482031,10,2994,2,7200,1.00334001336
479072,479083,482143,11,3060,2,7200,1.00359477124
479109,479983,486890,874,6907,1,18000,1.12653829448
479223,496281,503070,17058,6789,1,18000,3.5125939019
479232,479242,482419,10,3177,2,7200,1.00314762354
479270,479279,482352,9,3073,2,7200,1.00292873414
479300,479310,482229,10,2919,2,7200,1.00342583076
479315,479322,482562,7,3240,2,7200,1.00216049383
479348,479357,482352,9,2995,2,7200,1.00300500835
479445,479456,482368,11,2912,2,7200,1.00377747253
479475,479485,482337,10,2852,2,7200,1.00350631136
479532,479540,482552,8,3012,2,7200,1.0026560425
479568,479576,482480,8,2904,2,7200,1.00275482094
479594,479605,482659,11,3054,2,7200,1.00360183366
479609,479619,482494,10,2875,2,7200,1.00347826087
479624,479630,482585,6,2955,2,7200,1.00203045685
479666,479676,482560,10,2884,2,7200,1.00346740638
479772,479782,482827,10,3045,2,7200,1.00328407225
480018,480029,483016,11,2987,2,7200,1.00368262471
480099,480110,482996,11,2886,2,7200,1.00381150381
480156,480165,483101,9,2936,2,7200,1.0030653951
480430,480442,483265,12,2823,2,7200,1.00425079702
480736,480743,480822,7,79,1,600,1.08860759494
480794,497448,498519,16654,1071,1,3600,16.5499533147
480933,480944,483928,11,2984,2,7200,1.00368632708
481243,481254,484082,11,2828,2,7200,1.00388967468
481352,481364,484355,12,2991,2,7200,1.00401203611
481439,481448,484355,9,2907,2,7200,1.00309597523
481478,481488,484399,10,2911,2,7200,1.00343524562
481517,481528,484408,11,2880,2,7200,1.00381944444
481550,481560,484506,10,2946,2,7200,1.00339443313
481598,481609,484536,11,2927,2,7200,1.00375811411
481613,481620,484660,7,3040,2,7200,1.00230263158
481614,481627,484490,13,2863,2,7200,1.00454069158
481638,481649,484564,11,2915,2,7200,1.00377358491
481662,481674,484716,12,3042,2,7200,1.00394477318
481713,481724,484750,11,3026,2,7200,1.00363516193
481731,481742,484651,11,2909,2,7200,1.00378136817
481897,481908,484875,11,2967,2,7200,1.0037074486
481921,481930,484781,9,2851,2,7200,1.00315678709
481936,481942,484976,6,3034,2,7200,1.00197758734
481957,481966,484995,9,3029,2,7200,1.00297127765
481972,481980,485021,8,3041,2,7200,1.00263071358
481973,481987,484998,14,3011,2,7200,1.00464961807
482033,482042,485151,9,3109,2,7200,1.00289482149
482145,482155,485169,10,3014,2,7200,1.00331785003
482229,482240,485136,11,2896,2,7200,1.00379834254
482340,482350,485392,10,3042,2,7200,1.00328731098
482355,482363,485371,8,3008,2,7200,1.00265957447
482357,482368,485447,11,3079,2,7200,1.0035725885
482371,482379,485557,8,3178,2,7200,1.00251730648
482419,482431,485310,12,2879,2,7200,1.00416811393
482483,482491,485433,8,2942,2,7200,1.00271923861
482497,482506,485661,9,3155,2,7200,1.0028526149
482555,482563,485405,8,2842,2,7200,1.00281491907
482570,482576,485759,6,3183,2,7200,1.00188501414
482571,482583,485645,12,3062,2,7200,1.00391900718
482586,482596,485545,10,2949,2,7200,1.00339097999
482661,482671,485529,10,2858,2,7200,1.00349895031
482830,482838,485795,8,2957,2,7200,1.00270544471
482998,483007,485889,9,2882,2,7200,1.00312283137
483016,483029,485925,13,2896,2,7200,1.00448895028
483100,483113,486250,13,3137,2,7200,1.00414408671
483266,483277,486127,11,2850,2,7200,1.00385964912
483392,731593,774530,248201,42937,16,88200,6.780585509
483930,483940,486948,10,3008,2,7200,1.00332446809
484083,484093,487161,10,3068,2,7200,1.00325945241
484357,484366,487341,9,2975,2,7200,1.00302521008
484359,484372,487236,13,2864,2,7200,1.00453910615
484401,484411,487350,10,2939,2,7200,1.00340251786
484416,484421,487548,5,3127,2,7200,1.00159897665
484491,484502,487426,11,2924,2,7200,1.0037619699
484505,484517,487471,12,2954,2,7200,1.00406228842
484535,484547,487769,12,3222,2,7200,1.00372439479
484565,484575,487474,10,2899,2,7200,1.00344946533
484653,484663,487477,10,2814,2,7200,1.00355366027
484667,484675,487516,8,2841,2,7200,1.00281590989
484718,484728,487507,10,2779,2,7200,1.0035984167
484751,484762,487759,11,2997,2,7200,1.003670337
484781,484793,487729,12,2936,2,7200,1.00408719346
484875,484886,487751,11,2865,2,7200,1.00383944154
484977,484988,487862,11,2874,2,7200,1.00382741823
484998,485007,488122,9,3115,2,7200,1.00288924559
484999,485013,488127,14,3114,2,7200,1.00449582531
485020,530156,540248,45136,10092,4,36000,5.47245342846
485023,485033,488064,10,3031,2,7200,1.00329924117
485138,485147,488105,9,2958,2,7200,1.00304259635
485153,485162,488084,9,2922,2,7200,1.00308008214
485170,485182,488460,12,3278,2,7200,1.00366076876
485264,531462,532222,46198,760,2,28800,61.7868421053
485312,485322,488275,10,2953,2,7200,1.00338638673
485372,485384,488375,12,2991,2,7200,1.00401203611
485393,485404,488391,11,2987,2,7200,1.00368262471
485408,485416,488319,8,2903,2,7200,1.00275576989
485435,485446,488585,11,3139,2,7200,1.00350430073
485449,485459,488472,10,3013,2,7200,1.00331895121
485531,485540,488538,9,2998,2,7200,1.00300200133
485548,485557,488411,9,2854,2,7200,1.00315346882
485563,485569,488443,6,2874,2,7200,1.00208768267
485643,496973,497437,11330,464,2,14400,25.4181034483
485648,485656,488497,8,2841,2,7200,1.00281590989
485662,485673,488489,11,2816,2,7200,1.00390625
485759,485773,488744,14,2971,2,7200,1.00471221811
485798,485807,488752,9,2945,2,7200,1.00305602716
485892,485901,488924,9,3023,2,7200,1.00297717499
485928,485938,488787,10,2849,2,7200,1.00351000351
486130,486139,489145,9,3006,2,7200,1.00299401198
486253,486263,489054,10,2791,2,7200,1.00358294518
486949,486959,489953,10,2994,2,7200,1.00334001336
487162,487172,490095,10,2923,2,7200,1.00342114266
487237,487247,490185,10,2938,2,7200,1.00340367597
487343,487354,490382,11,3028,2,7200,1.0036327609
487357,487363,490326,6,2963,2,7200,1.00202497469
487427,487438,490411,11,2973,2,7200,1.00369996636
487469,487483,490266,14,2783,2,7200,1.00503054258
487484,487489,490597,5,3108,2,7200,1.00160875161
487485,487496,490540,11,3044,2,7200,1.00361366623
487509,487518,490257,9,2739,2,7200,1.00328587076
487524,487531,490650,7,3119,2,7200,1.00224430907
487551,487560,490344,9,2784,2,7200,1.00323275862
487612,496983,506334,9371,9351,2,18000,2.00213880868
487628,497359,497364,9731,5,2,18000,973.6
487712,487762,487784,50,22,2,1800,3.27272727273
487712,487771,487803,59,32,2,1800,2.84375
487712,487777,487810,65,33,2,1800,2.9696969697
487712,487784,487819,72,35,2,1800,3.05714285714
487712,487742,487764,30,22,2,1800,2.36363636364
487713,487823,487855,110,32,2,1800,4.4375
487713,487796,487819,83,23,2,1800,4.60869565217
487713,487831,487862,118,31,2,1800,4.8064516129
487713,487837,487872,124,35,2,1800,4.54285714286
487713,487814,487836,101,22,2,1800,5.59090909091
487714,487887,487928,173,41,2,1800,5.21951219512
487714,487880,487924,166,44,2,1800,4.77272727273
487714,487873,487905,159,32,2,1800,5.96875
487714,487866,487900,152,34,2,1800,5.47058823529
487714,487847,487871,133,24,2,1800,6.54166666667
487715,487936,487968,221,32,2,1800,7.90625
487715,487918,487950,203,32,2,1800,7.34375
487715,487912,487946,197,34,2,1800,6.79411764706
487715,487892,487933,177,41,2,1800,5.31707317073
487716,487943,487965,227,22,2,1800,11.3181818182
487731,487949,490825,218,2876,2,7200,1.07579972184
487752,487957,491084,205,3127,2,7200,1.06555804285
487767,487964,490871,197,2907,2,7200,1.06776745786
487782,487977,490908,195,2931,2,7200,1.06653019447
487863,487984,490934,121,2950,2,7200,1.04101694915
488067,488076,491071,9,2995,2,7200,1.00300500835
488085,488095,491055,10,2960,2,7200,1.00337837838
488106,488116,491161,10,3045,2,7200,1.00328407225
488125,488133,490984,8,2851,2,7200,1.00280603297
488140,488147,491081,7,2934,2,7200,1.0023858214
488275,488287,490973,12,2686,2,7200,1.00446760983
488320,488331,491319,11,2988,2,7200,1.00368139224
488377,488387,491284,10,2897,2,7200,1.00345184674
488392,488403,491325,11,2922,2,7200,1.00376454483
488413,488423,491450,10,3027,2,7200,1.00330360093
488443,488455,491301,12,2846,2,7200,1.00421644413
488461,488471,491415,10,2944,2,7200,1.00339673913
488475,488483,491556,8,3073,2,7200,1.00260331923
488490,488500,491563,10,3063,2,7200,1.0032647731
488505,488512,491655,7,3143,2,7200,1.00222717149
488538,488549,491489,11,2940,2,7200,1.0037414966
488586,488596,491507,10,2911,2,7200,1.00343524562
488746,488755,491888,9,3133,2,7200,1.00287264603
488760,488767,491858,7,3091,2,7200,1.00226463928
488787,488798,491650,11,2852,2,7200,1.0038569425
488926,488936,491733,10,2797,2,7200,1.00357525921
489055,489066,492186,11,3120,2,7200,1.00352564103
489145,489157,492092,12,2935,2,7200,1.00408858603
489157,496978,497348,7821,370,2,14400,22.1378378378
489957,489965,492931,8,2966,2,7200,1.00269723533
490096,490107,493193,11,3086,2,7200,1.00356448477
490186,490197,493329,11,3132,2,7200,1.00351213282
490219,532234,533214,42015,980,2,21600,43.8724489796
490258,490270,493285,12,3015,2,7200,1.0039800995
490273,490280,493164,7,2884,2,7200,1.00242718447
490327,490338,493309,11,2971,2,7200,1.00370245709
490345,490356,493298,11,2942,2,7200,1.00373895309
490384,490393,493393,9,3000,2,7200,1.003
490411,490423,493464,12,3041,2,7200,1.00394607037
490541,490551,493437,10,2886,2,7200,1.00346500347
490598,490608,493861,10,3253,2,7200,1.00307408546
490652,490662,493555,10,2893,2,7200,1.00345661943
490827,490836,493753,9,2917,2,7200,1.00308536167
490872,490882,493917,10,3035,2,7200,1.00329489292
490900,533226,534344,42326,1118,2,21600,38.8586762075
490911,490919,493961,8,3042,2,7200,1.00262984878
490935,490947,494105,12,3158,2,7200,1.00379987334
490974,490985,493929,11,2944,2,7200,1.00373641304
490988,490995,494055,7,3060,2,7200,1.0022875817
491058,491068,494055,10,2987,2,7200,1.00334784064
491072,491082,494147,10,3065,2,7200,1.00326264274
491088,491095,494103,7,3008,2,7200,1.00232712766
491090,491102,494009,12,2907,2,7200,1.00412796698
491162,491173,494151,11,2978,2,7200,1.0036937542
491286,491296,494313,10,3017,2,7200,1.00331455088
491303,491312,494320,9,3008,2,7200,1.00299202128
491321,491330,494446,9,3116,2,7200,1.00288831836
491336,491343,494535,7,3192,2,7200,1.00219298246
491418,491427,494670,9,3243,2,7200,1.00277520814
491451,491461,494421,10,2960,2,7200,1.00337837838
491491,491501,494402,10,2901,2,7200,1.00344708721
491509,491519,494362,10,2843,2,7200,1.00351741119
491559,491569,494426,10,2857,2,7200,1.00350017501
491574,491581,494563,7,2982,2,7200,1.00234741784
491652,491662,494484,10,2822,2,7200,1.00354358611
491667,491673,494405,6,2732,2,7200,1.00219619327
491736,491746,494688,10,2942,2,7200,1.00339904827
491859,491871,494634,12,2763,2,7200,1.00434310532
491889,491900,494863,11,2963,2,7200,1.00371245359
492094,492103,494941,9,2838,2,7200,1.00317124736
492188,492198,495133,10,2935,2,7200,1.00340715503
492932,492942,495867,10,2925,2,7200,1.00341880342
493166,493176,496249,10,3073,2,7200,1.00325414904
493193,493206,495982,13,2776,2,7200,1.00468299712
493287,493297,496124,10,2827,2,7200,1.00353731871
493302,493311,496269,9,2958,2,7200,1.00304259635
493316,493323,496252,7,2929,2,7200,1.00238989416
493331,493342,496227,11,2885,2,7200,1.00381282496
493394,493406,496220,12,2814,2,7200,1.00426439232
493439,493448,496379,9,2931,2,7200,1.00307062436
493466,493475,496391,9,2916,2,7200,1.00308641975
493557,493567,496355,10,2788,2,7200,1.00358680057
493753,493764,496893,11,3129,2,7200,1.00351550016
493861,493873,496880,12,3007,2,7200,1.00399068839
493918,493928,496986,10,3058,2,7200,1.00327011118
493933,493941,496852,8,2911,2,7200,1.0027481965
493963,493973,496923,10,2950,2,7200,1.00338983051
494011,494021,496880,10,2859,2,7200,1.00349772648
494056,494066,497123,10,3057,2,7200,1.0032711809
494058,494072,496902,14,2830,2,7200,1.00494699647
494103,494114,496933,11,2819,2,7200,1.00390209294
494118,494124,497205,6,3081,2,7200,1.00194741967
494148,494158,497200,10,3042,2,7200,1.00328731098
494162,494169,497225,7,3056,2,7200,1.00229057592
494313,494325,497234,12,2909,2,7200,1.00412512891
494328,494334,497122,6,2788,2,7200,1.00215208034
494364,494374,497396,10,3022,2,7200,1.00330906684
494404,494413,497698,9,3285,2,7200,1.00273972603
494419,494425,497461,6,3036,2,7200,1.00197628458
494434,494441,497298,7,2857,2,7200,1.00245012251
494435,494448,497338,13,2890,2,7200,1.0044982699
494450,494457,497366,7,2909,2,7200,1.0024063252
494475,634780,721228,140305,86448,1,86400,2.62299879696
494487,494496,497605,9,3109,2,7200,1.00289482149
494534,731611,731616,237077,5,16,88200,23708.2
494538,494547,497504,9,2957,2,7200,1.0030436253
494565,494575,497725,10,3150,2,7200,1.00317460317
494634,494646,497727,12,3081,2,7200,1.00389483934
494640,646631,733063,151991,86432,1,86400,2.75850379489
494670,494682,497539,12,2857,2,7200,1.00420021001
494688,494699,497798,11,3099,2,7200,1.00354953211
494790,660465,746897,165675,86432,1,86400,2.91682478712
494863,494875,497971,12,3096,2,7200,1.00387596899
494942,494952,497819,10,2867,2,7200,1.00348796652
495135,495145,498013,10,2868,2,7200,1.00348675035
495868,495878,498872,10,2994,2,7200,1.00334001336
495985,495994,499206,9,3212,2,7200,1.00280199253
496127,496136,499146,9,3010,2,7200,1.00299003322
496220,496231,499098,11,2867,2,7200,1.00383676317
496235,496242,499273,7,3031,2,7200,1.00230946882
496250,496261,499097,11,2836,2,7200,1.0038787024
496265,496271,499162,6,2891,2,7200,1.00207540643
496279,496287,499085,8,2798,2,7200,1.00285918513
496358,496367,499529,9,3162,2,7200,1.00284629981
496382,496390,499394,8,3004,2,7200,1.00266311585
496396,496402,499415,6,3013,2,7200,1.00199137073
496853,496864,499869,11,3005,2,7200,1.00366056572
496883,496891,499746,8,2855,2,7200,1.00280210158
496884,496897,499846,13,2949,2,7200,1.00440827399
496899,496905,500011,6,3106,2,7200,1.00193174501
496914,496921,499679,7,2758,2,7200,1.00253807107
496929,496935,499745,6,2810,2,7200,1.00213523132
496944,496951,499711,7,2760,2,7200,1.00253623188
496989,496998,499844,9,2846,2,7200,1.0031623331
497124,497134,500273,10,3139,2,7200,1.00318572794
497125,497140,500066,15,2926,2,7200,1.00512645249
497201,497211,500216,10,3005,2,7200,1.00332778702
497215,497222,500154,7,2932,2,7200,1.00238744884
497230,497237,500030,7,2793,2,7200,1.00250626566
497245,497251,500331,6,3080,2,7200,1.00194805195
497299,497310,500140,11,2830,2,7200,1.0038869258
497341,497350,500259,9,2909,2,7200,1.00309384668
497368,497376,500249,8,2873,2,7200,1.00278454577
497398,497404,500299,6,2895,2,7200,1.00207253886
497461,497468,500586,7,3118,2,7200,1.00224502886
497506,497513,500499,7,2986,2,7200,1.00234427328
497539,497547,500400,8,2853,2,7200,1.0028040659
497606,497612,500449,6,2837,2,7200,1.00211491012
497699,497706,500742,7,3036,2,7200,1.00230566535
497726,497732,500632,6,2900,2,7200,1.00206896552
497728,497738,500637,10,2899,2,7200,1.00344946533
497800,497806,500667,6,2861,2,7200,1.00209716882
497821,497827,500634,6,2807,2,7200,1.00213751336
497971,497978,500931,7,2953,2,7200,1.00237047071
498013,498020,500937,7,2917,2,7200,1.00239972575
498875,498882,502018,7,3136,2,7200,1.00223214286
499085,499093,502144,8,3051,2,7200,1.00262209112
499101,499107,502091,6,2984,2,7200,1.00201072386
499102,499115,502224,13,3109,2,7200,1.00418140881
499147,499154,502275,7,3121,2,7200,1.00224287087
499162,499169,502471,7,3302,2,7200,1.00211992732
499207,499213,502209,6,2996,2,7200,1.00200267023
499273,499279,502095,6,2816,2,7200,1.00213068182
499396,499403,502568,7,3165,2,7200,1.00221169036
499418,499424,502592,6,3168,2,7200,1.00189393939
499532,499538,502681,6,3143,2,7200,1.00190900414
499679,499685,502596,6,2911,2,7200,1.00206114737
499712,499720,502705,8,2985,2,7200,1.002680067
499746,499752,502654,6,2902,2,7200,1.00206753963
499747,499760,502727,13,2967,2,7200,1.00438153017
499847,499853,503047,6,3194,2,7200,1.00187852223
499848,499860,502723,12,2863,2,7200,1.00419140761
499852,634730,634736,134878,6,58,86400,13488.4
499869,499875,502971,6,3096,2,7200,1.0019379845
500014,500020,503127,6,3107,2,7200,1.00193112327
500031,500039,503123,8,3084,2,7200,1.00259403372
500067,500075,502939,8,2864,2,7200,1.00279329609
500143,500150,503235,7,3085,2,7200,1.00226904376
500157,500165,503070,8,2905,2,7200,1.00275387263
500218,500225,503201,7,2976,2,7200,1.00235215054
500250,500257,503441,7,3184,2,7200,1.00219849246
500265,500271,503226,6,2955,2,7200,1.00203045685
500280,500286,503087,6,2801,2,7200,1.00214209211
500301,500307,503343,6,3036,2,7200,1.00197628458
500334,500341,503303,7,2962,2,7200,1.00236326806
500403,500410,503415,7,3005,2,7200,1.00232945092
500452,500458,503401,6,2943,2,7200,1.00203873598
500500,500507,503579,7,3072,2,7200,1.00227864583
500587,500593,503616,6,3023,2,7200,1.00198478333
500635,500642,503817,7,3175,2,7200,1.00220472441
500637,500648,503559,11,2911,2,7200,1.00377877018
500652,500659,503613,7,2954,2,7200,1.00236966825
500670,500676,503343,6,2667,2,7200,1.00224971879
500742,500749,503773,7,3024,2,7200,1.00231481481
500932,500938,503732,6,2794,2,7200,1.00214745884
500947,500954,503966,7,3012,2,7200,1.00232403718
502020,502026,505088,6,3062,2,7200,1.00195950359
502092,502098,505173,6,3075,2,7200,1.00195121951
502107,502113,504981,6,2868,2,7200,1.00209205021
502146,502153,505027,7,2874,2,7200,1.00243562978
502212,502219,505072,7,2853,2,7200,1.00245355766
502227,502234,505312,7,3078,2,7200,1.00227420403
502278,502284,505192,6,2908,2,7200,1.00206327373
502474,502481,505450,7,2969,2,7200,1.00235769619
502570,502577,505583,7,3006,2,7200,1.00232867598
502594,502600,505451,6,2851,2,7200,1.00210452473
502609,502615,505608,6,2993,2,7200,1.00200467758
502657,502663,505656,6,2993,2,7200,1.00200467758
502681,502687,505794,6,3107,2,7200,1.00193112327
502705,502712,505717,7,3005,2,7200,1.00232945092
502726,502733,505759,7,3026,2,7200,1.00231328486
502741,502748,505688,7,2940,2,7200,1.00238095238
502940,502946,505975,6,3029,2,7200,1.00198085177
502973,502980,506061,7,3081,2,7200,1.00227198961
503049,503055,506006,6,2951,2,7200,1.00203320908
503070,503076,505943,6,2867,2,7200,1.00209277991
503088,503094,506080,6,2986,2,7200,1.00200937709
503124,503130,506103,6,2973,2,7200,1.00201816347
503138,503146,506121,8,2975,2,7200,1.00268907563
503202,503209,506190,7,2981,2,7200,1.0023482053
503229,503235,506256,6,3021,2,7200,1.00198609732
503243,503250,506268,7,3018,2,7200,1.00231941683
503304,503310,506160,6,2850,2,7200,1.00210526316
503343,503350,506300,7,2950,2,7200,1.00237288136
503344,503357,506580,13,3223,2,7200,1.00403350915
503402,503408,506286,6,2878,2,7200,1.0020847811
503416,503423,506354,7,2931,2,7200,1.00238826339
503444,503451,506390,7,2939,2,7200,1.0023817625
503561,503567,506521,6,2954,2,7200,1.00203114421
503582,503588,506452,6,2864,2,7200,1.00209497207
503615,503621,506528,6,2907,2,7200,1.00206398349
503630,503636,506400,6,2764,2,7200,1.002170767
503732,503740,506569,8,2829,2,7200,1.00282785437
503774,503782,506731,8,2949,2,7200,1.00271278399
503820,503826,506859,6,3033,2,7200,1.00197823937
503967,503974,507019,7,3045,2,7200,1.00229885057
504982,504990,507960,8,2970,2,7200,1.00269360269
505027,505034,508064,7,3030,2,7200,1.00231023102
505072,505080,508291,8,3211,2,7200,1.00249143569
505090,505097,508059,7,2962,2,7200,1.00236326806
505175,505181,508162,6,2981,2,7200,1.0020127474
505193,505199,508103,6,2904,2,7200,1.0020661157
505313,505319,508437,6,3118,2,7200,1.00192431046
505452,505458,508421,6,2963,2,7200,1.00202497469
505453,505466,508235,13,2769,2,7200,1.00469483568
505586,505592,508356,6,2764,2,7200,1.002170767
505610,505617,508372,7,2755,2,7200,1.00254083485
505652,505658,508752,6,3094,2,7200,1.00193923723
505688,505694,508599,6,2905,2,7200,1.00206540448
505718,505724,508710,6,2986,2,7200,1.00200937709
505760,505766,508619,6,2853,2,7200,1.00210304942
505796,505803,508600,7,2797,2,7200,1.00250268144
505944,505950,508874,6,2924,2,7200,1.00205198358
505977,505983,509036,6,3053,2,7200,1.00196528005
506006,506014,508991,8,2977,2,7200,1.00268726906
506064,506071,509077,7,3006,2,7200,1.00232867598
506082,506089,509079,7,2990,2,7200,1.00234113712
506106,506112,509209,6,3097,2,7200,1.00193735873
506123,506130,508973,7,2843,2,7200,1.00246218783
506163,506169,509193,6,3024,2,7200,1.00198412698
506193,506200,508922,7,2722,2,7200,1.0025716385
506259,506266,509133,7,2867,2,7200,1.00244157656
506274,506281,509151,7,2870,2,7200,1.00243902439
506288,506296,509336,8,3040,2,7200,1.00263157895
506303,506309,509187,6,2878,2,7200,1.0020847811
506354,506362,509354,8,2992,2,7200,1.00267379679
506391,506397,509404,6,3007,2,7200,1.0019953442
506406,506411,509321,5,2910,2,7200,1.00171821306
506454,506461,509346,7,2885,2,7200,1.00242634315
506523,506529,509478,6,2949,2,7200,1.002034588
506538,506544,509364,6,2820,2,7200,1.00212765957
506571,506577,509461,6,2884,2,7200,1.00208044383
506586,506593,509523,7,2930,2,7200,1.0023890785
506734,506740,509595,6,2855,2,7200,1.00210157618
506860,506868,509894,8,3026,2,7200,1.00264375413
507018,507024,510059,6,3035,2,7200,1.00197693575
507960,507967,510694,7,2727,2,7200,1.00256692336
508060,508066,511015,6,2949,2,7200,1.002034588
508075,508081,510830,6,2749,2,7200,1.00218261186
508105,508111,511094,6,2983,2,7200,1.00201139792
508165,508171,510913,6,2742,2,7200,1.00218818381
508237,508243,511152,6,2909,2,7200,1.00206256446
508291,508297,511391,6,3094,2,7200,1.00193923723
508357,508364,511579,7,3215,2,7200,1.00217729393
508372,508379,511390,7,3011,2,7200,1.00232480903
508423,508429,511398,6,2969,2,7200,1.00202088245
508438,508444,511428,6,2984,2,7200,1.00201072386
508601,508607,511588,6,2981,2,7200,1.0020127474
508602,508614,511530,12,2916,2,7200,1.00411522634
508620,508626,511657,6,3031,2,7200,1.0019795447
508711,508717,511553,6,2836,2,7200,1.00211565585
508753,508759,511941,6,3182,2,7200,1.00188560654
508873,508880,512007,7,3127,2,7200,1.00223856732
508925,508931,511922,6,2991,2,7200,1.00200601805
508973,508980,511768,7,2788,2,7200,1.0025107604
508994,509001,511727,7,2726,2,7200,1.002567865
509039,509046,511932,7,2886,2,7200,1.00242550243
509078,509085,512127,7,3042,2,7200,1.00230111769
509093,509100,511947,7,2847,2,7200,1.00245872849
509135,509142,512052,7,2910,2,7200,1.00240549828
509153,509160,512169,7,3009,2,7200,1.00232635427
509189,509196,512154,7,2958,2,7200,1.00236646383
509204,509210,511998,6,2788,2,7200,1.00215208034
509219,509225,512134,6,2909,2,7200,1.00206256446
509315,509322,512389,7,3067,2,7200,1.00228236061
509339,509345,512327,6,2982,2,7200,1.00201207243
509354,509361,512235,7,2874,2,7200,1.00243562978
509355,509368,512181,13,2813,2,7200,1.00462140064
509371,509378,512550,7,3172,2,7200,1.00220680958
509407,509413,512291,6,2878,2,7200,1.0020847811
509464,509470,512263,6,2793,2,7200,1.00214822771
509479,509485,512519,6,3034,2,7200,1.00197758734
509524,509530,512481,6,2951,2,7200,1.00203320908
509597,509603,512393,6,2790,2,7200,1.00215053763
509895,509903,512809,8,2906,2,7200,1.00275292498
510061,510067,512943,6,2876,2,7200,1.00208623088
510694,510700,513752,6,3052,2,7200,1.00196592398
510833,510840,513825,7,2985,2,7200,1.00234505863
510914,510920,514035,6,3115,2,7200,1.00192616372
511016,511024,513987,8,2963,2,7200,1.00269996625
511095,511102,513968,7,2866,2,7200,1.00244242847
511155,511161,513922,6,2761,2,7200,1.00217312568
511393,511405,514635,12,3230,2,7200,1.00371517028
511394,511411,514345,17,2934,2,7200,1.0057941377
511409,511418,514752,9,3334,2,7200,1.00269946011
511430,511437,514645,7,3208,2,7200,1.00218204489
511533,511539,514450,6,2911,2,7200,1.00206114737
511554,511560,514515,6,2955,2,7200,1.00203045685
511581,511587,514531,6,2944,2,7200,1.00203804348
511596,511603,514536,7,2933,2,7200,1.00238663484
511659,511665,514524,6,2859,2,7200,1.00209863589
511728,511734,514655,6,2921,2,7200,1.00205409106
511770,511776,514923,6,3147,2,7200,1.00190657769
511924,511930,514931,6,3001,2,7200,1.00199933356
511939,511945,514743,6,2798,2,7200,1.00214438885
511954,511960,514923,6,2963,2,7200,1.00202497469
511955,511967,515145,12,3178,2,7200,1.00377595972
512000,512006,515093,6,3087,2,7200,1.0019436346
512015,512022,515099,7,3077,2,7200,1.00227494313
512054,512060,515053,6,2993,2,7200,1.00200467758
512129,512135,515170,6,3035,2,7200,1.00197693575
512144,512150,514992,6,2842,2,7200,1.0021111893
512159,512165,515069,6,2904,2,7200,1.0020661157
512174,512180,515146,6,2966,2,7200,1.0020229265
512189,512195,515088,6,2893,2,7200,1.00207397166
512237,512244,515218,7,2974,2,7200,1.00235373235
512264,512270,515205,6,2935,2,7200,1.00204429302
512294,512300,515274,6,2974,2,7200,1.00201748487
512330,512337,515364,7,3027,2,7200,1.00231252065
512390,512397,515639,7,3242,2,7200,1.00215916101
512405,512411,515232,6,2821,2,7200,1.00212690535
512483,512489,515475,6,2986,2,7200,1.00200937709
512519,512525,515709,6,3184,2,7200,1.00188442211
512553,512559,515429,6,2870,2,7200,1.00209059233
512812,512822,515750,10,2928,2,7200,1.00341530055
512945,512956,515553,11,2597,2,7200,1.00423565653
513755,513764,516663,9,2899,2,7200,1.0031045188
513827,513836,517073,9,3237,2,7200,1.00278035218
513924,513935,516863,11,2928,2,7200,1.0037568306
513969,513980,516865,11,2885,2,7200,1.00381282496
513990,513998,517115,8,3117,2,7200,1.00256657042
514035,514047,517172,12,3125,2,7200,1.00384
514346,514356,517219,10,2863,2,7200,1.00349283968
514457,514463,517570,6,3107,2,7200,1.00193112327
514517,514527,517358,10,2831,2,7200,1.00353232073
514532,514540,517369,8,2829,2,7200,1.00282785437
514534,514547,517477,13,2930,2,7200,1.00443686007
514548,514555,517593,7,3038,2,7200,1.00230414747
514636,514648,517670,12,3022,2,7200,1.00397088021
514651,514657,517575,6,2918,2,7200,1.00205620288
514665,514672,517627,7,2955,2,7200,1.00236886633
514744,514754,517551,10,2797,2,7200,1.00357525921
514759,514765,517556,6,2791,2,7200,1.00214976711
514803,555888,594232,41085,38344,2,57600,2.0714844565
514926,514935,517934,9,2999,2,7200,1.00300100033
514927,514941,518084,14,3143,2,7200,1.00445434298
514942,514949,517901,7,2952,2,7200,1.00237127371
514993,515003,517815,10,2812,2,7200,1.00355618777
515056,515065,517954,9,2889,2,7200,1.0031152648
515071,515080,518307,9,3227,2,7200,1.00278896808
515089,515099,518031,10,2932,2,7200,1.0034106412
515104,515110,518048,6,2938,2,7200,1.00204220558
515105,515116,518196,11,3080,2,7200,1.00357142857
515148,515158,518205,10,3047,2,7200,1.00328191664
515149,515163,518331,14,3168,2,7200,1.00441919192
515170,515182,518203,12,3021,2,7200,1.00397219464
515206,515217,517957,11,2740,2,7200,1.00401459854
515221,515229,518024,8,2795,2,7200,1.00286225403
515236,515243,518460,7,3217,2,7200,1.00217594032
515275,515285,518191,10,2906,2,7200,1.00344115623
515365,515377,518337,12,2960,2,7200,1.00405405405
515432,515440,518381,8,2941,2,7200,1.00272016321
515477,515486,518535,9,3049,2,7200,1.00295178747
515555,515565,518632,10,3067,2,7200,1.00326051516
515640,515650,518730,10,3080,2,7200,1.00324675325
515709,515721,518566,12,2845,2,7200,1.00421792619
515751,515761,518701,10,2940,2,7200,1.00340136054
516665,516675,519500,10,2825,2,7200,1.00353982301
516864,516876,519730,12,2854,2,7200,1.00420462509
516879,516885,519754,6,2869,2,7200,1.00209132102
517075,517086,519936,11,2850,2,7200,1.00385964912
517117,517126,519961,9,2835,2,7200,1.00317460317
517174,517184,520107,10,2923,2,7200,1.00342114266
517222,517232,520221,10,2989,2,7200,1.00334560054
517358,517371,520259,13,2888,2,7200,1.00450138504
517373,517382,520488,9,3106,2,7200,1.00289761751
517478,517490,520420,12,2930,2,7200,1.00409556314
517554,517562,520406,8,2844,2,7200,1.00281293952
517568,517575,520513,7,2938,2,7200,1.00238257318
517583,517591,520558,8,2967,2,7200,1.00269632626
517585,517598,520509,13,2911,2,7200,1.00446581931
517600,517606,520684,6,3078,2,7200,1.00194931774
517630,517639,520577,9,2938,2,7200,1.00306330837
517672,517683,520551,11,2868,2,7200,1.00383542538
517817,517827,520739,10,2912,2,7200,1.00343406593
517901,517912,520817,11,2905,2,7200,1.00378657487
517934,517946,520900,12,2954,2,7200,1.00406228842
517949,517965,520873,16,2908,2,7200,1.00550206327
517964,517973,520898,9,2925,2,7200,1.00307692308
518027,518036,520927,9,2891,2,7200,1.00311310965
518042,518048,520946,6,2898,2,7200,1.00207039337
518057,518063,520845,6,2782,2,7200,1.00215672178
518087,518096,521042,9,2946,2,7200,1.00305498982
518192,518203,521310,11,3107,2,7200,1.00354039266
518207,518214,521129,7,2915,2,7200,1.00240137221
518209,518221,521043,12,2822,2,7200,1.00425230333
518210,518227,521024,17,2797,2,7200,1.00607794065
518310,518320,521498,10,3178,2,7200,1.0031466331
518333,518344,521175,11,2831,2,7200,1.00388555281
518348,518355,521487,7,3132,2,7200,1.00223499361
518382,518394,521381,12,2987,2,7200,1.00401740877
518463,518471,521400,8,2929,2,7200,1.00273130761
518535,518546,521393,11,2847,2,7200,1.00386371619
518568,518578,521588,10,3010,2,7200,1.00332225914
518635,518645,521660,10,3015,2,7200,1.00331674959
518704,518712,521420,8,2708,2,7200,1.00295420975
518731,518742,521638,11,2896,2,7200,1.00379834254
518933,792829,940165,273896,147336,18,198000,2.85898897758
519502,519511,522630,9,3119,2,7200,1.00288554024
519731,519741,522654,10,2913,2,7200,1.00343288706
519755,519765,522550,10,2785,2,7200,1.00359066427
519936,519948,522684,12,2736,2,7200,1.00438596491
519963,519973,522982,10,3009,2,7200,1.00332336324
520108,520118,522890,10,2772,2,7200,1.00360750361
520223,520234,523185,11,2951,2,7200,1.00372754998
520262,520271,523141,9,2870,2,7200,1.0031358885
520406,520417,523396,11,2979,2,7200,1.00369251427
520421,520431,523298,10,2867,2,7200,1.00348796652
520491,520501,523435,10,2934,2,7200,1.00340831629
520512,520521,523810,9,3289,2,7200,1.00273639404
520527,520533,523240,6,2707,2,7200,1.0022164758
520554,520563,523483,9,2920,2,7200,1.00308219178
520569,520575,523611,6,3036,2,7200,1.00197628458
520583,520590,523366,7,2776,2,7200,1.00252161383
520686,520696,523604,10,2908,2,7200,1.00343878955
520740,520750,523543,10,2793,2,7200,1.00358037952
520818,520828,523721,10,2893,2,7200,1.00345661943
520848,520857,523893,9,3036,2,7200,1.00296442688
520875,520884,523954,9,3070,2,7200,1.00293159609
520899,520909,523742,10,2833,2,7200,1.00352982704
520914,520920,523976,6,3056,2,7200,1.00196335079
520929,520938,524053,9,3115,2,7200,1.00288924559
520947,520958,523689,11,2731,2,7200,1.00402782863
521026,521035,524106,9,3071,2,7200,1.00293064148
521044,521054,524016,10,2962,2,7200,1.00337609723
521045,521060,523954,15,2894,2,7200,1.00518313753
521129,521140,524146,11,3006,2,7200,1.00365934797
521178,521186,524250,8,3064,2,7200,1.00261096606
521310,521322,524240,12,2918,2,7200,1.00411240576
521383,521393,524290,10,2897,2,7200,1.00345184674
521398,521404,524208,6,2804,2,7200,1.00213980029
521413,521419,524174,6,2755,2,7200,1.00217785844
521428,521434,524352,6,2918,2,7200,1.00205620288
521488,521498,524662,10,3164,2,7200,1.00316055626
521503,521509,524553,6,3044,2,7200,1.00197109067
521590,521599,524534,9,2935,2,7200,1.00306643952
521638,521650,524494,12,2844,2,7200,1.00421940928
521662,521672,524566,10,2894,2,7200,1.00345542502
522553,522562,525467,9,2905,2,7200,1.00309810671
522631,522642,525604,11,2962,2,7200,1.00371370695
522655,522665,525621,10,2956,2,7200,1.00338294993
522685,522697,525635,12,2938,2,7200,1.00408441116
522891,522902,525805,11,2903,2,7200,1.0037891836
522985,522993,525915,8,2922,2,7200,1.00273785079
523142,523152,526096,10,2944,2,7200,1.00339673913
523187,523196,526271,9,3075,2,7200,1.00292682927
523241,523252,526250,11,2998,2,7200,1.00366911274
523298,523310,526236,12,2926,2,7200,1.004101162
523367,523378,526202,11,2824,2,7200,1.00389518414
523397,523407,526511,10,3104,2,7200,1.00322164948
523433,523447,526501,14,3054,2,7200,1.00458415193
523485,523494,526401,9,2907,2,7200,1.00309597523
523545,523554,526631,9,3077,2,7200,1.00292492688
523605,523615,526684,10,3069,2,7200,1.00325839036
523620,523627,526554,7,2927,2,7200,1.00239152716
523689,523702,526812,13,3110,2,7200,1.00418006431
523722,523732,526719,10,2987,2,7200,1.00334784064
523743,523753,527007,10,3254,2,7200,1.00307314075
523813,523822,526767,9,2945,2,7200,1.00305602716
523894,523905,526736,11,2831,2,7200,1.00388555281
523955,523976,526966,21,2990,2,7200,1.00702341137
523956,523981,527025,25,3044,2,7200,1.00821287779
523977,523987,527070,10,3083,2,7200,1.0032435939
524019,524029,527027,10,2998,2,7200,1.00333555704
524055,524064,527031,9,2967,2,7200,1.00303336704
524103,524118,527180,15,3062,2,7200,1.00489875898
524149,524157,527003,8,2846,2,7200,1.00281096275
524176,524186,527076,10,2890,2,7200,1.00346020761
524209,524220,527268,11,3048,2,7200,1.00360892388
524242,524252,527252,10,3000,2,7200,1.00333333333
524257,524263,527347,6,3084,2,7200,1.00194552529
524290,524301,527327,11,3026,2,7200,1.00363516193
524353,524364,527183,11,2819,2,7200,1.00390209294
524495,524505,527321,10,2816,2,7200,1.00355113636
524537,524546,527462,9,2916,2,7200,1.00308641975
524555,524564,527455,9,2891,2,7200,1.00311310965
524570,524578,527472,8,2894,2,7200,1.00276434001
524664,524674,527692,10,3018,2,7200,1.00331345262
525470,525479,528330,9,2851,2,7200,1.00315678709
525606,525615,528584,9,2969,2,7200,1.00303132368
525621,525633,528716,12,3083,2,7200,1.00389231268
525636,525647,528444,11,2797,2,7200,1.00393278513
525805,525816,528899,11,3083,2,7200,1.00356795329
525916,525928,528852,12,2924,2,7200,1.00410396717
526097,526107,529015,10,2908,2,7200,1.00343878955
526203,526213,529230,10,3017,2,7200,1.00331455088
526236,526247,529188,11,2941,2,7200,1.00374022441
526251,526261,529050,10,2789,2,7200,1.00358551452
526272,526282,529322,10,3040,2,7200,1.00328947368
526402,526413,529319,11,2906,2,7200,1.00378527185
526501,526512,529311,11,2799,2,7200,1.00392997499
526516,526522,529382,6,2860,2,7200,1.0020979021
526555,526565,529442,10,2877,2,7200,1.00347584289
526633,526643,529418,10,2775,2,7200,1.0036036036
526685,526697,529683,12,2986,2,7200,1.00401875419
526721,526731,529834,10,3103,2,7200,1.00322268772
526739,526748,529650,9,2902,2,7200,1.00310130944
526769,526780,529819,11,3039,2,7200,1.00361961171
526814,526823,529781,9,2958,2,7200,1.00304259635
526965,526978,529977,13,2999,2,7200,1.00433477826
527005,527014,529950,9,2936,2,7200,1.0030653951
527006,527020,530019,14,2999,2,7200,1.00466822274
527027,527037,530205,10,3168,2,7200,1.00315656566
527029,527044,530179,15,3135,2,7200,1.004784689
527044,527050,529967,6,2917,2,7200,1.00205690778
527071,527082,529966,11,2884,2,7200,1.00381414702
527086,527092,529932,6,2840,2,7200,1.00211267606
527147,534356,534483,7209,127,1,3600,57.7637795276
527182,527192,530118,10,2926,2,7200,1.003417635
527184,527199,530279,15,3080,2,7200,1.00487012987
527253,527263,530363,10,3100,2,7200,1.00322580645
527268,527279,530234,11,2955,2,7200,1.00372250423
527323,527333,530329,10,2996,2,7200,1.00333778371
527337,527344,530457,7,3113,2,7200,1.00224863476
527352,527358,530326,6,2968,2,7200,1.00202156334
527455,527467,530607,12,3140,2,7200,1.00382165605
527470,527476,530457,6,2981,2,7200,1.0020127474
527485,527491,530212,6,2721,2,7200,1.00220507166
527693,527704,530612,11,2908,2,7200,1.0037826685
528331,528342,531303,11,2961,2,7200,1.00371496116
528445,528456,531419,11,2963,2,7200,1.00371245359
528587,528595,531700,8,3105,2,7200,1.00257648953
528716,528728,531791,12,3063,2,7200,1.00391772772
528855,528864,531901,9,3037,2,7200,1.00296345077
528900,528910,531905,10,2995,2,7200,1.00333889816
529018,529026,531861,8,2835,2,7200,1.00282186949
529051,529063,532200,12,3137,2,7200,1.00382531081
529190,529200,532297,10,3097,2,7200,1.00322893122
529232,529242,532246,10,3004,2,7200,1.00332889481
529313,529323,532168,10,2845,2,7200,1.00351493849
529328,529334,532278,6,2944,2,7200,1.00203804348
529330,529340,532408,10,3068,2,7200,1.00325945241
529384,529394,532431,10,3037,2,7200,1.00329272308
529420,529430,532399,10,2969,2,7200,1.00336813742
529444,529453,532626,9,3173,2,7200,1.0028364324
529652,529662,532680,10,3018,2,7200,1.00331345262
529685,529696,532553,11,2857,2,7200,1.00385019251
529782,529793,532557,11,2764,2,7200,1.00397973951
529821,529832,532763,11,2931,2,7200,1.00375298533
529836,529846,533108,10,3262,2,7200,1.00306560392
529932,529943,532842,11,2899,2,7200,1.00379441187
529953,529961,533015,8,3054,2,7200,1.00261951539
529954,530173,573383,219,43210,4,43200,1.00506827123
529968,529978,532865,10,2887,2,7200,1.00346380326
529970,529983,532888,13,2905,2,7200,1.00447504303
529985,529992,533125,7,3133,2,7200,1.00223428024
530021,530030,533092,9,3062,2,7200,1.00293925539
530120,530129,533041,9,2912,2,7200,1.00309065934
530180,530190,533174,10,2984,2,7200,1.00335120643
530208,530217,533335,9,3118,2,7200,1.00288646568
530222,530228,533208,6,2980,2,7200,1.00201342282
530237,530246,533134,9,2888,2,7200,1.00311634349
530279,530290,533057,11,2767,2,7200,1.00397542465
530328,530338,533206,10,2868,2,7200,1.00348675035
530343,530350,533508,7,3158,2,7200,1.00221659278
530364,530374,533308,10,2934,2,7200,1.00340831629
530458,530469,533585,11,3116,2,7200,1.00353016688
530459,530474,533363,15,2889,2,7200,1.005192108
530607,530620,533468,13,2848,2,7200,1.00456460674
530622,530629,533604,7,2975,2,7200,1.00235294118
530972,534361,534486,3389,125,1,3600,28.112
531305,531314,534251,9,2937,2,7200,1.00306435138
531420,531431,534397,11,2966,2,7200,1.00370869858
531700,531712,534632,12,2920,2,7200,1.00410958904
531793,531802,534626,9,2824,2,7200,1.00318696884
531863,531872,534897,9,3025,2,7200,1.00297520661
531902,531912,534737,10,2825,2,7200,1.00353982301
531917,531924,534867,7,2943,2,7200,1.00237852531
532170,532180,535067,10,2887,2,7200,1.00346380326
532200,532211,535312,11,3101,2,7200,1.00354724282
532248,532257,535331,9,3074,2,7200,1.00292778139
532279,532289,535171,10,2882,2,7200,1.00346981263
532293,532308,535200,15,2892,2,7200,1.00518672199
532399,532411,535581,12,3170,2,7200,1.00378548896
532414,532420,535506,6,3086,2,7200,1.00194426442
532432,532442,535452,10,3010,2,7200,1.00332225914
532556,532565,535661,9,3096,2,7200,1.00290697674
532571,532577,535685,6,3108,2,7200,1.00193050193
532628,532637,535547,9,2910,2,7200,1.00309278351
532682,532691,535612,9,2921,2,7200,1.0030811366
532763,532775,535722,12,2947,2,7200,1.00407193756
532845,532854,535841,9,2987,2,7200,1.00301305658
532866,532877,535800,11,2923,2,7200,1.00376325693
532890,532899,535804,9,2905,2,7200,1.00309810671
533017,533026,535983,9,2957,2,7200,1.0030436253
533044,533053,536006,9,2953,2,7200,1.00304774805
533059,533070,535866,11,2796,2,7200,1.0039341917
533095,533103,535940,8,2837,2,7200,1.00281988016
533110,533121,536220,11,3099,2,7200,1.00354953211
533128,533137,536110,9,2973,2,7200,1.00302724521
533143,533149,536144,6,2995,2,7200,1.0020033389
533176,533186,536173,10,2987,2,7200,1.00334784064
533206,533218,536182,12,2964,2,7200,1.004048583
533221,533232,536064,11,2832,2,7200,1.00388418079
533309,533320,536332,11,3012,2,7200,1.00365205843
533336,533346,536503,10,3157,2,7200,1.00316756414
533366,533375,536433,9,3058,2,7200,1.00294310007
533469,533479,536394,10,2915,2,7200,1.00343053173
533511,533520,536470,9,2950,2,7200,1.00305084746
533587,533596,536338,9,2742,2,7200,1.00328227571
533604,533616,536426,12,2810,2,7200,1.00427046263
534251,534262,537164,11,2902,2,7200,1.00379048932
534399,534408,537593,9,3185,2,7200,1.00282574568
534403,534494,534575,91,81,1,1800,2.12345679012
534608,534615,534923,7,308,1,3600,1.02272727273
534609,534621,534919,12,298,1,3600,1.04026845638
534628,534638,537544,10,2906,2,7200,1.00344115623
534643,534650,537600,7,2950,2,7200,1.00237288136
534737,534748,537638,11,2890,2,7200,1.00380622837
534810,534929,535033,119,104,1,1800,2.14423076923
534870,534878,537922,8,3044,2,7200,1.00262812089
534900,534909,538055,9,3146,2,7200,1.00286077559
535066,535072,537797,6,2725,2,7200,1.00220183486
535143,537812,538440,2669,628,1,3600,5.25
535145,537817,538447,2672,630,1,3600,5.24126984127
535172,535178,538129,6,2951,2,7200,1.00203320908
535202,535208,538151,6,2943,2,7200,1.00203873598
535313,535319,538192,6,2873,2,7200,1.00208840933
535331,535337,538126,6,2789,2,7200,1.00215130871
535455,535462,538437,7,2975,2,7200,1.00235294118
535506,535513,538372,7,2859,2,7200,1.00244840853
535533,538450,538836,2917,386,1,1800,8.55699481865
535548,535554,538495,6,2941,2,7200,1.00204012241
535584,535591,538564,7,2973,2,7200,1.00235452405
535614,535621,538660,7,3039,2,7200,1.00230338927
535662,535669,538744,7,3075,2,7200,1.00227642276
535686,535692,538695,6,3003,2,7200,1.001998002
535722,535729,538954,7,3225,2,7200,1.00217054264
535801,535808,538660,7,2852,2,7200,1.00245441795
535816,535823,539006,7,3183,2,7200,1.00219918316
535843,535850,539137,7,3287,2,7200,1.00212960146
535867,535873,538833,6,2960,2,7200,1.00202702703
535942,535948,538957,6,3009,2,7200,1.00199401795
535985,535991,538943,6,2952,2,7200,1.00203252033
536009,536015,538897,6,2882,2,7200,1.00208188758
536066,536072,538999,6,2927,2,7200,1.00204988042
536111,536117,539059,6,2942,2,7200,1.00203942896
536144,536151,539184,7,3033,2,7200,1.00230794593
536175,536182,539147,7,2965,2,7200,1.0023608769
536190,536196,539200,6,3004,2,7200,1.00199733688
536222,536229,539210,7,2981,2,7200,1.0023482053
536334,536341,539331,7,2990,2,7200,1.00234113712
536349,536355,539178,6,2823,2,7200,1.00212539851
536394,536401,539382,7,2981,2,7200,1.0023482053
536427,536443,539426,16,2983,2,7200,1.00536372779
536442,536450,539214,8,2764,2,7200,1.00289435601
536472,536480,539487,8,3007,2,7200,1.00266045893
536505,536512,539596,7,3084,2,7200,1.00226977951
537165,537172,540214,7,3042,2,7200,1.00230111769
537545,537551,540686,6,3135,2,7200,1.0019138756
537593,537599,540454,6,2855,2,7200,1.00210157618
537608,537614,540628,6,3014,2,7200,1.00199071002
537641,537649,540651,8,3002,2,7200,1.00266489007
537799,537805,541127,6,3322,2,7200,1.00180614088
537924,537935,540906,11,2971,2,7200,1.00370245709
538057,538068,541021,11,2953,2,7200,1.0037250254
538126,538138,541097,12,2959,2,7200,1.00405542413
538141,538147,541049,6,2902,2,7200,1.00206753963
538156,538162,541207,6,3045,2,7200,1.00197044335
538195,538205,541323,10,3118,2,7200,1.00320718409
538301,538463,538543,162,80,1,1800,3.025
538374,538383,541323,9,2940,2,7200,1.00306122449
538437,538457,541459,20,3002,2,7200,1.00666222518
538497,538508,541473,11,2965,2,7200,1.00370994941
538564,538575,541458,11,2883,2,7200,1.00381547
538661,538671,541514,10,2843,2,7200,1.00351741119
538662,538676,541711,14,3035,2,7200,1.00461285008
538695,538708,541940,13,3232,2,7200,1.00402227723
538746,538755,541673,9,2918,2,7200,1.00308430432
538786,538792,538884,6,92,1,1800,1.0652173913
538834,538845,541886,11,3041,2,7200,1.00361723117
538897,538903,541912,6,3009,2,7200,1.00199401795
538945,538951,541914,6,2963,2,7200,1.00202497469
538960,538967,541969,7,3002,2,7200,1.00233177881
538962,538974,541934,12,2960,2,7200,1.00405405405
539001,539008,542064,7,3056,2,7200,1.00229057592
539016,539022,542006,6,2984,2,7200,1.00201072386
539061,539068,542145,7,3077,2,7200,1.00227494313
539140,539147,542321,7,3174,2,7200,1.00220541903
539155,539162,542163,7,3001,2,7200,1.00233255581
539179,539185,542105,6,2920,2,7200,1.00205479452
539194,539200,542136,6,2936,2,7200,1.00204359673
539209,539215,542046,6,2831,2,7200,1.00211939244
539224,539230,542212,6,2982,2,7200,1.00201207243
539225,539237,542242,12,3005,2,7200,1.00399334443
539279,540259,540358,980,99,1,3600,10.898989899
539314,540265,540363,951,98,1,3600,10.7040816327
539331,539338,542392,7,3054,2,7200,1.00229207597
539361,540270,540649,909,379,1,1800,3.39841688654
539382,539388,542395,6,3007,2,7200,1.0019953442
539427,539435,542334,8,2899,2,7200,1.00275957227
539488,539494,542400,6,2906,2,7200,1.00206469374
539597,539603,542594,6,2991,2,7200,1.00200601805
539633,540275,540321,642,46,1,1800,14.9565217391
540216,540222,543110,6,2888,2,7200,1.00207756233
540454,540461,543449,7,2988,2,7200,1.00234270415
540479,540486,540768,7,282,1,3600,1.02482269504
540482,540492,540776,10,284,1,3600,1.03521126761
540555,540562,540637,7,75,1,1800,1.09333333333
540629,540635,543827,6,3192,2,7200,1.00187969925
540653,540659,543609,6,2950,2,7200,1.00203389831
540689,540696,543783,7,3087,2,7200,1.0022675737
540906,540912,543856,6,2944,2,7200,1.00203804348
541021,541027,541541,6,514,1,3600,1.01167315175
541024,541033,544136,9,3103,2,7200,1.00290041895
541029,541039,541560,10,521,1,3600,1.01919385797
541051,541057,543887,6,2830,2,7200,1.00212014134
541099,541105,543905,6,2800,2,7200,1.00214285714
541129,541135,543987,6,2852,2,7200,1.00210378682
541207,541214,544450,7,3236,2,7200,1.0021631644
541259,541265,541524,6,259,1,1800,1.02316602317
541325,541331,544288,6,2957,2,7200,1.00202908353
541326,541338,544390,12,3052,2,7200,1.00393184797
541459,541465,544440,6,2975,2,7200,1.00201680672
541461,541471,544373,10,2902,2,7200,1.00344589938
541476,541483,544527,7,3044,2,7200,1.00229960578
541515,541522,544554,7,3032,2,7200,1.00230870712
541675,541681,544570,6,2889,2,7200,1.0020768432
541714,541720,544691,6,2971,2,7200,1.00201952205
541857,541864,541909,7,45,1,1800,1.15555555556
541887,541893,544950,6,3057,2,7200,1.00196270854
541914,541920,544659,6,2739,2,7200,1.0021905805
541915,541928,544854,13,2926,2,7200,1.0044429255
541936,541943,545012,7,3069,2,7200,1.00228087325
541951,541958,544944,7,2986,2,7200,1.00234427328
541972,541979,544806,7,2827,2,7200,1.0024761231
542008,542014,544939,6,2925,2,7200,1.00205128205
542047,542054,545061,7,3007,2,7200,1.00232790156
542065,542072,545033,7,2961,2,7200,1.00236406619
542108,542114,545223,6,3109,2,7200,1.00192988099
542138,542145,544943,7,2798,2,7200,1.00250178699
542153,542165,542246,12,81,1,1800,1.14814814815
542153,542160,545199,7,3039,2,7200,1.00230338927
542168,542175,545214,7,3039,2,7200,1.00230338927
542213,542219,545344,6,3125,2,7200,1.00192
542243,542249,545274,6,3025,2,7200,1.00198347107
542324,542330,545205,6,2875,2,7200,1.00208695652
542339,542345,545234,6,2889,2,7200,1.0020768432
542394,542401,545315,7,2914,2,7200,1.00240219629
542409,542415,545396,6,2981,2,7200,1.0020127474
542410,542422,545455,12,3033,2,7200,1.00395647873
542595,542602,545652,7,3050,2,7200,1.00229508197
542877,542883,543123,6,240,1,1800,1.025
543111,543118,546146,7,3028,2,7200,1.00231175694
543452,543458,546429,6,2971,2,7200,1.00201952205
543612,543619,546517,7,2898,2,7200,1.00241545894
543784,543790,546602,6,2812,2,7200,1.00213371266
543829,543836,546810,7,2974,2,7200,1.00235373235
543857,543864,546684,7,2820,2,7200,1.0024822695
543889,543896,546970,7,3074,2,7200,1.00227716331
543907,543914,546836,7,2922,2,7200,1.00239561944
543989,543995,547084,6,3089,2,7200,1.00194237617
544139,544146,547142,7,2996,2,7200,1.0023364486
544291,544298,547337,7,3039,2,7200,1.00230338927
544375,544382,547267,7,2885,2,7200,1.00242634315
544390,544396,547632,6,3236,2,7200,1.00185414091
544442,544448,547059,6,2611,2,7200,1.00229797013
544457,544463,547384,6,2921,2,7200,1.00205409106
544529,544535,547409,6,2874,2,7200,1.00208768267
544556,544563,547639,7,3076,2,7200,1.0022756827
544571,544577,547510,6,2933,2,7200,1.00204568701
544659,544666,547905,7,3239,2,7200,1.00216116085
544692,544699,547480,7,2781,2,7200,1.00251708019
544806,544813,547785,7,2972,2,7200,1.00235531629
544855,544862,547762,7,2900,2,7200,1.0024137931
544939,544946,547820,7,2874,2,7200,1.00243562978
544955,544962,547915,7,2953,2,7200,1.00237047071
544956,544969,547906,13,2937,2,7200,1.00442628533
544957,544974,547906,17,2932,2,7200,1.00579809004
545012,545019,547868,7,2849,2,7200,1.00245700246
545036,545042,548049,6,3007,2,7200,1.0019953442
545063,545070,547866,7,2796,2,7200,1.00250357654
545199,545205,548201,6,2996,2,7200,1.00200267023
545214,545220,548250,6,3030,2,7200,1.00198019802
545216,545227,548186,11,2959,2,7200,1.00371747212
545231,545238,548210,7,2972,2,7200,1.00235531629
545245,545252,548195,7,2943,2,7200,1.00237852531
545276,545282,548117,6,2835,2,7200,1.00211640212
545318,545325,548254,7,2929,2,7200,1.00238989416
545345,545351,548395,6,3044,2,7200,1.00197109067
545396,545402,548290,6,2888,2,7200,1.00207756233
545456,545464,548440,8,2976,2,7200,1.00268817204
545652,545659,548621,7,2962,2,7200,1.00236326806
546148,546154,549087,6,2933,2,7200,1.00204568701
546320,546326,546345,6,19,1,600,1.31578947368
546432,546438,549642,6,3204,2,7200,1.00187265918
546519,546525,549525,6,3000,2,7200,1.002
546604,546610,549585,6,2975,2,7200,1.00201680672
546685,546692,549689,7,2997,2,7200,1.002335669
546813,546819,549635,6,2816,2,7200,1.00213068182
546837,546844,549967,7,3123,2,7200,1.00224143452
546930,546937,546960,7,23,2,3600,1.30434782609
546972,546979,549983,7,3004,2,7200,1.00233022636
547060,547066,549919,6,2853,2,7200,1.00210304942
547084,547090,550276,6,3186,2,7200,1.00188323917
547144,547151,550099,7,2948,2,7200,1.00237449118
547268,547275,550250,7,2975,2,7200,1.00235294118
547338,547344,550469,6,3125,2,7200,1.00192
547386,547393,550344,7,2951,2,7200,1.00237207726
547410,547417,550555,7,3138,2,7200,1.0022307202
547483,547490,550464,7,2974,2,7200,1.00235373235
547510,547517,550390,7,2873,2,7200,1.00243647755
547634,547641,550366,7,2725,2,7200,1.00256880734
547648,547655,550747,7,3092,2,7200,1.00226390686
547763,547769,550769,6,3000,2,7200,1.002
547787,547795,550767,8,2972,2,7200,1.00269179004
547821,547828,550849,7,3021,2,7200,1.00231711354
547866,547872,550914,6,3042,2,7200,1.00197238659
547881,547888,550990,7,3102,2,7200,1.00225660864
547909,547915,550573,6,2658,2,7200,1.00225733634
547910,547922,550949,12,3027,2,7200,1.00396432111
547912,547927,550787,15,2860,2,7200,1.00524475524
547927,547933,550791,6,2858,2,7200,1.00209937019
548051,548057,550906,6,2849,2,7200,1.00210600211
548121,548127,551089,6,2962,2,7200,1.00202565834
548143,734549,740855,186406,6306,25,7199,30.5601014906
548187,548193,551047,6,2854,2,7200,1.00210231254
548202,548209,551156,7,2947,2,7200,1.00237529691
548204,548216,551239,12,3023,2,7200,1.00396956666
548219,548226,551188,7,2962,2,7200,1.00236326806
548225,740866,745810,192641,4944,25,7199,39.9646035599
548252,548258,551351,6,3093,2,7200,1.00193986421
548267,548273,551358,6,3085,2,7200,1.00194489465
548291,548297,551333,6,3036,2,7200,1.00197628458
548397,548403,551411,6,3008,2,7200,1.00199468085
548442,548449,551287,7,2838,2,7200,1.00246652572
548623,548630,551646,7,3016,2,7200,1.00232095491
549088,549095,552034,7,2939,2,7200,1.0023817625
549525,549533,552492,8,2959,2,7200,1.00270361609
549586,549592,552594,6,3002,2,7200,1.00199866755
549637,549643,552733,6,3090,2,7200,1.00194174757
549652,549658,552640,6,2982,2,7200,1.00201207243
549691,549697,552656,6,2959,2,7200,1.00202771206
549920,549927,552895,7,2968,2,7200,1.00235849057
549968,549975,552952,7,2977,2,7200,1.00235136043
549983,549990,552782,7,2792,2,7200,1.00250716332
550101,550107,553051,6,2944,2,7200,1.00203804348
550252,550258,553154,6,2896,2,7200,1.0020718232
550276,550282,553186,6,2904,2,7200,1.0020661157
550346,550353,553132,7,2779,2,7200,1.00251889169
550367,550374,553507,7,3133,2,7200,1.00223428024
550391,550398,553296,7,2898,2,7200,1.00241545894
550466,550472,553429,6,2957,2,7200,1.00202908353
550481,550488,553461,7,2973,2,7200,1.00235452405
550557,550563,553530,6,2967,2,7200,1.00202224469
550575,550582,553475,7,2893,2,7200,1.0024196336
550748,550754,553741,6,2987,2,7200,1.00200870439
550769,550775,553831,6,3056,2,7200,1.00196335079
550771,550783,553743,12,2960,2,7200,1.00405405405
550789,550796,553748,7,2952,2,7200,1.00237127371
550804,550810,553664,6,2854,2,7200,1.00210231254
550852,550858,553751,6,2893,2,7200,1.00207397166
550907,550914,554123,7,3209,2,7200,1.00218136491
550921,550928,553708,7,2780,2,7200,1.00251798561
550952,550958,553996,6,3038,2,7200,1.00197498354
550991,550998,554053,7,3055,2,7200,1.0022913257
551048,551054,553881,6,2827,2,7200,1.00212239123
551090,551096,554070,6,2974,2,7200,1.00201748487
551157,551163,554161,6,2998,2,7200,1.00200133422
551190,551196,554197,6,3001,2,7200,1.00199933356
551241,551247,554182,6,2935,2,7200,1.00204429302
551289,551295,554431,6,3136,2,7200,1.00191326531
551334,551341,554324,7,2983,2,7200,1.00234663091
551352,551360,554115,8,2755,2,7200,1.00290381125
551367,551373,554543,6,3170,2,7200,1.00189274448
551413,551419,554376,6,2957,2,7200,1.00202908353
551612,551618,552667,6,1049,1,3600,1.00571973308
551649,551655,554730,6,3075,2,7200,1.00195121951
552036,552043,555100,7,3057,2,7200,1.00228982663
552494,552501,555334,7,2833,2,7200,1.00247087893
552596,552603,555547,7,2944,2,7200,1.00237771739
552642,552648,555655,6,3007,2,7200,1.0019953442
552656,552662,559004,6,6342,3,7200,1.00094607379
552657,552669,555603,12,2934,2,7200,1.00408997955
552735,552742,555686,7,2944,2,7200,1.00237771739
552769,553290,559500,521,6210,3,7200,1.08389694042
552784,552791,555791,7,3000,2,7200,1.00233333333
552896,552903,555714,7,2811,2,7200,1.002490217
552953,552960,555823,7,2863,2,7200,1.00244498778
553053,553059,555874,6,2815,2,7200,1.00213143872
553134,553141,556047,7,2906,2,7200,1.00240880936
553155,553163,556028,8,2865,2,7200,1.00279232112
553189,553195,556196,6,3001,2,7200,1.00199933356
553297,553305,556090,8,2785,2,7200,1.00287253142
553430,553437,556403,7,2966,2,7200,1.00236008092
553463,553470,556471,7,3001,2,7200,1.00233255581
553478,553485,556414,7,2929,2,7200,1.00238989416
553508,553515,556663,7,3148,2,7200,1.00222363405
553533,553539,556491,6,2952,2,7200,1.00203252033
553665,553672,556644,7,2972,2,7200,1.00235531629
553711,553717,556740,6,3023,2,7200,1.00198478333
553741,553747,556779,6,3032,2,7200,1.00197889182
553756,553762,556981,6,3219,2,7200,1.0018639329
553757,553769,556897,12,3128,2,7200,1.00383631714
553759,553774,556748,15,2974,2,7200,1.00504371217
553834,553840,556918,6,3078,2,7200,1.00194931774
553879,553886,557096,7,3210,2,7200,1.00218068536
553997,554004,557037,7,3033,2,7200,1.00230794593
554054,554061,556927,7,2866,2,7200,1.00244242847
554072,554078,557131,6,3053,2,7200,1.00196528005
554112,573911,573912,19799,1,1,18000,1980.0
554118,554124,556931,6,2807,2,7200,1.00213751336
554133,554139,557054,6,2915,2,7200,1.00205831904
554163,554169,557202,6,3033,2,7200,1.00197823937
554184,554190,557275,6,3085,2,7200,1.00194489465
554199,554205,557138,6,2933,2,7200,1.00204568701
554248,573917,580758,19669,6841,1,18000,3.87516444964
554326,554332,557512,6,3180,2,7200,1.00188679245
554377,554384,557278,7,2894,2,7200,1.00241879751
554431,554438,557449,7,3011,2,7200,1.00232480903
554543,554550,557690,7,3140,2,7200,1.00222929936
554731,554737,557950,6,3213,2,7200,1.00186741363
555100,555106,558163,6,3057,2,7200,1.00196270854
555336,555343,558287,7,2944,2,7200,1.00237771739
555547,555553,558286,6,2733,2,7200,1.00219538968
555605,555611,558417,6,2806,2,7200,1.00213827512
555656,555663,558565,7,2902,2,7200,1.00241212957
555686,555693,558840,7,3147,2,7200,1.00222434064
555716,555722,558556,6,2834,2,7200,1.00211714891
555794,555801,558897,7,3096,2,7200,1.00226098191
555824,555832,558657,8,2825,2,7200,1.00283185841
555876,555882,558933,6,3051,2,7200,1.00196656834
556030,556036,559126,6,3090,2,7200,1.00194174757
556048,556054,559043,6,2989,2,7200,1.00200736032
556093,556101,559129,8,3028,2,7200,1.00264200793
556199,556208,559429,9,3221,2,7200,1.0027941633
556405,556414,559319,9,2905,2,7200,1.00309810671
556420,556426,559221,6,2795,2,7200,1.00214669052
556471,556483,559298,12,2815,2,7200,1.00426287744
556493,556504,559604,11,3100,2,7200,1.0035483871
556647,556655,559674,8,3019,2,7200,1.00264988407
556665,556675,559509,10,2834,2,7200,1.00352858151
556741,556751,559812,10,3061,2,7200,1.00326690624
556756,556762,559865,6,3103,2,7200,1.00193361263
556780,556790,559656,10,2866,2,7200,1.00348918353
556898,556908,559959,10,3051,2,7200,1.0032776139
556919,556930,560098,11,3168,2,7200,1.00347222222
556934,556940,559989,6,3049,2,7200,1.00196785831
556935,556947,560108,12,3161,2,7200,1.003796267
556984,556992,559947,8,2955,2,7200,1.0027072758
557038,557048,559930,10,2882,2,7200,1.00346981263
557056,557065,559985,9,2920,2,7200,1.00308219178
557098,557108,560060,10,2952,2,7200,1.00338753388
557132,557143,560069,11,2926,2,7200,1.0037593985
557147,557153,560113,6,2960,2,7200,1.00202702703
557204,557215,560250,11,3035,2,7200,1.00362438221
557276,557287,560116,11,2829,2,7200,1.00388829975
557291,557297,560071,6,2774,2,7200,1.0021629416
557451,557461,560405,10,2944,2,7200,1.00339673913
557509,557523,560402,14,2879,2,7200,1.00486279958
557693,557701,560417,8,2716,2,7200,1.0029455081
557953,557962,561050,9,3088,2,7200,1.00291450777
558164,558174,561134,10,2960,2,7200,1.00337837838
558288,558297,561443,9,3146,2,7200,1.00286077559
558289,558305,561246,16,2941,2,7200,1.00544032642
558419,558428,561610,9,3182,2,7200,1.00282840981
558558,558568,561439,10,2871,2,7200,1.00348310693
558573,558579,561753,6,3174,2,7200,1.00189035917
558658,558668,561745,10,3077,2,7200,1.00324991875
558843,558851,561713,8,2862,2,7200,1.00279524808
558900,558908,561996,8,3088,2,7200,1.00259067358
558933,558945,562039,12,3094,2,7200,1.00387847447
559045,559055,562176,10,3121,2,7200,1.00320410125
559127,559137,562368,10,3231,2,7200,1.00309501702
559142,559148,562057,6,2909,2,7200,1.00206256446
559224,559233,562334,9,3101,2,7200,1.00290228958
559299,559309,562170,10,2861,2,7200,1.00349528137
559320,559330,562265,10,2935,2,7200,1.00340715503
559429,559442,562369,13,2927,2,7200,1.00444140758
559499,570516,577082,11017,6566,3,7200,2.67788607981
559511,559521,562339,10,2818,2,7200,1.00354861604
559512,573401,577082,13889,3681,3,7200,4.77315946754
559605,559617,562628,12,3011,2,7200,1.00398538691
559656,559667,562611,11,2944,2,7200,1.00373641304
559677,559686,562645,9,2959,2,7200,1.0030415681
559813,559824,562698,11,2874,2,7200,1.00382741823
559868,559877,562884,9,3007,2,7200,1.0029930163
559931,559942,562639,11,2697,2,7200,1.00407860586
559949,559958,562830,9,2872,2,7200,1.00313370474
559964,559970,562929,6,2959,2,7200,1.00202771206
559985,559996,562978,11,2982,2,7200,1.00368879946
560000,560006,562916,6,2910,2,7200,1.00206185567
560061,560072,563048,11,2976,2,7200,1.00369623656
560076,560082,562987,6,2905,2,7200,1.00206540448
560077,560088,563018,11,2930,2,7200,1.00375426621
560098,560109,562973,11,2864,2,7200,1.00384078212
560114,560120,563130,6,3010,2,7200,1.00199335548
560115,560127,563120,12,2993,2,7200,1.00400935516
560130,560136,562794,6,2658,2,7200,1.00225733634
560251,560262,563129,11,2867,2,7200,1.00383676317
560403,560419,563418,16,2999,2,7200,1.0053351117
560418,560425,563555,7,3130,2,7200,1.00223642173
560419,560432,563371,13,2939,2,7200,1.00442327322
561052,561062,564153,10,3091,2,7200,1.00323519896
561137,561145,564060,8,2915,2,7200,1.00274442539
561150,798587,963086,237437,164499,18,216000,2.44339479267
561249,561257,564031,8,2774,2,7200,1.00288392213
561439,561450,564481,11,3031,2,7200,1.00362916529
561454,561461,564341,7,2880,2,7200,1.00243055556
561612,561622,564674,10,3052,2,7200,1.00327653997
561715,561726,564741,11,3015,2,7200,1.00364842454
561748,561756,564666,8,2910,2,7200,1.00274914089
561763,561769,564879,6,3110,2,7200,1.00192926045
561996,562008,565137,12,3129,2,7200,1.00383509108
562042,562051,565032,9,2981,2,7200,1.0030191211
562060,562068,565123,8,3055,2,7200,1.00261865794
562171,562183,565125,12,2942,2,7200,1.00407885792
562186,562192,565279,6,3087,2,7200,1.0019436346
562268,562276,565163,8,2887,2,7200,1.0027710426
562337,562346,565333,9,2987,2,7200,1.00301305658
562352,562358,565188,6,2830,2,7200,1.00212014134
562370,562379,565321,9,2942,2,7200,1.00305914344
562372,562386,565193,14,2807,2,7200,1.00498753117
562614,562623,565677,9,3054,2,7200,1.00294695481
562629,562641,565443,12,2802,2,7200,1.00428265525
562644,562650,565636,6,2986,2,7200,1.00200937709
562659,562665,565456,6,2791,2,7200,1.00214976711
562698,562709,565703,11,2994,2,7200,1.0036740147
562795,562807,565767,12,2960,2,7200,1.00405405405
562831,562842,565814,11,2972,2,7200,1.00370121131
562886,562895,565842,9,2947,2,7200,1.00305395317
562916,562927,565760,11,2833,2,7200,1.00388280974
562931,562942,565810,11,2868,2,7200,1.00383542538
562973,562984,566102,11,3118,2,7200,1.0035279025
562989,562995,565938,6,2943,2,7200,1.00203873598
562990,563003,565963,13,2960,2,7200,1.00439189189
563020,563030,566083,10,3053,2,7200,1.00327546675
563050,563060,566046,10,2986,2,7200,1.00334896182
563120,563131,566164,11,3033,2,7200,1.00362677217
563135,563142,566009,7,2867,2,7200,1.00244157656
563137,563149,566145,12,2996,2,7200,1.00400534045
563373,563382,566449,9,3067,2,7200,1.00293446365
563421,563430,566475,9,3045,2,7200,1.00295566502
563557,563567,566620,10,3053,2,7200,1.00327546675
564029,564043,566942,14,2899,2,7200,1.00482925147
564062,564071,567090,9,3019,2,7200,1.00298111958
564156,564164,567016,8,2852,2,7200,1.00280504909
564344,564353,567336,9,2983,2,7200,1.00301709688
564483,564492,567391,9,2899,2,7200,1.0031045188
564667,564679,567651,12,2972,2,7200,1.00403768506
564682,564689,567574,7,2885,2,7200,1.00242634315
564742,564753,567843,11,3090,2,7200,1.00355987055
564882,564891,567801,9,2910,2,7200,1.00309278351
565033,565044,568103,11,3059,2,7200,1.00359594639
565123,565134,568049,11,2915,2,7200,1.00377358491
565138,565145,568032,7,2887,2,7200,1.00242466228
565140,565151,568008,11,2857,2,7200,1.00385019251
565164,565175,568057,11,2882,2,7200,1.00381679389
565191,565200,568149,9,2949,2,7200,1.00305188199
565206,565212,568276,6,3064,2,7200,1.00195822454
565282,565296,568297,14,3001,2,7200,1.00466511163
565324,565333,568479,9,3146,2,7200,1.00286077559
565339,565345,568288,6,2943,2,7200,1.00203873598
565445,565454,568401,9,2947,2,7200,1.00305395317
565460,565467,568844,7,3377,2,7200,1.00207284572
565638,565648,568843,10,3195,2,7200,1.00312989045
565677,565688,568729,11,3041,2,7200,1.00361723117
565705,565715,568557,10,2842,2,7200,1.00351864884
565762,565772,568641,10,2869,2,7200,1.00348553503
565777,565783,568986,6,3203,2,7200,1.00187324383
565814,565822,568692,8,2870,2,7200,1.00278745645
565815,565829,568787,14,2958,2,7200,1.00473292765
565842,565853,569103,11,3250,2,7200,1.00338461538
565939,565950,568840,11,2890,2,7200,1.00380622837
565963,565975,568908,12,2933,2,7200,1.00409137402
566012,566021,568951,9,2930,2,7200,1.00307167235
566048,566057,568974,9,2917,2,7200,1.00308536167
566084,566095,568840,11,2745,2,7200,1.00400728597
566105,566114,569150,9,3036,2,7200,1.00296442688
566147,566157,569058,10,2901,2,7200,1.00344708721
566165,566176,569026,11,2850,2,7200,1.00385964912
566450,566461,569150,11,2689,2,7200,1.00409074005
566477,566486,569150,9,2664,2,7200,1.00337837838
566622,566631,569150,9,2519,2,7200,1.00357284637
566942,566954,569150,12,2196,2,7200,1.00546448087
567018,567028,569150,10,2122,2,7200,1.00471253534
567090,567102,569150,12,2048,2,7200,1.005859375
567338,567348,569150,10,1802,2,7200,1.00554938957
567392,567403,569150,11,1747,2,7200,1.0062965083
567576,567585,569150,9,1565,2,7200,1.00575079872
567654,567663,569150,9,1487,2,7200,1.00605245461
567802,567812,569150,10,1338,2,7200,1.00747384155
567844,567854,569150,10,1296,2,7200,1.00771604938
568010,568020,569150,10,1130,2,7200,1.00884955752
568035,568044,569150,9,1106,2,7200,1.00813743219
568050,568061,569150,11,1089,2,7200,1.0101010101
568065,568071,569150,6,1079,2,7200,1.00556070436
568104,568114,569150,10,1036,2,7200,1.00965250965
568150,568161,569150,11,989,2,7200,1.0111223458
568278,568288,569152,10,864,2,7200,1.01157407407
568293,568299,569152,6,853,2,7200,1.00703399766
568308,568314,569152,6,838,2,7200,1.00715990453
568401,568412,569152,11,740,2,7200,1.01486486486
568480,568490,569152,10,662,2,7200,1.01510574018
568559,568568,569152,9,584,2,7200,1.0154109589
568644,568653,569152,9,499,2,7200,1.01803607214
568695,568703,569152,8,449,2,7200,1.01781737194
568731,568740,569152,9,412,2,7200,1.02184466019
568789,568799,569152,10,353,2,7200,1.0283286119
568844,568853,569152,9,299,2,7200,1.03010033445
568845,568858,569152,13,294,2,7200,1.04421768707
568847,568865,569152,18,287,2,7200,1.06271777003
568848,568870,569152,22,282,2,7200,1.0780141844
568909,568920,569152,11,232,2,7200,1.0474137931
568954,568962,569152,8,190,2,7200,1.04210526316
568975,568986,569152,11,166,2,7200,1.06626506024
568992,568998,569152,6,154,2,7200,1.03896103896
569029,569037,569152,8,115,2,7200,1.06956521739
569059,569070,569152,11,82,2,7200,1.13414634146
569104,569115,569152,11,37,2,7200,1.2972972973
569119,569161,569350,42,189,2,7200,1.22222222222
569150,569167,569350,17,183,2,7200,1.09289617486
569161,569175,569350,14,175,2,7200,1.08
569171,569182,569350,11,168,2,7200,1.06547619048
569172,569187,569350,15,163,2,7200,1.09202453988
569182,569194,569350,12,156,2,7200,1.07692307692
569183,569200,569350,17,150,2,7200,1.11333333333
569193,569206,569350,13,144,2,7200,1.09027777778
569204,569218,569350,14,132,2,7200,1.10606060606
569204,569213,569350,9,137,2,7200,1.06569343066
569215,569224,569350,9,126,2,7200,1.07142857143
569215,569230,569350,15,120,2,7200,1.125
569226,569236,569350,10,114,2,7200,1.08771929825
569226,569242,569350,16,108,2,7200,1.14814814815
569237,569248,569350,11,102,2,7200,1.10784313725
569237,569254,569350,17,96,2,7200,1.17708333333
569248,569260,569350,12,90,2,7200,1.13333333333
569258,569266,569350,8,84,2,7200,1.09523809524
569259,569272,569350,13,78,2,7200,1.16666666667
569269,569278,569350,9,72,2,7200,1.125
569270,569284,569350,14,66,2,7200,1.21212121212
569281,569290,569350,9,60,2,7200,1.15
569281,569295,569350,14,55,2,7200,1.25454545455
569292,569307,569350,15,43,2,7200,1.3488372093
569292,569302,569350,10,48,2,7200,1.20833333333
569444,569451,570634,7,1183,2,7200,1.00591715976
569455,569466,570637,11,1171,2,7200,1.00939368061
569455,569461,570650,6,1189,2,7200,1.00504625736
569466,569472,570635,6,1163,2,7200,1.00515907137
569466,569478,570655,12,1177,2,7200,1.01019541206
569477,569484,570660,7,1176,2,7200,1.00595238095
569477,569490,570678,13,1188,2,7200,1.01094276094
569488,569502,570683,14,1181,2,7200,1.01185436071
569488,569497,570662,9,1165,2,7200,1.00772532189
569498,569508,570688,10,1180,2,7200,1.00847457627
569499,569514,570681,15,1167,2,7200,1.01285347044
569509,569520,570706,11,1186,2,7200,1.00927487352
569510,569525,570697,15,1172,2,7200,1.01279863481
569521,569537,570702,16,1165,2,7200,1.01373390558
569521,569532,570718,11,1186,2,7200,1.00927487352
569532,569545,570742,13,1197,2,7200,1.01086048454
569542,569551,570714,9,1163,2,7200,1.00773860705
569542,569556,570719,14,1163,2,7200,1.01203783319
569553,569567,570763,14,1196,2,7200,1.01170568562
569553,569562,570725,9,1163,2,7200,1.00773860705
569564,569580,570761,16,1181,2,7200,1.01354784081
569564,569575,570747,11,1172,2,7200,1.00938566553
569575,569591,570772,16,1181,2,7200,1.01354784081
569575,569586,570762,11,1176,2,7200,1.0093537415
569586,569598,570774,12,1176,2,7200,1.01020408163
570774,745821,754442,175047,8621,16,14400,21.30472103
570839,570845,572022,6,1177,2,7200,1.00509770603
570850,570857,572077,7,1220,2,7200,1.00573770492
570851,570862,572024,11,1162,2,7200,1.00946643718
570861,570869,572046,8,1177,2,7200,1.00679694138
570862,570874,572057,12,1183,2,7200,1.01014370245
570872,570881,572058,9,1177,2,7200,1.00764655905
570873,570886,572054,13,1168,2,7200,1.01113013699
570883,570892,572061,9,1169,2,7200,1.00769888794
570884,570898,572080,14,1182,2,7200,1.01184433164
570894,570904,572087,10,1183,2,7200,1.00845308538
570895,570910,572080,15,1170,2,7200,1.01282051282
570905,570916,572089,11,1173,2,7200,1.00937766411
570906,570922,572107,16,1185,2,7200,1.0135021097
570916,570928,572116,12,1188,2,7200,1.0101010101
570927,570935,572105,8,1170,2,7200,1.00683760684
570927,570940,572106,13,1166,2,7200,1.01114922813
570938,570947,572130,9,1183,2,7200,1.00760777684
570938,570952,572116,14,1164,2,7200,1.01202749141
570949,570958,572129,9,1171,2,7200,1.00768573868
570949,570964,572158,15,1194,2,7200,1.01256281407
570960,570970,572168,10,1198,2,7200,1.00834724541
570961,570976,572162,15,1186,2,7200,1.01264755481
570971,570982,572169,11,1187,2,7200,1.00926705981
570972,570988,572163,16,1175,2,7200,1.01361702128
570982,570994,572159,12,1165,2,7200,1.01030042918
572154,572161,573301,7,1140,2,7200,1.00614035088
572155,572166,573304,11,1138,2,7200,1.00966608084
572165,572172,573348,7,1176,2,7200,1.00595238095
572166,572178,573349,12,1171,2,7200,1.01024765158
572176,572185,573334,9,1149,2,7200,1.00783289817
572177,572190,573386,13,1196,2,7200,1.01086956522
572187,572197,573342,10,1145,2,7200,1.00873362445
572188,572202,573349,14,1147,2,7200,1.01220575414
572198,572208,573368,10,1160,2,7200,1.00862068966
572199,572214,573359,15,1145,2,7200,1.01310043668
572209,572220,573363,11,1143,2,7200,1.00962379703
572210,572226,573379,16,1153,2,7200,1.01387684302
572220,572232,573395,12,1163,2,7200,1.01031814273
572231,572244,573401,13,1157,2,7200,1.01123595506
572231,572239,573393,8,1154,2,7200,1.00693240901
572242,572250,573423,8,1173,2,7200,1.00682011935
572243,572256,573434,13,1178,2,7200,1.01103565365
572253,572262,573421,9,1159,2,7200,1.00776531493
572254,572268,573418,14,1150,2,7200,1.01217391304
572264,572280,573440,16,1160,2,7200,1.01379310345
572264,572275,573435,11,1160,2,7200,1.00948275862
572275,572286,573448,11,1162,2,7200,1.00946643718
572276,572291,573458,15,1167,2,7200,1.01285347044
572286,572298,573466,12,1168,2,7200,1.0102739726
572297,572305,573490,8,1185,2,7200,1.00675105485
572297,572310,573473,13,1163,2,7200,1.01117798796
572308,572322,573495,14,1173,2,7200,1.01193520887
572308,572317,573479,9,1162,2,7200,1.00774526678
572319,572329,573500,10,1171,2,7200,1.00853970965
572319,572335,573503,16,1168,2,7200,1.01369863014
572412,572418,573548,6,1130,2,7200,1.00530973451
572413,572425,573588,12,1163,2,7200,1.01031814273
572424,572437,573592,13,1155,2,7200,1.01125541126
572424,572431,573607,7,1176,2,7200,1.00595238095
572435,572444,573613,9,1169,2,7200,1.00769888794
572435,572449,573607,14,1158,2,7200,1.01208981002
572446,572456,573612,10,1156,2,7200,1.00865051903
572447,572461,573616,14,1155,2,7200,1.01212121212
572457,572468,573640,11,1172,2,7200,1.00938566553
572458,572473,573636,15,1163,2,7200,1.01289767842
572469,573312,574487,843,1175,2,7200,1.71744680851
573358,573365,574507,7,1142,2,7200,1.0061295972
573359,573370,574515,11,1145,2,7200,1.0096069869
573370,573377,574513,7,1136,2,7200,1.00616197183
573370,573382,574529,12,1147,2,7200,1.01046207498
573381,573394,574533,13,1139,2,7200,1.01141352063
573381,573388,574566,7,1178,2,7200,1.00594227504
573392,573406,574548,14,1142,2,7200,1.0122591944
573392,573411,574550,19,1139,2,7200,1.01668129939
573404,573418,574597,14,1179,2,7200,1.01187446989
573414,573424,574574,10,1150,2,7200,1.00869565217
573509,573516,574685,7,1169,2,7200,1.00598802395
573510,573521,574675,11,1154,2,7200,1.00953206239
573521,573527,574663,6,1136,2,7200,1.00528169014
573521,573533,574673,12,1140,2,7200,1.01052631579
573532,573539,574674,7,1135,2,7200,1.00616740088
573532,573544,574697,12,1153,2,7200,1.01040763226
573543,573550,574701,7,1151,2,7200,1.00608166811
573543,573555,574680,12,1125,2,7200,1.01066666667
573554,573562,574695,8,1133,2,7200,1.00706090026
573555,573568,574755,13,1187,2,7200,1.01095197978
573565,573574,574710,9,1136,2,7200,1.00792253521
573566,573580,574709,14,1129,2,7200,1.0124003543
573576,573587,574724,11,1137,2,7200,1.00967458223
573577,573592,574733,15,1141,2,7200,1.01314636284
573587,573598,574744,11,1146,2,7200,1.00959860384
573588,573604,574750,16,1146,2,7200,1.01396160558
573598,573611,574761,13,1150,2,7200,1.01130434783
573599,573616,574778,17,1162,2,7200,1.01462994836
573610,573622,574782,12,1160,2,7200,1.01034482759
573620,573630,574783,10,1153,2,7200,1.00867302689
573621,573635,574781,14,1146,2,7200,1.01221640489
573631,573642,574763,11,1121,2,7200,1.00981266726
573632,573647,574804,15,1157,2,7200,1.01296456353
573643,573654,574811,11,1157,2,7200,1.00950734659
573643,573659,574824,16,1165,2,7200,1.01373390558
573654,573665,574838,11,1173,2,7200,1.00937766411
573664,573672,574803,8,1131,2,7200,1.00707338638
573665,573677,574815,12,1138,2,7200,1.01054481547
573675,573684,574854,9,1170,2,7200,1.00769230769
573676,573901,575052,225,1151,2,7200,1.1954821894
573901,573924,575043,23,1119,2,7200,1.02055406613
573922,574498,575691,576,1193,2,7200,1.48281642917
574502,574519,575621,17,1102,2,7200,1.01542649728
574523,574529,575642,6,1113,2,7200,1.00539083558
574533,574540,575661,7,1121,2,7200,1.00624442462
574534,574545,575705,11,1160,2,7200,1.00948275862
574544,574551,575704,7,1153,2,7200,1.00607111882
574555,574561,575727,6,1166,2,7200,1.0051457976
574566,574572,575731,6,1159,2,7200,1.00517687662
574576,574582,575742,6,1160,2,7200,1.00517241379
574587,574593,575769,6,1176,2,7200,1.00510204082
574597,574611,575763,14,1152,2,7200,1.01215277778
574608,574675,575827,67,1152,2,7200,1.05815972222
574670,574685,575837,15,1152,2,7200,1.01302083333
574680,574691,575775,11,1084,2,7200,1.01014760148
574681,574696,575833,15,1137,2,7200,1.01319261214
574692,574702,575857,10,1155,2,7200,1.00865800866
574702,574709,575871,7,1162,2,7200,1.00602409639
574703,574715,575898,12,1183,2,7200,1.01014370245
574714,574721,575877,7,1156,2,7200,1.00605536332
574715,574726,575877,11,1151,2,7200,1.00955690704
574726,574738,575870,12,1132,2,7200,1.01060070671
574726,574732,575892,6,1160,2,7200,1.00517241379
574737,574744,575915,7,1171,2,7200,1.00597779675
574744,574750,575909,6,1159,2,7200,1.00517687662
574754,574761,575895,7,1134,2,7200,1.00617283951
574765,574771,575906,6,1135,2,7200,1.00528634361
574766,574777,575894,11,1117,2,7200,1.00984780662
574776,574783,575919,7,1136,2,7200,1.00616197183
574787,574794,575910,7,1116,2,7200,1.00627240143
574788,574799,575938,11,1139,2,7200,1.00965759438
574798,574806,575927,8,1121,2,7200,1.00713648528
574799,574811,575949,12,1138,2,7200,1.01054481547
574809,574817,575941,8,1124,2,7200,1.00711743772
574810,574823,575961,13,1138,2,7200,1.01142355009
574821,574835,575973,14,1138,2,7200,1.01230228471
574821,574829,575964,8,1135,2,7200,1.00704845815
574832,574847,576005,15,1158,2,7200,1.01295336788
574842,574854,575975,12,1121,2,7200,1.01070472792
574853,574860,576019,7,1159,2,7200,1.00603968939
574864,574871,575997,7,1126,2,7200,1.00621669627
574874,575055,576199,181,1144,2,7200,1.15821678322
575058,575065,576183,7,1118,2,7200,1.00626118068
575069,575633,576751,564,1118,2,7200,1.50447227191
575631,575654,576782,23,1128,2,7200,1.02039007092
575652,575673,576776,21,1103,2,7200,1.01903898459
575673,575703,576829,30,1126,2,7200,1.02664298401
575704,575717,576876,13,1159,2,7200,1.01121656601
575715,575724,576893,9,1169,2,7200,1.00769888794
575725,575738,576901,13,1163,2,7200,1.01117798796
575736,575744,576885,8,1141,2,7200,1.00701139351
575747,575753,576890,6,1137,2,7200,1.00527704485
575757,575775,576924,18,1149,2,7200,1.01566579634
575778,575784,576914,6,1130,2,7200,1.00530973451
575789,575795,576915,6,1120,2,7200,1.00535714286
575799,575838,576973,39,1135,2,7200,1.03436123348
575840,575847,576966,7,1119,2,7200,1.00625558534
575851,575857,576985,6,1128,2,7200,1.00531914894
575862,575868,576987,6,1119,2,7200,1.00536193029
575872,575882,576996,10,1114,2,7200,1.00897666068
575883,575889,577054,6,1165,2,7200,1.00515021459
575884,575894,577065,10,1171,2,7200,1.00853970965
575894,575900,577044,6,1144,2,7200,1.00524475524
575895,575907,577055,12,1148,2,7200,1.01045296167
575905,575915,577055,10,1140,2,7200,1.00877192982
575906,575920,577076,14,1156,2,7200,1.01211072664
575916,575927,577083,11,1156,2,7200,1.00951557093
575917,575932,577082,15,1150,2,7200,1.01304347826
575927,575939,577088,12,1149,2,7200,1.01044386423
575928,575944,577064,16,1120,2,7200,1.01428571429
575938,575951,577077,13,1126,2,7200,1.01154529307
575949,575963,577092,14,1129,2,7200,1.0124003543
575949,575957,577091,8,1134,2,7200,1.00705467372
575960,575969,577093,9,1124,2,7200,1.00800711744
575960,575975,577149,15,1174,2,7200,1.01277683135
575971,575987,577128,16,1141,2,7200,1.01402278703
575971,575982,577146,11,1164,2,7200,1.00945017182
575982,575994,577144,12,1150,2,7200,1.01043478261
575983,575999,577138,16,1139,2,7200,1.01404741001
576003,576011,577141,8,1130,2,7200,1.00707964602
576014,576021,577151,7,1130,2,7200,1.00619469027
576025,576031,577186,6,1155,2,7200,1.00519480519
576036,576043,577174,7,1131,2,7200,1.00618921309
576046,576196,577319,150,1123,2,7200,1.13357079252
576200,576211,577327,11,1116,2,7200,1.00985663082
576210,576762,577733,552,971,2,7200,1.56848609681
576762,576788,577733,26,945,2,7200,1.02751322751
576793,576799,577733,6,934,2,7200,1.00642398287
576804,576841,577733,37,892,2,7200,1.04147982063
576845,576888,577733,43,845,2,7200,1.05088757396
576886,576897,577733,11,836,2,7200,1.01315789474
576897,576903,577733,6,830,2,7200,1.00722891566
576907,576913,577733,6,820,2,7200,1.00731707317
576918,576924,577733,6,809,2,7200,1.00741656366
576919,576932,577733,13,801,2,7200,1.01622971286
576929,576938,577733,9,795,2,7200,1.01132075472
576940,576947,577733,7,786,2,7200,1.00890585242
576950,576977,577733,27,756,2,7200,1.03571428571
576982,576988,577733,6,745,2,7200,1.00805369128
576992,576998,577733,6,735,2,7200,1.00816326531
577003,577009,577733,6,724,2,7200,1.00828729282
577013,577020,577733,7,713,2,7200,1.00981767181
577024,577056,577733,32,677,2,7200,1.04726735598
577055,577065,577733,10,668,2,7200,1.01497005988
577066,577078,577733,12,655,2,7200,1.01832061069
577066,577072,577733,6,661,2,7200,1.00907715582
577077,577085,577733,8,648,2,7200,1.01234567901
577077,577090,577733,13,643,2,7200,1.02021772939
577082,577097,580337,15,3240,3,7200,1.00462962963
577088,577102,577733,14,631,2,7200,1.02218700475
577088,577107,577733,19,626,2,7200,1.0303514377
577092,577994,580337,902,2343,3,7200,1.38497652582
577099,577114,577733,15,619,2,7200,1.02423263328
577110,577126,577733,16,607,2,7200,1.02635914333
577110,577121,577733,11,612,2,7200,1.01797385621
577175,577186,577733,11,547,2,7200,1.02010968921
577176,577191,577734,15,543,2,7200,1.02762430939
577186,577197,577734,11,537,2,7200,1.02048417132
577187,577203,577734,16,531,2,7200,1.03013182674
577198,577209,577733,11,524,2,7200,1.02099236641
577205,577215,577733,10,518,2,7200,1.01930501931
577205,577220,577733,15,513,2,7200,1.02923976608
577216,577227,577733,11,506,2,7200,1.02173913043
577216,577232,577733,16,501,2,7200,1.03193612774
577227,577239,577733,12,494,2,7200,1.02429149798
577237,577245,577733,8,488,2,7200,1.01639344262
577248,577254,577733,6,479,2,7200,1.01252609603
577258,577330,577733,72,403,2,7200,1.17866004963
577330,577338,577588,8,250,2,7200,1.032
577341,577599,577733,258,134,2,7200,2.92537313433
577657,577748,580645,91,2897,4,36000,1.03141180532
577799,577806,581003,7,3197,2,7200,1.00218955271
577810,577822,581030,12,3208,2,7200,1.00374064838
577810,577816,581005,6,3189,2,7200,1.00188146754
577821,577828,581017,7,3189,2,7200,1.00219504547
577821,577834,581026,13,3192,2,7200,1.0040726817
577832,577846,581053,14,3207,2,7200,1.00436545058
577832,577841,581063,9,3222,2,7200,1.00279329609
577843,577858,581048,15,3190,2,7200,1.00470219436
577843,577863,581057,20,3194,2,7200,1.00626174076
577854,577870,581066,16,3196,2,7200,1.00500625782
577865,577882,581110,17,3228,2,7200,1.00526641884
577865,577877,581082,12,3205,2,7200,1.00374414977
577876,577888,581100,12,3212,2,7200,1.00373599004
577886,577896,581125,10,3229,2,7200,1.00309693404
577887,577901,581086,14,3185,2,7200,1.0043956044
577897,577907,581104,10,3197,2,7200,1.00312793244
577898,577913,581096,15,3183,2,7200,1.00471253534
577908,577924,581115,16,3191,2,7200,1.00501410216
577909,577930,581123,21,3193,2,7200,1.00657688694
577919,577936,581133,17,3197,2,7200,1.00531748514
577930,577941,581142,11,3201,2,7200,1.00343642612
577941,577948,581137,7,3189,2,7200,1.00219504547
577941,577953,581194,12,3241,2,7200,1.00370256094
577952,577962,581153,10,3191,2,7200,1.00313381385
577952,577967,581163,15,3196,2,7200,1.00469336671
578483,587584,587591,9101,7,2,18000,910.8
580097,580657,589085,560,8428,4,43200,1.06644518272
580342,580348,587561,6,7213,3,7200,1.00083183142
580351,581258,588502,907,7244,3,7200,1.12520706792
581028,581039,584084,11,3045,2,7200,1.00361247947
581028,581034,584070,6,3036,2,7200,1.00197628458
581039,581046,584148,7,3102,2,7200,1.00225660864
581039,581051,584188,12,3137,2,7200,1.00382531081
581049,581057,584089,8,3032,2,7200,1.00263852243
581050,581063,584081,13,3018,2,7200,1.0043074884
581061,581070,584126,9,3056,2,7200,1.00294502618
581069,581076,584291,7,3215,2,7200,1.00217729393
581070,581082,584267,12,3185,2,7200,1.00376766091
581080,581088,584318,8,3230,2,7200,1.00247678019
581081,581094,584298,13,3204,2,7200,1.00405742821
581091,581101,584292,10,3191,2,7200,1.00313381385
581092,581106,584296,14,3190,2,7200,1.00438871473
581103,581118,584312,15,3194,2,7200,1.00469630557
581103,581113,584336,10,3223,2,7200,1.00310269935
581114,581130,584374,16,3244,2,7200,1.00493218249
581114,581125,584319,11,3194,2,7200,1.00344395742
581125,581137,584326,12,3189,2,7200,1.00376293509
581125,581142,584334,17,3192,2,7200,1.00532581454
581136,581149,584358,13,3209,2,7200,1.00405110626
581146,581155,584353,9,3198,2,7200,1.00281425891
581147,581161,584362,14,3201,2,7200,1.00437363324
581158,581173,584358,15,3185,2,7200,1.00470957614
581158,581168,584349,10,3181,2,7200,1.00314366551
581169,581185,584375,16,3190,2,7200,1.00501567398
581169,581180,584383,11,3203,2,7200,1.00343428036
581180,581191,584401,11,3210,2,7200,1.00342679128
581190,581197,584391,7,3194,2,7200,1.00219160927
581191,581202,584400,11,3198,2,7200,1.00343964978
581201,581210,584402,9,3192,2,7200,1.00281954887
581202,581215,584410,13,3195,2,7200,1.00406885759
581213,581222,584418,9,3196,2,7200,1.00281602003
581213,581227,584422,14,3195,2,7200,1.00438184664
581223,581233,584470,10,3237,2,7200,1.0030892802
581224,581239,584437,15,3198,2,7200,1.00469043152
581234,581245,584413,11,3168,2,7200,1.00347222222
581235,581250,584439,15,3189,2,7200,1.00470366886
581246,581268,584473,22,3205,2,7200,1.00686427457
581246,581263,584446,17,3183,2,7200,1.00534087339
581267,584082,587281,2815,3199,2,7200,1.87996248828
581267,581275,584481,8,3206,2,7200,1.00249532127
582115,587599,588557,5484,958,1,3600,6.72442588727
584078,584093,587259,15,3166,2,7200,1.00473783955
584089,584100,587294,11,3194,2,7200,1.00344395742
584089,584106,587304,17,3198,2,7200,1.00531582239
584100,584137,587323,37,3186,2,7200,1.01161330822
584131,584160,587350,29,3190,2,7200,1.00909090909
584152,584199,587381,47,3182,2,7200,1.01477058454
584193,584279,587455,86,3176,2,7200,1.02707808564
584275,584303,587494,28,3191,2,7200,1.00877467878
584297,584310,587497,13,3187,2,7200,1.00407907123
584307,584316,587509,9,3193,2,7200,1.00281866583
584308,584322,587511,14,3189,2,7200,1.00439009094
584318,584329,587507,11,3178,2,7200,1.00346129641
584319,584336,587516,17,3180,2,7200,1.00534591195
584330,584341,587539,11,3198,2,7200,1.00343964978
584340,584347,587541,7,3194,2,7200,1.00219160927
584341,584353,587568,12,3215,2,7200,1.00373250389
584351,584359,587534,8,3175,2,7200,1.00251968504
584352,584366,587553,14,3187,2,7200,1.00439284594
584362,584372,587559,10,3187,2,7200,1.0031377471
584363,584378,587595,15,3217,2,7200,1.00466272925
584373,584385,587554,12,3169,2,7200,1.0037866835
584374,584390,587571,16,3181,2,7200,1.00502986482
584385,584397,587605,12,3208,2,7200,1.00374064838
584395,584404,587580,9,3176,2,7200,1.00283375315
584396,584409,587592,13,3183,2,7200,1.0040841973
584406,584416,587601,10,3185,2,7200,1.00313971743
584407,584421,587611,14,3190,2,7200,1.00438871473
584417,584427,587622,10,3195,2,7200,1.00312989045
584418,584433,587631,15,3198,2,7200,1.00469043152
584429,584445,587638,16,3193,2,7200,1.00501096148
584429,584439,587610,10,3171,2,7200,1.00315357931
584440,584457,587629,17,3172,2,7200,1.0053593947
584440,584452,587624,12,3172,2,7200,1.00378310214
584451,584464,587660,13,3196,2,7200,1.00406758448
584461,584470,587648,9,3178,2,7200,1.00283196979
584462,584475,587646,13,3171,2,7200,1.00409965311
584473,584489,587685,16,3196,2,7200,1.00500625782
584473,584482,587699,9,3217,2,7200,1.00279763755
584484,584496,587682,12,3186,2,7200,1.00376647834
584484,587271,590463,2787,3192,2,7200,1.87312030075
587271,587293,590468,22,3175,2,7200,1.00692913386
587291,587310,590506,19,3196,2,7200,1.00594493116
587302,587316,590509,14,3193,2,7200,1.00438459129
587313,587335,590538,22,3203,2,7200,1.00686856072
587324,587361,590543,37,3182,2,7200,1.01162790698
587355,587392,590584,37,3192,2,7200,1.0115914787
587386,587466,590662,80,3196,2,7200,1.02503128911
587457,587505,590702,48,3197,2,7200,1.0150140757
587499,587512,590683,13,3171,2,7200,1.00409965311
587509,587518,590691,9,3173,2,7200,1.0028364324
587510,587525,590714,15,3189,2,7200,1.00470366886
587520,587531,590735,11,3204,2,7200,1.00343320849
587521,587537,590723,16,3186,2,7200,1.00502197112
587532,587545,590728,13,3183,2,7200,1.0040841973
587542,587551,590734,9,3183,2,7200,1.00282752121
587543,587559,590744,16,3185,2,7200,1.00502354788
587553,587565,590766,12,3201,2,7200,1.00374882849
587564,587577,590751,13,3174,2,7200,1.0040957782
587564,587571,590750,7,3179,2,7200,1.0022019503
587575,587594,590790,19,3196,2,7200,1.00594493116
587575,587589,590786,14,3197,2,7200,1.00437910541
587586,587606,590782,20,3176,2,7200,1.00629722922
587597,587611,590802,14,3191,2,7200,1.00438733939
587663,587669,590744,6,3075,2,7200,1.00195121951
587664,587675,590750,11,3075,2,7200,1.00357723577
587675,587682,590745,7,3063,2,7200,1.00228534117
587675,587687,590750,12,3063,2,7200,1.00391772772
587686,587694,590750,8,3056,2,7200,1.00261780105
587692,587702,590819,10,3117,2,7200,1.00320821303
587693,587707,590823,14,3116,2,7200,1.00449293967
587703,587713,590822,10,3109,2,7200,1.00321646832
587704,587719,590856,15,3137,2,7200,1.00478163851
587714,587725,590847,11,3122,2,7200,1.00352338245
587715,587731,590862,16,3131,2,7200,1.00511018844
587726,587737,590849,11,3112,2,7200,1.00353470437
587726,587743,590854,17,3111,2,7200,1.00546448087
587737,587750,590860,13,3110,2,7200,1.00418006431
587747,587756,590854,9,3098,2,7200,1.00290510006
587748,587762,590883,14,3121,2,7200,1.00448574175
587758,587768,590883,10,3115,2,7200,1.00321027287
587769,588515,591645,746,3130,2,7200,1.23833865815
588515,588521,591610,6,3089,2,7200,1.00194237617
588526,589096,592205,570,3109,2,7200,1.18333869411
588836,588842,588845,6,3,1,5400,1.0
588996,589002,589489,6,487,1,5400,1.01232032854
589098,589105,592220,7,3115,2,7200,1.00224719101
589109,590476,593580,1367,3104,2,7200,1.44039948454
590063,798592,805317,208529,6725,6,180000,32.0080297398
590478,590484,593641,6,3157,2,7200,1.00190053849
590488,590518,593666,30,3148,2,7200,1.00952986023
590519,590526,593624,7,3098,2,7200,1.00225952227
590530,590550,593622,20,3072,2,7200,1.00651041667
590551,590558,593628,7,3070,2,7200,1.00228013029
590561,590595,593706,34,3111,2,7200,1.01092896175
590592,590673,593754,81,3081,2,7200,1.02629016553
590675,590696,593829,21,3133,2,7200,1.00670284073
590695,590703,593840,8,3137,2,7200,1.0025502072
590706,590715,593849,9,3134,2,7200,1.00287172942
590717,590727,593893,10,3166,2,7200,1.0031585597
590727,590735,593909,8,3174,2,7200,1.00252047889
590738,590744,593937,6,3193,2,7200,1.00187911055
590749,590755,593854,6,3099,2,7200,1.00193610842
590760,590766,593824,6,3058,2,7200,1.00196206671
590760,590771,593840,11,3069,2,7200,1.00358422939
590771,590779,593883,8,3104,2,7200,1.00257731959
590771,590784,593903,13,3119,2,7200,1.00416800256
590782,590790,593916,8,3126,2,7200,1.00255918106
590782,590796,593917,14,3121,2,7200,1.00448574175
590793,590803,593992,10,3189,2,7200,1.00313577924
590793,590808,593971,15,3163,2,7200,1.00474233323
590804,590820,593980,16,3160,2,7200,1.00506329114
590804,590815,593973,11,3158,2,7200,1.00348321723
590825,590831,593995,6,3164,2,7200,1.00189633375
590826,590837,593870,11,3033,2,7200,1.00362677217
590836,590844,593857,8,3013,2,7200,1.00265516097
590847,590853,593900,6,3047,2,7200,1.00196914998
590857,590864,593975,7,3111,2,7200,1.00225008036
590858,590869,593966,11,3097,2,7200,1.00355182435
590868,590876,593995,8,3119,2,7200,1.00256492466
590869,590881,594028,12,3147,2,7200,1.00381315539
590879,590887,594045,8,3158,2,7200,1.00253324889
590880,590893,594054,13,3161,2,7200,1.00411262259
590890,590904,594070,14,3166,2,7200,1.00442198358
590891,590910,594079,19,3169,2,7200,1.0059955822
590912,590918,594102,6,3184,2,7200,1.00188442211
590922,590930,594076,8,3146,2,7200,1.00254291163
590933,590939,594096,6,3157,2,7200,1.00190053849
590944,590950,594122,6,3172,2,7200,1.00189155107
590954,591621,594803,667,3182,2,7200,1.20961659334
591619,591656,594782,37,3126,2,7200,1.01183621241
591652,591663,591666,11,3,1,18000,1.4
591660,592232,595358,572,3126,2,7200,1.18298144594
591696,599456,605201,7760,5745,2,18000,2.35073977372
591889,592218,599438,329,7220,3,7200,1.04556786704
591909,595145,602376,3236,7231,3,7200,1.44751763242
592232,593592,596636,1360,3044,2,7200,1.44678055191
593590,593633,596730,43,3097,2,7200,1.01388440426
593631,593641,596715,10,3074,2,7200,1.00325309044
593642,593648,596734,6,3086,2,7200,1.00194426442
593652,593660,596736,8,3076,2,7200,1.00260078023
593663,593678,596791,15,3113,2,7200,1.00481850305
593674,593718,596842,44,3124,2,7200,1.01408450704
593715,593766,596251,51,2485,2,7200,1.02052313883
593767,593835,596928,68,3093,2,7200,1.02198512771
593838,593845,596976,7,3131,2,7200,1.00223570744
593849,593855,596947,6,3092,2,7200,1.00194049159
593860,593866,596948,6,3082,2,7200,1.0019467878
593870,593876,597002,6,3126,2,7200,1.0019193858
593881,593887,596986,6,3099,2,7200,1.00193610842
593892,593898,596992,6,3094,2,7200,1.00193923723
593902,593909,597047,7,3138,2,7200,1.0022307202
593913,593919,597011,6,3092,2,7200,1.00194049159
593913,593925,597027,12,3102,2,7200,1.00386847195
593924,593937,596641,13,2704,2,7200,1.00480769231
593924,593932,597037,8,3105,2,7200,1.00257648953
593935,593944,597051,9,3107,2,7200,1.00289668491
593945,593952,597081,7,3129,2,7200,1.00223713647
593956,593962,597098,6,3136,2,7200,1.00191326531
593967,593973,597075,6,3102,2,7200,1.00193423598
593978,593984,597143,6,3159,2,7200,1.00189933523
593988,593994,597117,6,3123,2,7200,1.00192122959
593999,594011,597108,12,3097,2,7200,1.00387471747
593999,594005,597113,6,3108,2,7200,1.00193050193
594010,594018,597161,8,3143,2,7200,1.00254533885
594021,594027,597173,6,3146,2,7200,1.00190718373
594031,594039,597165,8,3126,2,7200,1.00255918106
594042,594049,597133,7,3084,2,7200,1.00226977951
594053,594059,597143,6,3084,2,7200,1.00194552529
594064,594071,597168,7,3097,2,7200,1.00226025186
594074,594081,597205,7,3124,2,7200,1.00224071703
594085,594091,597253,6,3162,2,7200,1.00189753321
594096,594103,597286,7,3183,2,7200,1.00219918316
594106,594113,597278,7,3165,2,7200,1.00221169036
594117,594124,597255,7,3131,2,7200,1.00223570744
594128,594134,597232,6,3098,2,7200,1.00193673338
594138,594145,597308,7,3163,2,7200,1.00221308884
594149,594794,597973,645,3179,2,7200,1.20289399182
594793,594814,597999,21,3185,2,7200,1.00659340659
594813,595370,598555,557,3185,2,7200,1.1748822606
595219,798598,885025,203379,86427,2,86400,3.35318823979
595222,798603,885014,203381,86411,2,86400,3.35364710511
595365,596262,599433,897,3171,2,7200,1.28287606433
596260,596647,599827,387,3180,2,7200,1.12169811321
596648,596654,599821,6,3167,2,7200,1.00189453742
596659,596726,599895,67,3169,2,7200,1.02114231619
596731,596742,599903,11,3161,2,7200,1.00347991142
596741,596748,599921,7,3173,2,7200,1.00220611409
596752,596758,599935,6,3177,2,7200,1.00188857413
596763,596804,599971,41,3167,2,7200,1.01294600568
596804,596854,600024,50,3170,2,7200,1.01577287066
596855,596940,600116,85,3176,2,7200,1.02676322418
596937,596959,600115,22,3156,2,7200,1.00697084918
596958,596965,600139,7,3174,2,7200,1.00220541903
596969,596987,600149,18,3162,2,7200,1.00569259962
596990,596998,600167,8,3169,2,7200,1.00252445566
597000,597006,600178,6,3172,2,7200,1.00189155107
597011,597018,600175,7,3157,2,7200,1.0022172949
597021,597028,600210,7,3182,2,7200,1.00219987429
597032,597038,600195,6,3157,2,7200,1.00190053849
597043,597049,600004,6,2955,2,7200,1.00203045685
597053,597059,600230,6,3171,2,7200,1.00189214759
597064,597070,600224,6,3154,2,7200,1.00190234623
597075,597088,600225,13,3137,2,7200,1.00414408671
597085,597095,600248,10,3153,2,7200,1.00317158262
597096,597110,600255,14,3145,2,7200,1.00445151033
597107,597119,600293,12,3174,2,7200,1.00378071834
597117,597126,600310,9,3184,2,7200,1.00282663317
597128,597134,600298,6,3164,2,7200,1.00189633375
597139,597144,599111,5,1967,2,7200,1.00254194204
597149,597155,600336,6,3181,2,7200,1.00188619931
597160,597166,600331,6,3165,2,7200,1.0018957346
597170,597177,600235,7,3058,2,7200,1.00228907783
597181,597187,600360,6,3173,2,7200,1.00189095493
597192,597198,600050,6,2852,2,7200,1.00210378682
597202,597209,600357,7,3148,2,7200,1.00222363405
597213,597219,600381,6,3162,2,7200,1.00189753321
597224,597244,600398,20,3154,2,7200,1.00634115409
597244,597265,600408,21,3143,2,7200,1.00668151448
597265,597271,600463,6,3192,2,7200,1.00187969925
597276,597289,600541,13,3252,2,7200,1.00399753998
597287,597297,600491,10,3194,2,7200,1.00313087038
597297,597320,600518,23,3198,2,7200,1.007191995
597318,597986,601166,668,3180,2,7200,1.21006289308
597982,598012,601143,30,3131,2,7200,1.00958160332
598013,598566,601717,553,3151,2,7200,1.17549984132
598565,599123,602314,558,3191,2,7200,1.17486681291
599128,599445,602606,317,3161,2,7200,1.10028472003
599445,599451,602580,6,3129,2,7200,1.00191754554
599456,599833,602955,377,3122,2,7200,1.12075592569
599834,599841,603043,7,3202,2,7200,1.00218613367
599844,599907,603104,63,3197,2,7200,1.01970597435
599906,599915,603094,9,3179,2,7200,1.00283107896
599917,599933,603117,16,3184,2,7200,1.00502512563
599937,599948,603129,11,3181,2,7200,1.00345803207
599948,599984,603163,36,3179,2,7200,1.01132431582
599979,600015,603200,36,3185,2,7200,1.01130298273
600020,600035,603200,15,3165,2,7200,1.00473933649
600031,600061,603204,30,3143,2,7200,1.00954502068
600062,600127,603281,65,3154,2,7200,1.02060875079
600124,600133,602342,9,2209,2,7200,1.00407424174
600134,600151,603275,17,3124,2,7200,1.00544174136
600155,600162,602294,7,2132,2,7200,1.00328330206
600166,600179,603310,13,3131,2,7200,1.00415202811
600176,600186,601794,10,1608,2,7200,1.00621890547
600187,600193,603336,6,3143,2,7200,1.00190900414
600189,602388,609621,2199,7233,3,7200,1.30402322688
600198,600206,603339,8,3133,2,7200,1.00255346313
600208,600222,603355,14,3133,2,7200,1.00446856049
600219,600236,602531,17,2295,2,7200,1.00740740741
600240,600246,603382,6,3136,2,7200,1.00191326531
600250,600256,603386,6,3130,2,7200,1.00191693291
600261,600267,602229,6,1962,2,7200,1.00305810398
600272,600279,603477,7,3198,2,7200,1.00218886804
600282,600288,603453,6,3165,2,7200,1.0018957346
600293,600299,603426,6,3127,2,7200,1.00191877199
600303,600310,603481,7,3171,2,7200,1.00220750552
600314,600320,603448,6,3128,2,7200,1.00191815857
600325,600331,603503,6,3172,2,7200,1.00189155107
600335,600344,603478,9,3134,2,7200,1.00287172942
600346,600353,603473,7,3120,2,7200,1.00224358974
600357,600369,603504,12,3135,2,7200,1.0038277512
600367,600375,603532,8,3157,2,7200,1.00253405131
600378,600393,603571,15,3178,2,7200,1.00471994965
600389,600409,603605,20,3196,2,7200,1.00625782228
600409,600419,603562,10,3143,2,7200,1.00318167356
600420,600426,603583,6,3157,2,7200,1.00190053849
600431,600475,603630,44,3155,2,7200,1.01394611727
600472,600502,603640,30,3138,2,7200,1.00956022945
600503,600530,603444,27,2914,2,7200,1.00926561428
600534,600552,603683,18,3131,2,7200,1.00574896199
600555,601154,604265,599,3111,2,7200,1.19254259081
601158,601179,604346,21,3167,2,7200,1.00663088096
601179,601728,604905,549,3177,2,7200,1.17280453258
601731,601806,604923,75,3117,2,7200,1.02406159769
601803,602241,604540,438,2299,2,7200,1.19051761635
602243,602306,605481,63,3175,2,7200,1.01984251969
602305,602326,605488,21,3162,2,7200,1.00664136622
602326,602353,605529,27,3176,2,7200,1.00850125945
602357,602543,605710,186,3167,2,7200,1.05873065993
602541,602592,605734,51,3142,2,7200,1.01623169955
602593,602617,605757,24,3140,2,7200,1.0076433121
602614,602967,606119,353,3152,2,7200,1.11199238579
602971,603056,606134,85,3078,2,7200,1.02761533463
603056,603105,606280,49,3175,2,7200,1.01543307087
603108,603116,606275,8,3159,2,7200,1.00253244698
603118,603129,606247,11,3118,2,7200,1.0035279025
603129,603140,606327,11,3187,2,7200,1.00345152181
603140,603174,606338,34,3164,2,7200,1.01074589128
603171,603211,606377,40,3166,2,7200,1.01263423879
603212,603218,606364,6,3146,2,7200,1.00190718373
603223,603229,606360,6,3131,2,7200,1.00191632066
603234,603287,606455,53,3168,2,7200,1.01672979798
603285,603293,606464,8,3171,2,7200,1.00252286345
603296,603322,606496,26,3174,2,7200,1.0081915564
603327,603347,606512,20,3165,2,7200,1.00631911532
603348,603354,606478,6,3124,2,7200,1.0019206146
603358,603366,606479,8,3113,2,7200,1.00256986829
603369,603393,606552,24,3159,2,7200,1.00759734093
603390,603401,606550,11,3149,2,7200,1.00349317244
603401,603438,606089,37,2651,2,7200,1.01395699736
603442,603455,606613,13,3158,2,7200,1.00411652945
603452,603463,606618,11,3155,2,7200,1.00348652932
603463,603469,606610,6,3141,2,7200,1.00191021968
603474,603485,606595,11,3110,2,7200,1.00353697749
603485,603491,606656,6,3165,2,7200,1.0018957346
603495,603501,606653,6,3152,2,7200,1.0019035533
603506,603513,606664,7,3151,2,7200,1.00222151698
603516,603523,606683,7,3160,2,7200,1.00221518987
603527,603533,605450,6,1917,2,7200,1.00312989045
603538,603544,606679,6,3135,2,7200,1.0019138756
603548,603573,606701,25,3128,2,7200,1.00799232737
603569,603582,606687,13,3105,2,7200,1.00418679549
603580,603594,605801,14,2207,2,7200,1.00634345265
603591,603616,606779,25,3163,2,7200,1.00790388871
603622,603641,606249,19,2608,2,7200,1.00728527607
603642,603652,606780,10,3128,2,7200,1.00319693095
603653,603695,606846,42,3151,2,7200,1.01332910187
603694,604277,607428,583,3151,2,7200,1.18502062837
604276,604357,607491,81,3134,2,7200,1.02584556477
604358,604552,607650,194,3098,2,7200,1.06262104584
604553,604916,608017,363,3101,2,7200,1.11705901322
