SubmitTime,StartTime,EndTime,QueuedTime,RunTime,NodesRequested,walltime,bslowdown
61,68,3720,7,3652,2,7200,1.00191675794
82,88,3752,6,3664,2,7200,1.00163755459
97,103,4008,6,3905,2,7200,1.00153649168
139,145,3659,6,3514,2,7200,1.00170745589
254,261,3914,7,3653,2,7200,1.00191623323
314,320,4172,6,3852,2,7200,1.0015576324
634,641,4108,7,3467,2,7200,1.00201903663
655,662,4119,7,3457,2,7200,1.00202487706
710,717,4385,7,3668,2,7200,1.00190839695
788,795,4675,7,3880,2,7200,1.00180412371
1405,1412,5155,7,3743,2,7200,1.00187015763
1605,1612,5483,7,3871,2,7200,1.00180831826
1916,1923,5664,7,3741,2,7200,1.00187115744
2499,2506,6177,7,3671,2,7200,1.00190683737
2553,2561,6080,8,3519,2,7200,1.00227337312
2586,2593,6043,7,3450,2,7200,1.00202898551
2629,2636,6343,7,3707,2,7200,1.0018883194
2644,2651,6299,7,3648,2,7200,1.00191885965
2659,2665,6355,6,3690,2,7200,1.00162601626
2837,2844,6211,7,3367,2,7200,1.00207900208
2861,2868,6407,7,3539,2,7200,1.00197795988
2876,2883,6836,7,3953,2,7200,1.00177080698
2930,2936,6425,6,3489,2,7200,1.00171969046
2975,2981,6393,6,3412,2,7200,1.00175849941
3002,3009,6591,7,3582,2,7200,1.00195421552
3020,3026,6667,6,3641,2,7200,1.00164789893
3116,3123,6786,7,3663,2,7200,1.00191100191
3171,3178,6950,7,3772,2,7200,1.00185577943
3201,3208,7089,7,3881,2,7200,1.00180365885
3219,3225,6869,6,3644,2,7200,1.00164654226
3234,3240,6817,6,3577,2,7200,1.00167738328
3235,3247,6927,12,3680,2,7200,1.00326086957
3283,3290,6715,7,3425,2,7200,1.00204379562
3304,3310,6754,6,3444,2,7200,1.00174216028
3322,3328,6798,6,3470,2,7200,1.00172910663
3337,3343,6895,6,3552,2,7200,1.00168918919
3364,3370,7062,6,3692,2,7200,1.00162513543
3391,3397,7120,6,3723,2,7200,1.00161160355
3509,3516,7258,7,3742,2,7200,1.0018706574
3590,3596,7383,6,3787,2,7200,1.00158436757
3660,3667,7281,7,3614,2,7200,1.00193691201
3720,3727,7212,7,3485,2,7200,1.00200860832
3753,3760,7271,7,3511,2,7200,1.00199373398
3916,3923,7712,7,3789,2,7200,1.00184745315
4010,4016,7504,6,3488,2,7200,1.00172018349
4109,4116,7752,7,3636,2,7200,1.00192519252
4124,4131,8198,7,4067,2,7200,1.0017211704
4172,4179,7762,7,3583,2,7200,1.00195367011
4387,4393,7945,6,3552,2,7200,1.00168918919
4677,4683,8485,6,3802,2,7200,1.00157811678
5155,5162,9031,7,3869,2,7200,1.00180925304
5485,5491,9319,6,3828,2,7200,1.00156739812
5593,5600,5640,7,40,1,342000,1.175
5666,5672,9274,6,3602,2,7200,1.00166574125
5693,5701,5704,8,3,1,342000,1.1
5738,5744,145728,6,139984,1,342000,1.00004286204
6043,6050,9866,7,3816,2,7200,1.00183438155
6082,6088,9625,6,3537,2,7200,1.00169635284
6178,6185,10014,7,3829,2,7200,1.00182815356
6214,6220,9497,6,3277,2,7200,1.00183094294
6302,6309,9898,7,3589,2,7200,1.00195040401
6344,6350,9840,6,3490,2,7200,1.00171919771
6359,6365,10172,6,3807,2,7200,1.00157604413
6395,6402,9967,7,3565,2,7200,1.00196353436
6410,6416,10191,6,3775,2,7200,1.00158940397
6428,6434,10100,6,3666,2,7200,1.00163666121
6594,6601,10438,7,3837,2,7200,1.00182434193
6670,6677,10294,7,3617,2,7200,1.0019353055
6715,6721,10464,6,3743,2,7200,1.00160299225
6757,6764,10623,7,3859,2,7200,1.00181394144
6787,6794,10679,7,3885,2,7200,1.0018018018
6802,6808,10358,6,3550,2,7200,1.00169014085
6817,6823,10411,6,3588,2,7200,1.0016722408
6834,6841,10347,7,3506,2,7200,1.0019965773
6867,6874,10653,7,3779,2,7200,1.00185234189
6894,6902,10482,8,3580,2,7200,1.00223463687
6927,6933,10647,6,3714,2,7200,1.00161550889
6951,6959,10816,8,3857,2,7200,1.00207415089
7063,7071,10750,8,3679,2,7200,1.00217450394
7090,7096,10880,6,3784,2,7200,1.00158562368
7120,7127,11002,7,3875,2,7200,1.00180645161
7213,7219,10649,6,3430,2,7200,1.00174927114
7258,7264,10912,6,3648,2,7200,1.00164473684
7273,7280,11152,7,3872,2,7200,1.00180785124
7288,7294,11050,6,3756,2,7200,1.00159744409
7384,7390,11232,6,3842,2,7200,1.00156168662
7505,7512,11327,7,3815,2,7200,1.00183486239
7714,7721,11240,7,3519,2,7200,1.00198920148
7753,7760,11310,7,3550,2,7200,1.00197183099
7768,7776,11437,8,3661,2,7200,1.0021851953
7946,7953,11714,7,3761,2,7200,1.00186120713
8201,8207,11760,6,3553,2,7200,1.00168871376
8316,8322,8324,6,2,2,3540,1.0
8485,8491,11952,6,3461,2,7200,1.001733603
9033,9040,12795,7,3755,2,7200,1.00186418109
9282,9289,12664,7,3375,2,7200,1.00207407407
9321,9328,13145,7,3817,2,7200,1.00183390097
9414,9421,9607,7,186,1,3600,1.0376344086
9499,9506,13161,7,3655,2,7200,1.00191518468
9626,9633,13183,7,3550,2,7200,1.00197183099
9798,9805,10173,7,368,1,3600,1.01902173913
9841,9848,13653,7,3805,2,7200,1.00183968463
9868,9875,13556,7,3681,2,7200,1.00190165716
9898,9905,14041,7,4136,2,7200,1.00169245648
9967,9973,13492,6,3519,2,7200,1.00170502984
10015,10022,13634,7,3612,2,7200,1.0019379845
10100,10106,13632,6,3526,2,7200,1.00170164492
10166,10173,13664,7,3491,2,7200,1.00200515612
10193,10200,13799,7,3599,2,7200,1.00194498472
10295,10303,14059,8,3756,2,7200,1.00212992545
10350,10356,14021,6,3665,2,7200,1.00163710778
10365,10372,14108,7,3736,2,7200,1.00187366167
10413,10419,14240,6,3821,2,7200,1.00157026956
10440,10447,14215,7,3768,2,7200,1.00185774947
10464,10471,14308,7,3837,2,7200,1.00182434193
10482,10488,14433,6,3945,2,7200,1.00152091255
10543,10550,11454,7,904,1,3600,1.00774336283
10624,10630,14245,6,3615,2,7200,1.00165975104
10648,10654,14317,6,3663,2,7200,1.00163800164
10663,10669,14408,6,3739,2,7200,1.00160470714
10664,10675,14357,11,3682,2,7200,1.00298750679
10679,10686,14443,7,3757,2,7200,1.00186318871
10752,10758,14510,6,3752,2,7200,1.00159914712
10819,10825,14526,6,3701,2,7200,1.00162118346
10882,10890,14519,8,3629,2,7200,1.00220446404
10912,10920,14246,8,3326,2,7200,1.00240529164
11003,11010,14402,7,3392,2,7200,1.00206367925
11051,11057,14608,6,3551,2,7200,1.00168966488
11151,11158,14593,7,3435,2,7200,1.00203784571
11233,11239,15169,6,3930,2,7200,1.00152671756
11248,11254,14880,6,3626,2,7200,1.00165471594
11311,11318,15022,7,3704,2,7200,1.00188984881
11329,11335,14835,6,3500,2,7200,1.00171428571
11438,11445,15296,7,3851,2,7200,1.00181770969
11715,11722,15572,7,3850,2,7200,1.00181818182
11761,11767,15282,6,3515,2,7200,1.00170697013
11952,11959,15683,7,3724,2,7200,1.00187969925
12669,12675,16435,6,3760,2,7200,1.00159574468
12795,12802,16501,7,3699,2,7200,1.00189240335
12822,12828,12981,6,153,1,3600,1.03921568627
12962,12969,13154,7,185,1,3600,1.03783783784
13075,13082,13092,7,10,1,900,1.7
13105,13111,14323,6,1212,14,1560,1.00495049505
13154,13164,16933,10,3769,2,7200,1.00265322367
13169,13175,16974,6,3799,2,7200,1.00157936299
13178,13196,13516,18,320,1,3600,1.05625
13184,13190,16895,6,3705,2,7200,1.0016194332
13331,13337,13685,6,348,1,3600,1.01724137931
13495,13502,16890,7,3388,2,7200,1.0020661157
13559,13565,17272,6,3707,2,7200,1.00161855948
13631,13639,17049,8,3410,2,7200,1.00234604106
13646,13653,17351,7,3698,2,7200,1.00189291509
13661,13667,17367,6,3700,2,7200,1.00162162162
13676,13682,17460,6,3778,2,7200,1.00158814187
13800,13807,17484,7,3677,2,7200,1.00190372586
13994,14001,14645,7,644,1,3600,1.01086956522
14021,14028,17496,7,3468,2,7200,1.00201845444
14042,14048,17507,6,3459,2,7200,1.00173460538
14052,14058,14902,6,844,1,3600,1.00710900474
14060,14067,17400,7,3333,2,7200,1.00210021002
14108,14114,17890,6,3776,2,7200,1.00158898305
14217,14224,18194,7,3970,2,7200,1.00176322418
14241,14247,17951,6,3704,2,7200,1.00161987041
14256,14262,17826,6,3564,2,7200,1.00168350168
14257,14269,17747,12,3478,2,7200,1.00345025877
14309,14316,18000,7,3684,2,7200,1.00190010858
14321,14329,14371,8,42,1,900,1.19047619048
14324,14335,17940,11,3605,2,7200,1.00305131761
14360,14366,17891,6,3525,2,7200,1.00170212766
14360,14382,15333,22,951,14,1560,1.02313354364
14404,14410,18093,6,3683,2,7200,1.00162910671
14419,14425,18129,6,3704,2,7200,1.00161987041
14433,14440,17985,7,3545,2,7200,1.00197461213
14448,14455,18250,7,3795,2,7200,1.00184453228
14450,15345,45726,895,30381,12,43200,1.02945920147
14512,14519,18274,7,3755,2,7200,1.00186418109
14527,14533,17791,6,3258,2,7200,1.00184162063
14528,14540,18255,12,3715,2,7200,1.00323014805
14595,14602,18058,7,3456,2,7200,1.00202546296
14610,14616,18374,6,3758,2,7200,1.00159659393
14835,14841,18469,6,3628,2,7200,1.00165380375
14881,14888,18450,7,3562,2,7200,1.0019651881
15024,15031,18871,7,3840,2,7200,1.00182291667
15169,15176,18807,7,3631,2,7200,1.00192784357
15281,15287,19369,6,4082,2,7200,1.00146986771
15299,15306,18764,7,3458,2,7200,1.0020242915
15331,15337,15343,6,6,1,900,1.2
15348,45767,46980,30419,1213,14,1560,26.077493817
15577,15583,19140,6,3557,2,7200,1.00168681473
15685,15691,19206,6,3515,2,7200,1.00170697013
16242,16249,16368,7,119,1,3600,1.05882352941
16437,16444,19934,7,3490,2,7200,1.00200573066
16504,16511,19912,7,3401,2,7200,1.00205821817
16550,16556,16892,6,336,1,3600,1.01785714286
16694,16701,16817,7,116,1,1800,1.06034482759
16891,16898,20505,7,3607,2,7200,1.00194067092
16906,16913,20786,7,3873,2,7200,1.00180738446
16933,16940,20669,7,3729,2,7200,1.00187717887
16976,16982,20778,6,3796,2,7200,1.00158061117
17051,17058,20829,7,3771,2,7200,1.00185627155
17129,17136,17257,7,121,1,1800,1.05785123967
17276,17283,20908,7,3625,2,7200,1.00193103448
17352,17358,20768,6,3410,2,7200,1.00175953079
17367,17374,20998,7,3624,2,7200,1.00193156733
17396,17402,18064,6,662,1,3600,1.00906344411
17400,17409,21108,9,3699,2,7200,1.00243309002
17463,17469,20983,6,3514,2,7200,1.00170745589
17484,17490,21008,6,3518,2,7200,1.0017055145
17499,17505,21253,6,3748,2,7200,1.00160085379
17514,17520,21066,6,3546,2,7200,1.00169204738
17747,17753,21475,6,3722,2,7200,1.00161203654
17792,17799,21558,7,3759,2,7200,1.00186219739
17828,17836,21715,8,3879,2,7200,1.00206238721
17893,17899,21516,6,3617,2,7200,1.00165883329
17894,17906,21587,12,3681,2,7200,1.0032599837
17942,17948,21412,6,3464,2,7200,1.00173210162
17946,17955,18553,9,598,1,1800,1.01505016722
17957,17964,21684,7,3720,2,7200,1.00188172043
17987,17994,21873,7,3879,2,7200,1.00180458881
18004,18010,21742,6,3732,2,7200,1.00160771704
18058,18064,21844,6,3780,2,7200,1.00158730159
18091,18097,21796,6,3699,2,7200,1.00162206002
18130,18138,22002,8,3864,2,7200,1.00207039337
18165,18743,74739,578,55996,6,432000,1.01032216587
18194,18201,21789,7,3588,2,7200,1.0019509476
18251,18258,22179,7,3921,2,7200,1.00178525886
18266,18272,22178,6,3906,2,7200,1.00153609831
18281,18289,22221,8,3932,2,7200,1.002034588
18375,18381,21999,6,3618,2,7200,1.00165837479
18451,18457,22156,6,3699,2,7200,1.00162206002
18469,18476,22141,7,3665,2,7200,1.00190995907
18768,18775,22347,7,3572,2,7200,1.00195968645
18810,18816,22464,6,3648,2,7200,1.00164473684
18874,18880,22526,6,3646,2,7200,1.00164563906
19140,19147,22971,7,3824,2,7200,1.00183054393
19207,19213,22858,6,3645,2,7200,1.00164609053
19370,19378,23063,8,3685,2,7200,1.00217096336
19916,19923,23652,7,3729,2,7200,1.00187717887
19931,19938,23304,7,3366,2,7200,1.00207961973
20320,20326,20445,6,119,1,1800,1.05042016807
20448,20455,20503,7,48,1,1800,1.14583333333
20507,20514,24350,7,3836,2,7200,1.00182481752
20667,20673,20737,6,64,10,432000,1.09375
20670,20680,24406,10,3726,2,7200,1.00268384326
20767,20773,24526,6,3753,2,7200,1.00159872102
20782,20788,24573,6,3785,2,7200,1.00158520476
20793,20799,20937,6,138,1,1800,1.04347826087
20797,20806,24246,9,3440,2,7200,1.00261627907
20823,20830,20935,7,105,1,1800,1.06666666667
20830,20837,25002,7,4165,2,7200,1.00168067227
20909,20915,24685,6,3770,2,7200,1.00159151194
20986,20992,24646,6,3654,2,7200,1.00164203612
21001,21008,24382,7,3374,2,7200,1.0020746888
21016,21022,24728,6,3706,2,7200,1.00161899622
21067,21074,24534,7,3460,2,7200,1.00202312139
21110,21116,24873,6,3757,2,7200,1.0015970189
21252,21259,24642,7,3383,2,7200,1.00206916938
21394,25020,441765,3626,416745,10,432000,1.00870076426
21412,21419,24886,7,3467,2,7200,1.00201903663
21478,21485,25390,7,3905,2,7200,1.00179257362
21518,21525,25007,7,3482,2,7200,1.00201033889
21560,21567,24986,7,3419,2,7200,1.00204738228
21587,21593,24971,6,3378,2,7200,1.00177619893
21680,21688,22201,8,513,1,1800,1.01559454191
21684,21694,25354,10,3660,2,7200,1.00273224044
21717,21724,25108,7,3384,2,7200,1.00206855792
21744,21751,25073,7,3322,2,7200,1.00210716436
21790,21796,25902,6,4106,2,7200,1.00146127618
21805,21812,25026,7,3214,2,7200,1.00217797138
21847,21853,25466,6,3613,2,7200,1.0016606698
21874,21880,25493,6,3613,2,7200,1.0016606698
21916,21922,22216,6,294,1,1800,1.02040816327
22001,22008,25724,7,3716,2,7200,1.00188374596
22015,22023,25520,8,3497,2,7200,1.00228767515
22140,22147,25697,7,3550,2,7200,1.00197183099
22157,22164,25977,7,3813,2,7200,1.00183582481
22179,22185,25740,6,3555,2,7200,1.00168776371
22180,22192,25656,12,3464,2,7200,1.00346420323
22226,22232,25707,6,3475,2,7200,1.00172661871
22350,22356,26137,6,3781,2,7200,1.00158688178
22459,22466,25901,7,3435,2,7200,1.00203784571
22527,22533,26096,6,3563,2,7200,1.00168397418
22860,22866,26489,6,3623,2,7200,1.00165608612
22972,22978,26806,6,3828,2,7200,1.00156739812
23062,23069,26714,7,3645,2,7200,1.00192043896
23304,23310,27022,6,3712,2,7200,1.00161637931
23652,23660,27099,8,3439,2,7200,1.00232625763
24141,24148,24219,7,71,1,1800,1.0985915493
24249,24255,28055,6,3800,2,7200,1.00157894737
24352,24359,28222,7,3863,2,7200,1.00181206316
24385,24391,28110,6,3719,2,7200,1.00161333692
24406,24412,28097,6,3685,2,7200,1.00162822252
24527,24534,28100,7,3566,2,7200,1.00196298374
24542,24549,28743,7,4194,2,7200,1.00166905103
24573,24580,24671,7,91,1,1800,1.07692307692
24575,24587,28189,12,3602,2,7200,1.00333148251
24644,24650,28420,6,3770,2,7200,1.00159151194
24659,24666,28819,7,4153,2,7200,1.00168552853
24687,24693,28189,6,3496,2,7200,1.00171624714
24729,24736,28300,7,3564,2,7200,1.0019640853
24874,24881,28797,7,3916,2,7200,1.0017875383
24889,24895,28455,6,3560,2,7200,1.00168539326
24974,24980,28917,6,3937,2,7200,1.00152400305
24989,24995,28818,6,3823,2,7200,1.00156944808
25004,25010,28514,6,3504,2,7200,1.00171232877
25019,25026,28827,7,3801,2,7200,1.00184162063
25034,25041,28494,7,3453,2,7200,1.0020272227
25076,25083,28690,7,3607,2,7200,1.00194067092
25109,25116,28721,7,3605,2,7200,1.00194174757
25355,25363,28981,8,3618,2,7200,1.00221116639
25392,25399,28858,7,3459,2,7200,1.00202370627
25467,25473,29237,6,3764,2,7200,1.00159404888
25495,25501,29402,6,3901,2,7200,1.00153806716
25522,25528,29300,6,3772,2,7200,1.00159066808
25657,25664,29747,7,4083,2,7200,1.00171442567
25685,25692,26031,7,339,1,1800,1.02064896755
25700,25706,29114,6,3408,2,7200,1.00176056338
25715,25722,29489,7,3767,2,7200,1.00185824263
25730,25736,29375,6,3639,2,7200,1.00164880462
25745,25751,29477,6,3726,2,7200,1.00161030596
25899,25905,29657,6,3752,2,7200,1.00159914712
25914,25921,29214,7,3293,2,7200,1.00212572123
25978,25985,29952,7,3967,2,7200,1.0017645576
26096,26103,29845,7,3742,2,7200,1.0018706574
26138,26145,29965,7,3820,2,7200,1.00183246073
26491,26498,30324,7,3826,2,7200,1.00182958704
26716,26723,30479,7,3756,2,7200,1.00186368477
26806,26813,30247,7,3434,2,7200,1.00203843914
27022,27029,30449,7,3420,2,7200,1.00204678363
27100,27107,30798,7,3691,2,7200,1.00189650501
28058,28065,31606,7,3541,2,7200,1.0019768427
28097,28104,31771,7,3667,2,7200,1.00190891737
28112,28119,32028,7,3909,2,7200,1.00179073932
28113,28126,31658,13,3532,2,7200,1.0036806342
28189,28196,31838,7,3642,2,7200,1.00192202087
28190,28203,32038,13,3835,2,7200,1.00338983051
28223,28230,32032,7,3802,2,7200,1.00184113624
28302,28309,31996,7,3687,2,7200,1.00189856252
28420,28427,31952,7,3525,2,7200,1.0019858156
28456,28462,32009,6,3547,2,7200,1.00169157034
28495,28501,32213,6,3712,2,7200,1.00161637931
28516,28523,32403,7,3880,2,7200,1.00180412371
28691,28698,32321,7,3623,2,7200,1.00193210047
28721,28728,32280,7,3552,2,7200,1.00197072072
28745,28751,32745,6,3994,2,7200,1.00150225338
28797,28804,32326,7,3522,2,7200,1.0019875071
28815,28822,32613,7,3791,2,7200,1.0018464785
28830,28836,32280,6,3444,2,7200,1.00174216028
28831,28842,32646,11,3804,2,7200,1.00289169295
28859,28866,32123,7,3257,2,7200,1.00214921707
28919,28926,32581,7,3655,2,7200,1.00191518468
28983,28990,32658,7,3668,2,7200,1.00190839695
29116,29122,32729,6,3607,2,7200,1.00166343222
29225,29231,32943,6,3712,2,7200,1.00161637931
29240,29246,33049,6,3803,2,7200,1.00157770181
29301,29307,32847,6,3540,2,7200,1.00169491525
29376,29383,32850,7,3467,2,7200,1.00201903663
29403,29411,33229,8,3818,2,7200,1.00209533787
29479,29486,33591,7,4105,2,7200,1.00170523752
29494,29500,33130,6,3630,2,7200,1.00165289256
29658,29664,33073,6,3409,2,7200,1.00176004693
29748,29756,33634,8,3878,2,7200,1.00206291903
29845,29852,33400,7,3548,2,7200,1.0019729425
29951,29958,33466,7,3508,2,7200,1.001995439
29966,29972,33790,6,3818,2,7200,1.0015715034
30248,30254,33877,6,3623,2,7200,1.00165608612
30324,30330,33988,6,3658,2,7200,1.00164024057
30451,30457,34122,6,3665,2,7200,1.00163710778
30481,30487,34156,6,3669,2,7200,1.00163532298
30799,30806,34524,7,3718,2,7200,1.00188273265
31608,31615,35062,7,3447,2,7200,1.00203075138
31659,31665,35256,6,3591,2,7200,1.00167084378
31771,31777,35571,6,3794,2,7200,1.00158144439
31840,31848,35457,8,3609,2,7200,1.00221668052
31952,31959,35638,7,3679,2,7200,1.00190269095
31998,32004,35901,6,3897,2,7200,1.00153964588
32013,32019,36023,6,4004,2,7200,1.0014985015
32031,32037,36016,6,3979,2,7200,1.00150791656
32046,32052,35829,6,3777,2,7200,1.00158856235
32047,32059,35875,12,3816,2,7200,1.00314465409
32123,32130,35868,7,3738,2,7200,1.00187265918
32214,32221,35834,7,3613,2,7200,1.0019374481
32277,32284,36010,7,3726,2,7200,1.00187869028
32292,32298,36033,6,3735,2,7200,1.0016064257
32322,32328,35954,6,3626,2,7200,1.00165471594
32337,32343,36172,6,3829,2,7200,1.00156698877
32404,32410,36112,6,3702,2,7200,1.00162074554
32582,32589,36241,7,3652,2,7200,1.00191675794
32615,32621,36062,6,3441,2,7200,1.00174367916
32648,32655,36052,7,3397,2,7200,1.00206064174
32663,32670,36386,7,3716,2,7200,1.00188374596
32730,32736,36262,6,3526,2,7200,1.00170164492
32745,32751,36311,6,3560,2,7200,1.00168539326
32847,32854,36546,7,3692,2,7200,1.00189599133
32862,32868,36504,6,3636,2,7200,1.00165016502
32944,32951,36463,7,3512,2,7200,1.00199316629
33050,33057,36710,7,3653,2,7200,1.00191623323
33074,33082,36669,8,3587,2,7200,1.002230276
33132,33139,36742,7,3603,2,7200,1.00194282542
33229,33236,36799,7,3563,2,7200,1.00196463654
33401,33408,37268,7,3860,2,7200,1.0018134715
33467,33474,36979,7,3505,2,7200,1.00199714693
33591,33597,37288,6,3691,2,7200,1.00162557572
33636,33644,37249,8,3605,2,7200,1.00221914008
33791,33798,37119,7,3321,2,7200,1.00210779886
33879,33885,37673,6,3788,2,7200,1.00158394931
33988,33994,37958,6,3964,2,7200,1.0015136226
34124,34130,37649,6,3519,2,7200,1.00170502984
34157,34164,38044,7,3880,2,7200,1.00180412371
34524,34531,37998,7,3467,2,7200,1.00201903663
35064,35071,38819,7,3748,2,7200,1.00186766275
35255,35262,39239,7,3977,2,7200,1.00176012069
35458,35465,39116,7,3651,2,7200,1.00191728294
35573,35580,39133,7,3553,2,7200,1.00197016606
35637,35643,39310,6,3667,2,7200,1.00163621489
35830,35837,39242,7,3405,2,7200,1.00205580029
35845,35851,39579,6,3728,2,7200,1.00160944206
35869,35876,39434,7,3558,2,7200,1.00196739741
35884,35891,39454,7,3563,2,7200,1.00196463654
35902,35909,39487,7,3578,2,7200,1.00195640022
35956,35962,39573,6,3611,2,7200,1.00166158959
36011,36018,39408,7,3390,2,7200,1.00206489676
36026,36032,39783,6,3751,2,7200,1.00159957345
36027,36039,39803,12,3764,2,7200,1.00318809777
36042,36049,39723,7,3674,2,7200,1.00190528035
36057,36063,39490,6,3427,2,7200,1.00175080245
36072,36078,39695,6,3617,2,7200,1.00165883329
36114,36121,39969,7,3848,2,7200,1.00181912682
36172,36178,39928,6,3750,2,7200,1.0016
36241,36248,39996,7,3748,2,7200,1.00186766275
36262,36268,39997,6,3729,2,7200,1.00160901046
36314,36321,40086,7,3765,2,7200,1.00185922975
36389,36397,39685,8,3288,2,7200,1.00243309002
36465,36472,39935,7,3463,2,7200,1.00202136876
36504,36511,40111,7,3600,2,7200,1.00194444444
36547,36553,40402,6,3849,2,7200,1.00155884645
36671,36678,40045,7,3367,2,7200,1.00207900208
36710,36718,40160,8,3442,2,7200,1.0023242301
36744,36751,40261,7,3510,2,7200,1.00199430199
36801,36807,40333,6,3526,2,7200,1.00170164492
36980,36987,40474,7,3487,2,7200,1.00200745627
37119,37125,40772,6,3647,2,7200,1.00164518783
37249,37257,41180,8,3923,2,7200,1.00203925567
37270,37276,40747,6,3471,2,7200,1.00172860847
37288,37294,41059,6,3765,2,7200,1.0015936255
37652,37659,41394,7,3735,2,7200,1.00187416332
37673,37680,41527,7,3847,2,7200,1.00181959969
37958,37965,41471,7,3506,2,7200,1.0019965773
37997,38004,41807,7,3803,2,7200,1.00184065212
38045,38052,41558,7,3506,2,7200,1.0019965773
38820,38827,42499,7,3672,2,7200,1.00190631808
39117,39124,42739,7,3615,2,7200,1.00193637621
39132,39138,42701,6,3563,2,7200,1.00168397418
39241,39248,42881,7,3633,2,7200,1.00192678227
39256,39263,43229,7,3966,2,7200,1.00176500252
39310,39316,43038,6,3722,2,7200,1.00161203654
39410,39416,43117,6,3701,2,7200,1.00162118346
39434,39441,43239,7,3798,2,7200,1.0018430753
39455,39461,43108,6,3647,2,7200,1.00164518783
39488,39495,43320,7,3825,2,7200,1.00183006536
39503,39509,43415,6,3906,2,7200,1.00153609831
39575,39581,43016,6,3435,2,7200,1.00174672489
39590,39597,43394,7,3797,2,7200,1.00184356071
39687,39694,43341,7,3647,2,7200,1.0019193858
39702,39707,43383,5,3676,2,7200,1.0013601741
39723,39729,43350,6,3621,2,7200,1.00165700083
39783,39789,43520,6,3731,2,7200,1.00160814795
39804,39811,43572,7,3761,2,7200,1.00186120713
39928,39935,43497,7,3562,2,7200,1.0019651881
39943,39950,43678,7,3728,2,7200,1.0018776824
39970,39976,43721,6,3745,2,7200,1.00160213618
39997,40004,43558,7,3554,2,7200,1.00196961171
39999,40011,43660,12,3649,2,7200,1.00328857221
40047,40054,43746,7,3692,2,7200,1.00189599133
40086,40094,43628,8,3534,2,7200,1.00226372383
40111,40117,43646,6,3529,2,7200,1.00170019836
40162,40169,43883,7,3714,2,7200,1.00188476037
40262,40268,44139,6,3871,2,7200,1.00154998708
40334,40340,43927,6,3587,2,7200,1.001672707
40404,40410,44171,6,3761,2,7200,1.00159532039
40476,40483,44271,7,3788,2,7200,1.00184794087
40510,41343,118511,833,77168,16,324000,1.0107946299
40748,40755,44315,7,3560,2,7200,1.00196629213
40772,40778,44393,6,3615,2,7200,1.00165975104
41060,41067,44611,7,3544,2,7200,1.0019751693
41180,41188,44753,8,3565,2,7200,1.00224403927
41396,41403,45145,7,3742,2,7200,1.0018706574
41472,41479,45180,7,3701,2,7200,1.00189138071
41529,41536,45161,7,3625,2,7200,1.00193103448
41559,41565,45038,6,3473,2,7200,1.00172761301
41810,41817,45368,7,3551,2,7200,1.0019712757
42172,42178,60200,6,18022,2,18000,1.00033292642
42500,42507,45990,7,3483,2,7200,1.0020097617
42696,42703,46192,7,3489,2,7200,1.00200630553
42741,42747,46189,6,3442,2,7200,1.00174317257
42883,42890,46541,7,3651,2,7200,1.00191728294
43016,43024,46926,8,3902,2,7200,1.00205023065
43040,43047,46760,7,3713,2,7200,1.00188526798
43110,43116,46968,6,3852,2,7200,1.0015576324
43124,43132,46917,8,3785,2,7200,1.00211360634
43232,43238,46706,6,3468,2,7200,1.00173010381
43246,43254,46795,8,3541,2,7200,1.0022592488
43319,43325,47032,6,3707,2,7200,1.00161855948
43340,43346,46838,6,3492,2,7200,1.00171821306
43355,43362,47155,7,3793,2,7200,1.00184550488
43385,43392,47002,7,3610,2,7200,1.00193905817
43400,43407,47205,7,3798,2,7200,1.0018430753
43418,43424,47141,6,3717,2,7200,1.001614205
43500,43506,47414,6,3908,2,7200,1.00153531218
43521,43528,47420,7,3892,2,7200,1.00179856115
43560,43566,47133,6,3567,2,7200,1.00168208579
43575,43581,46982,6,3401,2,7200,1.001764187
43629,43636,47242,7,3606,2,7200,1.0019412091
43648,43654,47581,6,3927,2,7200,1.00152788388
43662,43669,47454,7,3785,2,7200,1.00184940555
43677,43684,47344,7,3660,2,7200,1.00191256831
43720,43726,47817,6,4091,2,18000,1.00146663407
43723,43734,47565,11,3831,2,7200,1.00287131297
43747,43753,47440,6,3687,2,7200,1.0016273393
43883,43890,47686,7,3796,2,7200,1.00184404636
43928,43934,47473,6,3539,2,7200,1.00169539418
44140,44147,47806,7,3659,2,7200,1.00191309101
44173,44179,47609,6,3430,2,7200,1.00174927114
44273,44280,48017,7,3737,2,7200,1.00187316029
44315,44321,47900,6,3579,2,7200,1.00167644593
44394,44400,47980,6,3580,2,7200,1.00167597765
44611,44619,48187,8,3568,2,7200,1.00224215247
44754,44760,48566,6,3806,2,7200,1.00157645822
45038,45045,48733,7,3688,2,7200,1.00189804772
45147,45154,49159,7,4005,2,7200,1.00174781523
45162,45168,49047,6,3879,2,7200,1.00154679041
45180,45186,48570,6,3384,2,7200,1.00177304965
45371,45378,48941,7,3563,2,7200,1.00196463654
45989,45995,50154,6,4159,2,7200,1.00144265448
46190,46197,49961,7,3764,2,7200,1.0018597237
46204,46211,49776,7,3565,2,7200,1.00196353436
46541,46547,50270,6,3723,2,7200,1.00161160355
46708,46715,50349,7,3634,2,7200,1.00192625206
46762,46768,50501,6,3733,2,7200,1.00160728636
46798,46804,50386,6,3582,2,7200,1.00167504188
46837,46844,50552,7,3708,2,7200,1.00188781014
46919,46926,50844,7,3918,2,7200,1.00178662583
46934,46940,50597,6,3657,2,7200,1.00164068909
46971,46977,50708,6,3731,2,7200,1.00160814795
46976,46983,47006,7,23,1,900,1.30434782609
46986,46992,50713,6,3721,2,7200,1.00161246977
47000,47007,50773,7,3766,2,7200,1.00185873606
47009,47015,48032,6,1017,14,1560,1.00589970501
47034,47041,50594,7,3553,2,7200,1.00197016606
47134,47141,50981,7,3840,2,7200,1.00182291667
47149,47156,51017,7,3861,2,7200,1.00181300181
47163,47170,50476,7,3306,2,7200,1.00211736237
47206,47213,51016,7,3803,2,7200,1.00184065212
47245,47252,50730,7,3478,2,7200,1.00201265095
47345,47351,50952,6,3601,2,7200,1.00166620383
47415,47422,51176,7,3754,2,7200,1.00186467768
47430,47436,51111,6,3675,2,7200,1.00163265306
47444,47452,51320,8,3868,2,7200,1.00206825233
47459,47466,50924,7,3458,2,7200,1.0020242915
47474,47481,51215,7,3734,2,7200,1.00187466524
47565,47572,51544,7,3972,2,7200,1.00176233635
47583,47589,51362,6,3773,2,7200,1.00159024649
47610,47617,51332,7,3715,2,7200,1.00188425303
47686,47692,51059,6,3367,2,7200,1.00178200178
47807,47814,51467,7,3653,2,7200,1.00191623323
47901,47908,51516,7,3608,2,7200,1.00194013304
47983,47990,51880,7,3890,2,7200,1.00179948586
48019,48026,51882,7,3856,2,7200,1.0018153527
48030,48037,48042,7,5,1,900,1.2
48044,48050,49066,6,1016,14,1560,1.00590551181
48188,48195,51946,7,3751,2,7200,1.00186616902
48569,48576,52211,7,3635,2,7200,1.00192572215
48583,48590,52110,7,3520,2,7200,1.00198863636
48644,48650,53136,6,4486,2,18000,1.00133749443
48735,48741,52271,6,3530,2,7200,1.00169971671
48943,48949,52852,6,3903,2,7200,1.00153727902
49046,49053,52569,7,3516,2,7200,1.00199089875
49059,49066,49097,7,31,1,900,1.22580645161
49077,49084,50212,7,1128,14,1560,1.00620567376
49160,49166,52834,6,3668,2,7200,1.00163576881
49777,49783,53408,6,3625,2,7200,1.00165517241
49959,49965,53756,6,3791,2,7200,1.00158269586
50033,50039,61649,6,11610,2,18000,1.00051679587
50155,50161,54018,6,3857,2,7200,1.00155561317
50202,50209,50249,7,40,1,900,1.175
50225,50232,51414,7,1182,14,1560,1.00592216582
50270,50277,54035,7,3758,2,7200,1.00186269292
50349,50356,53905,7,3549,2,7200,1.00197238659
50388,50395,53976,7,3581,2,7200,1.00195476124
50476,50482,53903,6,3421,2,7200,1.00175387314
50503,50509,54063,6,3554,2,7200,1.0016882386
50554,50561,54477,7,3916,2,7200,1.0017875383
50597,50604,54387,7,3783,2,7200,1.00185038329
50598,50611,54132,13,3521,2,7200,1.00369213292
50710,50717,54116,7,3399,2,7200,1.00205942924
50725,50731,53994,6,3263,2,7200,1.00183879865
50740,50746,54167,6,3421,2,7200,1.00175387314
50773,50779,54341,6,3562,2,7200,1.00168444694
50845,50852,54553,7,3701,2,7200,1.00189138071
50924,50930,54480,6,3550,2,7200,1.00169014085
50951,50957,54536,6,3579,2,7200,1.00167644593
50981,50988,54817,7,3829,2,7200,1.00182815356
51018,51024,54580,6,3556,2,7200,1.00168728909
51019,51031,54461,12,3430,2,7200,1.00349854227
51061,51067,54477,6,3410,2,7200,1.00175953079
51113,51119,54647,6,3528,2,7200,1.00170068027
51176,51183,54802,7,3619,2,7200,1.00193423598
51215,51221,54703,6,3482,2,7200,1.00172314762
51322,51329,55113,7,3784,2,7200,1.00184989429
51337,51343,54750,6,3407,2,7200,1.00176108013
51361,51368,55404,7,4036,2,7200,1.00173439049
51412,51419,51427,7,8,1,900,1.5
51430,51437,52735,7,1298,14,1560,1.00539291217
51467,51473,55067,6,3594,2,7200,1.00166944908
51515,51522,55214,7,3692,2,7200,1.00189599133
51545,51551,55154,6,3603,2,7200,1.00166527893
51666,51673,69679,7,18006,2,18000,1.0003887593
51880,51887,55686,7,3799,2,7200,1.00184259016
51882,51894,55758,12,3864,2,7200,1.00310559006
51945,51951,55633,6,3682,2,7200,1.00162954916
52112,52119,55815,7,3696,2,7200,1.00189393939
52215,52222,56137,7,3915,2,7200,1.00178799489
52272,52278,55738,6,3460,2,7200,1.00173410405
52570,52576,56418,6,3842,2,7200,1.00156168662
52732,52738,52747,6,9,1,900,1.5
52748,52755,54046,7,1291,14,1560,1.00542215337
52833,52839,56175,6,3336,2,7200,1.00179856115
52854,52862,56708,8,3846,2,7200,1.0020800832
53410,53417,57138,7,3721,2,7200,1.00188121473
53757,53764,57341,7,3577,2,7200,1.00195694716
53906,53913,57445,7,3532,2,7200,1.00198187995
53907,53920,57746,13,3826,2,7200,1.0033978045
53977,53983,57846,6,3863,2,7200,1.001553197
53995,54002,57812,7,3810,2,7200,1.00183727034
54019,54025,57486,6,3461,2,7200,1.001733603
54037,54044,57342,7,3298,2,7200,1.00212249848
54044,54051,54060,7,9,1,900,1.6
54054,54060,54421,6,361,14,1560,1.01662049861
54065,54071,57597,6,3526,2,7200,1.00170164492
54116,54123,57875,7,3752,2,7200,1.00186567164
54134,54141,57794,7,3653,2,7200,1.00191623323
54168,54174,57749,6,3575,2,7200,1.00167832168
54343,54350,57901,7,3551,2,7200,1.0019712757
54388,54394,58245,6,3851,2,7200,1.00155803687
54420,54427,54428,7,1,1,900,1.0
54461,54468,58185,7,3717,2,7200,1.00188323917
54476,54483,57872,7,3389,2,7200,1.00206550605
54478,54490,57986,12,3496,2,7200,1.00343249428
54493,54500,58160,7,3660,2,7200,1.00191256831
54532,54539,58071,7,3532,2,7200,1.00198187995
54553,54560,58108,7,3548,2,7200,1.0019729425
54581,54588,58119,7,3531,2,7200,1.00198244123
54647,54653,58400,6,3747,2,7200,1.00160128102
54705,54711,58574,6,3863,2,7200,1.001553197
54750,54757,58437,7,3680,2,7200,1.00190217391
54804,54810,58420,6,3610,2,7200,1.00166204986
54819,54825,58681,6,3856,2,7200,1.0015560166
55065,55072,58567,7,3495,2,7200,1.00200286123
55113,55120,58723,7,3603,2,7200,1.00194282542
55156,55163,58897,7,3734,2,7200,1.00187466524
55213,55220,58766,7,3546,2,7200,1.00197405527
55407,55414,59195,7,3781,2,7200,1.00185136207
55472,55479,56663,7,1184,6,174600,1.00591216216
55634,55640,59246,6,3606,2,7200,1.00166389351
55689,55695,59364,6,3669,2,7200,1.00163532298
55724,55731,55733,7,2,11,176400,1.0
55740,55747,59494,7,3747,2,7200,1.0018681612
55758,55764,59354,6,3590,2,7200,1.00167130919
55779,55786,86777,7,30991,11,176400,1.00022587203
55815,55822,59579,7,3757,2,7200,1.00186318871
56137,56144,59759,7,3615,2,7200,1.00193637621
56176,56182,60108,6,3926,2,7200,1.00152827305
56419,56426,60330,7,3904,2,7200,1.00179303279
56711,56718,60235,7,3517,2,7200,1.00199033267
57138,57145,60603,7,3458,2,7200,1.0020242915
57342,57348,61077,6,3729,2,7200,1.00160901046
57344,57356,61011,12,3655,2,7200,1.00328317373
57446,57453,60870,7,3417,2,7200,1.00204858063
57488,57495,61292,7,3797,2,7200,1.00184356071
57598,57605,61401,7,3796,2,7200,1.00184404636
57729,57736,58830,7,1094,6,88200,1.00639853748
57746,57752,61139,6,3387,2,7200,1.00177147919
57747,57759,61359,12,3600,2,7200,1.00333333333
57796,57803,61604,7,3801,2,7200,1.00184162063
57811,57817,61393,6,3576,2,7200,1.00167785235
57847,57853,61276,6,3423,2,7200,1.00175284838
57874,57881,61349,7,3468,2,7200,1.00201845444
57876,57888,61476,12,3588,2,7200,1.00334448161
57903,57909,61679,6,3770,2,7200,1.00159151194
57912,118524,124577,60612,6053,64,23410,11.0135470015
57988,57995,61819,7,3824,2,7200,1.00183054393
58072,58079,61925,7,3846,2,7200,1.0018200728
58109,58116,62017,7,3901,2,7200,1.00179441169
58124,58131,61994,7,3863,2,7200,1.00181206316
58160,58167,61935,7,3768,2,7200,1.00185774947
58187,58193,61618,6,3425,2,7200,1.00175182482
58244,58251,61759,7,3508,2,7200,1.001995439
58402,58410,61773,8,3363,2,7200,1.00237882843
58420,58427,62206,7,3779,2,7200,1.00185234189
58438,58444,62182,6,3738,2,7200,1.00160513644
58569,58576,61935,7,3359,2,7200,1.00208395356
58584,58591,62244,7,3653,2,7200,1.00191623323
58683,58690,62063,7,3373,2,7200,1.00207530388
58723,58730,62524,7,3794,2,7200,1.00184501845
58765,58771,62233,6,3462,2,7200,1.00173310225
58898,58905,62326,7,3421,2,7200,1.00204618533
59195,59201,62986,6,3785,2,7200,1.00158520476
59246,59252,62791,6,3539,2,7200,1.00169539418
59355,59361,63247,6,3886,2,7200,1.00154400412
59370,59377,63117,7,3740,2,7200,1.00187165775
59497,59503,63216,6,3713,2,7200,1.00161594398
59578,59586,63461,8,3875,2,7200,1.00206451613
59760,59767,63381,7,3614,2,7200,1.00193691201
60107,60114,63565,7,3451,2,7200,1.00202839757
60237,60244,64143,7,3899,2,7200,1.00179533214
60331,60337,64017,6,3680,2,7200,1.00163043478
60604,60610,64247,6,3637,2,7200,1.0016497113
60871,60877,64602,6,3725,2,7200,1.00161073826
61010,61016,64708,6,3692,2,7200,1.00162513543
61080,61086,64734,6,3648,2,7200,1.00164473684
61140,61147,64929,7,3782,2,7200,1.00185087255
61277,61283,64873,6,3590,2,7200,1.00167130919
61292,61299,65120,7,3821,2,7200,1.00183198116
61349,61356,64864,7,3508,2,7200,1.001995439
61364,61370,65125,6,3755,2,7200,1.00159786951
61394,61400,65344,6,3944,2,7200,1.00152129817
61409,61415,64898,6,3483,2,7200,1.00172265289
61478,61484,65108,6,3624,2,7200,1.00165562914
61606,61612,65391,6,3779,2,7200,1.00158772162
61621,61628,65308,7,3680,2,7200,1.00190217391
61681,61687,65560,6,3873,2,7200,1.00154918668
61759,61766,65552,7,3786,2,7200,1.00184891706
61774,61781,65363,7,3582,2,7200,1.00195421552
61820,61826,65750,6,3924,2,7200,1.00152905199
61926,61932,65660,6,3728,2,7200,1.00160944206
61941,61949,65237,8,3288,2,7200,1.00243309002
61942,61954,65465,12,3511,2,7200,1.00341782968
61997,62003,65830,6,3827,2,7200,1.00156780768
62018,62024,65641,6,3617,2,7200,1.00165883329
62066,62072,65847,6,3775,2,7200,1.00158940397
62184,62191,65967,7,3776,2,7200,1.00185381356
62205,62211,65732,6,3521,2,7200,1.00170406135
62236,62242,65756,6,3514,2,7200,1.00170745589
62251,62257,65929,6,3672,2,7200,1.00163398693
62326,62333,66071,7,3738,2,7200,1.00187265918
62526,62533,65975,7,3442,2,7200,1.00203370134
62792,62798,66410,6,3612,2,7200,1.00166112957
62989,62995,66995,6,4000,2,7200,1.0015
63119,63125,67007,6,3882,2,7200,1.00154559505
63216,63222,67318,6,4096,2,7200,1.00146484375
63249,63256,66848,7,3592,2,7200,1.00194877506
63382,63390,67101,8,3711,2,7200,1.00215575317
63461,63467,67148,6,3681,2,7200,1.00162999185
63567,63574,67469,7,3895,2,7200,1.00179717587
64019,64025,67933,6,3908,2,7200,1.00153531218
64144,64151,67491,7,3340,2,7200,1.00209580838
64227,64234,69482,7,5248,1,5400,1.00133384146
64249,64255,67964,6,3709,2,7200,1.00161768671
64601,64608,68256,7,3648,2,7200,1.00191885965
64710,64716,68507,6,3791,2,7200,1.00158269586
64734,64741,68284,7,3543,2,7200,1.00197572679
64865,64872,68560,7,3688,2,7200,1.00189804772
64880,64886,68644,6,3758,2,7200,1.00159659393
64898,64904,68280,6,3376,2,7200,1.00177725118
64928,64935,68688,7,3753,2,7200,1.00186517453
65110,65118,68597,8,3479,2,7200,1.00229951135
65126,65133,68860,7,3727,2,7200,1.00187818621
65127,65139,68625,12,3486,2,7200,1.00344234079
65239,65246,69046,7,3800,2,7200,1.00184210526
65308,65314,69064,6,3750,2,7200,1.0016
65345,65351,68986,6,3635,2,7200,1.00165061898
65366,65372,68922,6,3550,2,7200,1.00169014085
65393,65400,69135,7,3735,2,7200,1.00187416332
65462,65469,69125,7,3656,2,7200,1.00191466083
65553,65559,68987,6,3428,2,7200,1.00175029172
65568,65574,69319,6,3745,2,7200,1.00160213618
65643,65649,69124,6,3475,2,7200,1.00172661871
65661,65667,69256,6,3589,2,7200,1.00167177487
65734,65741,69677,7,3936,2,7200,1.00177845528
65749,65756,69608,7,3852,2,7200,1.0018172378
65764,65770,69463,6,3693,2,7200,1.00162469537
65831,65837,69398,6,3561,2,7200,1.00168491997
65848,65855,69250,7,3395,2,7200,1.00206185567
65930,65936,69348,6,3412,2,7200,1.00175849941
65969,65976,69954,7,3978,2,7200,1.00175967823
65984,65991,69877,7,3886,2,7200,1.00180133814
66072,66078,69766,6,3688,2,7200,1.00162689805
66412,66419,69887,7,3468,2,7200,1.00201845444
66849,66856,70308,7,3452,2,7200,1.00202780997
66997,67004,70519,7,3515,2,7200,1.00199146515
67012,67018,70665,6,3647,2,7200,1.00164518783
67100,67106,70846,6,3740,2,7200,1.00160427807
67148,67154,70388,6,3234,2,7200,1.00185528757
67320,67327,70798,7,3471,2,7200,1.00201670988
67468,67475,71228,7,3753,2,7200,1.00186517453
67492,67498,71015,6,3517,2,7200,1.00170599943
67936,67942,71553,6,3611,2,7200,1.00166158959
67966,67973,71603,7,3630,2,7200,1.00192837466
68257,68263,71862,6,3599,2,7200,1.00166712976
68282,68288,72162,6,3874,2,7200,1.00154878678
68296,68303,72018,7,3715,2,7200,1.00188425303
68508,68514,72079,6,3565,2,7200,1.00168302945
68560,68566,72301,6,3735,2,7200,1.0016064257
68599,68605,72471,6,3866,2,7200,1.00155199172
68626,68632,72066,6,3434,2,7200,1.00174723355
68647,68653,72593,6,3940,2,7200,1.00152284264
68689,68695,72401,6,3706,2,7200,1.00161899622
68862,68868,72375,6,3507,2,7200,1.00171086399
68923,68929,72360,6,3431,2,7200,1.00174876129
68986,68994,72745,8,3751,2,7200,1.0021327646
68988,68999,72676,11,3677,2,7200,1.00299156921
69048,69055,72663,7,3608,2,7200,1.00194013304
69066,69074,72889,8,3815,2,7200,1.00209698558
69124,69130,72608,6,3478,2,7200,1.00172512938
69125,69137,72716,12,3579,2,7200,1.00335289187
69140,69147,72674,7,3527,2,7200,1.00198468954
69252,69258,72941,6,3683,2,7200,1.00162910671
69267,69273,72971,6,3698,2,7200,1.00162249865
69322,69329,72774,7,3445,2,7200,1.00203193033
69350,69356,72809,6,3453,2,7200,1.00173761946
69398,69404,73299,6,3895,2,7200,1.00154043646
69464,69470,73136,6,3666,2,7200,1.00163666121
69522,69528,393566,6,324038,3,324000,1.00001851635
69609,69616,73384,7,3768,2,7200,1.00185774947
69679,69687,73572,8,3885,2,7200,1.00205920206
69767,69773,73264,6,3491,2,7200,1.00171870524
69878,69885,73553,7,3668,2,7200,1.00190839695
69893,69899,73715,6,3816,2,7200,1.00157232704
69957,69963,73577,6,3614,2,7200,1.00166021029
70309,70315,74033,6,3718,2,7200,1.00161377084
70391,70398,74076,7,3678,2,7200,1.00190320827
70521,70527,74188,6,3661,2,7200,1.00163889648
70666,70672,74432,6,3760,2,7200,1.00159574468
70800,70807,74726,7,3919,2,7200,1.00178616994
70845,70851,74398,6,3547,2,7200,1.00169157034
71017,71025,74632,8,3607,2,7200,1.00221790962
71229,71235,74887,6,3652,2,7200,1.00164293538
71554,71561,75379,7,3818,2,7200,1.00183342064
71602,71608,75337,6,3729,2,7200,1.00160901046
71863,71869,75749,6,3880,2,7200,1.00154639175
72019,72026,75945,7,3919,2,7200,1.00178616994
72068,72075,75411,7,3336,2,7200,1.00209832134
72083,72089,75737,6,3648,2,7200,1.00164473684
72162,72169,75694,7,3525,2,7200,1.0019858156
72303,72310,76007,7,3697,2,7200,1.0018934271
72361,72367,76173,6,3806,2,7200,1.00157645822
72376,72383,75971,7,3588,2,7200,1.0019509476
72403,72410,75955,7,3545,2,7200,1.00197461213
72472,72480,76101,8,3621,2,7200,1.00220933444
72593,72600,76320,7,3720,2,7200,1.00188172043
72608,72615,76408,7,3793,2,7200,1.00184550488
72666,72672,76246,6,3574,2,7200,1.00167879127
72681,72688,76217,7,3529,2,7200,1.00198356475
72682,72695,76298,13,3603,2,7200,1.00360810436
72718,72725,76340,7,3615,2,7200,1.00193637621
72745,72751,76333,6,3582,2,7200,1.00167504188
72775,72783,76452,8,3669,2,7200,1.00218043064
72812,72818,76565,6,3747,2,7200,1.00160128102
72890,72896,76735,6,3839,2,7200,1.00156290701
72941,72948,76692,7,3744,2,7200,1.00186965812
72968,72975,76652,7,3677,2,7200,1.00190372586
73138,73145,76950,7,3805,2,7200,1.00183968463
73265,73272,76753,7,3481,2,7200,1.0020109164
73299,73306,77033,7,3727,2,7200,1.00187818621
73384,73391,77233,7,3842,2,7200,1.00182196773
73420,73426,73429,6,3,2,3540,1.0
73553,73560,77277,7,3717,2,7200,1.00188323917
73571,73578,77232,7,3654,2,7200,1.00191570881
73586,73593,77128,7,3535,2,7200,1.00198019802
73716,73724,77331,8,3607,2,7200,1.00221790962
74035,74041,77750,6,3709,2,7200,1.00161768671
74077,74085,77839,8,3754,2,7200,1.0021310602
74189,74196,77923,7,3727,2,7200,1.00187818621
74398,74404,78092,6,3688,2,7200,1.00162689805
74434,74441,78301,7,3860,2,7200,1.0018134715
74634,74640,78265,6,3625,2,7200,1.00165517241
74725,74731,78476,6,3745,2,7200,1.00160213618
74886,74892,78877,6,3985,2,7200,1.00150564617
75338,75345,79082,7,3737,2,7200,1.00187316029
75381,75387,79076,6,3689,2,7200,1.00162645703
75411,75418,79074,7,3656,2,7200,1.00191466083
75696,75703,79348,7,3645,2,7200,1.00192043896
75739,75745,79306,6,3561,2,7200,1.00168491997
75754,75761,79651,7,3890,2,7200,1.00179948586
75948,75954,79603,6,3649,2,7200,1.00164428611
75963,75970,79870,7,3900,2,7200,1.00179487179
75978,75984,79535,6,3551,2,7200,1.00168966488
76008,76014,79659,6,3645,2,7200,1.00164609053
76102,76109,80004,7,3895,2,7200,1.00179717587
76174,76181,80143,7,3962,2,7200,1.00176678445
76219,76225,79967,6,3742,2,7200,1.00160342063
76246,76253,79913,7,3660,2,7200,1.00191256831
76298,76304,79952,6,3648,2,7200,1.00164473684
76322,76328,79784,6,3456,2,7200,1.00173611111
76337,76344,80160,7,3816,2,7200,1.00183438155
76352,76358,79650,6,3292,2,7200,1.00182260024
76409,76417,80325,8,3908,2,7200,1.00204708291
76455,76462,80090,7,3628,2,7200,1.00192943771
76566,76573,79879,7,3306,2,7200,1.00211736237
76651,76657,80240,6,3583,2,7200,1.00167457438
76690,76697,80372,7,3675,2,7200,1.0019047619
76736,76742,80174,6,3432,2,7200,1.00174825175
76754,76761,80481,7,3720,2,7200,1.00188172043
76950,76956,80681,6,3725,2,7200,1.00161073826
76966,76973,76991,7,18,6,108000,1.38888888889
76975,76981,84702,6,7721,6,108000,1.00077710141
77035,77042,80821,7,3779,2,7200,1.00185234189
77129,77136,80733,7,3597,2,7200,1.00194606617
77231,77238,81150,7,3912,2,7200,1.00178936605
77246,77252,80707,6,3455,2,7200,1.0017366136
77277,77283,81071,6,3788,2,7200,1.00158394931
77334,77340,80973,6,3633,2,7200,1.00165152766
77702,77711,77723,9,12,6,108000,1.75
77753,77760,81587,7,3827,2,7200,1.00182910896
77813,77820,97710,7,19890,6,108000,1.00035193565
77840,77847,81544,7,3697,2,7200,1.0018934271
77925,77932,81798,7,3866,2,7200,1.00181065701
78094,78101,81563,7,3462,2,7200,1.00202195263
78267,78273,82017,6,3744,2,7200,1.0016025641
78303,78311,81657,8,3346,2,7200,1.00239091452
78475,78481,82061,6,3580,2,7200,1.00167597765
78543,78551,81378,8,2827,2,18000,1.00282985497
78562,78568,80845,6,2277,2,18000,1.00263504611
78877,78883,82475,6,3592,2,7200,1.00167037862
79026,79032,85131,6,6099,2,18000,1.00098376783
79073,79080,82483,7,3403,2,7200,1.00205700852
79088,79094,82777,6,3683,2,7200,1.00162910671
79090,79101,82760,11,3659,2,7200,1.00300628587
79186,79193,82129,7,2936,2,18000,1.00238419619
79305,79311,82795,6,3484,2,7200,1.00172215844
79350,79358,83308,8,3950,2,7200,1.00202531646
79537,79545,83318,8,3773,2,7200,1.00212032865
79553,79560,82515,7,2955,2,7200,1.00236886633
79604,79610,83224,6,3614,2,7200,1.00166021029
79650,79657,83118,7,3461,2,7200,1.00202253684
79665,79672,83112,7,3440,2,7200,1.00203488372
79666,79677,83445,11,3768,2,7200,1.00291932059
79784,79790,83602,6,3812,2,7200,1.00157397692
79872,79878,84027,6,4149,2,7200,1.0014461316
79887,79893,83625,6,3732,2,7200,1.00160771704
79914,79921,83869,7,3948,2,7200,1.00177304965
79953,79959,83462,6,3503,2,7200,1.00171281758
79968,79975,83471,7,3496,2,7200,1.00200228833
80004,80012,83831,8,3819,2,7200,1.00209478921
80092,80098,83770,6,3672,2,7200,1.00163398693
80143,80150,83892,7,3742,2,7200,1.0018706574
80162,80169,83571,7,3402,2,7200,1.00205761317
80177,80183,83837,6,3654,2,7200,1.00164203612
80240,80246,84221,6,3975,2,7200,1.00150943396
80325,80331,83901,6,3570,2,7200,1.00168067227
80374,80380,83872,6,3492,2,7200,1.00171821306
80483,80490,83948,7,3458,2,7200,1.0020242915
80684,80691,84515,7,3824,2,7200,1.00183054393
80708,80714,84542,6,3828,2,7200,1.00156739812
80735,80741,84338,6,3597,2,7200,1.00166805671
80820,80827,84505,7,3678,2,7200,1.00190320827
80974,80981,84912,7,3931,2,7200,1.00178071737
81071,81077,84918,6,3841,2,7200,1.0015620932
81152,81159,84812,7,3653,2,7200,1.00191623323
81543,81550,85192,7,3642,2,7200,1.00192202087
81564,81571,85206,7,3635,2,7200,1.00192572215
81588,81594,85269,6,3675,2,7200,1.00163265306
81658,81665,85229,7,3564,2,7200,1.0019640853
81800,81807,85521,7,3714,2,7200,1.00188476037
82018,82025,85464,7,3439,2,7200,1.00203547543
82060,82066,85711,6,3645,2,7200,1.00164609053
82363,82370,90185,7,7815,2,18000,1.00089571337
82476,82483,85814,7,3331,2,7200,1.00210147103
82491,82497,85991,6,3494,2,7200,1.00171722954
82763,82770,86328,7,3558,2,7200,1.00196739741
82781,82787,86384,6,3597,2,7200,1.00166805671
82796,82802,86280,6,3478,2,7200,1.00172512938
83115,83121,86765,6,3644,2,7200,1.00164654226
83115,83126,83141,11,15,2,7200,1.73333333333
83129,83136,86609,7,3473,2,7200,1.00201554852
83151,83157,87933,6,4776,2,18000,1.00125628141
83223,83230,86945,7,3715,2,7200,1.00188425303
83256,83262,101283,6,18021,2,18000,1.0003329449
83308,83316,86994,8,3678,2,7200,1.00217509516
83323,83331,87050,8,3719,2,7200,1.00215111589
83445,83451,87355,6,3904,2,7200,1.00153688525
83463,83469,87093,6,3624,2,7200,1.00165562914
83478,83484,87209,6,3725,2,7200,1.00161073826
83572,83579,87030,7,3451,2,7200,1.00202839757
83605,83612,87239,7,3627,2,7200,1.00192996967
83626,83632,87251,6,3619,2,7200,1.00165791655
83771,83779,87569,8,3790,2,7200,1.00211081794
83832,83838,87385,6,3547,2,7200,1.00169157034
83847,83853,87602,6,3749,2,7200,1.00160042678
83871,83877,87509,6,3632,2,7200,1.00165198238
83872,83884,87761,12,3877,2,7200,1.00309517668
83893,83900,87491,7,3591,2,7200,1.00194931774
83908,83916,87433,8,3517,2,7200,1.00227466591
83948,83954,87591,6,3637,2,7200,1.0016497113
84029,84036,87946,7,3910,2,7200,1.00179028133
84220,84226,87565,6,3339,2,7200,1.00179694519
84338,84345,87962,7,3617,2,7200,1.0019353055
84507,84515,88212,8,3697,2,7200,1.00216391669
84522,84529,87968,7,3439,2,7200,1.00203547543
84544,84550,87864,6,3314,2,7200,1.00181050091
84814,84820,88285,6,3465,2,7200,1.00173160173
84914,84921,88645,7,3724,2,7200,1.00187969925
84929,84936,88483,7,3547,2,7200,1.00197349873
85192,85198,88748,6,3550,2,7200,1.00169014085
85207,85213,88994,6,3781,2,7200,1.00158688178
85231,85239,88942,8,3703,2,7200,1.00216041048
85271,85278,88851,7,3573,2,7200,1.00195913798
85465,85471,89170,6,3699,2,7200,1.00162206002
85520,85527,89149,7,3622,2,7200,1.0019326339
85711,85717,89518,6,3801,2,7200,1.00157853197
85813,85820,89743,7,3923,2,7200,1.00178434871
85838,85844,103881,6,18037,2,18000,1.00033264955
85975,85981,87151,6,1170,2,18000,1.00512820513
85993,85999,89848,6,3849,2,7200,1.00155884645
86082,86089,90921,7,4832,2,18000,1.0014486755
86165,86172,86227,7,55,10,432000,1.12727272727
86266,86274,94125,8,7851,2,18000,1.00101897847
86281,86287,89825,6,3538,2,7200,1.00169587337
86329,86337,90085,8,3748,2,7200,1.00213447172
86364,86371,86421,7,50,10,432000,1.14
86387,86393,89981,6,3588,2,7200,1.0016722408
86612,86618,90238,6,3620,2,7200,1.00165745856
86732,86738,137323,6,50585,10,432000,1.00011861224
86767,86774,90679,7,3905,2,7200,1.00179257362
86946,86953,90417,7,3464,2,7200,1.00202078522
86994,87001,90604,7,3603,2,7200,1.00194282542
87031,87038,90645,7,3607,2,7200,1.00194067092
87052,87059,90779,7,3720,2,7200,1.00188172043
87094,87101,90685,7,3584,2,7200,1.001953125
87209,87216,90953,7,3737,2,7200,1.00187316029
87242,87248,90699,6,3451,2,7200,1.00173862649
87257,87265,90751,8,3486,2,7200,1.00229489386
87357,87364,90972,7,3608,2,7200,1.00194013304
87387,87393,91226,6,3833,2,7200,1.00156535351
87433,87440,90863,7,3423,2,7200,1.00204498978
87493,87499,91248,6,3749,2,7200,1.00160042678
87511,87518,91175,7,3657,2,7200,1.00191413727
87566,87572,91351,6,3779,2,7200,1.00158772162
87581,87588,91242,7,3654,2,7200,1.00191570881
87596,87603,91556,7,3953,2,7200,1.00177080698
87611,87618,91003,7,3385,2,7200,1.00206794682
87762,87768,91531,6,3763,2,7200,1.0015944725
87865,87871,91527,6,3656,2,7200,1.00164113786
87947,87953,91919,6,3966,2,7200,1.0015128593
87962,87969,91819,7,3850,2,7200,1.00181818182
87977,87983,91585,6,3602,2,7200,1.00166574125
88213,88220,92275,7,4055,2,7200,1.00172626387
88286,88293,91983,7,3690,2,7200,1.00189701897
88483,88489,92068,6,3579,2,7200,1.00167644593
88644,88651,92518,7,3867,2,7200,1.00181018878
88747,88754,92367,7,3613,2,7200,1.0019374481
88850,88857,92665,7,3808,2,7200,1.00183823529
88940,88947,92519,7,3572,2,7200,1.00195968645
88995,89002,92737,7,3735,2,7200,1.00187416332
89150,89156,92728,6,3572,2,7200,1.00167973124
89171,89178,92536,7,3358,2,7200,1.00208457415
89518,89525,93249,7,3724,2,7200,1.00187969925
89745,89751,93551,6,3800,2,7200,1.00157894737
89826,89833,93634,7,3801,2,7200,1.00184162063
89847,89853,93259,6,3406,2,7200,1.00176159718
89983,89989,93868,6,3879,2,7200,1.00154679041
90086,90093,93611,7,3518,2,7200,1.00198976691
90237,90243,93937,6,3694,2,7200,1.00162425555
90418,90425,94299,7,3874,2,7200,1.00180691791
90606,90612,94606,6,3994,2,7200,1.00150225338
90645,90652,94186,7,3534,2,7200,1.00198075835
90678,90684,94524,6,3840,2,7200,1.0015625
90693,90699,94273,6,3574,2,7200,1.00167879127
90708,90714,94418,6,3704,2,7200,1.00161987041
90750,90757,94500,7,3743,2,7200,1.00187015763
90781,90787,94580,6,3793,2,7200,1.00158186132
90865,90872,94140,7,3268,2,7200,1.00214198286
90956,90963,94714,7,3751,2,7200,1.00186616902
90971,90977,94611,6,3634,2,7200,1.0016510732
91004,91010,94622,6,3612,2,7200,1.00166112957
91176,91183,95144,7,3961,2,7200,1.0017672305
91228,91235,94652,7,3417,2,7200,1.00204858063
91243,91249,95123,6,3874,2,7200,1.00154878678
91257,91264,94663,7,3399,2,7200,1.00205942924
91351,91357,94824,6,3467,2,7200,1.00173060283
91526,91534,95400,8,3866,2,7200,1.0020693223
91541,91548,95295,7,3747,2,7200,1.0018681612
91556,91563,95523,7,3960,2,7200,1.00176767677
91587,91593,95242,6,3649,2,7200,1.00164428611
91820,91826,95417,6,3591,2,7200,1.00167084378
91920,91926,95382,6,3456,2,7200,1.00173611111
91984,91991,95653,7,3662,2,7200,1.00191152376
92069,92076,96097,7,4021,2,7200,1.00174086048
92275,92282,95981,7,3699,2,7200,1.00189240335
92369,92375,95726,6,3351,2,7200,1.0017905103
92517,92523,96086,6,3563,2,7200,1.00168397418
92532,92539,96084,7,3545,2,7200,1.00197461213
92547,92553,96212,6,3659,2,7200,1.00163979229
92665,92671,96409,6,3738,2,7200,1.00160513644
92728,92735,96512,7,3777,2,7200,1.00185332274
92743,92750,96625,7,3875,2,7200,1.00180645161
93250,93257,96953,7,3696,2,7200,1.00189393939
93265,93273,96986,8,3713,2,7200,1.00215459197
93553,93560,97015,7,3455,2,7200,1.0020260492
93610,93618,97541,8,3923,2,7200,1.00203925567
93635,93642,97468,7,3826,2,7200,1.00182958704
93870,93876,97566,6,3690,2,7200,1.00162601626
93940,93947,97359,7,3412,2,7200,1.00205158265
94142,94149,97556,7,3407,2,7200,1.00205459348
94187,94194,98091,7,3897,2,7200,1.00179625353
94273,94279,98209,6,3930,2,7200,1.00152671756
94300,94308,97783,8,3475,2,7200,1.00230215827
94418,94424,98096,6,3672,2,7200,1.00163398693
94500,94506,98002,6,3496,2,7200,1.00171624714
94527,94533,98092,6,3559,2,7200,1.00168586682
94580,94587,98402,7,3815,2,7200,1.00183486239
94608,94615,98318,7,3703,2,7200,1.00189035917
94623,94629,98160,6,3531,2,7200,1.00169923534
94625,94636,98262,11,3626,2,7200,1.00303364589
94655,94662,98312,7,3650,2,7200,1.00191780822
94670,94677,98334,7,3657,2,7200,1.00191413727
94689,94695,94697,6,2,2,3540,1.0
94715,94721,97972,6,3251,2,7200,1.00184558597
94824,94831,98406,7,3575,2,7200,1.00195804196
95124,95131,98913,7,3782,2,7200,1.00185087255
95145,95151,98722,6,3571,2,7200,1.00168020162
95242,95249,98848,7,3599,2,7200,1.00194498472
95296,95303,98832,7,3529,2,7200,1.00198356475
95384,95390,99197,6,3807,2,7200,1.00157604413
95402,95409,98881,7,3472,2,7200,1.00201612903
95418,95424,99062,6,3638,2,7200,1.00164925783
95524,95530,99452,6,3922,2,7200,1.00152983172
95565,95572,102325,7,6753,4,14400,1.00103657634
95654,95661,99229,7,3568,2,7200,1.00196188341
95726,95734,99445,8,3711,2,7200,1.00215575317
95787,95793,95976,6,183,1,3600,1.03278688525
95984,95991,99727,7,3736,2,7200,1.00187366167
96084,96090,99535,6,3445,2,7200,1.00174165457
96085,96097,99715,12,3618,2,7200,1.00331674959
96100,96108,99964,8,3856,2,7200,1.0020746888
96160,96167,96546,7,379,1,3600,1.01846965699
96212,96218,99582,6,3364,2,7200,1.00178359096
96410,96417,100171,7,3754,2,7200,1.00186467768
96513,96519,100147,6,3628,2,7200,1.00165380375
96628,96634,99890,6,3256,2,7200,1.00184275184
96924,96930,97761,6,831,1,3600,1.00722021661
96952,96958,100603,6,3645,2,7200,1.00164609053
96985,96993,100876,8,3883,2,7200,1.00206026268
97016,97022,100863,6,3841,2,7200,1.0015620932
97360,97367,100956,7,3589,2,7200,1.00195040401
97468,97474,100880,6,3406,2,7200,1.00176159718
97541,97548,101199,7,3651,2,7200,1.00191728294
97556,97562,101326,6,3764,2,7200,1.00159404888
97571,97577,101169,6,3592,2,7200,1.00167037862
97786,97794,101488,8,3694,2,7200,1.00216567407
97976,97982,101394,6,3412,2,7200,1.00175849941
98003,98010,101394,7,3384,2,7200,1.00206855792
98091,98098,101700,7,3602,2,7200,1.0019433648
98107,98114,101464,7,3350,2,7200,1.00208955224
98108,98121,101851,13,3730,2,7200,1.00348525469
98165,98172,101858,7,3686,2,7200,1.00189907759
98212,98218,101802,6,3584,2,7200,1.00167410714
98264,98270,102002,6,3732,2,7200,1.00160771704
98312,98318,101917,6,3599,2,7200,1.00166712976
98327,98334,101962,7,3628,2,7200,1.00192943771
98342,98350,101752,8,3402,2,7200,1.00235155791
98403,98409,101942,6,3533,2,7200,1.00169827342
98418,98425,101784,7,3359,2,7200,1.00208395356
98724,98730,102348,6,3618,2,7200,1.00165837479
98834,98841,102470,7,3629,2,7200,1.00192890603
98849,98855,102632,6,3777,2,7200,1.00158856235
98885,98891,102353,6,3462,2,7200,1.00173310225
98915,98921,102609,6,3688,2,7200,1.00162689805
99064,99070,103127,6,4057,2,7200,1.00147892531
99124,99130,99262,6,132,1,3600,1.04545454545
99197,99204,102987,7,3783,2,7200,1.00185038329
99231,99238,102680,7,3442,2,7200,1.00203370134
99330,99337,99539,7,202,1,3600,1.03465346535
99446,99453,103104,7,3651,2,7200,1.00191728294
99461,99468,103417,7,3949,2,7200,1.00177260066
99474,99480,99860,6,380,1,3600,1.01578947368
99536,99544,103235,8,3691,2,7200,1.0021674343
99586,99593,103380,7,3787,2,7200,1.00184842884
99716,99722,103078,6,3356,2,7200,1.00178784267
99731,99738,103281,7,3543,2,7200,1.00197572679
99766,99773,100164,7,391,1,3600,1.0179028133
99893,99900,103962,7,4062,2,7200,1.00172328902
99966,99972,103270,6,3298,2,7200,1.00181928441
100148,100156,103820,8,3664,2,7200,1.00218340611
100161,100168,100813,7,645,3,259200,1.01085271318
100173,100179,103972,6,3793,2,7200,1.00158186132
100191,100197,100815,6,618,1,108000,1.00970873786
100191,100203,100816,12,613,1,108000,1.01957585644
100192,100209,100817,17,608,1,108000,1.02796052632
100368,100375,101007,7,632,1,3600,1.01107594937
100521,100527,101367,6,840,1,3600,1.00714285714
100606,100612,104267,6,3655,2,7200,1.00164158687
100865,100872,104741,7,3869,2,7200,1.00180925304
100880,100887,104423,7,3536,2,7200,1.00197963801
100881,100894,104707,13,3813,2,7200,1.00340938893
100946,100970,161628,24,60658,1,259200,1.00039566092
100946,100952,160369,6,59417,1,259200,1.0001009812
100946,100957,161282,11,60325,1,259200,1.00018234563
100957,100965,104566,8,3601,2,7200,1.00222160511
100982,101001,101005,19,4,1,360000,2.3
100982,100994,101002,12,8,1,360000,2.0
100982,100989,100997,7,8,1,360000,1.5
101171,101178,104839,7,3661,2,7200,1.00191204589
101201,101208,104850,7,3642,2,7200,1.00192202087
101204,101226,234576,22,133350,1,360000,1.00016497938
101204,101221,233853,17,132632,1,360000,1.0001281742
101204,101215,235042,11,133827,1,360000,1.00008219567
101237,101243,368405,6,267162,1,432000,1.00002245828
101237,101249,369795,12,268546,1,432000,1.00004468508
101237,101254,370019,17,268765,1,432000,1.00006325228
101325,101331,105044,6,3713,2,7200,1.00161594398
101395,101401,105010,6,3609,2,7200,1.00166251039
101396,101409,104853,13,3444,2,7200,1.0037746806
101466,101473,105372,7,3899,2,7200,1.00179533214
101487,101494,105014,7,3520,2,7200,1.00198863636
101705,101711,105322,6,3611,2,7200,1.00166158959
101753,101759,105131,6,3372,2,7200,1.00177935943
101786,101792,105401,6,3609,2,7200,1.00166251039
101801,101808,105381,7,3573,2,7200,1.00195913798
101853,101859,105514,6,3655,2,7200,1.00164158687
101868,101874,105690,6,3816,2,7200,1.00157232704
101919,101926,105741,7,3815,2,7200,1.00183486239
101943,101950,105477,7,3527,2,7200,1.00198468954
101965,101971,105633,6,3662,2,7200,1.00163844894
102004,102010,105619,6,3609,2,7200,1.00166251039
102348,102354,106030,6,3676,2,7200,1.00163220892
102363,102369,106011,6,3642,2,7200,1.00164744646
102428,102434,102607,6,173,4,86400,1.03468208092
102470,102477,106217,7,3740,2,7200,1.00187165775
102610,102616,106108,6,3492,2,7200,1.00171821306
102634,102640,106119,6,3479,2,7200,1.00172463352
102681,102688,106389,7,3701,2,7200,1.00189138071
102736,102743,102885,7,142,1,3600,1.04929577465
102993,103000,106817,7,3817,2,7200,1.00183390097
103081,103088,106930,7,3842,2,7200,1.00182196773
103090,103096,103234,6,138,1,1800,1.04347826087
103100,103107,103459,7,352,1,3600,1.01988636364
103105,103114,107066,9,3952,2,7200,1.00227732794
103126,103133,106932,7,3799,2,7200,1.00184259016
103146,103152,103250,6,98,4,86400,1.0612244898
103236,103244,106927,8,3683,2,7200,1.00217214228
103272,103278,106713,6,3435,2,7200,1.00174672489
103287,103294,106825,7,3531,2,7200,1.00198244123
103381,103387,107285,6,3898,2,7200,1.0015392509
103418,103424,107201,6,3777,2,7200,1.00158856235
103552,103559,103727,7,168,1,1800,1.04166666667
103810,103817,107451,7,3634,1,72000,1.00192625206
103827,103833,107615,6,3782,2,7200,1.00158646219
103831,103839,104009,8,170,4,86400,1.04705882353
103837,103845,103981,8,136,1,259200,1.05882352941
103963,103969,107732,6,3763,2,7200,1.0015944725
103974,103980,104639,6,659,1,3600,1.0091047041
103978,103986,107804,8,3818,2,7200,1.00209533787
104006,104014,364887,8,260873,1,360000,1.00003066626
104269,104277,107699,8,3422,2,7200,1.00233781414
104325,104333,104406,8,73,4,14400,1.1095890411
104424,104431,108018,7,3587,2,7200,1.0019514915
104441,104447,105070,6,623,1,1800,1.00963081862
104477,104483,106009,6,1526,4,86400,1.00393184797
104569,104576,108421,7,3845,2,7200,1.00182054616
104709,104716,108214,7,3498,2,7200,1.00200114351
104742,104748,108642,6,3894,2,7200,1.00154083205
104839,104845,108395,6,3550,2,7200,1.00169014085
104854,104861,108549,7,3688,2,7200,1.00189804772
104855,104868,108154,13,3286,2,7200,1.00395617772
105013,105020,108735,7,3715,2,7200,1.00188425303
105028,105035,108642,7,3607,2,7200,1.00194067092
105046,105053,108617,7,3564,2,7200,1.0019640853
105135,105141,109032,6,3891,2,7200,1.00154202005
105235,105241,157686,6,52445,1,259200,1.00011440557
105326,105332,109049,6,3717,2,7200,1.001614205
105374,105380,109027,6,3647,2,7200,1.00164518783
105377,105387,226056,10,120669,1,259200,1.00008287133
105382,105394,349002,12,243608,1,432000,1.00004925947
105389,105401,109202,12,3801,2,7200,1.00315706393
105404,105411,109047,7,3636,2,7200,1.00192519252
105477,105484,109255,7,3771,2,7200,1.00185627155
105513,105520,108923,7,3403,2,7200,1.00205700852
105619,105625,109517,6,3892,2,7200,1.00154162384
105634,105641,109408,7,3767,2,7200,1.00185824263
105692,105698,109317,6,3619,2,7200,1.00165791655
105743,105749,109458,6,3709,2,7200,1.00161768671
106015,106021,109668,6,3647,2,7200,1.00164518783
106016,106028,112061,12,6033,4,14400,1.00198906017
106030,106037,109754,7,3717,2,7200,1.00188323917
106111,106119,110203,8,4084,2,7200,1.00195886386
106126,106133,109813,7,3680,2,7200,1.00190217391
106158,106165,129267,7,23102,3,108000,1.00030300407
106194,106200,162110,6,55910,1,72000,1.00010731533
106218,106225,109859,7,3634,2,7200,1.00192625206
106391,106398,110179,7,3781,2,7200,1.00185136207
106714,106720,110210,6,3490,2,7200,1.00171919771
106817,106823,110445,6,3622,2,7200,1.00165654335
106825,106832,106946,7,114,1,1800,1.06140350877
106832,106840,111146,8,4306,2,7200,1.00185787274
106929,106935,110507,6,3572,2,7200,1.00167973124
106944,106950,110868,6,3918,2,7200,1.00153139357
106944,106955,107017,11,62,1,1800,1.17741935484
106945,106962,110390,17,3428,2,7200,1.00495915986
107072,107079,110501,7,3422,2,7200,1.00204558738
107203,107209,110734,6,3525,2,7200,1.00170212766
107285,107292,111302,7,4010,2,7200,1.00174563591
107292,107299,107439,7,140,1,1800,1.05
107352,107359,107462,7,103,1,1800,1.06796116505
107618,107624,111235,6,3611,2,7200,1.00166158959
107700,107706,111330,6,3624,2,7200,1.00165562914
107733,107740,111626,7,3886,2,7200,1.00180133814
107806,107812,111342,6,3530,2,7200,1.00169971671
108020,108027,111577,7,3550,2,7200,1.00197183099
108156,108162,111931,6,3769,2,7200,1.0015919342
108170,108176,108775,6,599,1,1800,1.01001669449
108217,108224,111800,7,3576,2,7200,1.00195749441
108396,108402,112318,6,3916,2,7200,1.00153217569
108423,108429,112082,6,3653,2,7200,1.00164248563
108430,108436,108748,6,312,1,1800,1.01923076923
108550,108556,112180,6,3624,2,7200,1.00165562914
108616,108624,112334,8,3710,2,7200,1.00215633423
108637,108645,112557,8,3912,2,7200,1.00204498978
108652,108659,112497,7,3838,2,7200,1.0018238666
108737,108743,112495,6,3752,2,7200,1.00159914712
108930,108938,112862,8,3924,2,7200,1.00203873598
109027,109035,112504,8,3469,2,7200,1.0023061401
109042,109049,112627,7,3578,2,7200,1.00195640022
109057,109064,112482,7,3418,2,7200,1.00204798128
109059,109070,112921,11,3851,2,7200,1.00285640093
109204,109210,112529,6,3319,2,7200,1.00180777343
109255,109262,113061,7,3799,2,7200,1.00184259016
109319,109325,112924,6,3599,2,7200,1.00166712976
109410,109417,113170,7,3753,2,7200,1.00186517453
109458,109465,113153,7,3688,2,7200,1.00189804772
109519,109526,113097,7,3571,2,7200,1.00196023523
109671,109678,113243,7,3565,2,7200,1.00196353436
109755,109762,113698,7,3936,2,7200,1.00177845528
109816,109822,113350,6,3528,2,7200,1.00170068027
109858,109864,113686,6,3822,2,7200,1.00156985871
110180,110186,113880,6,3694,2,7200,1.00162425555
110207,110214,113844,7,3630,2,7200,1.00192837466
110222,110228,113920,6,3692,2,7200,1.00162513543
110392,110399,113807,7,3408,2,7200,1.00205399061
110446,110453,114073,7,3620,2,7200,1.00193370166
110500,110507,114247,7,3740,2,7200,1.00187165775
110515,110523,114134,8,3611,2,7200,1.00221545278
110737,110744,114780,7,4036,2,7200,1.00173439049
110744,110750,110810,6,60,1,1800,1.1
110870,110876,114595,6,3719,2,7200,1.00161333692
111149,111156,114968,7,3812,2,7200,1.0018363064
111162,111168,111286,6,118,1,1800,1.05084745763
111237,111243,114881,6,3638,2,7200,1.00164925783
111304,111311,115011,7,3700,2,7200,1.00189189189
111331,111337,115008,6,3671,2,7200,1.00163443203
111346,111353,115347,7,3994,2,7200,1.00175262894
111579,111586,115255,7,3669,2,7200,1.00190787681
111629,111636,115185,7,3549,2,7200,1.00197238659
111801,111809,115202,8,3393,2,7200,1.00235779546
111931,111939,115724,8,3785,2,7200,1.00211360634
112083,112090,115752,7,3662,2,7200,1.00191152376
112180,112186,115907,6,3721,2,7200,1.00161246977
112301,112308,112608,7,300,1,1800,1.02333333333
112314,112320,115958,6,3638,2,7200,1.00164925783
112335,112342,116020,7,3678,2,7200,1.00190320827
112483,112490,116079,7,3589,2,7200,1.00195040401
112498,112505,116189,7,3684,2,7200,1.00190010858
112499,112512,116280,13,3768,2,7200,1.00345010616
112515,112521,116134,6,3613,2,7200,1.0016606698
112530,112537,116211,7,3674,2,7200,1.00190528035
112560,112567,116486,7,3919,2,7200,1.00178616994
112630,112638,116351,8,3713,2,7200,1.00215459197
112864,112871,116319,7,3448,2,7200,1.00203016241
112924,112930,116932,6,4002,2,7200,1.00149925037
112925,112937,116577,12,3640,2,7200,1.0032967033
113062,113068,116692,6,3624,2,7200,1.00165562914
113098,113104,116888,6,3784,2,7200,1.00158562368
113156,113162,117099,6,3937,2,7200,1.00152400305
113171,113178,116791,7,3613,2,7200,1.0019374481
113243,113250,117010,7,3760,2,7200,1.00186170213
113352,113359,116905,7,3546,2,7200,1.00197405527
113688,113695,117211,7,3516,2,7200,1.00199089875
113703,113710,117896,7,4186,2,7200,1.0016722408
113809,113815,117664,6,3849,2,7200,1.00155884645
113845,113852,117240,7,3388,2,7200,1.0020661157
113881,113889,117615,8,3726,2,7200,1.00214707461
113921,113928,117683,7,3755,2,7200,1.00186418109
114075,114081,117594,6,3513,2,7200,1.00170794193
114136,114142,117782,6,3640,2,7200,1.00164835165
114248,114254,118216,6,3962,2,7200,1.00151438667
114598,114605,118244,7,3639,2,7200,1.00192360539
114780,114786,118450,6,3664,2,7200,1.00163755459
114880,114888,118689,8,3801,2,7200,1.00210470929
114968,114975,118789,7,3814,2,7200,1.00183534347
115011,115018,118684,7,3666,2,7200,1.00190943808
115012,115024,118933,12,3909,2,7200,1.00306983883
115188,115194,119143,6,3949,2,7200,1.00151937199
115204,115210,118874,6,3664,2,7200,1.00163755459
115256,115262,119069,6,3807,2,7200,1.00157604413
115346,115354,119242,8,3888,2,7200,1.00205761317
115725,115731,119242,6,3511,2,7200,1.00170891484
115752,115759,119623,7,3864,2,7200,1.0018115942
115910,115917,119263,7,3346,2,7200,1.00209205021
115961,115968,119719,7,3751,2,7200,1.00186616902
116021,116028,119724,7,3696,2,7200,1.00189393939
117666,117672,117888,6,216,2,10800,1.02777777778
117789,117794,117797,5,3,4,36000,1.0
117855,117861,117865,6,4,4,36000,1.0
117967,117973,118193,6,220,2,10800,1.02727272727
117997,118003,118601,6,598,4,36000,1.01003344482
118197,118204,118620,7,416,14,1560,1.01682692308
118202,118210,118357,8,147,2,10800,1.05442176871
118394,118401,118574,7,173,2,10800,1.04046242775
118619,118626,118711,7,85,1,900,1.08235294118
118637,118644,119501,7,857,14,1560,1.008168028
118770,118946,119231,176,285,16,324000,1.61754385965
119202,119208,119464,6,256,2,10800,1.0234375
119265,119513,119661,248,148,16,324000,2.67567567568
119499,119505,119515,6,10,1,900,1.6
119512,119736,120769,224,1033,14,1560,1.21684414327
120208,120214,120287,6,73,16,324000,1.08219178082
120398,120573,120637,175,64,16,324000,3.734375
120766,120774,120780,8,6,1,900,1.4
120780,120786,121845,6,1059,14,1560,1.00566572238
120917,121201,121278,284,77,16,324000,4.68831168831
121050,121878,121879,828,1,2,1800,82.9
121054,121883,121884,829,1,2,1800,83.0
121057,121888,121889,831,1,2,1800,83.2
121060,121895,121896,835,1,2,1800,83.6
121063,121900,121901,837,1,2,1800,83.8
121081,121873,121874,792,1,2,900,79.3
121085,121867,121868,782,1,2,900,78.3
121093,121862,121863,769,1,2,900,77.0
121096,121857,121859,761,2,2,900,76.3
121379,121554,204669,175,83115,16,324000,1.00210551645
121843,121849,121856,6,7,1,900,1.3
121855,121918,122931,63,1013,14,1560,1.06219151037
122588,122594,125648,6,3054,4,36000,1.00196463654
122647,122654,127401,7,4747,2,18000,1.00147461555
122914,122920,123032,6,112,1,900,1.05357142857
122931,122938,124006,7,1068,14,1560,1.00655430712
123322,123328,127632,6,4304,2,18000,1.00139405204
123506,123513,139511,7,15998,2,18000,1.00043755469
123813,123820,124218,7,398,2,43200,1.0175879397
123854,123860,126759,6,2899,1,14400,1.0020696792
123995,124003,124017,8,14,1,900,1.57142857143
124017,124025,125030,8,1005,14,1560,1.007960199
124071,124078,124079,7,1,1,345600,1.0
124082,124089,124120,7,31,2,18000,1.22580645161
124083,124094,226156,11,102062,2,345600,1.00010777763
124118,124125,140606,7,16481,2,18000,1.00042473151
124242,124248,124263,6,15,2,900,1.4
124244,124254,124267,10,13,2,900,1.76923076923
124254,124261,124280,7,19,2,900,1.36842105263
124257,124282,124317,25,35,2,900,1.71428571429
124261,124275,124335,14,60,2,900,1.23333333333
124274,124291,124297,17,6,2,1800,2.3
124277,124310,124321,33,11,2,1800,4.0
124279,124334,124359,55,25,2,1800,3.2
124282,124348,124419,66,71,2,1800,1.92957746479
124285,124371,124510,86,139,2,1800,1.61870503597
124322,124328,303175,6,178847,2,345600,1.00003354823
124868,124874,135745,6,10871,2,18000,1.00055192715
124895,124902,211367,7,86465,2,345600,1.00008095761
125025,125031,125056,6,25,1,900,1.24
125048,125054,126266,6,1212,14,1560,1.00495049505
125246,125251,125256,5,5,1,300,1.0
125277,125283,125468,6,185,1,600,1.03243243243
125286,125292,128702,6,3410,4,14400,1.00175953079
125617,125624,127415,7,1791,1,1800,1.00390843104
125706,125712,212117,6,86405,36,86400,1.00006944043
125857,125863,126113,6,250,4,540000,1.024
126007,126013,126115,6,102,4,540000,1.05882352941
126013,126019,126980,6,961,4,36000,1.00624349636
126132,126138,307040,6,180902,4,540000,1.00003316713
126151,126157,295892,6,169735,4,540000,1.00003534922
126261,126267,126410,6,143,1,900,1.04195804196
126285,126291,127268,6,977,14,1560,1.00614124872
126679,126685,126708,6,23,14,1560,1.26086956522
126906,126912,128030,6,1118,8,86400,1.0053667263
126994,127000,127671,6,671,16,36000,1.00894187779
127068,127074,130733,6,3659,2,7200,1.00163979229
127069,127080,130880,11,3800,2,7200,1.00289473684
127070,127085,130601,15,3516,2,7200,1.0042662116
127072,127090,131000,18,3910,2,7200,1.00460358056
127073,127096,130724,23,3628,2,7200,1.00633958104
127074,127101,130849,27,3748,2,7200,1.00720384205
127076,127107,130934,31,3827,2,7200,1.00810033969
127077,127112,130867,35,3755,2,7200,1.00932090546
127078,127117,130696,39,3579,2,7200,1.01089689858
127080,127122,130610,42,3488,2,7200,1.0120412844
127081,127128,131034,47,3906,2,7200,1.0120327701
127082,127133,130921,51,3788,2,7200,1.01346356917
127084,127138,131104,54,3966,2,7200,1.01361573374
127085,127143,130903,58,3760,2,7200,1.01542553191
127086,127149,130818,63,3669,2,7200,1.01717089125
127088,127154,131031,66,3877,2,7200,1.01702347176
127089,127159,130840,70,3681,2,7200,1.01901657158
127090,127164,130842,74,3678,2,7200,1.02011963023
127092,127170,130853,78,3683,2,7200,1.02117838718
127093,127175,130830,82,3655,2,7200,1.02243502052
127095,127180,130666,85,3486,2,7200,1.02438324727
127096,127185,130608,89,3423,2,7200,1.02600058428
127097,127191,130805,94,3614,2,7200,1.02600996126
127098,127196,131099,98,3903,2,7200,1.0251088906
127100,127201,131168,101,3967,2,7200,1.02546004537
127101,127206,130721,105,3515,2,7200,1.02987197724
127102,127213,130625,111,3412,2,7200,1.03253223916
127104,127218,130907,114,3689,2,7200,1.03090268365
127105,127224,130693,119,3469,2,7200,1.03430383396
127106,127229,130982,123,3753,2,7200,1.03277378098
127108,127234,131275,126,4041,2,7200,1.03118040089
127109,127239,130910,130,3671,2,7200,1.03541269409
127110,127245,130986,135,3741,2,7200,1.03608660786
127112,127250,130860,138,3610,2,7200,1.03822714681
127113,127255,130774,142,3519,2,7200,1.04035237283
127114,127260,130789,146,3529,2,7200,1.04137149334
127116,127266,131101,150,3835,2,7200,1.03911342894
127117,127271,130690,154,3419,2,7200,1.04504241006
127118,127276,130540,158,3264,2,7200,1.04840686275
127120,127281,130738,161,3457,2,7200,1.0465721724
127250,127293,127577,43,284,1,900,1.1514084507
127277,127288,128450,11,1162,14,1560,1.00946643718
127425,127432,128389,7,957,2,3600,1.00731452456
127458,128462,128773,1004,311,14,1560,4.22829581994
127575,127588,135807,13,8219,2,18000,1.00158170094
127858,128030,134324,172,6294,2,18000,1.0273276136
128209,128215,128223,6,8,1,3600,1.4
128233,128239,137476,6,9237,2,43200,1.00064956155
128604,128610,128619,6,9,1,3600,1.5
128635,128642,128646,7,4,1,1800,1.1
128688,128694,128697,6,3,1,3600,1.0
128822,128828,128835,6,7,1,1800,1.3
128886,128893,128904,7,11,1,1800,1.63636363636
128900,128907,128915,7,8,1,3600,1.5
129012,129018,131030,6,2012,6,88200,1.00298210736
129021,129027,131208,6,2181,6,88200,1.00275103164
129052,129058,129061,6,3,1,600,1.0
129133,129139,129140,6,1,1,600,1.0
129346,129352,133543,6,4191,2,18000,1.00143163923
129375,129382,129400,7,18,2,1200,1.38888888889
129540,130704,134259,1164,3555,32,3600,1.32742616034
129589,129596,129643,7,47,1,3600,1.14893617021
129744,129751,129795,7,44,1,3600,1.15909090909
129760,129766,129793,6,27,8,86400,1.22222222222
129938,129945,130125,7,180,1,3600,1.03888888889
129965,129971,186719,6,56748,8,86400,1.0001057306
130039,130048,130110,9,62,1,3600,1.14516129032
130053,130061,134557,8,4496,2,18000,1.00177935943
130111,130119,130126,8,7,1,600,1.5
130190,130198,130208,8,10,1,600,1.8
130204,130211,130228,7,17,1,3600,1.41176470588
130288,130295,130309,7,14,1,3600,1.5
130399,130405,130410,6,5,2,14400,1.1
130482,130489,130513,7,24,2,86400,1.29166666667
130505,130514,130524,9,10,1,600,1.9
130506,130521,131281,15,760,1,3600,1.01973684211
130517,130528,134463,11,3935,2,18000,1.00279542567
130631,130640,130644,9,4,1,600,1.3
130633,130647,131196,14,549,2,86400,1.02550091075
130727,130737,130790,10,53,1,3600,1.18867924528
130855,130861,207026,6,76165,2,86400,1.00007877634
130974,130981,131044,7,63,1,3600,1.11111111111
131228,131235,134393,7,3158,2,7200,1.00221659278
131229,131242,134393,13,3151,2,7200,1.00412567439
131231,131247,134393,16,3146,2,7200,1.00508582327
131232,131252,134393,20,3141,2,7200,1.00636739892
131233,131257,134393,24,3136,2,7200,1.00765306122
131235,131263,134393,28,3130,2,7200,1.0089456869
131236,131270,134393,34,3123,2,7200,1.01088696766
131237,131275,134393,38,3118,2,7200,1.01218729955
131239,131280,134393,41,3113,2,7200,1.01317057501
131240,131286,134393,46,3107,2,7200,1.0148052784
131241,131291,134393,50,3102,2,7200,1.01611863314
131243,131296,134393,53,3097,2,7200,1.01711333549
131244,131301,134393,57,3092,2,7200,1.01843467012
131245,131307,134393,62,3086,2,7200,1.02009073234
131247,131312,134393,65,3081,2,7200,1.02109704641
131248,131317,134393,69,3076,2,7200,1.02243172952
131249,131322,134393,73,3071,2,7200,1.02377075871
131251,131328,134393,77,3065,2,7200,1.0251223491
131252,131333,134393,81,3060,2,7200,1.02647058824
131253,131338,134393,85,3055,2,7200,1.02782324059
131255,131343,134393,88,3050,2,7200,1.02885245902
131256,131349,134393,93,3044,2,7200,1.03055190539
131257,131354,134393,97,3039,2,7200,1.03191839421
131259,131359,134393,100,3034,2,7200,1.03295978906
131260,131364,134393,104,3029,2,7200,1.03433476395
131261,131370,134393,109,3023,2,7200,1.03605689712
131263,131375,134393,112,3018,2,7200,1.03711066932
131264,131382,134393,118,3011,2,7200,1.03918963799
131265,131387,134393,122,3006,2,7200,1.04058549568
131267,131392,134393,125,3001,2,7200,1.04165278241
131268,131397,134393,129,2996,2,7200,1.04305740988
131269,131403,134393,134,2990,2,7200,1.04481605351
131271,131408,134393,137,2985,2,7200,1.0458961474
131272,131413,134393,141,2980,2,7200,1.04731543624
131273,131419,134393,146,2974,2,7200,1.04909213181
131275,131424,134393,149,2969,2,7200,1.05018524756
131276,131429,134393,153,2964,2,7200,1.0516194332
131277,131434,134393,157,2959,2,7200,1.0530584657
131279,131440,134393,161,2953,2,7200,1.05452082628
131294,131445,134393,151,2948,2,7200,1.05122116689
132256,133555,133888,1299,333,2,86400,4.9009009009
133004,134405,181794,1401,47389,4,54000,1.02956382283
133229,134410,242421,1181,108011,4,108000,1.01093407153
133923,133929,145380,6,11451,2,18000,1.00052397171
134485,134492,138211,7,3719,2,7200,1.0018822264
134486,134498,138329,12,3831,2,7200,1.00313234143
134487,134504,138343,17,3839,2,7200,1.00442823652
134489,134509,138068,20,3559,2,7200,1.00561955606
134490,134514,138489,24,3975,2,7200,1.00603773585
134492,134519,138253,27,3734,2,7200,1.00723085163
134493,134526,138479,33,3953,2,7200,1.00834809006
134494,134531,138184,37,3653,2,7200,1.01012866137
134496,134536,138214,40,3678,2,7200,1.0108754758
134497,134542,138083,45,3541,2,7200,1.0127082745
134498,134547,138228,49,3681,2,7200,1.01331160011
134500,134552,138157,52,3605,2,7200,1.01442441054
134501,134557,138208,56,3651,2,7200,1.01533826349
134503,134563,138106,60,3543,2,7200,1.01693480102
134504,134568,138288,64,3720,2,7200,1.01720430108
134505,134573,138474,68,3901,2,7200,1.01743142784
134507,134578,138176,71,3598,2,7200,1.0197331851
134508,134584,138510,76,3926,2,7200,1.01935812532
134510,134589,138342,79,3753,2,7200,1.02104982681
134511,134594,138321,83,3727,2,7200,1.02226992219
134513,134599,138403,86,3804,2,7200,1.02260778128
134514,134605,138499,91,3894,2,7200,1.02336928608
134515,134610,138016,95,3406,2,7200,1.02789195537
134517,134615,138327,98,3712,2,7200,1.02640086207
134518,134620,138538,102,3918,2,7200,1.02603369066
134520,134626,138039,106,3413,2,7200,1.03105772048
134521,134632,138255,111,3623,2,7200,1.03063759315
134522,134638,138704,116,4066,2,7200,1.02852926709
134524,134643,138256,119,3613,2,7200,1.03293661777
134525,134648,138248,123,3600,2,7200,1.03416666667
134526,134653,138278,127,3625,2,7200,1.03503448276
134528,134659,138274,131,3615,2,7200,1.03623789765
134529,134664,138295,135,3631,2,7200,1.03717984026
134531,134669,138292,138,3623,2,7200,1.03808998068
134532,134674,138419,142,3745,2,7200,1.03791722296
134533,134680,138157,147,3477,2,7200,1.04227782571
134535,134685,138232,150,3547,2,7200,1.04228925853
134536,134691,138014,155,3323,2,7200,1.04664459825
134537,134696,138443,159,3747,2,7200,1.04243394716
134539,134701,137907,162,3206,2,7200,1.05053025577
134686,134854,145386,168,10532,2,18000,1.01595138625
134892,134898,136227,6,1329,16,3600,1.00451467269
134984,134991,138616,7,3625,1,3600,1.00193103448
135476,135483,140202,7,4719,6,86400,1.00148336512
135478,135757,135776,279,19,2,1200,15.6842105263
135598,137336,141175,1738,3839,6,88200,1.45272206304
135606,141115,144780,5509,3665,6,88200,2.5031377899
135721,135788,135816,67,28,2,1200,3.39285714286
135782,135819,142567,37,6748,2,18000,1.00548310611
136277,136283,136288,6,5,16,3600,1.1
136296,136700,144098,404,7398,4,88200,1.05460935388
136302,137341,145325,1039,7984,4,88200,1.13013527054
136351,136357,136856,6,499,16,3600,1.0120240481
136601,136608,143300,7,6692,2,18000,1.0010460251
136867,136873,137706,6,833,16,3600,1.00720288115
137359,138082,302950,723,164868,2,345600,1.00438532644
137413,137488,138888,75,1400,2,18000,1.05357142857
137828,138098,237504,270,99406,2,345600,1.00271613383
137908,137915,141465,7,3550,2,7200,1.00197183099
138013,138020,141538,7,3518,2,7200,1.00198976691
138028,138035,141681,7,3646,2,7200,1.00191991223
138042,138050,141924,8,3874,2,7200,1.00206504904
138055,138061,138234,6,173,16,3600,1.03468208092
138069,138075,141627,6,3552,2,7200,1.00168918919
138084,138091,141788,7,3697,2,7200,1.0018934271
138108,138115,141872,7,3757,2,7200,1.00186318871
138156,138163,141626,7,3463,2,7200,1.00202136876
138171,138178,141894,7,3716,2,7200,1.00188374596
138186,138192,141880,6,3688,2,7200,1.00162689805
138187,138199,141959,12,3760,2,7200,1.00319148936
138208,138214,142022,6,3808,2,7200,1.00157563025
138209,138222,141764,13,3542,2,7200,1.0036702428
138224,138230,142098,6,3868,2,7200,1.00155118925
138235,138252,141702,17,3450,16,3600,1.00492753623
138239,138245,141899,6,3654,2,7200,1.00164203612
138240,138258,141869,18,3611,2,7200,1.00498476876
138255,138265,141707,10,3442,2,7200,1.00290528762
138257,138270,141746,13,3476,2,7200,1.00373993096
138258,138275,141933,17,3658,2,7200,1.00464734828
138260,138282,141955,22,3673,2,7200,1.00598965423
138275,138288,141770,13,3482,2,7200,1.0037334865
138281,138342,138365,61,23,2,18000,3.65217391304
138290,138297,141841,7,3544,2,7200,1.0019751693
138291,138304,142124,13,3820,2,7200,1.00340314136
138306,138313,142046,7,3733,2,7200,1.00187516743
138307,138320,141828,13,3508,2,7200,1.00370581528
138322,138329,141881,7,3552,2,7200,1.00197072072
138337,138348,142189,11,3841,2,7200,1.00286383754
138338,138377,396797,39,258420,2,345600,1.00015091711
138339,138354,142109,15,3755,2,7200,1.00399467377
138354,138361,141975,7,3614,2,7200,1.00193691201
138355,138367,142073,12,3706,2,7200,1.00323799244
138403,138432,142019,29,3587,2,7200,1.00808475049
138418,138450,142033,32,3583,2,7200,1.00893106335
138442,138455,141830,13,3375,2,7200,1.00385185185
138449,138715,138777,266,62,16,3600,5.29032258065
138475,138491,141937,16,3446,2,7200,1.00464306442
138490,138502,142368,12,3866,2,7200,1.00310398345
138491,138636,142618,145,3982,2,7200,1.03641386238
138506,138900,142779,394,3879,2,7200,1.10157257025
138520,139220,142722,700,3502,2,7200,1.19988577955
138538,139234,142930,696,3696,2,7200,1.18831168831
138704,139523,143194,819,3671,2,7200,1.22309997276
138781,138789,142395,8,3606,16,3600,1.00221852468
138811,142112,142120,3301,8,2,345600,330.9
139452,141970,143351,2518,1381,2,18000,2.82331643736
139603,141780,145753,2177,3973,2,43200,1.54794865341
140024,141908,145443,1884,3535,2,18000,1.53295615276
140307,141976,145467,1669,3491,2,18000,1.47808650816
140317,141519,491449,1202,349930,2,432000,1.00343497271
140359,141192,147584,833,6392,2,50400,1.13031914894
140738,141187,141653,449,466,4,7200,1.9635193133
140847,141990,145488,1143,3498,2,18000,1.32675814751
141464,141477,144834,13,3357,2,7200,1.00387250521
141539,141550,145452,11,3902,2,7200,1.00281906715
141627,141638,145422,11,3784,2,7200,1.00290697674
141628,141645,145294,17,3649,2,7200,1.00465881063
141682,141693,145522,11,3829,2,7200,1.00287281274
141709,141716,145261,7,3545,2,7200,1.00197461213
141745,141752,145653,7,3901,2,7200,1.00179441169
141766,141773,145335,7,3562,2,7200,1.0019651881
141780,141786,145242,6,3456,2,7200,1.00173611111
141795,141803,145504,8,3701,2,7200,1.00216157795
141828,141834,145483,6,3649,2,7200,1.00164428611
141843,141850,145529,7,3679,2,7200,1.00190269095
141844,141857,145616,13,3759,2,7200,1.00345836659
141871,141877,145712,6,3835,2,7200,1.00156453716
141873,141885,145397,12,3512,2,7200,1.00341685649
141887,141894,145425,7,3531,2,7200,1.00198244123
141889,141901,145833,12,3932,2,7200,1.00305188199
141904,141915,145574,11,3659,2,7200,1.00300628587
141905,141920,145408,15,3488,2,7200,1.00430045872
141917,143363,145746,1446,2383,8,108000,1.60679815359
141926,141933,145646,7,3713,2,7200,1.00188526798
141941,141947,145383,6,3436,2,7200,1.00174621653
141942,141955,145582,13,3627,2,7200,1.00358422939
141957,141964,145918,7,3954,2,7200,1.00177035913
141972,141983,145658,11,3675,2,7200,1.00299319728
141984,142132,142140,148,8,1,126000,15.6
141986,141996,145578,10,3582,2,7200,1.00279173646
142016,142022,145546,6,3524,2,7200,1.00170261067
142031,142038,145742,7,3704,2,7200,1.00188984881
142046,142053,145895,7,3842,2,7200,1.00182196773
142047,142060,145587,13,3527,2,7200,1.003685852
142074,142081,145655,7,3574,2,7200,1.00195858982
142098,142105,145930,7,3825,2,7200,1.00183006536
142113,142119,146321,6,4202,2,7200,1.00142789148
142127,142139,145540,12,3401,2,7200,1.00352837401
142191,142198,145738,7,3540,2,7200,1.00197740113
142217,142382,145707,165,3325,2,345600,1.04962406015
142369,142375,145767,6,3392,2,7200,1.00176886792
142619,142625,146190,6,3565,2,7200,1.00168302945
142688,142695,153259,7,10564,1,126000,1.00066262779
142721,142728,146060,7,3332,2,7200,1.00210084034
142781,142788,146470,7,3682,2,7200,1.00190114068
142929,142936,146685,7,3749,2,7200,1.00186716458
143175,202488,202525,59313,37,14,660,1604.05405405
143194,143202,146822,8,3620,2,7200,1.00220994475
143847,144110,145711,263,1601,2,18000,1.16427232979
144414,144421,148125,7,3704,2,3600,1.00188984881
144774,144793,145268,19,475,2,18000,1.04
144837,144843,148290,6,3447,2,7200,1.00174064404
144938,144944,145496,6,552,2,14400,1.01086956522
145243,145251,148962,8,3711,2,7200,1.00215575317
145261,145267,149039,6,3772,2,7200,1.00159066808
145294,145301,148861,7,3560,2,7200,1.00196629213
145336,145343,149070,7,3727,2,7200,1.00187818621
145384,145391,149296,7,3905,2,7200,1.00179257362
145399,145405,148933,6,3528,2,7200,1.00170068027
145414,145420,149265,6,3845,2,7200,1.00156046814
145429,145435,149211,6,3776,2,7200,1.00158898305
145430,145442,148777,12,3335,2,7200,1.0035982009
145454,145460,149285,6,3825,2,7200,1.00156862745
145484,145491,149230,7,3739,2,7200,1.00187215833
145505,145512,149115,7,3603,2,7200,1.00194282542
145523,145529,149015,6,3486,2,7200,1.0017211704
145537,145543,148954,6,3411,2,7200,1.00175901495
145552,145560,149213,8,3653,2,7200,1.00218998084
145553,145565,149119,12,3554,2,7200,1.00337647721
145571,145579,149068,8,3489,2,7200,1.00229292061
145586,145592,149012,6,3420,2,7200,1.00175438596
145588,145599,149414,11,3815,2,7200,1.00288335518
145589,145605,149055,16,3450,2,7200,1.00463768116
145619,145626,149072,7,3446,2,7200,1.00203134068
145646,145653,149443,7,3790,2,7200,1.0018469657
145661,145667,149327,6,3660,2,7200,1.00163934426
145662,145674,149209,12,3535,2,7200,1.00339462518
145663,145679,149610,16,3931,2,7200,1.00407021114
145712,145718,149398,6,3680,2,7200,1.00163043478
145738,145745,145748,7,3,2,7200,1.0
145753,145760,149287,7,3527,2,7200,1.00198468954
145758,145766,146076,8,310,16,3600,1.02580645161
145768,145776,149675,8,3899,2,7200,1.00205180816
145835,145842,149252,7,3410,2,7200,1.00205278592
145874,145880,147909,6,2029,2,21600,1.00295712173
145895,145902,149712,7,3810,2,7200,1.00183727034
145919,145926,149661,7,3735,2,7200,1.00187416332
145919,173650,226405,27731,52755,8,108000,1.52565633589
145934,145940,149779,6,3839,2,7200,1.00156290701
145982,145988,147611,6,1623,2,18000,1.00369685767
146019,146401,156652,382,10251,2,18000,1.03726465711
146060,146067,149851,7,3784,2,7200,1.00184989429
146074,146080,146086,6,6,16,3600,1.2
146155,147624,150247,1469,2623,4,18000,1.56004574914
146174,146181,146353,7,172,16,3600,1.04069767442
146190,146197,149727,7,3530,2,7200,1.00198300283
146320,146327,150096,7,3769,2,7200,1.00185725657
146434,146483,159126,49,12643,2,18000,1.00387566242
146468,146474,150335,6,3861,2,7200,1.00155400155
146618,146624,146644,6,20,16,3600,1.3
146680,146686,146789,6,103,16,3600,1.05825242718
146685,146694,150446,9,3752,2,7200,1.00239872068
146759,146765,157582,6,10817,2,18000,1.00055468244
146796,146802,146840,6,38,16,3600,1.15789473684
146821,146828,150752,7,3924,2,7200,1.00178389399
146855,146861,146898,6,37,16,3600,1.16216216216
146932,146938,147003,6,65,16,3600,1.09230769231
147052,147058,147095,6,37,16,3600,1.16216216216
147113,147119,147183,6,64,16,3600,1.09375
147233,147239,147302,6,63,16,3600,1.09523809524
147353,147359,147501,6,142,16,3600,1.04225352113
147512,148133,149933,621,1800,4,18000,1.345
147534,147540,148055,6,515,16,3600,1.01165048544
147561,147569,161412,8,13843,2,43200,1.00057790941
148075,148081,148329,6,248,16,3600,1.02419354839
148290,148296,152033,6,3737,2,7200,1.00160556596
148579,148585,149444,6,859,16,3600,1.00698486612
148683,148689,160622,6,11933,2,14400,1.00050280734
148777,148785,152201,8,3416,2,7200,1.00234192037
148819,148825,149628,6,803,2,3600,1.00747198007
148862,148868,152716,6,3848,2,7200,1.00155925156
148934,148941,152211,7,3270,2,7200,1.00214067278
148955,148961,152829,6,3868,2,7200,1.00155118925
148969,148975,152729,6,3754,2,7200,1.00159829515
149014,149021,152785,7,3764,2,7200,1.0018597237
149016,149028,152539,12,3511,2,7200,1.00341782968
149040,149047,152701,7,3654,2,7200,1.00191570881
149058,149065,152762,7,3697,2,7200,1.0018934271
149073,149080,152587,7,3507,2,7200,1.00199600798
149074,149087,152885,13,3798,2,7200,1.00342285413
149075,149092,152941,17,3849,2,7200,1.00441673162
149115,149121,152733,6,3612,2,7200,1.00166112957
149129,149135,152874,6,3739,2,7200,1.00160470714
149208,149215,152806,7,3591,2,7200,1.00194931774
149222,149230,152562,8,3332,2,7200,1.00240096038
149224,149237,152738,13,3501,2,7200,1.00371322479
149238,149246,152724,8,3478,2,7200,1.00230017251
149253,149259,152996,6,3737,2,7200,1.00160556596
149268,149274,152840,6,3566,2,7200,1.00168255749
149286,149292,152753,6,3461,2,7200,1.001733603
149301,149308,152715,7,3407,2,7200,1.00205459348
149302,149314,153140,12,3826,2,7200,1.00313643492
149329,149335,153052,6,3717,2,7200,1.001614205
149377,149415,155418,38,6003,2,14400,1.00633016825
149401,149408,153078,7,3670,2,7200,1.00190735695
149416,149422,152886,6,3464,2,7200,1.00173210162
149443,149450,153171,7,3721,2,7200,1.00188121473
149480,149487,149655,7,168,16,3600,1.04166666667
149609,149615,153379,6,3764,2,7200,1.00159404888
149656,149675,150342,19,667,4,14400,1.02848575712
149661,149667,149836,6,169,16,3600,1.03550295858
149663,149680,153286,17,3606,2,7200,1.00471436495
149677,149687,153478,10,3791,2,7200,1.00263782643
149713,149719,153322,6,3603,2,7200,1.00166527893
149728,149735,153425,7,3690,2,7200,1.00189701897
149780,149788,153382,8,3594,2,7200,1.00222593211
149841,149847,150016,6,169,16,3600,1.03550295858
149853,149860,153244,7,3384,2,7200,1.00206855792
150022,150029,150225,7,196,16,3600,1.03571428571
150096,150104,153590,8,3486,2,7200,1.00229489386
150124,150130,151310,6,1180,2,21600,1.00508474576
150136,152149,226029,2013,73880,2,345600,1.02724688684
150186,150469,168501,283,18032,2,18000,1.01569432121
150262,150268,150489,6,221,16,3600,1.02714932127
150338,150344,153891,6,3547,2,7200,1.00169157034
150443,150449,153804,6,3355,2,7200,1.00178837556
150468,151161,152481,693,1320,2,21600,1.525
150503,150509,150729,6,220,16,3600,1.02727272727
150633,151322,152137,689,815,2,18000,1.84539877301
150743,150750,151050,7,300,16,3600,1.02333333333
150756,150763,154400,7,3637,2,7200,1.00192466318
151103,151166,173638,63,22472,2,28800,1.00280348879
151104,151111,151331,7,220,16,3600,1.03181818182
151344,151351,151597,7,246,16,3600,1.02845528455
151645,151651,151903,6,252,16,3600,1.02380952381
151946,151952,152201,6,249,16,3600,1.02409638554
152043,152050,155808,7,3758,2,7200,1.00186269292
152153,152223,155754,70,3531,2,18000,1.01982441235
152197,152493,156370,296,3877,2,18000,1.07634769151
152202,152208,156015,6,3807,2,7200,1.00157604413
152217,152230,156001,13,3771,2,7200,1.00344736144
152246,152252,152478,6,226,16,3600,1.02654867257
152540,152546,156321,6,3775,2,7200,1.00158940397
152564,152570,156143,6,3573,2,7200,1.00167926113
152588,152595,156261,7,3666,2,7200,1.00190943808
152701,152707,156542,6,3835,2,7200,1.00156453716
152716,152722,156144,6,3422,2,7200,1.00175336061
152717,152728,156290,11,3562,2,7200,1.00308815272
152733,152739,156142,6,3403,2,7200,1.00176315016
152734,152746,156492,12,3746,2,7200,1.00320341698
152736,152751,156792,15,4041,2,7200,1.00371195249
152750,152758,156379,8,3621,2,7200,1.00220933444
152765,152772,156677,7,3905,2,7200,1.00179257362
152767,152779,156298,12,3519,2,7200,1.00341005968
152784,152791,156520,7,3729,2,7200,1.00187717887
152799,152844,154412,45,1568,2,18000,1.02869897959
152806,152812,156677,6,3865,2,7200,1.00155239327
152830,152837,156896,7,4059,2,7200,1.0017245627
152846,152852,156527,6,3675,2,7200,1.00163265306
152876,152882,156515,6,3633,2,7200,1.00165152766
152891,152897,156501,6,3604,2,7200,1.00166481687
152892,152904,156395,12,3491,2,7200,1.00343741048
152943,152949,156768,6,3819,2,7200,1.00157109191
152997,153004,156677,7,3673,2,7200,1.00190579907
153055,153063,156551,8,3488,2,7200,1.00229357798
153080,153086,156770,6,3684,2,7200,1.0016286645
153140,153146,156749,6,3603,2,7200,1.00166527893
153173,153180,157129,7,3949,2,7200,1.00177260066
153242,153248,156762,6,3514,2,7200,1.00170745589
153287,153294,156872,7,3578,2,7200,1.00195640022
153320,153327,156840,7,3513,2,7200,1.00199259892
153380,153388,156964,8,3576,2,7200,1.00223713647
153395,153402,157366,7,3964,2,7200,1.00176589304
153425,153431,157186,6,3755,2,7200,1.00159786951
153428,153438,153441,10,3,1,342000,1.3
153479,153486,157236,7,3750,2,7200,1.00186666667
153513,153520,226410,7,72890,1,342000,1.00009603512
153591,153597,157191,6,3594,2,7200,1.00166944908
153805,153812,157450,7,3638,2,7200,1.00192413414
153893,153899,157321,6,3422,2,7200,1.00175336061
154408,154414,158148,6,3734,2,7200,1.00160685592
154921,154928,155274,7,346,1,600,1.02023121387
155281,155288,155694,7,406,1,1200,1.01724137931
155808,155815,159135,7,3320,2,7200,1.00210843373
156001,156007,159677,6,3670,2,7200,1.00163487738
156016,156022,159512,6,3490,2,7200,1.00171919771
156146,156154,159618,8,3464,2,7200,1.00230946882
156147,156159,159608,12,3449,2,7200,1.00347926935
156149,156166,159673,17,3507,2,7200,1.00484744796
156260,156267,159833,7,3566,2,7200,1.00196298374
156287,156293,159899,6,3606,2,7200,1.00166389351
156302,156309,160055,7,3746,2,7200,1.0018686599
156319,156326,159785,7,3459,2,7200,1.00202370627
156379,156385,160226,6,3841,2,7200,1.0015620932
156397,156403,160235,6,3832,2,7200,1.001565762
156494,156500,160228,6,3728,2,7200,1.00160944206
156508,156515,160258,7,3743,2,7200,1.00187015763
156523,156530,160304,7,3774,2,7200,1.00185479597
156525,156536,160380,11,3844,2,7200,1.0028616025
156539,156546,159919,7,3373,2,7200,1.00207530388
156554,156562,160303,8,3741,2,7200,1.00213846565
156556,156567,160395,11,3828,2,7200,1.00287356322
156679,156686,160514,7,3828,2,7200,1.00182863114
156681,156693,160287,12,3594,2,7200,1.00333889816
156682,156698,160461,16,3763,2,7200,1.00425192665
156751,156758,160220,7,3462,2,7200,1.00202195263
156766,156773,160746,7,3973,2,7200,1.00176189278
156781,156788,160332,7,3544,2,7200,1.0019751693
156782,156795,160628,13,3833,2,7200,1.00339159927
156797,156804,160379,7,3575,2,7200,1.00195804196
156842,156849,160392,7,3543,2,7200,1.00197572679
156872,156878,160489,6,3611,2,7200,1.00166158959
156896,156902,160396,6,3494,2,7200,1.00171722954
156965,156972,160498,7,3526,2,7200,1.00198525241
157129,157135,160947,6,3812,2,7200,1.00157397692
157187,157194,160854,7,3660,2,7200,1.00191256831
157201,157208,160765,7,3557,2,7200,1.00196795052
157234,157241,160821,7,3580,2,7200,1.00195530726
157322,157328,161011,6,3683,2,7200,1.00162910671
157367,157374,161060,7,3686,2,7200,1.00189907759
157451,157457,161343,6,3886,2,7200,1.00154400412
157516,157523,161837,7,4314,1,18000,1.00162262401
158149,158157,161627,8,3470,2,7200,1.0023054755
159135,159142,162620,7,3478,2,7200,1.00201265095
159487,159493,159495,6,2,2,3540,1.0
159512,159519,162884,7,3365,2,7200,1.00208023774
159609,159616,163257,7,3641,2,7200,1.00192254875
159623,159630,163180,7,3550,2,7200,1.00197183099
159674,159681,163174,7,3493,2,7200,1.00200400802
159676,159688,163214,12,3526,2,7200,1.00340328985
159785,159792,163448,7,3656,2,7200,1.00191466083
159830,159836,163459,6,3623,2,7200,1.00165608612
159899,159906,163809,7,3903,2,7200,1.00179349219
159920,159926,163653,6,3727,2,7200,1.00160987389
160053,160059,163585,6,3526,2,7200,1.00170164492
160222,160228,164125,6,3897,2,7200,1.00153964588
160237,160243,163800,6,3557,2,7200,1.00168681473
160238,160250,163752,12,3502,2,7200,1.00342661336
160240,160255,164014,15,3759,2,7200,1.00399042298
160258,160265,163942,7,3677,2,7200,1.00190372586
160287,160295,164009,8,3714,2,7200,1.00215401185
160303,160310,164031,7,3721,2,7200,1.00188121473
160304,160317,163776,13,3459,2,7200,1.00375831165
160334,160340,163987,6,3647,2,7200,1.00164518783
160379,160386,164177,7,3791,2,7200,1.0018464785
160380,160393,163789,13,3396,2,7200,1.00382803298
160396,160402,164049,6,3647,2,7200,1.00164518783
160397,160409,164127,12,3718,2,7200,1.00322754169
160398,160414,164206,16,3792,2,7200,1.00421940928
160461,160469,164256,8,3787,2,7200,1.0021124901
160488,160494,164189,6,3695,2,7200,1.00162381597
160503,160510,164033,7,3523,2,7200,1.00198694295
160518,160524,164078,6,3554,2,7200,1.0016882386
160629,160636,164138,7,3502,2,7200,1.0019988578
160744,160751,164717,7,3966,2,7200,1.00176500252
160765,160772,164429,7,3657,2,7200,1.00191413727
160816,160823,164563,7,3740,2,7200,1.00187165775
160855,160861,164672,6,3811,2,7200,1.00157438992
160946,160953,164416,7,3463,2,7200,1.00202136876
161012,161019,164798,7,3779,2,7200,1.00185234189
161060,161067,164777,7,3710,2,7200,1.00188679245
161341,161348,165114,7,3766,2,7200,1.00185873606
161627,161635,165445,8,3810,2,7200,1.00209973753
162619,162626,166503,7,3877,2,7200,1.00180551973
162881,162887,166899,6,4012,2,7200,1.00149551346
163177,163184,166833,7,3649,2,7200,1.00191833379
163191,163199,166847,8,3648,2,7200,1.00219298246
163212,163218,166697,6,3479,2,7200,1.00172463352
163257,163264,166975,7,3711,2,7200,1.00188628402
163450,163456,167028,6,3572,2,7200,1.00167973124
163465,163471,167035,6,3564,2,7200,1.00168350168
163585,163592,167108,7,3516,2,7200,1.00199089875
163654,163660,167590,6,3930,2,7200,1.00152671756
163754,163760,167391,6,3631,2,7200,1.00165243735
163778,163785,167693,7,3908,2,7200,1.00179119754
163793,163799,167623,6,3824,2,7200,1.00156903766
163809,163815,167278,6,3463,2,7200,1.00173260179
163823,163831,167639,8,3808,2,7200,1.00210084034
163944,163950,167544,6,3594,2,7200,1.00166944908
163986,163993,167734,7,3741,2,7200,1.00187115744
164010,164016,168109,6,4093,2,7200,1.00146591742
164025,164031,167641,6,3610,2,7200,1.00166204986
164039,164045,167582,6,3537,2,7200,1.00169635284
164041,164052,167732,11,3680,2,7200,1.00298913043
164055,164062,167848,7,3786,2,7200,1.00184891706
164079,164086,167620,7,3534,2,7200,1.00198075835
164125,164132,167687,7,3555,2,7200,1.00196905767
164140,164147,167743,7,3596,2,7200,1.00194660734
164141,164154,167776,13,3622,2,7200,1.00358917725
164174,164180,167608,6,3428,2,7200,1.00175029172
164189,164196,167518,7,3322,2,7200,1.00210716436
164207,164213,167946,6,3733,2,7200,1.00160728636
164258,164265,167805,7,3540,2,7200,1.00197740113
164418,164425,168309,7,3884,2,7200,1.00180226571
164433,164440,167912,7,3472,2,7200,1.00201612903
164563,164569,168312,6,3743,2,7200,1.00160299225
164675,164681,168379,6,3698,2,7200,1.00162249865
164714,164721,168738,7,4017,2,7200,1.00174259398
164777,164783,168268,6,3485,2,7200,1.00172166428
164798,164804,168342,6,3538,2,7200,1.00169587337
165115,165121,168624,6,3503,2,7200,1.00171281758
165444,165451,169187,7,3736,2,7200,1.00187366167
166505,166512,170318,7,3806,2,7200,1.00183920126
166698,166704,170344,6,3640,2,7200,1.00164835165
166833,166839,170466,6,3627,2,7200,1.00165425972
166848,166855,170601,7,3746,2,7200,1.0018686599
166902,166908,170392,6,3484,2,7200,1.00172215844
166977,166984,170803,7,3819,2,7200,1.00183294056
167028,167034,170564,6,3530,2,7200,1.00169971671
167043,167049,170633,6,3584,2,7200,1.00167410714
167109,167116,170623,7,3507,2,7200,1.00199600798
167278,167285,170708,7,3423,2,7200,1.00204498978
167393,167400,170836,7,3436,2,7200,1.00203725262
167520,167527,170913,7,3386,2,7200,1.00206733609
167541,167547,171180,6,3633,2,7200,1.00165152766
167583,167590,170967,7,3377,2,7200,1.00207284572
167598,167604,171362,6,3758,2,7200,1.00159659393
167613,167620,171433,7,3813,2,7200,1.00183582481
167628,167634,171136,6,3502,2,7200,1.00171330668
167629,167641,171517,12,3876,2,7200,1.00309597523
167644,167650,171699,6,4049,2,7200,1.00148184737
167645,167658,171579,13,3921,2,7200,1.00331548074
167687,167694,171346,7,3652,2,7200,1.00191675794
167702,167709,171296,7,3587,2,7200,1.0019514915
167732,167738,171378,6,3640,2,7200,1.00164835165
167734,167745,171223,11,3478,2,7200,1.00316273721
167748,167754,171589,6,3835,2,7200,1.00156453716
167775,167782,171462,7,3680,2,7200,1.00190217391
167805,167812,171637,7,3825,2,7200,1.00183006536
167850,167857,171495,7,3638,2,7200,1.00192413414
167913,167919,171744,6,3825,2,7200,1.00156862745
167946,167953,171454,7,3501,2,7200,1.00199942873
168109,168116,171805,7,3689,2,7200,1.00189753321
168269,168275,172029,6,3754,2,7200,1.00159829515
168311,168318,171797,7,3479,2,7200,1.00201207243
168312,168325,171897,13,3572,2,7200,1.00363941769
168342,168348,172088,6,3740,2,7200,1.00160427807
168381,168388,172167,7,3779,2,7200,1.00185234189
168626,168633,172278,7,3645,2,7200,1.00192043896
168670,168676,177752,6,9076,2,18000,1.00066108418
168740,168747,172295,7,3548,2,7200,1.0019729425
169184,169192,172722,8,3530,2,7200,1.00226628895
169589,170333,178097,744,7764,2,18000,1.09582689335
170283,170357,174442,74,4085,2,18000,1.01811505508
170320,170326,173881,6,3555,2,7200,1.00168776371
170344,170350,173901,6,3551,2,7200,1.00168966488
170392,170398,174133,6,3735,2,7200,1.0016064257
170467,170473,173871,6,3398,2,7200,1.00176574456
170566,170572,173937,6,3365,2,7200,1.00178306092
170602,170608,174299,6,3691,2,7200,1.00162557572
170623,170630,174214,7,3584,2,7200,1.001953125
170638,170645,174599,7,3954,2,7200,1.00177035913
170710,170716,174258,6,3542,2,7200,1.00169395822
170803,170811,174664,8,3853,2,7200,1.00207630418
170836,170843,174321,7,3478,2,7200,1.00201265095
170915,170922,174572,7,3650,2,7200,1.00191780822
170969,170975,174596,6,3621,2,7200,1.00165700083
171138,171145,174839,7,3694,2,7200,1.00189496481
171180,171187,174586,7,3399,2,7200,1.00205942924
171225,171231,175011,6,3780,2,7200,1.00158730159
171294,171302,174999,8,3697,2,7200,1.00216391669
171348,171355,174984,7,3629,2,7200,1.00192890603
171363,171369,175014,6,3645,2,7200,1.00164609053
171378,171385,174931,7,3546,2,7200,1.00197405527
171435,171441,175082,6,3641,2,7200,1.00164789893
171456,171462,174888,6,3426,2,7200,1.00175131349
171471,171478,175127,7,3649,2,7200,1.00191833379
171495,171501,175335,6,3834,2,7200,1.00156494523
171515,171522,174939,7,3417,2,7200,1.00204858063
171579,171586,175165,7,3579,2,7200,1.00195585359
171594,171600,175112,6,3512,2,7200,1.00170842825
171635,171642,175136,7,3494,2,7200,1.00200343446
171699,171706,175452,7,3746,2,7200,1.0018686599
171744,171750,175551,6,3801,2,7200,1.00157853197
171798,171804,175635,6,3831,2,7200,1.00156617071
171813,171819,175355,6,3536,2,7200,1.00169683258
171897,171904,175480,7,3576,2,7200,1.00195749441
172030,172037,175658,7,3621,2,7200,1.00193316763
172090,172097,175749,7,3652,2,7200,1.00191675794
172169,172176,175825,7,3649,2,7200,1.00191833379
172280,172286,176098,6,3812,2,7200,1.00157397692
172295,172302,175888,7,3586,2,7200,1.00195203569
172721,172728,176280,7,3552,2,7200,1.00197072072
173457,173464,173484,7,20,4,43200,1.35
173872,173879,177448,7,3569,2,7200,1.00196133371
173887,173894,177691,7,3797,2,7200,1.00184356071
173902,173909,177572,7,3663,2,7200,1.00191100191
173938,173945,177826,7,3881,2,7200,1.00180365885
174134,174140,177858,6,3718,2,7200,1.00161377084
174212,174218,177825,6,3607,2,7200,1.00166343222
174260,174266,178025,6,3759,2,7200,1.00159616919
174299,174305,177898,6,3593,2,7200,1.00166991372
174323,174329,177938,6,3609,2,7200,1.00166251039
174573,174580,178191,7,3611,2,7200,1.00193852119
174588,174595,178175,7,3580,2,7200,1.00195530726
174603,174609,178157,6,3548,2,7200,1.00169109357
174605,174617,178348,12,3731,2,7200,1.0032162959
174665,174671,178290,6,3619,2,7200,1.00165791655
174840,174847,178660,7,3813,2,7200,1.00183582481
174888,174894,178648,6,3754,2,7200,1.00159829515
174933,174940,178719,7,3779,2,7200,1.00185234189
174948,174955,178749,7,3794,2,7200,1.00184501845
174987,174994,178624,7,3630,2,7200,1.00192837466
175001,175007,178655,6,3648,2,7200,1.00164473684
175016,175023,178995,7,3972,2,7200,1.00176233635
175018,175030,178649,12,3619,2,7200,1.0033158331
175084,175090,178610,6,3520,2,7200,1.00170454545
175113,175120,178676,7,3556,2,7200,1.00196850394
175128,175134,179058,6,3924,2,7200,1.00152905199
175143,175150,178619,7,3469,2,7200,1.00201787259
175167,175173,179119,6,3946,2,7200,1.00152052712
175333,175340,179162,7,3822,2,7200,1.00183150183
175357,175363,178984,6,3621,2,7200,1.00165700083
175453,175460,179221,7,3761,2,7200,1.00186120713
175480,175487,179047,7,3560,2,7200,1.00196629213
175553,175560,179231,7,3671,2,7200,1.00190683737
175637,175643,179112,6,3469,2,7200,1.00172960507
175658,175665,179269,7,3604,2,7200,1.00194228635
175745,175752,179403,7,3651,2,7200,1.00191728294
175827,175833,179448,6,3615,2,7200,1.00165975104
175890,175897,179865,7,3968,2,7200,1.0017641129
176098,176104,179715,6,3611,2,7200,1.00166158959
176279,176285,179996,6,3711,2,7200,1.00161681487
177448,177454,181097,6,3643,2,7200,1.00164699424
177572,177578,181271,6,3693,2,7200,1.00162469537
177692,177699,181250,7,3551,2,7200,1.0019712757
177825,177832,181190,7,3358,2,7200,1.00208457415
177840,177847,181449,7,3602,2,7200,1.0019433648
177858,177864,181615,6,3751,2,7200,1.00159957345
177900,177906,181685,6,3779,2,7200,1.00158772162
177939,177945,181858,6,3913,2,7200,1.00153335037
178026,178033,182049,7,4016,2,7200,1.00174302789
178159,178166,181745,7,3579,2,7200,1.00195585359
178177,178184,181805,7,3621,2,7200,1.00193316763
178191,178198,182042,7,3844,2,7200,1.00182101977
178288,178295,181892,7,3597,2,7200,1.00194606617
178348,178354,182213,6,3859,2,7200,1.00155480694
178611,178618,182579,7,3961,2,7200,1.0017672305
178626,178632,182210,6,3578,2,7200,1.00167691448
178627,178639,182446,12,3807,2,7200,1.00315208826
178648,178655,182292,7,3637,2,7200,1.00192466318
178650,178662,182168,12,3506,2,7200,1.00342270394
178662,178668,178934,6,266,2,300,1.02255639098
178665,178675,182331,10,3656,2,7200,1.00273522976
178666,178681,182463,15,3782,2,7200,1.00396615547
178681,178688,182562,7,3874,2,7200,1.00180691791
178720,178727,182283,7,3556,2,7200,1.00196850394
178750,178757,182334,7,3577,2,7200,1.00195694716
178933,178939,178942,6,3,2,300,1.0
178986,178992,182731,6,3739,2,7200,1.00160470714
179000,179006,182746,6,3740,2,7200,1.00160427807
179027,202496,237376,23469,34880,38,172800,1.67284977064
179049,179055,183060,6,4005,2,7200,1.00149812734
179063,179070,182783,7,3713,2,7200,1.00188526798
179115,179121,182857,6,3736,2,7200,1.00160599572
179129,179136,182726,7,3590,2,7200,1.00194986072
179162,179170,182919,8,3749,2,7200,1.00213390237
179222,179229,182825,7,3596,2,7200,1.00194660734
179237,179244,183066,7,3822,2,7200,1.00183150183
179270,179276,183226,6,3950,2,7200,1.00151898734
179404,179410,182803,6,3393,2,7200,1.0017683466
179449,179455,183284,6,3829,2,7200,1.00156698877
179714,179721,183444,7,3723,2,7200,1.00188020414
179865,179872,183548,7,3676,2,7200,1.00190424374
179998,180005,183889,7,3884,2,7200,1.00180226571
181097,181104,184933,7,3829,2,7200,1.00182815356
181156,181205,181206,49,1,2,3540,5.0
181191,181198,184744,7,3546,2,7200,1.00197405527
181251,181257,184633,6,3376,2,7200,1.00177725118
181272,181279,185038,7,3759,2,7200,1.00186219739
181450,181457,185111,7,3654,2,7200,1.00191570881
181606,181614,183070,8,1456,2,14400,1.00549450549
181615,181623,185196,8,3573,2,7200,1.00223901483
181685,181691,185314,6,3623,2,7200,1.00165608612
181745,181751,185524,6,3773,2,7200,1.00159024649
181805,181813,185356,8,3543,2,7200,1.00225797347
181859,181866,185300,7,3434,2,7200,1.00203843914
181892,181899,185486,7,3587,2,7200,1.0019514915
182040,182047,185673,7,3626,2,7200,1.00193050193
182055,182063,185662,8,3599,2,7200,1.00222283968
182170,182177,185768,7,3591,2,7200,1.00194931774
182190,182197,182391,7,194,1,3600,1.03608247423
182206,182212,185801,6,3589,2,7200,1.00167177487
182221,182227,185903,6,3676,2,7200,1.00163220892
182284,182290,186101,6,3811,2,7200,1.00157438992
182299,182305,185879,6,3574,2,7200,1.00167879127
182332,182338,185971,6,3633,2,7200,1.00165152766
182346,182354,186157,8,3803,2,7200,1.00210360242
182446,182452,186032,6,3580,2,7200,1.00167597765
182464,182470,186181,6,3711,2,7200,1.00161681487
182563,182571,186235,8,3664,2,7200,1.00218340611
182582,182589,186315,7,3726,2,7200,1.00187869028
182604,182611,182713,7,102,1,3600,1.06862745098
182604,182616,183003,12,387,1,3600,1.03100775194
182726,182733,186410,7,3677,2,7200,1.00190372586
182741,182748,186531,7,3783,2,7200,1.00185038329
182756,182762,186539,6,3777,2,7200,1.00158856235
182783,182789,186660,6,3871,2,7200,1.00154998708
182804,182810,186620,6,3810,2,7200,1.00157480315
182819,182825,186306,6,3481,2,7200,1.00172364263
182858,182865,186633,7,3768,2,7200,1.00185774947
182918,182926,186710,8,3784,2,7200,1.0021141649
183060,183068,186866,8,3798,2,7200,1.00210637177
183075,183082,186601,7,3519,2,7200,1.00198920148
183100,183106,187402,6,4296,2,14400,1.00139664804
183193,183199,183304,6,105,1,3600,1.05714285714
183226,183233,187210,7,3977,2,7200,1.00176012069
183283,183289,187056,6,3767,2,7200,1.0015927794
183374,183380,184270,6,890,1,3600,1.00674157303
183443,183449,187120,6,3671,2,7200,1.00163443203
183549,183555,187125,6,3570,2,7200,1.00168067227
183888,183895,187271,7,3376,2,7200,1.00207345972
184633,184640,188491,7,3851,2,7200,1.00181770969
184744,184751,188379,7,3628,2,7200,1.00192943771
184934,184941,188482,7,3541,2,7200,1.0019768427
185039,185046,188713,7,3667,2,7200,1.00190891737
185112,185119,188833,7,3714,2,7200,1.00188476037
185196,185203,189062,7,3859,2,7200,1.00181394144
185301,185307,188898,6,3591,2,7200,1.00167084378
185316,185322,189107,6,3785,2,7200,1.00158520476
185358,185364,188674,6,3310,2,7200,1.00181268882
185488,185494,189250,6,3756,2,7200,1.00159744409
185524,185531,188903,7,3372,2,7200,1.00207591934
185580,185586,185718,6,132,1,3600,1.04545454545
185663,185669,189248,6,3579,2,7200,1.00167644593
185677,185683,189304,6,3621,2,7200,1.00165700083
185768,185774,189593,6,3819,2,7200,1.00157109191
185786,185792,185983,6,191,1,3600,1.03141361257
185801,185808,189534,7,3726,2,7200,1.00187869028
185879,185887,189306,8,3419,2,7200,1.00233986546
185900,185906,189686,6,3780,2,7200,1.00158730159
185920,185926,186261,6,335,1,3600,1.01791044776
185972,185978,189932,6,3954,2,7200,1.00151745068
186032,186038,189689,6,3651,2,7200,1.00164338537
186102,186109,189559,7,3450,2,7200,1.00202898551
186156,186162,190300,6,4138,2,7200,1.00144997583
186183,186190,189612,7,3422,2,7200,1.00204558738
186185,186197,186554,12,357,1,3600,1.03361344538
186237,186244,190216,7,3972,2,7200,1.00176233635
186307,186313,190057,6,3744,2,7200,1.0016025641
186321,186329,189886,8,3557,2,7200,1.00224908631
186412,186419,190197,7,3778,2,7200,1.00185283219
186533,186540,190145,7,3605,2,7200,1.00194174757
186547,186554,190554,7,4000,2,7200,1.00175
186601,186609,190123,8,3514,2,7200,1.00227660785
186619,186626,190370,7,3744,2,7200,1.00186965812
186634,186640,190613,6,3973,2,7200,1.00151019381
186661,186668,190284,7,3616,2,7200,1.00193584071
186712,186719,190640,7,3921,2,7200,1.00178525886
186759,186766,187453,7,687,1,3600,1.01018922853
186866,186872,190619,6,3747,2,7200,1.00160128102
186912,186918,187844,6,926,1,3600,1.00647948164
187056,187063,190531,7,3468,2,7200,1.00201845444
187120,187126,190726,6,3600,2,7200,1.00166666667
187134,187140,190718,6,3578,2,7200,1.00167691448
187213,187220,190721,7,3501,2,7200,1.00199942873
187273,187280,190692,7,3412,2,7200,1.00205158265
187996,188003,188681,7,678,2,14400,1.01032448378
188379,188386,192069,7,3683,2,7200,1.00190062449
188482,188488,192354,6,3866,2,7200,1.00155199172
188497,188503,191990,6,3487,2,7200,1.0017206768
188674,188682,192271,8,3589,2,7200,1.00222903316
188714,188721,192199,7,3478,2,7200,1.00201265095
188834,188842,192510,8,3668,2,7200,1.00218102508
188898,188904,192404,6,3500,2,7200,1.00171428571
188912,188918,192646,6,3728,2,7200,1.00160944206
189063,189069,192644,6,3575,2,7200,1.00167832168
189108,189116,192764,8,3648,2,7200,1.00219298246
189177,189184,197331,7,8147,2,14400,1.00085921198
189188,189196,189350,8,154,1,3600,1.05194805195
189247,189255,193204,8,3949,2,7200,1.00202582932
189262,189268,192974,6,3706,2,7200,1.00161899622
189304,189310,192953,6,3643,2,7200,1.00164699424
189306,189318,192907,12,3589,2,7200,1.00334354974
189521,189528,189673,7,145,1,1800,1.04827586207
189533,189540,193109,7,3569,2,7200,1.00196133371
189560,189567,193056,7,3489,2,7200,1.00200630553
189562,189574,189913,12,339,1,3600,1.03539823009
189593,189600,193439,7,3839,2,7200,1.00182339151
189611,189618,193454,7,3836,2,7200,1.00182481752
189686,189692,193257,6,3565,2,7200,1.00168302945
189701,189707,193382,6,3675,2,7200,1.00163265306
189888,189895,194109,7,4214,2,7200,1.00166112957
189930,189937,193797,7,3860,2,7200,1.0018134715
190012,190019,190149,7,130,1,1800,1.05384615385
190057,190064,193461,7,3397,2,7200,1.00206064174
190123,190130,193785,7,3655,2,7200,1.00191518468
190147,190153,193549,6,3396,2,7200,1.00176678445
190198,190206,193926,8,3720,2,7200,1.00215053763
190216,190222,193763,6,3541,2,7200,1.0016944366
190286,190293,193892,7,3599,2,7200,1.00194498472
190301,190307,194427,6,4120,2,7200,1.00145631068
190370,190376,194098,6,3722,2,7200,1.00161203654
190443,190449,191113,6,664,1,3600,1.00903614458
190530,190536,194100,6,3564,2,7200,1.00168350168
190554,190560,194185,6,3625,2,7200,1.00165517241
190614,190621,194181,7,3560,2,7200,1.00196629213
190629,190635,194150,6,3515,2,7200,1.00170697013
190644,190651,194710,7,4059,2,7200,1.0017245627
190692,190698,194323,6,3625,2,7200,1.00165517241
190719,190725,194405,6,3680,2,7200,1.00163043478
190734,190740,194717,6,3977,2,7200,1.00150867488
190735,190747,194699,12,3952,2,7200,1.00303643725
190849,190856,191445,7,589,1,1800,1.01188455008
191990,191997,195708,7,3711,2,7200,1.00188628402
192068,192075,195874,7,3799,2,7200,1.00184259016
192202,192209,196151,7,3942,2,7200,1.00177574835
192271,192277,195946,6,3669,2,7200,1.00163532298
192356,192362,196188,6,3826,2,7200,1.00156821746
192398,192405,196124,7,3719,2,7200,1.0018822264
192512,192519,196233,7,3714,2,7200,1.00188476037
192646,192653,196313,7,3660,2,7200,1.00191256831
192648,192660,196114,12,3454,2,7200,1.00347423277
192765,192772,196424,7,3652,2,7200,1.00191675794
192907,192913,196470,6,3557,2,7200,1.00168681473
192955,192961,196634,6,3673,2,7200,1.00163354206
192976,192983,196796,7,3813,2,7200,1.00183582481
193057,193063,196964,6,3901,2,7200,1.00153806716
193111,193119,196611,8,3492,2,7200,1.00229095074
193181,193188,193337,7,149,1,1800,1.04697986577
193205,193211,196766,6,3555,2,7200,1.00168776371
193256,193262,196931,6,3669,2,7200,1.00163532298
193328,193335,193395,7,60,1,1800,1.11666666667
193383,193389,197218,6,3829,2,7200,1.00156698877
193440,193446,196906,6,3460,2,7200,1.00173410405
193455,193461,196933,6,3472,2,7200,1.0017281106
193469,193476,197264,7,3788,2,7200,1.00184794087
193551,193558,196951,7,3393,2,7200,1.00206307103
193718,193724,193866,6,142,1,1800,1.04225352113
193761,193768,193864,7,96,1,1800,1.07291666667
193766,193775,197335,9,3560,2,7200,1.00252808989
193787,193793,197529,6,3736,2,7200,1.00160599572
193801,193809,197194,8,3385,2,7200,1.0023633678
193895,193902,197588,7,3686,2,7200,1.00189907759
193925,193931,197499,6,3568,2,7200,1.00168161435
194100,194107,197542,7,3435,2,7200,1.00203784571
194102,194114,197440,12,3326,2,7200,1.00360793746
194117,194124,197696,7,3572,2,7200,1.00195968645
194150,194157,197603,7,3446,2,7200,1.00203134068
194183,194189,198079,6,3890,2,7200,1.00154241645
194197,194204,197989,7,3785,2,7200,1.00184940555
194324,194330,197968,6,3638,2,7200,1.00164925783
194407,194413,198326,6,3913,2,7200,1.00153335037
194427,194435,197635,8,3200,2,7200,1.0025
194655,194662,195281,7,619,1,1800,1.0113085622
194699,194707,198320,8,3613,2,7200,1.0022142264
194715,194721,198483,6,3762,2,7200,1.00159489633
194716,194728,198331,12,3603,2,7200,1.00333055787
194874,194881,195221,7,340,1,1800,1.02058823529
195712,195719,199496,7,3777,2,7200,1.00185332274
195874,195882,199665,8,3783,2,7200,1.00211472376
195947,195953,199489,6,3536,2,7200,1.00169683258
196116,196123,200005,7,3882,2,7200,1.00180319423
196130,196138,199875,8,3737,2,7200,1.00214075462
196151,196158,199970,7,3812,2,7200,1.0018363064
196187,196193,199915,6,3722,2,7200,1.00161203654
196235,196242,200040,7,3798,2,7200,1.0018430753
196311,196317,200003,6,3686,2,7200,1.00162778079
196426,196433,199964,7,3531,2,7200,1.00198244123
196471,196478,200098,7,3620,2,7200,1.00193370166
196613,196620,200272,7,3652,2,7200,1.00191675794
196636,196643,200328,7,3685,2,7200,1.00189959294
196767,196772,200377,5,3605,2,7200,1.00138696255
196797,196803,200362,6,3559,2,7200,1.00168586682
196908,196914,200483,6,3569,2,7200,1.00168114318
196932,196938,200821,6,3883,2,7200,1.00154519701
196934,196945,200751,11,3806,2,7200,1.00289017341
196951,196959,201051,8,4092,2,7200,1.00195503421
196966,196973,200439,7,3466,2,7200,1.00201961916
197196,197202,200692,6,3490,2,7200,1.00171919771
197217,197223,201297,6,4074,2,7200,1.00147275405
197265,197271,201019,6,3748,2,7200,1.00160085379
197275,197282,197347,7,65,1,1800,1.10769230769
197331,197341,201247,10,3906,2,7200,1.00256016385
197333,197348,202056,15,4708,2,14400,1.00318606627
197439,197446,201000,7,3554,2,7200,1.00196961171
197456,197463,253474,7,56011,1,259200,1.00012497545
197457,197514,200468,57,2954,1,259200,1.01929587001
197457,197468,200466,11,2998,1,259200,1.00366911274
197500,197507,201349,7,3842,2,7200,1.00182196773
197501,197563,200478,62,2915,1,360000,1.02126929674
197501,197558,200475,57,2917,1,360000,1.01954062393
197501,197519,324471,18,126952,1,360000,1.00014178587
197530,197536,201205,6,3669,2,7200,1.00163532298
197545,197551,201213,6,3662,2,7200,1.00163844894
197566,197608,200483,42,2875,1,432000,1.01460869565
197566,197603,299909,37,102306,1,432000,1.00036166012
197567,197648,200485,81,2837,1,432000,1.02855128657
197590,197596,201301,6,3705,2,7200,1.0016194332
197605,197614,201368,9,3754,2,7200,1.00239744273
197635,197641,201152,6,3511,2,7200,1.00170891484
197683,197689,197787,6,98,1,1800,1.0612244898
197698,197706,201281,8,3575,2,7200,1.00223776224
197968,197974,201665,6,3691,2,7200,1.00162557572
197992,197999,201820,7,3821,2,7200,1.00183198116
198030,198048,200368,18,2320,1,259200,1.00775862069
198030,198041,200367,11,2326,1,259200,1.00472914875
198030,198036,256060,6,58024,1,259200,1.00010340549
198079,198087,201690,8,3603,2,7200,1.00222037191
198318,198326,201921,8,3595,2,7200,1.00222531293
198333,198339,201911,6,3572,2,7200,1.00167973124
198335,198346,202306,11,3960,2,7200,1.00277777778
198483,198490,202079,7,3589,2,7200,1.00195040401
198834,198841,199154,7,313,1,1800,1.02236421725
199155,199164,199460,9,296,2,14400,1.03040540541
199493,199500,202474,7,2974,2,7200,1.00235373235
199507,199514,202474,7,2960,2,7200,1.00236486486
199664,199671,202474,7,2803,2,7200,1.0024973243
199875,199882,202474,7,2592,2,7200,1.00270061728
199917,199925,202474,8,2549,2,7200,1.00313848568
199966,199972,202474,6,2502,2,7200,1.00239808153
199980,199987,202474,7,2487,2,7200,1.00281463611
200005,200011,202474,6,2463,2,7200,1.00243605359
200006,200018,202474,12,2456,2,7200,1.00488599349
200039,200045,202474,6,2429,2,7200,1.00247015233
200099,200106,202474,7,2368,2,7200,1.00295608108
200271,200277,202474,6,2197,2,7200,1.00273099681
200326,200333,202474,7,2141,2,7200,1.00326950023
200365,200371,202474,6,2103,2,7200,1.00285306705
200366,200379,259213,13,58834,1,259200,1.00022096067
200368,200393,260331,25,59938,1,259200,1.00041709767
200379,200386,202474,7,2088,2,7200,1.00335249042
200440,200447,202474,7,2027,2,7200,1.00345337938
200482,200488,202474,6,1986,2,7200,1.00302114804
200484,200495,302825,11,102330,1,432000,1.00010749536
200487,200500,302927,13,102427,1,432000,1.00012691966
200492,200508,256275,16,55767,1,259200,1.00028690803
200494,200513,256667,19,56154,1,259200,1.00033835524
200498,200519,328724,21,128205,1,360000,1.00016380016
200500,200706,329956,206,129250,1,360000,1.00159381044
200693,200699,202474,6,1775,2,7200,1.00338028169
200750,200758,202474,8,1716,2,7200,1.00466200466
200823,200830,202475,7,1645,2,7200,1.00425531915
201001,201008,202475,7,1467,2,7200,1.00477164281
201019,201026,202475,7,1449,2,7200,1.00483091787
201052,201059,202475,7,1416,2,7200,1.00494350282
201155,201161,202475,6,1314,2,7200,1.00456621005
201206,201212,202475,6,1263,2,7200,1.00475059382
201221,201227,202475,6,1248,2,7200,1.00480769231
201248,201254,202475,6,1221,2,7200,1.00491400491
201281,201288,202475,7,1187,2,7200,1.00589721988
201299,201305,202475,6,1170,2,7200,1.00512820513
201301,201313,202475,12,1162,2,7200,1.01032702238
201349,201355,202475,6,1120,2,7200,1.00535714286
201370,201376,202475,6,1099,2,7200,1.00545950864
201667,201674,202475,7,801,2,7200,1.00873907615
201691,201697,202475,6,778,2,7200,1.00771208226
201821,201828,202475,7,647,2,7200,1.01081916538
201908,201915,202476,7,561,2,7200,1.01247771836
201923,201929,202475,6,546,2,7200,1.01098901099
202055,202062,202117,7,55,2,86400,1.12727272727
202080,202086,202475,6,389,2,7200,1.01542416452
202307,202314,202475,7,161,2,7200,1.04347826087
202499,202505,204880,6,2375,2,86400,1.00252631579
202607,202613,206206,6,3593,2,7200,1.00166991372
202608,202620,206439,12,3819,2,7200,1.00314218382
202610,202625,206238,15,3613,2,7200,1.00415167451
202611,202630,206227,19,3597,2,7200,1.00528217959
202612,202636,206512,24,3876,2,7200,1.00619195046
202614,202643,206255,29,3612,2,7200,1.00802879291
202615,202648,206526,33,3878,2,7200,1.008509541
202617,202653,206414,36,3761,2,7200,1.00957192236
202618,202659,206010,41,3351,2,7200,1.01223515369
202619,202664,206370,45,3706,2,7200,1.01214247167
202621,202669,206202,48,3533,2,7200,1.01358618738
202622,202674,206274,52,3600,2,7200,1.01444444444
202624,202680,206165,56,3485,2,7200,1.01606886657
202625,202685,206207,60,3522,2,7200,1.01703577513
202627,202690,205996,63,3306,2,7200,1.01905626134
202628,202695,206075,67,3380,2,7200,1.01982248521
202629,202701,206325,72,3624,2,7200,1.01986754967
202631,202706,206460,75,3754,2,7200,1.0199786894
202632,202711,206293,79,3582,2,7200,1.02205471803
202634,202717,206206,83,3489,2,7200,1.0237890513
202635,202722,206505,87,3783,2,7200,1.02299762094
202637,202727,206207,90,3480,2,7200,1.02586206897
202638,202733,206313,95,3580,2,7200,1.02653631285
202640,202739,206449,99,3710,2,7200,1.02668463612
202641,202744,206350,103,3606,2,7200,1.02856350527
202642,202749,206380,107,3631,2,7200,1.02946846599
202644,202754,206395,110,3641,2,7200,1.03021148036
202645,202760,206448,115,3688,2,7200,1.03118221258
202647,202765,206508,118,3743,2,7200,1.03152551429
202648,202770,206413,122,3643,2,7200,1.03348888279
202650,202775,206420,125,3645,2,7200,1.03429355281
202652,202784,206398,132,3614,2,7200,1.03652462645
202653,202789,203316,136,527,2,7200,1.25806451613
202655,202794,203316,139,522,2,7200,1.2662835249
202657,202799,203316,142,517,2,7200,1.2746615087
202658,202805,203316,147,511,2,7200,1.28767123288
202660,202810,203316,150,506,2,7200,1.29644268775
202661,202815,203316,154,501,2,7200,1.30738522954
202663,202820,203316,157,496,2,7200,1.31653225806
202664,202826,203316,162,490,2,7200,1.3306122449
203058,203328,204187,270,859,16,3600,1.31431897555
203847,205581,205920,1734,339,14,660,6.11504424779
204200,204206,204460,6,254,16,3600,1.02362204724
204500,204507,204698,7,191,16,3600,1.03664921466
205179,205186,205585,7,399,16,3600,1.01754385965
205600,205606,205859,6,253,16,3600,1.02371541502
205901,205907,206419,6,512,16,3600,1.01171875
206000,206006,209564,6,3558,2,7200,1.00168634064
206017,206024,209534,7,3510,2,7200,1.00199430199
206077,206084,209597,7,3513,2,7200,1.00199259892
206166,206173,209899,7,3726,2,7200,1.00187869028
206202,206208,209665,6,3457,2,7200,1.00173560891
206217,206223,209660,6,3437,2,7200,1.00174570847
206218,206230,209638,12,3408,2,7200,1.00352112676
206220,206235,209764,15,3529,2,7200,1.00425049589
206221,206240,210057,19,3817,2,7200,1.0049777312
206236,206248,209718,12,3470,2,7200,1.00345821326
206238,206253,209896,15,3643,2,7200,1.00411748559
206256,206262,209645,6,3383,2,7200,1.00177357375
206274,206281,209775,7,3494,2,7200,1.00200343446
206292,206298,209779,6,3481,2,7200,1.00172364263
206314,206320,209929,6,3609,2,7200,1.00166251039
206329,206335,209946,6,3611,2,7200,1.00166158959
206349,206356,209807,7,3451,2,7200,1.00202839757
206370,206376,209975,6,3599,2,7200,1.00166712976
206385,206392,209660,7,3268,2,7200,1.00214198286
206400,206407,210042,7,3635,2,7200,1.00192572215
206401,206414,210236,13,3822,2,7200,1.00340136054
206416,206422,210058,6,3636,2,7200,1.00165016502
206418,206429,209795,11,3366,2,7200,1.00326797386
206434,206441,209998,7,3557,2,7200,1.00196795052
206442,206448,206795,6,347,16,3600,1.01729106628
206453,206459,210199,6,3740,2,7200,1.00160427807
206454,206466,210170,12,3704,2,7200,1.00323974082
206456,206471,210038,15,3567,2,7200,1.00420521447
206471,206478,210088,7,3610,2,7200,1.00193905817
206507,206515,210036,8,3521,2,7200,1.00227208179
206522,206529,210031,7,3502,2,7200,1.0019988578
206524,206535,210165,11,3630,2,7200,1.00303030303
206538,206544,210066,6,3522,2,7200,1.00170357751
206676,207039,207680,363,641,2,660,1.56630265211
206802,206808,207255,6,447,16,3600,1.01342281879
207025,207032,208169,7,1137,1,86400,1.00615655233
207108,207693,210818,585,3125,2,50400,1.1872
207131,209925,209954,2794,29,2,900,97.3448275862
207133,209918,209953,2785,35,2,900,80.5714285714
207137,209913,209962,2776,49,2,900,57.6530612245
207139,209850,209997,2711,147,2,900,19.4421768707
207142,209732,209911,2590,179,2,900,15.469273743
207155,209944,209959,2789,15,2,1800,186.933333333
207158,209966,209995,2808,29,2,1800,97.8275862069
207161,209971,210038,2810,67,2,1800,42.9402985075
207167,209978,210191,2811,213,2,1800,14.1971830986
207170,209983,210441,2813,458,2,1800,7.14192139738
207187,209612,212227,2425,2615,2,86400,1.92734225621
207283,207289,207989,6,700,16,3600,1.00857142857
207688,209549,209838,1861,289,2,660,7.43944636678
208004,208011,208316,7,305,16,3600,1.02295081967
208140,209652,223558,1512,13906,2,43200,1.10873004459
208365,208371,208608,6,237,16,3600,1.0253164557
208606,208612,208970,6,358,16,3600,1.01675977654
208708,212134,214487,3426,2353,8,14400,2.45601359966
208853,208860,208861,7,1,1,21600,1.0
208956,209672,267278,716,57606,2,57600,1.01242926084
208966,208973,209177,7,204,16,3600,1.03431372549
209262,209780,211189,518,1409,2,18000,1.36763662172
209437,209579,212682,142,3103,2,21600,1.04576216565
209535,209542,213010,7,3468,2,7200,1.00201845444
209565,209572,213048,7,3476,2,7200,1.00201380898
209598,209605,213061,7,3456,2,7200,1.00202546296
209637,209645,213253,8,3608,2,7200,1.0022172949
209652,209659,213302,7,3643,2,7200,1.00192149327
209667,209678,213123,11,3445,2,7200,1.00319303338
209668,209684,213291,16,3607,2,7200,1.00443581924
209670,209689,213243,19,3554,2,7200,1.00534608891
209718,209725,213173,7,3448,2,7200,1.00203016241
209766,209773,213368,7,3595,2,7200,1.00194714882
209781,209788,213314,7,3526,2,7200,1.00198525241
209783,209795,213241,12,3446,2,7200,1.00348229832
209798,209805,213432,7,3627,2,7200,1.00192996967
209813,209819,213353,6,3534,2,7200,1.00169779287
209885,209891,213441,6,3550,2,7200,1.00169014085
209899,209906,213508,7,3602,2,7200,1.0019433648
209930,209937,213546,7,3609,2,7200,1.00193959546
209943,209951,209952,8,1,1,21600,1.0
209949,209957,213569,8,3612,2,7200,1.00221483942
209983,209989,213704,6,3715,2,7200,1.00161507402
210000,210006,213637,6,3631,2,7200,1.00165243735
210033,210041,213446,8,3405,2,7200,1.00234948605
210049,210057,213439,8,3382,2,7200,1.00236546422
210051,210063,213845,12,3782,2,7200,1.00317292438
210052,210069,213627,17,3558,2,7200,1.00477796515
210074,210081,213862,7,3781,2,7200,1.00185136207
210075,210087,213906,12,3819,2,7200,1.00314218382
210077,210093,213647,16,3554,2,7200,1.00450196961
210098,210104,213612,6,3508,2,7200,1.00171037628
210116,212139,482145,2023,270006,7,270000,1.00749242609
210172,210179,213515,7,3336,2,7200,1.00209832134
210174,210186,213984,12,3798,2,7200,1.00315955766
210204,210211,213968,7,3757,2,7200,1.00186318871
210273,210279,213920,6,3641,2,7200,1.00164789893
210331,212129,213085,1798,956,16,324000,2.88075313808
210429,210437,210438,8,1,1,21600,1.0
210477,210483,213018,6,2535,2,14400,1.00236686391
210716,210723,210725,7,2,1,21600,1.0
210742,210830,212575,88,1745,2,14400,1.05042979943
211363,211370,312668,7,101298,1,342000,1.00006910304
211482,211488,218834,6,7346,1,21600,1.00081677103
212228,212235,298642,7,86407,2,86400,1.00008101196
212503,212509,212515,6,6,16,3600,1.2
212550,212556,212562,6,6,16,3600,1.2
212594,212601,215090,7,2489,16,3600,1.00281237445
213016,213023,216727,7,3704,2,7200,1.00188984881
213050,213056,216676,6,3620,2,7200,1.00165745856
213066,213073,216747,7,3674,2,7200,1.00190528035
213126,213134,216776,8,3642,2,7200,1.00219659528
213175,213182,216826,7,3644,2,7200,1.00192096597
213226,214003,214530,777,527,16,324000,2.47438330171
213243,213249,216697,6,3448,2,7200,1.00174013921
213245,213256,217210,11,3954,2,7200,1.00278199292
213260,213267,216926,7,3659,2,7200,1.00191309101
213293,213299,217105,6,3806,2,7200,1.00157645822
213308,213314,216887,6,3573,2,7200,1.00167926113
213322,213329,216862,7,3533,2,7200,1.00198131899
213356,213363,217050,7,3687,2,7200,1.00189856252
213371,213378,217102,7,3724,2,7200,1.00187969925
213434,213441,217107,7,3666,2,7200,1.00190943808
213452,213458,217123,6,3665,2,7200,1.00163710778
213453,213466,216958,13,3492,2,7200,1.00372279496
213454,213471,216763,17,3292,2,7200,1.00516403402
213489,213649,213696,160,47,2,900,4.40425531915
213491,213583,213682,92,99,2,900,1.92929292929
213506,213514,217061,8,3547,2,7200,1.00225542712
213522,213528,217080,6,3552,2,7200,1.00168918919
213546,213553,217262,7,3709,2,7200,1.00188730116
213570,213576,217285,6,3709,2,7200,1.00161768671
213612,213618,217133,6,3515,2,7200,1.00170697013
213630,213636,217479,6,3843,2,7200,1.00156128025
213644,213655,217349,11,3694,2,7200,1.00297780184
213659,213665,217144,6,3479,2,7200,1.00172463352
213704,213711,217314,7,3603,2,7200,1.00194282542
213847,213853,217478,6,3625,2,7200,1.00165517241
213865,213872,217292,7,3420,2,7200,1.00204678363
213907,213914,217605,7,3691,2,7200,1.00189650501
213926,213934,217542,8,3608,2,7200,1.0022172949
213944,213951,237498,7,23547,4,172800,1.00029727778
213972,213979,217845,7,3866,2,7200,1.00181065701
213990,213996,217731,6,3735,2,7200,1.0016064257
214021,215453,219880,1432,4427,2,18000,1.32346961825
214078,215448,253336,1370,37888,4,172800,1.03615920608
214436,214497,214554,61,57,8,324000,2.0701754386
214531,214566,216860,35,2294,8,86400,1.01525719268
214701,215443,215626,742,183,8,324000,5.05464480874
214792,215459,220538,667,5079,2,43200,1.13132506399
215115,215529,295614,414,80085,2,172800,1.0051695074
215309,215314,218964,5,3650,2,7200,1.00136986301
215310,215321,219148,11,3827,2,7200,1.00287431408
215311,215327,218917,16,3590,2,7200,1.00445682451
215313,215332,218701,19,3369,2,7200,1.00563965568
215314,215337,219110,23,3773,2,7200,1.00609594487
215315,215342,219052,27,3710,2,7200,1.00727762803
215317,215349,219038,32,3689,2,7200,1.00867443752
215318,215354,219020,36,3666,2,7200,1.00981996727
215429,215648,220641,219,4993,2,43200,1.04386140597
215494,220069,220227,4575,158,16,324000,29.9556962025
215498,215643,253293,145,37650,4,172800,1.00385126162
216077,216083,216258,6,175,2,7200,1.03428571429
216423,216429,216470,6,41,2,18000,1.14634146341
216516,216523,221659,7,5136,2,18000,1.00136292835
216680,216687,220054,7,3367,2,7200,1.00207900208
216697,216705,220054,8,3349,2,7200,1.00238877277
216727,216734,220054,7,3320,2,7200,1.00210843373
216748,216754,220054,6,3300,2,7200,1.00181818182
216763,216770,220054,7,3284,2,7200,1.00213154689
216778,216784,220054,6,3270,2,7200,1.00183486239
216829,216836,220054,7,3218,2,7200,1.00217526414
216843,216851,216852,8,1,2,3600,1.0
216865,216872,220054,7,3182,2,7200,1.00219987429
216901,216907,220054,6,3147,2,7200,1.00190657769
216929,216937,220054,8,3117,2,7200,1.00256657042
216961,216968,220054,7,3086,2,7200,1.00226830849
217053,217059,220054,6,2995,2,7200,1.0020033389
217068,217075,220054,7,2979,2,7200,1.00234978181
217083,217089,220054,6,2965,2,7200,1.00202360877
217096,217103,217143,7,40,2,18000,1.175
217102,217123,217126,21,3,2,3600,2.4
217104,217111,220054,7,2943,2,7200,1.00237852531
217105,217118,220054,13,2936,2,7200,1.00442779292
217123,217130,220054,7,2924,2,7200,1.00239398085
217124,217137,220054,13,2917,2,7200,1.00445663353
217139,217146,220055,7,2909,2,7200,1.0024063252
217156,217162,220058,6,2896,2,7200,1.0020718232
217211,217218,220055,7,2837,2,7200,1.00246739514
217258,217264,221573,6,4309,2,18000,1.00139243444
217263,217271,220055,8,2784,2,7200,1.00287356322
217287,217295,220055,8,2760,2,7200,1.00289855072
217303,217309,220055,6,2746,2,7200,1.00218499636
217322,217329,220055,7,2726,2,7200,1.002567865
217344,217558,217563,214,5,2,3600,21.9
217351,217357,220055,6,2698,2,7200,1.00222386953
217481,217487,220055,6,2568,2,7200,1.0023364486
217482,217494,220055,12,2561,2,7200,1.00468566966
217544,217551,220055,7,2504,2,7200,1.00279552716
217642,217650,220055,8,2405,2,7200,1.00332640333
217733,217739,220055,6,2316,2,7200,1.00259067358
217851,217859,220055,8,2196,2,7200,1.00364298725
218064,218847,219348,783,501,2,7200,2.5628742515
218704,218710,220055,6,1345,2,7200,1.00446096654
218918,218924,220055,6,1131,2,7200,1.00530503979
218968,218975,220055,7,1080,2,7200,1.00648148148
219000,219359,219695,359,336,2,10800,2.06845238095
219020,219027,220055,7,1028,2,7200,1.00680933852
219038,219044,220055,6,1011,2,7200,1.0059347181
219053,219060,220055,7,995,2,7200,1.00703517588
219118,219125,220055,7,930,2,7200,1.00752688172
219154,219162,220055,8,893,2,7200,1.00895856663
219571,219707,219891,136,184,2,10800,1.73913043478
219810,219903,219913,93,10,2,18000,10.3
219879,219891,221200,12,1309,2,18000,1.00916730328
220076,220083,223547,7,3464,2,7200,1.00202078522
220227,220233,220245,6,12,2,18000,1.5
220358,220366,220399,8,33,2,18000,1.24242424242
220435,220442,220506,7,64,2,18000,1.109375
220454,220460,220477,6,17,2,18000,1.35294117647
220454,220466,220480,12,14,2,18000,1.85714285714
220455,220473,220484,18,11,2,18000,2.63636363636
220456,220483,220484,27,1,2,18000,2.8
220456,220478,220485,22,7,2,18000,2.9
220456,220489,220495,33,6,2,18000,3.9
220545,220553,224966,8,4413,2,18000,1.00181282574
221053,221061,242459,8,21398,2,43200,1.00037386672
221163,221170,244633,7,23463,2,43200,1.00029834207
221497,221504,221553,7,49,2,900,1.14285714286
221507,221514,221607,7,93,2,900,1.0752688172
221857,221865,226393,8,4528,2,18000,1.00176678445
221868,221875,226389,7,4514,2,18000,1.00155073106
221971,221978,225474,7,3496,2,7200,1.00200228833
221972,221985,225462,13,3477,2,7200,1.00373885534
221974,221990,225583,16,3593,2,7200,1.00445310326
221975,221995,225392,20,3397,2,7200,1.00588754784
221976,222001,225699,25,3698,2,7200,1.00676041103
221978,222006,225114,28,3108,2,7200,1.00900900901
221979,222012,225582,33,3570,2,7200,1.00924369748
221980,222017,225615,37,3598,2,7200,1.01028349083
221982,222022,225627,40,3605,2,7200,1.01109570042
221983,222028,225630,45,3602,2,7200,1.01249305941
221984,222033,225346,49,3313,2,7200,1.01479022034
221986,222038,225458,52,3420,2,7200,1.01520467836
221987,222044,225350,57,3306,2,7200,1.01724137931
221989,222049,225609,60,3560,2,7200,1.01685393258
221990,222054,225610,64,3556,2,7200,1.01799775028
221991,222059,225393,68,3334,2,7200,1.02039592082
221993,222065,225568,72,3503,2,7200,1.02055381102
221994,222070,225460,76,3390,2,7200,1.02241887906
221995,222075,225431,80,3356,2,7200,1.02383790226
221997,222082,225475,85,3393,2,7200,1.02505157678
221998,222087,225436,89,3349,2,7200,1.02657509704
221999,222092,225661,93,3569,2,7200,1.02605771925
222001,222097,225437,96,3340,2,7200,1.02874251497
222002,222103,225164,101,3061,2,7200,1.03299575302
222003,222108,225571,105,3463,2,7200,1.03032053133
222005,222113,225081,108,2968,2,7200,1.03638814016
222006,222118,225560,112,3442,2,7200,1.03253922138
222007,222125,225278,118,3153,2,7200,1.03742467491
222009,222130,225814,121,3684,2,7200,1.03284473398
222010,222135,225645,125,3510,2,7200,1.03561253561
222011,222141,225297,130,3156,2,7200,1.0411913815
222013,222146,225598,133,3452,2,7200,1.03852838934
222014,222151,225564,137,3413,2,7200,1.04014063873
222015,222156,225541,141,3385,2,7200,1.04165435746
222017,222162,225573,145,3411,2,7200,1.042509528
222018,222167,225749,149,3582,2,7200,1.04159687326
222020,222172,225622,152,3450,2,7200,1.04405797101
222021,222177,225696,156,3519,2,7200,1.04433077579
222023,222183,225608,160,3425,2,7200,1.04671532847
222969,223561,224498,592,937,2,18000,1.6318036286
223120,223571,226397,451,2826,2,18000,1.15958952583
223547,223554,227047,7,3493,2,7200,1.00200400802
223673,225412,225448,1739,36,2,900,49.3055555556
223683,225407,225509,1724,102,2,900,17.9019607843
223704,224978,225972,1274,994,2,18000,2.28169014085
223789,225127,228447,1338,3320,2,18000,1.40301204819
223936,224511,225851,575,1340,2,18000,1.42910447761
224221,225488,226392,1267,904,8,324000,2.40154867257
224531,226408,226410,1877,2,10,43200,187.9
224735,226417,226423,1682,6,16,324000,168.8
225084,225091,228646,7,3555,2,7200,1.00196905767
225113,225119,228685,6,3566,2,7200,1.00168255749
225129,225361,229605,232,4244,2,18000,1.05466540999
225169,225175,228904,6,3729,2,7200,1.00160901046
225200,225368,226410,168,1042,2,18000,1.16122840691
225286,225294,228757,8,3463,2,7200,1.00231013572
225304,225311,228670,7,3359,2,7200,1.00208395356
225347,225354,228814,7,3460,2,7200,1.00202312139
225362,225375,228769,13,3394,2,7200,1.00383028874
225393,225400,229001,7,3601,2,7200,1.00194390447
225408,225419,228839,11,3420,2,7200,1.00321637427
225429,225436,229076,7,3640,2,7200,1.00192307692
225444,225450,229027,6,3577,2,7200,1.00167738328
225445,225457,228906,12,3449,2,7200,1.00347926935
225460,225467,228851,7,3384,2,7200,1.00206855792
225475,225481,228962,6,3481,2,7200,1.00172364263
225476,225493,228815,17,3322,2,7200,1.00511739916
225478,225499,228869,21,3370,2,7200,1.00623145401
225479,225504,228925,25,3421,2,7200,1.00730780474
225543,225549,228651,6,3102,2,7200,1.00193423598
225564,225571,229073,7,3502,2,7200,1.0019988578
225565,225578,229247,13,3669,2,7200,1.00354319978
225587,225594,228846,7,3252,2,7200,1.00215252153
225588,225601,228969,13,3368,2,7200,1.00385985748
225590,225606,229378,16,3772,2,7200,1.00424178155
225591,225611,229007,20,3396,2,7200,1.00588928151
225593,225617,228976,24,3359,2,7200,1.00714498363
225613,225623,228970,10,3347,2,7200,1.00298775022
225614,225629,229089,15,3460,2,7200,1.00433526012
225616,225634,229073,18,3439,2,7200,1.00523407967
225617,225639,228731,22,3092,2,7200,1.00711513583
225618,225646,228717,28,3071,2,7200,1.00911755129
225637,225651,229026,14,3375,2,7200,1.00414814815
225638,225657,229207,19,3550,2,7200,1.00535211268
225639,225662,229146,23,3484,2,7200,1.00660160735
225654,225669,229004,15,3335,2,7200,1.00449775112
225669,225675,229009,6,3334,2,7200,1.00179964007
225698,225704,229144,6,3440,2,7200,1.00174418605
225699,225711,229115,12,3404,2,7200,1.00352526439
225753,225760,229072,7,3312,2,7200,1.00211352657
225812,225863,226404,51,541,2,18000,1.09426987061
225813,225821,229464,8,3643,2,7200,1.00219599231
226003,226009,226022,6,13,2,18000,1.46153846154
226062,226069,226427,7,358,2,18000,1.01955307263
226578,226584,226647,6,63,16,324000,1.09523809524
226629,226635,226638,6,3,1,90000,1.0
226703,226710,233643,7,6933,2,18000,1.00100966393
226774,226781,250178,7,23397,16,324000,1.00029918366
227051,227057,230383,6,3326,2,7200,1.00180396873
227536,227560,230324,24,2764,2,18000,1.00868306802
227891,227897,230639,6,2742,2,18000,1.00218818381
227922,227928,232538,6,4610,2,18000,1.00130151844
227980,227987,232347,7,4360,2,18000,1.00160550459
228000,228007,233116,7,5109,2,18000,1.00137013114
228016,228023,232972,7,4949,2,18000,1.00141442716
228107,237379,289481,9272,52102,8,324000,1.17795861963
228272,237393,237399,9121,6,10,43200,912.7
228413,228420,229765,7,1345,2,10800,1.00520446097
228650,228656,232137,6,3481,2,7200,1.00172364263
228665,228672,231744,7,3072,2,7200,1.00227864583
228680,228687,232079,7,3392,2,7200,1.00206367925
228695,228702,232340,7,3638,2,7200,1.00192413414
228721,228728,232223,7,3495,2,7200,1.00200286123
228735,228743,231994,8,3251,2,7200,1.0024607813
228759,228765,232267,6,3502,2,7200,1.00171330668
228774,228780,232007,6,3227,2,7200,1.00185931205
228816,228823,232333,7,3510,2,7200,1.00199430199
228817,228830,232023,13,3193,2,7200,1.0040714062
228838,228845,232405,7,3560,2,7200,1.00196629213
228853,228860,232248,7,3388,2,7200,1.0020661157
228854,228867,232250,13,3383,2,7200,1.00384274313
228859,228919,228928,60,9,1,3600,6.9
228869,228875,232274,6,3399,2,7200,1.00176522507
228905,228912,232305,7,3393,2,7200,1.00206307103
228920,228926,232054,6,3128,2,7200,1.00191815857
228935,228941,232436,6,3495,2,7200,1.0017167382
228964,228970,232474,6,3504,2,7200,1.00171232877
228979,228986,232347,7,3361,2,7200,1.00208271348
228981,228993,232484,12,3491,2,7200,1.00343741048
228982,228998,232524,16,3526,2,7200,1.0045377198
229003,229010,232609,7,3599,2,7200,1.00194498472
229023,229030,232221,7,3191,2,7200,1.0021936697
229025,229036,232468,11,3432,2,7200,1.00320512821
229026,229042,232291,16,3249,2,7200,1.00492459218
229043,229050,232325,7,3275,2,7200,1.00213740458
229045,229057,232308,12,3251,2,7200,1.00369117195
229076,229083,232795,7,3712,2,7200,1.00188577586
229077,229090,232688,13,3598,2,7200,1.0036131184
229079,229095,232255,16,3160,2,7200,1.00506329114
229080,229100,232536,20,3436,2,7200,1.00582072177
229097,229107,232470,10,3363,2,7200,1.00297353553
229118,229124,232178,6,3054,2,7200,1.00196463654
229146,229153,232380,7,3227,2,7200,1.0021691974
229163,229170,232579,7,3409,2,7200,1.00205338809
229208,229214,232724,6,3510,2,7200,1.00170940171
229255,229262,232550,7,3288,2,7200,1.00212895377
229380,229386,232721,6,3335,2,7200,1.00179910045
229467,229474,233010,7,3536,2,7200,1.00197963801
229567,229783,235589,216,5806,2,18000,1.03720289356
229692,230336,235900,644,5564,2,18000,1.11574406902
229811,230519,234817,708,4298,1,90000,1.16472778036
230386,230392,233810,6,3418,2,7200,1.00175541252
231119,231125,233615,6,2490,2,18000,1.00240963855
231575,237398,410218,5823,172820,8,172800,1.0336940169
231747,231753,235222,6,3469,2,7200,1.00172960507
231994,232001,235454,7,3453,2,7200,1.0020272227
232009,232016,235414,7,3398,2,7200,1.00206003531
232024,232030,235509,6,3479,2,7200,1.00172463352
232054,232060,235404,6,3344,2,7200,1.00179425837
232081,232088,235421,7,3333,2,7200,1.00210021002
232139,232146,235927,7,3781,2,7200,1.00185136207
232182,232189,235757,7,3568,2,7200,1.00196188341
232223,232231,235697,8,3466,2,7200,1.00230813618
232240,232246,235503,6,3257,2,7200,1.00184218606
232267,232273,235770,6,3497,2,7200,1.00171575636
232268,232280,235812,12,3532,2,7200,1.00339750849
232270,232285,235512,15,3227,2,7200,1.00464828014
232271,232290,235868,19,3578,2,7200,1.00531022918
232286,232297,235796,11,3499,2,7200,1.00314375536
232301,232307,235859,6,3552,2,7200,1.00168918919
232335,232341,235522,6,3181,2,7200,1.00188619931
232336,232348,235989,12,3641,2,7200,1.00329579786
232337,232353,235747,16,3394,2,7200,1.00471420153
232339,232358,235669,19,3311,2,7200,1.0057384476
232353,232370,235738,17,3368,2,7200,1.00504750594
232355,232364,232371,9,7,16,3600,1.6
232355,232375,235934,20,3559,2,7200,1.00561955606
232380,232387,235978,7,3591,2,7200,1.00194931774
232408,232415,236079,7,3664,2,7200,1.00191048035
232438,232444,236130,6,3686,2,7200,1.00162778079
232468,232475,235930,7,3455,2,7200,1.0020260492
232483,232489,235908,6,3419,2,7200,1.00175489909
232484,232496,235821,12,3325,2,7200,1.00360902256
232499,232506,235893,7,3387,2,7200,1.00206672572
232523,232529,235976,6,3447,2,7200,1.00174064404
232537,232544,236006,7,3462,2,7200,1.00202195263
232552,232558,236103,6,3545,2,7200,1.00169252468
232579,232585,236098,6,3513,2,7200,1.00170794193
232613,232619,236290,6,3671,2,7200,1.00163443203
232616,232625,233326,9,701,16,3600,1.01283880171
232659,232733,237346,74,4613,2,18000,1.0160416215
232690,232698,236142,8,3444,2,7200,1.00232288037
232720,232726,235994,6,3268,2,7200,1.00183598531
232735,232741,235986,6,3245,2,7200,1.00184899846
232795,232801,236088,6,3287,2,7200,1.00182537268
233010,233017,236543,7,3526,2,7200,1.00198525241
233332,233338,235791,6,2453,2,18000,1.00244598451
233428,233435,234912,7,1477,16,3600,1.00473933649
233619,233625,238310,6,4685,2,18000,1.00128068303
233656,233663,234150,7,487,2,18000,1.01437371663
233812,233819,237107,7,3288,2,7200,1.00212895377
233970,234555,235149,585,594,2,10800,1.98484848485
234148,235161,238318,1013,3157,2,18000,1.3208742477
234624,235063,236578,439,1515,2,18000,1.2897689769
234818,234824,235466,6,642,1,600,1.00934579439
234918,234925,235098,7,173,16,14400,1.04046242775
235224,235231,238532,7,3301,2,7200,1.00212056952
235282,235426,237357,144,1931,2,18000,1.07457276023
235407,235413,238979,6,3566,2,7200,1.00168255749
235422,235432,238973,10,3541,2,7200,1.002824061
235423,235438,239101,15,3663,2,7200,1.0040950041
235456,235462,238932,6,3470,2,7200,1.00172910663
235470,235476,238944,6,3468,2,14400,1.00173010381
235489,235518,237482,29,1964,2,18000,1.01476578411
235505,235512,239011,7,3499,2,7200,1.00200057159
235521,235528,239069,7,3541,2,7200,1.0019768427
235522,235535,238826,13,3291,2,7200,1.00395016712
235523,235540,239067,17,3527,2,7200,1.00481996031
235672,235679,239187,7,3508,2,7200,1.001995439
235700,235707,238993,7,3286,2,7200,1.00213024954
235739,235746,239182,7,3436,2,7200,1.00203725262
235756,235762,239305,6,3543,2,7200,1.0016934801
235772,235779,239192,7,3413,2,7200,1.00205098154
235773,235785,238939,12,3154,2,7200,1.00380469245
235797,235804,239173,7,3369,2,7200,1.00207776788
235815,235822,239222,7,3400,2,7200,1.00205882353
235830,235836,239356,6,3520,2,7200,1.00170454545
235860,235867,239133,7,3266,2,7200,1.00214329455
235875,235881,239165,6,3284,2,7200,1.00182704019
235895,235903,239289,8,3386,2,7200,1.00236266982
235906,235911,239626,5,3715,2,14400,1.00134589502
235910,235917,239233,7,3316,2,7200,1.00211097708
235928,235934,239518,6,3584,2,7200,1.00167410714
235944,235950,239179,6,3229,2,7200,1.00185816042
235945,235956,239231,11,3275,2,7200,1.00335877863
235956,236110,237363,154,1253,2,18000,1.12290502793
235977,235983,239318,6,3335,2,7200,1.00179910045
235992,235999,239535,7,3536,2,7200,1.00197963801
235993,236004,239417,11,3413,2,7200,1.00322297099
235995,236012,239297,17,3285,2,7200,1.00517503805
236010,236019,239320,9,3301,2,7200,1.00272644653
236011,236024,239617,13,3593,2,7200,1.0036181464
236034,236090,242278,56,6188,2,18000,1.00904977376
236086,236098,239382,12,3284,2,7200,1.00365408039
236088,236103,239567,15,3464,2,7200,1.00433025404
236108,236116,239546,8,3430,2,7200,1.00233236152
236109,236122,239570,13,3448,2,7200,1.00377030162
236130,236136,239577,6,3441,2,7200,1.00174367916
236149,236155,239440,6,3285,2,7200,1.00182648402
236294,236301,239621,7,3320,2,7200,1.00210843373
236423,236506,237369,83,863,2,14400,1.09617612978
236547,236554,239764,7,3210,2,7200,1.00218068536
236773,236780,238810,7,2030,2,14400,1.00344827586
237109,237116,240780,7,3664,2,7200,1.00191048035
237340,237346,237349,6,3,2,18000,1.0
238206,238213,281442,7,43229,3,43200,1.00016192834
238382,238389,242738,7,4349,2,18000,1.00160956542
238482,238489,238519,7,30,3,43200,1.23333333333
238535,238542,242036,7,3494,2,7200,1.00200343446
238828,238834,242188,6,3354,2,7200,1.00178890877
238896,238903,243446,7,4543,2,18000,1.00154083205
238933,238940,242166,7,3226,2,7200,1.00216986981
238936,238947,244955,11,6008,2,18000,1.00183089214
238948,238956,242344,8,3388,2,7200,1.00236127509
238975,238982,242549,7,3567,2,7200,1.00196243342
238989,238996,242371,7,3375,2,7200,1.00207407407
239005,239012,242498,7,3486,2,7200,1.00200803213
239020,239026,242260,6,3234,2,7200,1.00185528757
239070,239077,242510,7,3433,2,7200,1.00203903292
239071,239084,242566,13,3482,2,7200,1.0037334865
239106,239113,242444,7,3331,2,7200,1.00210147103
239134,239141,242473,7,3332,2,7200,1.00210084034
239167,239173,242658,6,3485,2,7200,1.00172166428
239183,239190,242709,7,3519,2,7200,1.00198920148
239185,239197,242483,12,3286,2,7200,1.00365185636
239186,239202,242759,16,3557,2,7200,1.00449817262
239202,239209,242864,7,3655,2,7200,1.00191518468
239204,239215,242974,11,3759,2,7200,1.00292631019
239222,239228,242719,6,3491,2,7200,1.00171870524
239242,239249,242887,7,3638,2,7200,1.00192413414
239243,239255,242382,12,3127,2,7200,1.00383754397
239292,239298,242366,6,3068,2,7200,1.00195567145
239307,239313,243084,6,3771,2,7200,1.0015910899
239309,239320,242714,11,3394,2,7200,1.00324101355
239323,239330,242613,7,3283,2,7200,1.00213219616
239325,239337,242525,12,3188,2,7200,1.00376411543
239358,239365,242858,7,3493,2,7200,1.00200400802
239384,239392,242586,8,3194,2,7200,1.00250469631
239420,239427,242870,7,3443,2,7200,1.00203311066
239441,239448,242588,7,3140,2,7200,1.00222929936
239520,239526,243011,6,3485,2,7200,1.00172166428
239537,239543,242583,6,3040,2,7200,1.00197368421
239553,239560,242669,7,3109,2,7200,1.00225152782
239573,239580,242919,7,3339,2,7200,1.00209643606
239575,239586,243174,11,3588,2,7200,1.0030657748
239589,239597,242984,8,3387,2,7200,1.00236197225
239619,239625,243151,6,3526,2,7200,1.00170164492
239621,239632,243264,11,3632,2,7200,1.00302863436
239767,239775,243328,8,3553,2,7200,1.00225161835
240784,240790,244517,6,3727,2,7200,1.00160987389
241376,241383,241992,7,609,16,14400,1.01149425287
242038,242044,245342,6,3298,2,7200,1.00181928441
242168,242175,245571,7,3396,2,7200,1.00206124853
242189,242196,245828,7,3632,2,7200,1.00192731278
242261,242268,245711,7,3443,2,7200,1.00203311066
242345,242352,246107,7,3755,2,7200,1.00186418109
242366,242372,245676,6,3304,2,7200,1.00181598063
242368,302852,302854,60484,2,38,172800,6048.6
242380,242387,245923,7,3536,2,7200,1.00197963801
242395,242401,246022,6,3621,2,7200,1.00165700083
242446,242453,245743,7,3290,2,7200,1.00212765957
242475,242481,245836,6,3355,2,7200,1.00178837556
242491,242497,246073,6,3576,2,7200,1.00167785235
242506,242513,245932,7,3419,2,7200,1.00204738228
242522,242529,245975,7,3446,2,7200,1.00203134068
242537,242544,246166,7,3622,2,7200,1.0019326339
242552,242558,246015,6,3457,2,7200,1.00173560891
242575,242582,246110,7,3528,2,7200,1.00198412698
242591,242598,246245,7,3647,2,7200,1.0019193858
242592,242605,246016,13,3411,2,7200,1.00381119906
242594,242610,245893,16,3283,2,7200,1.00487359123
242615,242622,246168,7,3546,2,7200,1.00197405527
242658,242664,246269,6,3605,2,7200,1.00166435506
242672,242678,246045,6,3367,2,7200,1.00178200178
242711,242717,246385,6,3668,2,7200,1.00163576881
242726,242733,246274,7,3541,2,7200,1.0019768427
242727,242738,246135,11,3397,2,7200,1.00323815131
242761,242768,246339,7,3571,2,7200,1.00196023523
242863,242869,246367,6,3498,2,7200,1.00171526587
242878,242884,246407,6,3523,2,7200,1.00170309395
242879,242891,246343,12,3452,2,7200,1.00347624565
242894,242901,246078,7,3177,2,7200,1.00220333648
242921,242928,246462,7,3534,2,7200,1.00198075835
242978,242985,246382,7,3397,2,7200,1.00206064174
242993,242999,246559,6,3560,2,7200,1.00168539326
243014,243021,246676,7,3655,2,7200,1.00191518468
243083,243089,246317,6,3228,2,7200,1.00185873606
243152,243159,246650,7,3491,2,7200,1.00200515612
243177,243183,246516,6,3333,2,7200,1.00180018002
243270,243276,246708,6,3432,2,7200,1.00174825175
243331,243338,246673,7,3335,2,7200,1.00209895052
244327,244334,244376,7,42,4,259200,1.16666666667
244519,244525,247957,6,3432,2,7200,1.00174825175
244950,244957,397244,7,152287,1,259200,1.00004596584
245068,245074,392050,6,146976,1,259200,1.00004082299
245344,245351,248787,7,3436,2,7200,1.00203725262
245436,245442,414166,6,168724,1,259200,1.00003556103
245508,245515,399473,7,153958,1,259200,1.00004546695
245571,245578,249104,7,3526,2,7200,1.00198525241
245681,245688,249159,7,3471,2,7200,1.00201670988
245719,245726,248821,7,3095,2,7200,1.00226171244
245743,245750,249098,7,3348,2,7200,1.00209080048
245786,245793,245795,7,2,2,3540,1.0
245827,245833,249325,6,3492,2,7200,1.00171821306
245842,245848,249260,6,3412,2,7200,1.00175849941
245893,245900,249333,7,3433,2,7200,1.00203903292
245923,245929,249186,6,3257,2,7200,1.00184218606
245937,245944,249368,7,3424,2,7200,1.00204439252
245973,245981,249215,8,3234,2,7200,1.00247371676
246016,246022,249371,6,3349,2,7200,1.00179157958
246017,246029,249511,12,3482,2,7200,1.00344629523
246032,246039,249561,7,3522,2,7200,1.0019875071
246046,246052,249423,6,3371,2,7200,1.00177988727
246073,246080,249588,7,3508,2,7200,1.001995439
246088,246094,249442,6,3348,2,7200,1.0017921147
246109,246116,249504,7,3388,2,7200,1.0020661157
246124,246130,249458,6,3328,2,7200,1.00180288462
246138,246145,249419,7,3274,2,7200,1.00213805742
246165,246171,249489,6,3318,2,7200,1.00180831826
246180,246187,249498,7,3311,2,7200,1.0021141649
246246,246253,249552,7,3299,2,7200,1.00212185511
246267,246273,249589,6,3316,2,7200,1.00180940893
246281,246288,249880,7,3592,2,7200,1.00194877506
246317,246323,249720,6,3397,2,7200,1.00176626435
246338,246344,249768,6,3424,2,7200,1.00175233645
246354,246361,249541,7,3180,2,7200,1.00220125786
246370,246377,249742,7,3365,2,7200,1.00208023774
246385,246393,249929,8,3536,2,7200,1.00226244344
246387,246398,249882,11,3484,2,7200,1.00315729047
246407,246415,249804,8,3389,2,7200,1.00236057834
246461,246469,249990,8,3521,2,7200,1.00227208179
246516,246522,249969,6,3447,2,7200,1.00174064404
246558,246564,250141,6,3577,2,7200,1.00167738328
246657,246664,250099,7,3435,2,7200,1.00203784571
246676,246682,250022,6,3340,2,7200,1.00179640719
246677,246689,250478,12,3789,2,7200,1.00316706255
246710,246717,250282,7,3565,2,7200,1.00196353436
247959,247965,251283,6,3318,2,7200,1.00180831826
248787,248793,252122,6,3329,2,7200,1.00180234305
248822,248829,252279,7,3450,2,7200,1.00202898551
249096,249104,252588,8,3484,2,7200,1.00229621125
249111,249117,252570,6,3453,2,7200,1.00173761946
249159,249166,252587,7,3421,2,7200,1.00204618533
249188,249195,252703,7,3508,2,7200,1.001995439
249219,249226,252731,7,3505,2,7200,1.00199714693
249261,249267,252703,6,3436,2,7200,1.00174621653
249327,249333,252839,6,3506,2,7200,1.00171135197
249342,249348,252606,6,3258,2,7200,1.00184162063
249370,249376,252800,6,3424,2,7200,1.00175233645
249386,249392,252930,6,3538,2,7200,1.00169587337
249419,249425,253123,6,3698,2,7200,1.00162249865
249435,249441,253021,6,3580,2,7200,1.00167597765
249450,249456,252999,6,3543,2,7200,1.0016934801
249465,249472,252999,7,3527,2,7200,1.00198468954
249487,249494,253003,7,3509,2,7200,1.00199487033
249502,249508,252921,6,3413,2,7200,1.00175798418
249517,249523,252795,6,3272,2,7200,1.00183374083
249518,249530,252903,12,3373,2,7200,1.0035576638
249539,249545,253103,6,3558,2,7200,1.00168634064
249554,249560,253049,6,3489,2,7200,1.00171969046
249569,249575,252909,6,3334,2,7200,1.00179964007
249590,249597,253158,7,3561,2,7200,1.00196573996
249591,249604,252943,13,3339,2,7200,1.00389338125
249720,249728,253097,8,3369,2,7200,1.00237459187
249744,249751,253299,7,3548,2,7200,1.0019729425
249768,249774,253055,6,3281,2,7200,1.00182871076
249804,249811,253089,7,3278,2,7200,1.00213544844
249884,249890,253297,6,3407,2,7200,1.00176108013
249885,249897,253215,12,3318,2,7200,1.00361663653
249931,249938,253397,7,3459,2,7200,1.00202370627
249971,249977,253585,6,3608,2,7200,1.00166297118
249993,250000,253604,7,3604,2,7200,1.00194228635
250023,250029,253459,6,3430,2,7200,1.00174927114
250101,250107,253641,6,3534,2,7200,1.00169779287
250145,250152,253682,7,3530,2,7200,1.00198300283
250177,250190,303247,13,53057,16,324000,1.00024501951
250283,250291,253584,8,3293,2,7200,1.00242939569
250299,250306,255784,7,5478,2,18000,1.00127783863
250465,250471,255078,6,4607,2,18000,1.00130236596
250479,250486,253771,7,3285,2,7200,1.00213089802
250563,250569,251982,6,1413,2,18000,1.0042462845
251200,251207,256941,7,5734,2,18000,1.00122078828
251284,251290,254681,6,3391,2,7200,1.00176938956
252126,252132,255632,6,3500,2,7200,1.00171428571
252130,252140,856982,10,604842,3,604800,1.00001653324
252281,252288,255822,7,3534,2,7200,1.00198075835
252575,252582,256339,7,3757,2,7200,1.00186318871
252596,252602,256138,6,3536,2,7200,1.00169683258
252598,252609,256146,11,3537,2,7200,1.00310998021
252615,252621,256126,6,3505,2,7200,1.00171184023
252705,252712,255883,7,3171,2,7200,1.00220750552
252706,252719,256051,13,3332,2,7200,1.00390156062
252733,252741,256245,8,3504,2,7200,1.00228310502
252783,252790,253106,7,316,2,18000,1.02215189873
252797,252804,256199,7,3395,2,7200,1.00206185567
252811,252818,256337,7,3519,2,7200,1.00198920148
252824,252830,253195,6,365,2,18000,1.01643835616
252844,252850,256062,6,3212,2,7200,1.00186799502
252904,252910,256483,6,3573,2,7200,1.00167926113
252919,252926,256271,7,3345,2,7200,1.00209267564
252934,252940,256454,6,3514,2,7200,1.00170745589
252935,252947,256280,12,3333,2,7200,1.00360036004
252950,252956,256573,6,3617,2,7200,1.00165883329
252971,252978,252986,7,8,1,1200,1.5
253001,253008,256574,7,3566,2,7200,1.00196298374
253003,253015,256327,12,3312,2,7200,1.00362318841
253017,253025,256331,8,3306,2,7200,1.00241984271
253032,253039,256610,7,3571,2,7200,1.00196023523
253050,253057,256463,7,3406,2,7200,1.00205519671
253065,253072,256420,7,3348,2,7200,1.00209080048
253089,253095,256419,6,3324,2,7200,1.00180505415
253104,253111,256445,7,3334,2,7200,1.00209958008
253105,253118,256626,13,3508,2,7200,1.00370581528
253123,253130,256563,7,3433,2,7200,1.00203903292
253159,253165,256845,6,3680,2,7200,1.00163043478
253170,253177,295272,7,42095,2,43200,1.00016629053
253197,253203,253418,6,215,2,18000,1.02790697674
253216,253222,256622,6,3400,2,7200,1.00176470588
253253,253260,295272,7,42012,2,43200,1.00016661906
253297,253304,256654,7,3350,2,7200,1.00208955224
253311,253318,256760,7,3442,2,7200,1.00203370134
253399,253405,256678,6,3273,2,7200,1.00183318057
253460,253466,256985,6,3519,2,7200,1.00170502984
253531,253537,253539,6,2,1,60,1.0
253588,253595,257158,7,3563,2,7200,1.00196463654
253589,253602,257067,13,3465,2,7200,1.00375180375
253606,253613,257036,7,3423,2,7200,1.00204498978
253642,253648,257283,6,3635,2,7200,1.00165061898
253684,253691,257096,7,3405,2,7200,1.00205580029
253697,253705,254344,8,639,1,600,1.01251956182
253771,253777,256978,6,3201,2,7200,1.00187441425
254448,254455,255063,7,608,2,900,1.01151315789
254452,254467,255131,15,664,2,900,1.02259036145
254454,254461,255133,7,672,2,900,1.01041666667
254456,254473,255135,17,662,2,900,1.02567975831
254691,254697,258195,6,3498,2,7200,1.00171526587
254728,255091,255142,363,51,4,259200,8.11764705882
254801,255241,255831,440,590,4,14400,1.74576271186
254814,255154,255229,340,75,4,259200,5.53333333333
255344,255644,255821,300,177,2,900,2.69491525424
255347,255690,255781,343,91,2,900,4.76923076923
255349,255695,255742,346,47,2,900,8.36170212766
255640,255650,259191,10,3541,2,7200,1.002824061
255789,255796,256442,7,646,2,18000,1.01083591331
255824,255830,259253,6,3423,2,7200,1.00175284838
255884,255890,259381,6,3491,2,7200,1.00171870524
256056,256063,259599,7,3536,2,7200,1.00197963801
256071,256078,259490,7,3412,2,7200,1.00205158265
256107,256114,261779,7,5665,2,18000,1.00123565755
256130,256137,259681,7,3544,2,7200,1.0019751693
256145,256151,259508,6,3357,2,7200,1.0017873101
256147,256159,259614,12,3455,2,7200,1.00347322721
256198,256205,259600,7,3395,2,7200,1.00206185567
256246,256253,259691,7,3438,2,7200,1.00203606748
256273,256279,259823,6,3544,2,7200,1.00169300226
256288,256295,259520,7,3225,2,7200,1.00217054264
256327,256333,260060,6,3727,2,7200,1.00160987389
256343,256351,259694,8,3343,2,7200,1.00239306013
256345,256358,259848,13,3490,2,7200,1.00372492837
256346,256363,259829,17,3466,2,7200,1.00490478938
256426,256432,259920,6,3488,2,7200,1.00172018349
256427,256440,259756,13,3316,2,7200,1.00392038601
256448,256454,260025,6,3571,2,7200,1.00168020162
256464,256471,259949,7,3478,2,7200,1.00201265095
256465,256478,259845,13,3367,2,7200,1.00386100386
256483,256490,259806,7,3316,2,7200,1.00211097708
256566,256573,260142,7,3569,2,7200,1.00196133371
256581,256588,260088,7,3500,2,7200,1.002
256582,256593,260197,11,3604,2,7200,1.00305216426
256612,256620,260049,8,3429,2,7200,1.0023330417
256627,256634,260048,7,3414,2,7200,1.00205038079
256629,256641,259870,12,3229,2,7200,1.00371632084
256656,256663,260198,7,3535,2,7200,1.00198019802
256679,256687,260151,8,3464,2,7200,1.00230946882
256683,256694,257805,11,1111,4,14400,1.0099009901
256760,256767,260336,7,3569,2,7200,1.00196133371
256845,256851,260296,6,3445,2,7200,1.00174165457
256978,256985,260482,7,3497,2,7200,1.00200171576
256992,257000,260337,8,3337,2,7200,1.0023973629
257038,257045,260455,7,3410,2,7200,1.00205278592
257068,257074,260613,6,3539,2,7200,1.00169539418
257099,257105,260655,6,3550,2,7200,1.00169014085
257159,257165,260734,6,3569,2,7200,1.00168114318
257232,257239,258879,7,1640,2,18000,1.00426829268
257285,257291,260772,6,3481,2,7200,1.00172364263
258195,258201,261627,6,3426,2,7200,1.00175131349
259198,259205,262671,7,3466,2,7200,1.00201961916
259252,259260,262771,8,3511,2,7200,1.00227855312
259383,259390,262800,7,3410,2,7200,1.00205278592
259493,259500,262800,7,3300,2,7200,1.00212121212
259509,259516,262918,7,3402,2,7200,1.00205761317
259525,259531,263155,6,3624,2,7200,1.00165562914
259601,259608,263023,7,3415,2,7200,1.00204978038
259602,259614,263039,12,3425,2,7200,1.00350364964
259620,259626,262923,6,3297,2,7200,1.00181983621
259683,259689,263330,6,3641,2,7200,1.00164789893
259699,259706,263162,7,3456,2,7200,1.00202546296
259700,259713,263034,13,3321,2,7200,1.00391448359
259758,259765,263076,7,3311,2,7200,1.0021141649
259806,259813,263420,7,3607,2,7200,1.00194067092
259824,259831,263310,7,3479,2,7200,1.00201207243
259839,259845,263272,6,3427,2,7200,1.00175080245
259854,259860,263342,6,3482,2,7200,1.00172314762
259855,259867,263103,12,3236,2,7200,1.00370828183
259870,259876,263133,6,3257,2,7200,1.00184218606
259921,259927,263295,6,3368,2,7200,1.00178147268
259951,259957,263291,6,3334,2,7200,1.00179964007
260026,260033,263327,7,3294,2,7200,1.0021250759
260050,260056,263611,6,3555,2,7200,1.00168776371
260051,260063,263595,12,3532,2,7200,1.00339750849
260066,260073,263501,7,3428,2,7200,1.002042007
260090,260097,263558,7,3461,2,7200,1.00202253684
260145,260153,263623,8,3470,2,7200,1.0023054755
260160,260166,263688,6,3522,2,7200,1.00170357751
260197,260204,263585,7,3381,2,7200,1.00207039337
260199,260211,263514,12,3303,2,7200,1.00363306085
260298,260305,263735,7,3430,2,7200,1.00204081633
260334,260342,263855,8,3513,2,7200,1.00227725591
260349,260355,263845,6,3490,2,7200,1.00171919771
260458,260464,263714,6,3250,2,7200,1.00184615385
260482,260488,263793,6,3305,2,7200,1.00181543116
260614,260620,264152,6,3532,2,7200,1.00169875425
260656,260662,264070,6,3408,2,7200,1.00176056338
260731,260738,264072,7,3334,2,7200,1.00209958008
260773,260779,264212,6,3433,2,7200,1.0017477425
261626,261632,264785,6,3153,2,7200,1.00190294957
262675,262681,266082,6,3401,2,7200,1.001764187
262775,262781,266199,6,3418,2,7200,1.00175541252
262806,262814,266072,8,3258,2,7200,1.00245549417
262808,262819,266128,11,3309,2,7200,1.00332426715
262919,262927,266211,8,3284,2,7200,1.00243605359
262934,262941,266577,7,3636,2,7200,1.00192519252
263024,263031,266550,7,3519,2,7200,1.00198920148
263039,263046,266137,7,3091,2,7200,1.00226463928
263041,263053,266545,12,3492,2,7200,1.00343642612
263074,263081,266637,7,3556,2,7200,1.00196850394
263104,263110,266642,6,3532,2,7200,1.00169875425
263134,263140,266756,6,3616,2,7200,1.00165929204
263155,263162,266596,7,3434,2,7200,1.00203843914
263170,263176,266784,6,3608,2,7200,1.00166297118
263274,263281,266734,7,3453,2,7200,1.0020272227
263291,263299,266766,8,3467,2,7200,1.00230747044
263306,263312,266863,6,3551,2,7200,1.00168966488
263321,263328,266650,7,3322,2,7200,1.00210716436
263336,263343,266693,7,3350,2,7200,1.00208955224
263337,263349,266917,12,3568,2,7200,1.0033632287
263352,263358,266800,6,3442,2,7200,1.00174317257
263421,263428,266887,7,3459,2,7200,1.00202370627
263502,263509,266948,7,3439,2,7200,1.00203547543
263517,263524,267016,7,3492,2,7200,1.0020045819
263559,263566,266964,7,3398,2,7200,1.00206003531
263586,263593,267121,7,3528,2,7200,1.00198412698
263601,263607,267057,6,3450,2,7200,1.00173913043
263617,263625,267147,8,3522,2,7200,1.00227143668
263632,263638,267221,6,3583,2,7200,1.00167457438
263689,263696,267260,7,3564,2,7200,1.0019640853
263716,263723,267062,7,3339,2,7200,1.00209643606
263737,263744,267132,7,3388,2,7200,1.0020661157
263791,263797,267321,6,3524,2,7200,1.00170261067
263846,263852,267350,6,3498,2,7200,1.00171526587
263861,263869,267144,8,3275,2,7200,1.00244274809
264071,264078,267352,7,3274,2,7200,1.00213805742
264072,264085,267652,13,3567,2,7200,1.0036445192
264154,264160,267594,6,3434,2,7200,1.00174723355
264211,264219,267476,8,3257,2,7200,1.00245624808
264784,264791,268517,7,3726,2,7200,1.00187869028
266074,266080,269367,6,3287,2,7200,1.00182537268
266091,266098,269615,7,3517,2,7200,1.00199033267
266126,266132,269581,6,3449,2,7200,1.00173963468
266141,266147,269785,6,3638,2,7200,1.00164925783
266201,266207,269692,6,3485,2,7200,1.00172166428
266216,266222,269544,6,3322,2,7200,1.00180614088
266544,266551,269977,7,3426,2,7200,1.00204319907
266559,266565,269872,6,3307,2,7200,1.00181433323
266581,266588,270051,7,3463,2,7200,1.00202136876
266597,266604,270064,7,3460,2,7200,1.00202312139
266642,266649,270008,7,3359,2,7200,1.00208395356
266644,266656,270143,12,3487,2,7200,1.0034413536
266660,266667,270390,7,3723,2,7200,1.00188020414
266692,266699,270041,7,3342,2,7200,1.00209455416
266737,266744,270093,7,3349,2,7200,1.00209017617
266763,266769,270120,6,3351,2,7200,1.0017905103
266764,266776,270293,12,3517,2,7200,1.00341199886
266789,266795,270493,6,3698,2,7200,1.00162249865
266804,266810,270309,6,3499,2,7200,1.00171477565
266867,266874,270207,7,3333,2,7200,1.00210021002
266889,266895,270499,6,3604,2,7200,1.00166481687
266919,266925,270438,6,3513,2,7200,1.00170794193
266949,266955,270363,6,3408,2,7200,1.00176056338
266966,266973,270244,7,3271,2,7200,1.00214001834
267017,267024,270434,7,3410,2,7200,1.00205278592
267059,267065,270438,6,3373,2,7200,1.0017788319
267074,267080,270605,6,3525,2,7200,1.00170212766
267123,267129,270637,6,3508,2,7200,1.00171037628
267138,267145,270557,7,3412,2,7200,1.00205158265
267155,267161,270743,6,3582,2,7200,1.00167504188
267157,267168,270549,11,3381,2,7200,1.0032534753
267223,267230,270839,7,3609,2,7200,1.00193959546
267262,267268,270800,6,3532,2,7200,1.00169875425
267324,267330,270818,6,3488,2,7200,1.00172018349
267351,267357,270940,6,3583,2,7200,1.00167457438
267366,267373,270766,7,3393,2,7200,1.00206307103
267474,267481,270846,7,3365,2,7200,1.00208023774
267592,267600,267601,8,1,2,3540,1.0
267595,267607,270929,12,3322,2,7200,1.00361228176
267652,267658,271029,6,3371,2,7200,1.00177988727
268519,268526,271740,7,3214,2,7200,1.00217797138
268548,268554,268726,6,172,1,3600,1.03488372093
268913,268919,269273,6,354,1,3600,1.01694915254
269368,269374,272722,6,3348,2,7200,1.0017921147
269546,269553,273164,7,3611,2,7200,1.00193852119
269583,269590,273031,7,3441,2,7200,1.00203429236
269617,269624,272958,7,3334,2,7200,1.00209958008
269652,269658,270488,6,830,1,3600,1.00722891566
269695,269702,273183,7,3481,2,7200,1.0020109164
269785,269791,272960,6,3169,2,7200,1.00189334175
269872,269880,273253,8,3373,2,7200,1.00237177587
269983,269989,273378,6,3389,2,7200,1.00177043376
270014,270021,273507,7,3486,2,7200,1.00200803213
270044,270051,273477,7,3426,2,7200,1.00204319907
270061,270068,273502,7,3434,2,7200,1.00203843914
270077,270083,273707,6,3624,2,7200,1.00165562914
270095,270101,273352,6,3251,2,7200,1.00184558597
270121,270128,273660,7,3532,2,7200,1.00198187995
270142,270149,273490,7,3341,2,7200,1.00209518108
270209,270216,273645,7,3429,2,7200,1.00204141149
270245,270251,273789,6,3538,2,7200,1.00169587337
270293,270299,273742,6,3443,2,7200,1.00174266628
270311,270318,273602,7,3284,2,7200,1.00213154689
270365,270372,273818,7,3446,2,7200,1.00203134068
270390,270396,274015,6,3619,2,7200,1.00165791655
270435,270442,274011,7,3569,2,7200,1.00196133371
270449,270456,273945,7,3489,2,7200,1.00200630553
270451,270463,273956,12,3493,2,7200,1.00343544231
270496,270503,273799,7,3296,2,7200,1.00212378641
270511,270518,273813,7,3295,2,7200,1.00212443096
270550,270556,274135,6,3579,2,7200,1.00167644593
270565,270571,273796,6,3225,2,7200,1.00186046512
270597,270604,270788,7,184,8,14400,1.03804347826
270607,270614,273985,7,3371,2,7200,1.00207653515
270639,270646,274074,7,3428,2,7200,1.002042007
270745,270751,273980,6,3229,2,7200,1.00185816042
270767,270773,274307,6,3534,2,7200,1.00169779287
270800,270807,273993,7,3186,2,7200,1.00219711237
270819,270825,274295,6,3470,2,7200,1.00172910663
270839,270847,274215,8,3368,2,7200,1.00237529691
270852,270858,272128,6,1270,1,14400,1.00472440945
270854,270864,274534,10,3670,2,7200,1.00272479564
270930,270937,274430,7,3493,2,7200,1.00200400802
270945,270952,274474,7,3522,2,7200,1.0019875071
271029,271036,274266,7,3230,2,7200,1.00216718266
271742,271749,275276,7,3527,2,7200,1.00198468954
271777,271784,271900,7,116,1,3600,1.06034482759
272083,272090,272412,7,322,1,3600,1.02173913043
272119,272127,272294,8,167,1,3600,1.04790419162
272472,272479,272843,7,364,1,3600,1.01923076923
272724,272732,276288,8,3556,2,7200,1.00224971879
272898,272904,273541,6,637,1,3600,1.00941915228
272956,272964,276189,8,3225,2,7200,1.00248062016
272971,272977,276273,6,3296,2,7200,1.00182038835
273031,273037,276373,6,3336,2,7200,1.00179856115
273167,273174,276790,7,3616,2,7200,1.00193584071
273185,273192,276602,7,3410,2,7200,1.00205278592
273212,273219,274084,7,865,1,3600,1.00809248555
273253,273260,276760,7,3500,2,7200,1.002
273352,273358,276631,6,3273,2,7200,1.00183318057
273379,273386,276656,7,3270,2,7200,1.00214067278
273478,273485,277053,7,3568,2,7200,1.00196188341
273493,273499,276948,6,3449,2,7200,1.00173963468
273508,273515,276868,7,3353,2,7200,1.00208768267
273510,273522,276837,12,3315,2,7200,1.0036199095
273603,273611,276859,8,3248,2,7200,1.00246305419
273648,273654,277121,6,3467,2,7200,1.00173060283
273663,273670,277304,7,3634,2,7200,1.00192625206
273708,273715,277213,7,3498,2,7200,1.00200114351
273744,273750,276903,6,3153,2,7200,1.00190294957
273792,273799,277325,7,3526,2,7200,1.00198525241
273807,273814,277185,7,3371,2,7200,1.00207653515
273808,273821,277237,13,3416,2,7200,1.00380562061
273823,273832,277156,9,3324,2,7200,1.00270758123
273825,273838,277238,13,3400,2,7200,1.00382352941
273946,273953,277435,7,3482,2,7200,1.00201033889
273961,273968,277727,7,3759,2,7200,1.00186219739
273982,273988,277505,6,3517,2,7200,1.00170599943
273997,274003,277360,6,3357,2,7200,1.0017873101
273998,274010,277690,12,3680,2,7200,1.00326086957
274013,274020,277270,7,3250,2,7200,1.00215384615
274028,274034,277455,6,3421,2,7200,1.00175387314
274076,274083,277553,7,3470,2,7200,1.00201729107
274133,274139,277535,6,3396,2,7200,1.00176678445
274218,274224,277757,6,3533,2,7200,1.00169827342
274267,274273,277673,6,3400,2,7200,1.00176470588
274294,274303,277657,9,3354,2,7200,1.00268336315
274309,274316,277722,7,3406,2,7200,1.00205519671
274432,274438,277946,6,3508,2,7200,1.00171037628
274479,274486,277863,7,3377,2,7200,1.00207284572
274534,274540,278043,6,3503,2,7200,1.00171281758
275278,275285,278780,7,3495,2,7200,1.00200286123
275397,275403,275522,6,119,1,3600,1.05042016807
275729,275736,276062,7,326,1,3600,1.02147239264
275731,275742,275795,11,53,12,432000,1.20754716981
275820,275826,275947,6,121,1,1800,1.04958677686
275833,276708,289816,875,13108,12,432000,1.06675312786
276191,276197,279648,6,3451,2,7200,1.00173862649
276259,276265,276379,6,114,1,1800,1.05263157895
276276,276282,279697,6,3415,2,7200,1.00175695461
276291,276297,279567,6,3270,2,7200,1.00183486239
276375,276382,279865,7,3483,2,7200,1.0020097617
276495,276501,277122,6,621,1,3600,1.00966183575
276601,276608,280248,7,3640,2,7200,1.00192307692
276631,276637,280031,6,3394,2,7200,1.00176782557
276658,276665,280046,7,3381,2,7200,1.00207039337
276763,276769,279929,6,3160,2,7200,1.00189873418
276790,276796,280260,6,3464,2,7200,1.00173210162
276840,276846,280087,6,3241,2,7200,1.00185128047
276862,276868,280072,6,3204,2,7200,1.00187265918
276878,276886,280397,8,3511,2,7200,1.00227855312
276904,276911,280191,7,3280,2,7200,1.00213414634
276947,276954,280261,7,3307,2,7200,1.0021167221
277004,277011,277607,7,596,1,1800,1.01174496644
277053,277060,280359,7,3299,2,7200,1.00212185511
277119,277126,280448,7,3322,2,7200,1.00210716436
277158,277164,280534,6,3370,2,7200,1.00178041543
277188,277194,280530,6,3336,2,7200,1.00179856115
277215,277221,280474,6,3253,2,7200,1.00184445128
277239,277246,280848,7,3602,2,7200,1.0019433648
277240,277253,280747,13,3494,2,7200,1.003720664
277270,277278,280678,8,3400,2,7200,1.00235294118
277306,277314,280674,8,3360,2,7200,1.00238095238
277327,277333,280750,6,3417,2,7200,1.00175592625
277360,277367,280807,7,3440,2,7200,1.00203488372
277435,277442,280954,7,3512,2,7200,1.00199316629
277456,277463,280803,7,3340,2,7200,1.00209580838
277507,277513,281152,6,3639,2,7200,1.00164880462
277534,277540,280760,6,3220,2,7200,1.00186335404
277555,277561,281034,6,3473,2,7200,1.00172761301
277659,277665,281122,6,3457,2,7200,1.00173560891
277675,277681,281048,6,3367,2,7200,1.00178200178
277693,277699,281062,6,3363,2,7200,1.00178412132
277724,277732,280913,8,3181,2,7200,1.00251493241
277739,277746,281137,7,3391,2,7200,1.00206428782
277761,277768,281280,7,3512,2,7200,1.00199316629
277864,277870,281375,6,3505,2,7200,1.00171184023
277948,277955,281377,7,3422,2,7200,1.00204558738
278045,278052,281444,7,3392,2,7200,1.00206367925
278783,278790,282180,7,3390,2,7200,1.00206489676
279419,279425,279474,6,49,1,1800,1.12244897959
279548,279555,279678,7,123,1,1800,1.05691056911
279568,279575,282664,7,3089,2,7200,1.00226610554
279649,279655,283036,6,3381,2,7200,1.00177462289
279698,279705,283126,7,3421,2,7200,1.00204618533
279799,279805,279917,6,112,1,1800,1.05357142857
279893,279900,283446,7,3546,2,7200,1.00197405527
279932,279938,283373,6,3435,2,7200,1.00174672489
280033,280040,283320,7,3280,2,7200,1.00213414634
280050,280057,283116,7,3059,2,7200,1.00228832952
280053,280064,280178,11,114,1,1800,1.09649122807
280071,280078,283670,7,3592,2,7200,1.00194877506
280088,280095,283551,7,3456,2,7200,1.00202546296
280191,280197,283487,6,3290,2,7200,1.00182370821
280248,280255,283685,7,3430,2,7200,1.00204081633
280263,280269,283897,6,3628,2,7200,1.00165380375
280264,280277,283572,13,3295,2,7200,1.00394537178
280361,280368,283842,7,3474,2,7200,1.00201496834
280399,280406,283932,7,3526,2,7200,1.00198525241
280451,280458,284024,7,3566,2,7200,1.00196298374
280476,280482,283992,6,3510,2,7200,1.00170940171
280533,280539,284218,6,3679,2,7200,1.00163087796
280534,280545,283983,11,3438,2,7200,1.00319953461
280675,280682,284130,7,3448,2,7200,1.00203016241
280691,280697,284158,6,3461,2,7200,1.001733603
280749,280756,284223,7,3467,2,7200,1.00201903663
280764,280771,284082,7,3311,2,7200,1.0021141649
280765,280778,284348,13,3570,2,7200,1.00364145658
280805,280811,284460,6,3649,2,7200,1.00164428611
280819,280826,284226,7,3400,2,7200,1.00205882353
280849,280855,284144,6,3289,2,7200,1.00182426269
280867,280873,281165,6,292,1,1800,1.02054794521
280900,280907,281510,7,603,1,1800,1.01160862355
280913,280920,284588,7,3668,2,7200,1.00190839695
280954,280961,284147,7,3186,2,7200,1.00219711237
281036,281042,284318,6,3276,2,7200,1.00183150183
281050,281057,284488,7,3431,2,7200,1.00204022151
281065,281072,284531,7,3459,2,7200,1.00202370627
281122,281129,284562,7,3433,2,7200,1.00203903292
281137,281143,284681,6,3538,2,7200,1.00169587337
281152,281158,284684,6,3526,2,7200,1.00170164492
281283,281290,284830,7,3540,2,7200,1.00197740113
281377,281383,284829,6,3446,2,7200,1.00174114916
281378,281390,284723,12,3333,2,7200,1.00360036004
281445,281453,284719,8,3266,2,7200,1.00244947949
282181,282187,285511,6,3324,2,7200,1.00180505415
282669,282675,286078,6,3403,2,7200,1.00176315016
283037,283044,286350,7,3306,2,7200,1.00211736237
283116,283123,286470,7,3347,2,7200,1.00209142516
283131,283138,286759,7,3621,2,7200,1.00193316763
283320,283327,286900,7,3573,2,7200,1.00195913798
283374,283380,286823,6,3443,2,7200,1.00174266628
283446,283454,286872,8,3418,2,7200,1.00234055003
283473,283480,283530,7,50,1,1800,1.14
283488,283496,286791,8,3295,2,7200,1.00242792109
283552,283559,286980,7,3421,2,7200,1.00204618533
283575,283581,287157,6,3576,2,7200,1.00167785235
283671,283678,287153,7,3475,2,7200,1.00201438849
283686,283692,286879,6,3187,2,7200,1.00188264826
283842,283850,287069,8,3219,2,7200,1.00248524386
283878,283885,283964,7,79,1,1800,1.08860759494
283899,283905,287228,6,3323,2,7200,1.00180559735
283932,283938,287544,6,3606,2,7200,1.00166389351
283986,283994,287440,8,3446,2,7200,1.00232153221
284001,284008,287288,7,3280,2,7200,1.00213414634
284019,284026,287657,7,3631,2,7200,1.00192784357
284085,284092,287715,7,3623,2,7200,1.00193210047
284130,284137,287797,7,3660,2,7200,1.00191256831
284146,284152,287607,6,3455,2,7200,1.0017366136
284161,284168,287469,7,3301,2,7200,1.00212056952
284162,284175,287688,13,3513,2,7200,1.00370054085
284220,284226,287542,6,3316,2,7200,1.00180940893
284235,284241,287829,6,3588,2,7200,1.0016722408
284236,284248,287808,12,3560,2,7200,1.00337078652
284298,284305,289304,7,4999,1,25200,1.00140028006
284321,284327,287580,6,3253,2,7200,1.00184445128
284351,284359,287736,8,3377,2,7200,1.00236896654
284460,284466,287904,6,3438,2,7200,1.0017452007
284491,284498,287625,7,3127,2,7200,1.00223856732
284530,284536,288114,6,3578,2,7200,1.00167691448
284563,284569,287861,6,3292,2,7200,1.00182260024
284587,284593,287654,6,3061,2,7200,1.00196014374
284684,284691,288084,7,3393,2,7200,1.00206307103
284685,284698,288046,13,3348,2,7200,1.00388291517
284721,284728,288308,7,3580,2,7200,1.00195530726
284736,284743,287866,7,3123,2,7200,1.00224143452
284829,284837,288075,8,3238,2,7200,1.0024706609
284831,284844,288407,13,3563,2,7200,1.00364861072
285002,285008,285299,6,291,1,1800,1.0206185567
285511,285517,289076,6,3559,2,7200,1.00168586682
286078,286084,289500,6,3416,2,7200,1.00175644028
286350,286356,289635,6,3279,2,7200,1.00182982617
286470,286476,289956,6,3480,2,7200,1.00172413793
286762,286768,290240,6,3472,2,7200,1.0017281106
286792,286799,290244,7,3445,2,7200,1.00203193033
286825,286832,290314,7,3482,2,7200,1.00201033889
286870,286877,290342,7,3465,2,7200,1.00202020202
286885,286892,290333,7,3441,2,7200,1.00203429236
286900,286906,290329,6,3423,2,7200,1.00175284838
286981,286987,290534,6,3547,2,7200,1.00169157034
287071,287078,290664,7,3586,2,7200,1.00195203569
287153,287160,290485,7,3325,2,7200,1.00210526316
287168,287175,290566,7,3391,2,7200,1.00206428782
287229,287237,290678,8,3441,2,7200,1.00232490555
287289,287296,290849,7,3553,2,7200,1.00197016606
287440,287447,290922,7,3475,2,7200,1.00201438849
287471,287478,291042,7,3564,2,7200,1.0019640853
287544,287550,291025,6,3475,2,7200,1.00172661871
287558,287564,291088,6,3524,2,7200,1.00170261067
287579,287586,290855,7,3269,2,7200,1.00214132762
287606,287612,289104,6,1492,4,86400,1.00402144772
287609,287620,290893,11,3273,2,7200,1.00336083104
287625,287631,291064,6,3433,2,7200,1.0017477425
287656,287662,291176,6,3514,2,7200,1.00170745589
287657,287670,291314,13,3644,2,7200,1.00356750823
287687,287695,290937,8,3242,2,7200,1.00246761258
287717,287724,291166,7,3442,2,7200,1.00203370134
287726,287825,289572,99,1747,8,14400,1.0566685747
287736,287743,291041,7,3298,2,7200,1.00212249848
287798,287805,291459,7,3654,2,7200,1.00191570881
287822,287832,291304,10,3472,2,7200,1.00288018433
287837,287845,291564,8,3719,2,7200,1.00215111589
287861,287869,291229,8,3360,2,7200,1.00238095238
287876,287882,291124,6,3242,2,7200,1.00185070944
287906,287912,291246,6,3334,2,7200,1.00179964007
288048,288055,291378,7,3323,2,7200,1.00210653024
288077,288084,291589,7,3505,2,7200,1.00199714693
288095,288102,291537,7,3435,2,7200,1.00203784571
288115,288121,291758,6,3637,2,7200,1.0016497113
288306,288312,291894,6,3582,2,7200,1.00167504188
288409,288415,292000,6,3585,2,7200,1.00167364017
289078,289085,292579,7,3494,2,7200,1.00200343446
289464,289470,291522,6,2052,16,14400,1.00292397661
289501,289507,293025,6,3518,2,7200,1.0017055145
289621,289627,302625,6,12998,1,25200,1.00046160948
289634,289641,292944,7,3303,2,7200,1.0021192855
289822,289828,289864,6,36,12,86400,1.16666666667
289878,289886,302829,8,12943,12,172800,1.00061809472
289924,289930,292243,6,2313,2,21600,1.00259403372
289959,289966,293346,7,3380,2,7200,1.00207100592
289986,289993,291136,7,1143,4,14400,1.00612423447
290003,290009,305217,6,15208,4,21600,1.0003945292
290242,290249,293712,7,3463,2,7200,1.00202136876
290257,290264,293638,7,3374,2,7200,1.0020746888
290317,290324,293609,7,3285,2,7200,1.00213089802
290332,290338,293599,6,3261,2,7200,1.0018399264
290347,290354,293700,7,3346,2,7200,1.00209205021
290349,290361,293641,12,3280,2,7200,1.00365853659
290488,290495,293990,7,3495,2,7200,1.00200286123
290534,290540,293763,6,3223,2,7200,1.00186161961
290567,290573,294002,6,3429,2,7200,1.00174978128
290667,290674,294160,7,3486,2,7200,1.00200803213
290684,290691,294139,7,3448,2,7200,1.00203016241
290850,290857,294175,7,3318,2,7200,1.00210970464
290865,290872,294287,7,3415,2,7200,1.00204978038
290895,290901,294458,6,3557,2,7200,1.00168681473
290922,290929,294282,7,3353,2,7200,1.00208768267
290937,290944,294427,7,3483,2,7200,1.0020097617
290994,291000,292816,6,1816,2,21600,1.00330396476
291029,291036,294507,7,3471,2,7200,1.00201670988
291046,291052,294283,6,3231,2,7200,1.00185701021
291047,291059,294442,12,3383,2,7200,1.0035471475
291067,291073,294408,6,3335,2,7200,1.00179910045
291090,291098,294492,8,3394,2,7200,1.00235710077
291127,291133,294324,6,3191,2,7200,1.00188028831
291169,291175,294569,6,3394,2,7200,1.00176782557
291184,291190,294946,6,3756,2,7200,1.00159744409
291193,291199,292074,6,875,4,14400,1.00685714286
291232,291238,294575,6,3337,2,7200,1.00179802218
291250,291257,294656,7,3399,2,7200,1.00205942924
291304,291311,294809,7,3498,2,7200,1.00200114351
291320,291327,294812,7,3485,2,7200,1.00200860832
291382,291388,294952,6,3564,2,7200,1.00168350168
291418,292081,293533,663,1452,8,324000,1.45661157025
291454,291461,292067,7,606,2,10800,1.01155115512
291461,291468,294814,7,3346,2,7200,1.00209205021
291537,291543,295145,6,3602,2,7200,1.00166574125
291564,291571,295175,7,3604,2,7200,1.00194228635
291591,291597,295043,6,3446,2,7200,1.00174114916
291660,291667,292034,7,367,2,10800,1.01907356948
291758,291764,295214,6,3450,2,7200,1.00173913043
291894,291900,295316,6,3416,2,7200,1.00175644028
292002,292009,295344,7,3335,2,7200,1.00209895052
292074,293546,441695,1472,148149,12,432000,1.00993594287
292342,292348,292825,6,477,16,14400,1.01257861635
292578,292584,295889,6,3305,2,7200,1.00181543116
292732,292739,292875,7,136,2,1440,1.05147058824
292793,292799,293194,6,395,2,10800,1.01518987342
292946,292953,296413,7,3460,2,7200,1.00202312139
293027,293033,296660,6,3627,2,7200,1.00165425972
293346,293353,296827,7,3474,2,7200,1.00201496834
293502,293508,293874,6,366,16,14400,1.01639344262
293577,293583,294200,6,617,2,10800,1.00972447326
293600,293607,296908,7,3301,2,7200,1.00212056952
293615,293621,296981,6,3360,2,7200,1.00178571429
293639,293646,297090,7,3444,2,7200,1.00203252033
293654,293660,297153,6,3493,2,7200,1.00171772116
293657,293666,293856,9,190,2,900,1.04736842105
293704,293711,297025,7,3314,2,7200,1.00211225106
293719,293727,297224,8,3497,2,7200,1.00228767515
293757,293777,294144,20,367,2,10800,1.05449591281
293764,293770,296832,6,3062,2,7200,1.00195950359
293921,293927,294406,6,479,16,14400,1.01252609603
293990,293998,297170,8,3172,2,7200,1.0025220681
294005,294012,297302,7,3290,2,7200,1.00212765957
294141,294147,297954,6,3807,2,7200,1.00157604413
294162,294169,297679,7,3510,2,7200,1.00199430199
294177,294183,297778,6,3595,2,7200,1.0016689847
294205,294212,294213,7,1,1,60,1.0
294242,294249,294252,7,3,1,3600,1.0
294282,294289,297805,7,3516,2,7200,1.00199089875
294283,294296,297757,13,3461,2,7200,1.00375613984
294298,294304,297845,6,3541,2,7200,1.0016944366
294325,294332,297832,7,3500,2,7200,1.002
294409,294416,298051,7,3635,2,7200,1.00192572215
294427,294434,297944,7,3510,2,7200,1.00199430199
294442,294449,298006,7,3557,2,7200,1.00196795052
294457,294463,298133,6,3670,2,7200,1.00163487738
294493,294500,297904,7,3404,2,7200,1.00205640423
294508,294514,297812,6,3298,2,7200,1.00181928441
294520,294526,294983,6,457,16,14400,1.01312910284
294571,294578,297928,7,3350,2,7200,1.00208955224
294586,294593,297896,7,3303,2,7200,1.0021192855
294656,294664,294781,8,117,2,1440,1.06837606838
294658,294671,297945,13,3274,2,7200,1.00397067807
294690,294697,294713,7,16,2,900,1.4375
294695,294704,294730,9,26,2,900,1.34615384615
294812,294818,298220,6,3402,2,7200,1.00176366843
294813,294825,298236,12,3411,2,7200,1.0035180299
294828,294834,298308,6,3474,2,7200,1.00172711572
294947,294954,298242,7,3288,2,7200,1.00212895377
294962,294969,298396,7,3427,2,7200,1.00204260286
295045,295052,298455,7,3403,2,7200,1.00205700852
295099,295105,295574,6,469,16,14400,1.01279317697
295148,295155,298545,7,3390,2,7200,1.00206489676
295173,295180,297377,7,2197,4,14400,1.00318616295
295183,295189,298664,6,3475,2,7200,1.00172661871
295220,295226,298601,6,3375,2,7200,1.00177777778
295243,295251,295280,8,29,2,900,1.27586206897
295291,296821,310615,1530,13794,4,43200,1.11091779034
295316,295323,298821,7,3498,2,7200,1.00200114351
295322,297387,310615,2065,13228,4,43200,1.15610825522
295344,295350,298732,6,3382,2,7200,1.00177409817
295652,296527,306617,875,10090,4,345600,1.08671952428
295890,295896,299300,6,3404,2,7200,1.0017626322
295947,295954,296127,7,173,16,14400,1.04046242775
295974,296186,299913,212,3727,4,3600,1.05688221089
296003,296010,296043,7,33,1,3600,1.21212121212
296084,296091,296107,7,16,2,900,1.4375
296156,296162,302859,6,6697,2,18000,1.00089592355
296414,296421,299741,7,3320,2,7200,1.00210843373
296535,296804,296809,269,5,4,3600,27.4
296664,296671,299872,7,3201,2,7200,1.00218681662
296696,296702,296895,6,193,16,14400,1.0310880829
296760,296843,296933,83,90,2,7200,1.92222222222
296824,296951,302847,127,5896,2,18000,1.02154002714
296829,296836,300486,7,3650,2,7200,1.00191780822
296844,296851,300094,7,3243,2,7200,1.00215849522
296907,296915,300416,8,3501,2,7200,1.00228506141
296950,296958,296959,8,1,1,3600,1.0
296985,296992,300375,7,3383,2,7200,1.00206916938
297029,297035,300392,6,3357,2,7200,1.0017873101
297071,297107,299187,36,2080,2,18000,1.01730769231
297093,297100,300623,7,3523,2,7200,1.00198694295
297109,297169,297170,60,1,1,3600,6.1
297156,297162,300540,6,3378,2,7200,1.00177619893
297171,297178,300701,7,3523,2,7200,1.00198694295
297217,297223,298066,6,843,16,14400,1.00711743772
297225,297232,300290,7,3058,2,7200,1.00228907783
297303,297309,300978,6,3669,2,7200,1.00163532298
297381,297394,297395,13,1,1,3600,1.4
297448,297826,297989,378,163,4,86400,3.31901840491
297523,297530,297644,7,114,2,1440,1.06140350877
297680,297686,301231,6,3545,2,7200,1.00169252468
297758,297766,301237,8,3471,2,7200,1.00230481129
297779,297785,301064,6,3279,2,7200,1.00182982617
297806,297812,301191,6,3379,2,7200,1.00177567328
297821,297832,301410,11,3578,2,7200,1.00307434321
297836,297842,301251,6,3409,2,7200,1.00176004693
297836,297850,297974,14,124,2,1440,1.11290322581
297840,298004,298047,164,43,8,14400,4.81395348837
297851,297857,301245,6,3388,2,7200,1.00177095632
297899,297905,301501,6,3596,2,7200,1.00166852058
297914,297920,301199,6,3279,2,7200,1.00182982617
297928,297935,301356,7,3421,2,7200,1.00204618533
297946,297953,301473,7,3520,2,7200,1.00198863636
297948,297960,301487,12,3527,2,7200,1.00340232492
297963,297969,301354,6,3385,2,7200,1.00177252585
298008,298014,301416,6,3402,2,7200,1.00176366843
298051,298057,301430,6,3373,2,7200,1.0017788319
298060,298066,298249,6,183,16,14400,1.03278688525
298069,298076,302785,7,4709,2,18000,1.00148651518
298133,298140,301442,7,3302,2,7200,1.00211992732
298182,298189,312696,7,14507,4,14400,1.00048252568
298221,298227,301699,6,3472,2,7200,1.0017281106
298237,298244,301770,7,3526,2,7200,1.00198525241
298253,298260,301432,7,3172,2,7200,1.00220680958
298309,298316,301870,7,3554,2,7200,1.00196961171
298397,298404,301800,7,3396,2,7200,1.00206124853
298455,298461,301769,6,3308,2,7200,1.00181378476
298521,298527,298575,6,48,2,1440,1.125
298547,298553,301978,6,3425,2,7200,1.00175182482
298551,298560,303364,9,4804,2,18000,1.0018734388
298601,298607,301930,6,3323,2,7200,1.00180559735
298664,298670,302038,6,3368,2,7200,1.00178147268
298708,298715,298841,7,126,2,1440,1.05555555556
298713,298722,471543,9,172821,2,172800,1.000052077
298724,298746,298749,22,3,1,3600,2.5
298733,298739,302248,6,3509,2,7200,1.00170988886
298810,298817,300060,7,1243,1,1200,1.0056315366
298823,298830,302296,7,3466,2,7200,1.00201961916
298869,298875,300229,6,1354,2,14400,1.00443131462
299056,299062,299190,6,128,2,1440,1.046875
299237,299244,299330,7,86,15,14400,1.08139534884
299303,299310,302558,7,3248,2,7200,1.00215517241
299477,299484,299501,7,17,2,900,1.41176470588
299480,299702,299726,222,24,2,900,10.25
299485,299491,299538,6,47,2,900,1.12765957447
299488,299550,299739,62,189,2,900,1.32804232804
299492,299513,299690,21,177,2,900,1.1186440678
299499,299505,300174,6,669,15,14400,1.00896860987
299658,299739,299756,81,17,2,1800,5.76470588235
299660,299768,301578,108,1810,2,1800,1.05966850829
299663,299887,299952,224,65,2,1800,4.44615384615
299666,299924,300101,258,177,2,1800,2.45762711864
299669,299929,300393,260,464,2,1800,1.56034482759
299744,299750,302827,6,3077,2,7200,1.00194995125
299792,302844,302846,3052,2,8,86400,305.4
299873,299880,302827,7,2947,2,7200,1.00237529691
300096,300102,302827,6,2725,2,7200,1.00220183486
300292,300299,302827,7,2528,2,7200,1.00276898734
300377,300383,302827,6,2444,2,7200,1.00245499182
300392,300399,302827,7,2428,2,7200,1.0028830313
300416,300422,302827,6,2405,2,7200,1.00249480249
300488,300495,302827,7,2332,2,7200,1.00300171527
300541,300548,300704,7,156,15,14400,1.04487179487
300544,300556,302827,12,2271,2,7200,1.00528401585
300624,300630,302827,6,2197,2,7200,1.00273099681
300702,300708,302827,6,2119,2,7200,1.0028315243
300705,300715,301221,10,506,15,14400,1.01976284585
300979,300986,302827,7,1841,2,7200,1.00380228137
301028,301035,301051,7,16,2,1800,1.4375
301067,301074,302827,7,1753,2,7200,1.00399315459
301122,301128,301144,6,16,2,1800,1.375
301193,301199,302827,6,1628,2,7200,1.00368550369
301208,301214,302827,6,1613,2,7200,1.00371977681
301217,301225,301253,8,28,2,1800,1.28571428571
301220,301245,301312,25,67,2,1800,1.37313432836
301222,301253,301441,31,188,2,1800,1.16489361702
301225,301325,301760,100,435,2,1800,1.22988505747
301232,301238,302828,6,1590,2,7200,1.00377358491
301247,301260,302828,13,1568,2,7200,1.00829081633
301248,301265,302828,17,1563,2,7200,1.01087651951
301263,301272,302828,9,1556,2,7200,1.0057840617
301353,301360,302828,7,1468,2,7200,1.00476839237
301368,301374,302828,6,1454,2,7200,1.00412654746
301410,301417,302828,7,1411,2,7200,1.00496102055
301414,301423,301893,9,470,16,14400,1.01914893617
301425,301431,302828,6,1397,2,7200,1.00429491768
301440,301447,302828,7,1381,2,7200,1.00506879073
301442,301453,302828,11,1375,2,7200,1.008
301456,301464,302828,8,1364,2,7200,1.00586510264
301474,301482,302828,8,1346,2,7200,1.0059435364
301489,301495,302828,6,1333,2,7200,1.00450112528
301504,301511,302828,7,1317,2,7200,1.0053151101
301701,301708,302828,7,1120,2,7200,1.00625
301770,301777,302828,7,1051,2,7200,1.0066603235
301772,301784,302828,12,1044,2,7200,1.01149425287
301799,301806,302828,7,1022,2,7200,1.00684931507
301872,301878,302828,6,950,2,7200,1.00631578947
301932,301938,302828,6,890,2,7200,1.00674157303
301980,301986,302828,6,842,2,7200,1.00712589074
302008,302015,303370,7,1355,2,18000,1.00516605166
302046,302053,302828,7,775,2,7200,1.00903225806
302251,302257,302828,6,571,2,7200,1.01050788091
302296,302303,302828,7,525,2,7200,1.01333333333
302326,302332,302733,6,401,16,14400,1.01496259352
302558,302565,302828,7,263,2,7200,1.02661596958
302813,302820,302830,7,10,2,18000,1.7
302886,302892,303149,6,257,16,14400,1.0233463035
303025,303031,303143,6,112,2,18000,1.05357142857
303059,303066,303067,7,1,2,18000,1.0
303090,303098,303100,8,2,2,7200,1.0
303092,303104,303106,12,2,2,7200,1.4
303093,303109,303341,16,232,2,7200,1.06896551724
303094,303115,303341,21,226,2,7200,1.09292035398
303096,303120,303123,24,3,2,7200,2.7
303097,303125,303129,28,4,2,7200,3.2
303098,303130,303133,32,3,2,7200,3.5
303100,303137,303138,37,1,2,7200,3.8
303101,303142,303143,41,1,2,7200,4.2
303102,303147,303148,45,1,2,7200,4.6
303104,303153,303341,49,188,2,7200,1.26063829787
303105,303158,303161,53,3,2,7200,5.6
303106,303163,303341,57,178,2,7200,1.3202247191
303108,303168,303341,60,173,2,7200,1.34682080925
303109,303174,303341,65,167,2,7200,1.38922155689
303110,303179,303341,69,162,2,7200,1.42592592593
303112,303184,303341,72,157,2,7200,1.45859872611
303113,303189,303341,76,152,2,7200,1.5
303114,303195,303341,81,146,2,7200,1.55479452055
303116,303200,303341,84,141,2,7200,1.59574468085
303117,303205,303341,88,136,2,7200,1.64705882353
303118,303210,303341,92,131,2,7200,1.70229007634
303120,303216,303341,96,125,2,7200,1.768
303121,303221,303341,100,120,2,7200,1.83333333333
303122,303226,303341,104,115,2,7200,1.90434782609
303124,303232,303341,108,109,2,7200,1.99082568807
303125,303237,303341,112,104,2,7200,2.07692307692
303126,303242,303341,116,99,2,7200,2.17171717172
303128,303247,303341,119,94,2,7200,2.26595744681
303129,303253,303341,124,88,2,7200,2.40909090909
303131,303258,303341,127,83,2,7200,2.53012048193
303132,303265,303341,133,76,2,7200,2.75
303133,303271,303341,138,70,2,7200,2.97142857143
303135,303276,303341,141,65,2,7200,3.16923076923
303136,303281,303341,145,60,2,7200,3.41666666667
303137,303286,303341,149,55,2,7200,3.70909090909
303139,303292,303341,153,49,2,7200,4.12244897959
303140,303297,303341,157,44,2,7200,4.56818181818
303141,303302,303341,161,39,2,7200,5.12820512821
303143,303307,303341,164,34,2,7200,5.82352941176
303175,303313,303379,138,66,2,18000,3.09090909091
303328,303335,312600,7,9265,2,18000,1.00075553157
303367,303373,306717,6,3344,2,7200,1.00179425837
303369,303380,306782,11,3402,2,7200,1.00323339212
303370,303385,306837,15,3452,2,7200,1.00434530707
303371,303390,306846,19,3456,2,7200,1.00549768519
303373,303396,306840,23,3444,2,7200,1.00667828107
303374,303402,306631,28,3229,2,7200,1.0086714153
303376,303408,306692,32,3284,2,7200,1.00974421437
303377,303413,306822,36,3409,2,7200,1.01056028161
303378,303418,306960,40,3542,2,7200,1.01129305477
303380,303424,306755,44,3331,2,7200,1.01320924647
303381,303429,306925,48,3496,2,7200,1.01372997712
303383,303434,306957,51,3523,2,7200,1.01447629861
303384,303439,306922,55,3483,2,7200,1.01579098478
303386,303445,307071,59,3626,2,7200,1.01627137341
303387,303450,306921,63,3471,2,7200,1.01815038894
303388,303455,306986,67,3531,2,7200,1.01897479468
303390,303460,306737,70,3277,2,7200,1.02136100092
303391,303466,306900,75,3434,2,7200,1.02184041934
303392,303471,307026,79,3555,2,7200,1.02222222222
303394,303476,306962,82,3486,2,7200,1.02352266208
303395,303481,306961,86,3480,2,7200,1.02471264368
303397,303487,306951,90,3464,2,7200,1.02598152425
303398,303494,307144,96,3650,2,7200,1.02630136986
303399,303499,306907,100,3408,2,7200,1.029342723
303401,303504,307055,103,3551,2,7200,1.02900591383
303402,303509,307222,107,3713,2,7200,1.02881766765
303403,303515,306781,112,3266,2,7200,1.0342927128
303405,303520,307157,115,3637,2,7200,1.03161946659
303406,303525,307092,119,3567,2,7200,1.0333613681
303407,303530,307080,123,3550,2,7200,1.03464788732
303409,303536,306709,127,3173,2,7200,1.04002521273
303410,303541,307108,131,3567,2,7200,1.03672553967
303411,303546,306924,135,3378,2,7200,1.03996447602
303413,303551,306964,138,3413,2,7200,1.0404336361
303414,303557,306982,143,3425,2,7200,1.04175182482
303415,303562,307196,147,3634,2,7200,1.04045129334
303417,303567,307008,150,3441,2,7200,1.04359197908
303418,303573,307070,155,3497,2,7200,1.04432370603
303419,303578,307010,159,3432,2,7200,1.04632867133
303420,303588,312615,168,9027,2,18000,1.01861083416
303421,303583,307158,162,3575,2,7200,1.04531468531
303971,303977,304032,6,55,16,324000,1.10909090909
304059,304066,304455,7,389,2,1800,1.01799485861
304060,304073,304074,13,1,16,324000,1.4
304068,304079,304094,11,15,2,1800,1.73333333333
304073,304084,304113,11,29,2,1800,1.37931034483
304080,304091,304146,11,55,2,1800,1.2
304088,304103,304275,15,172,2,1800,1.08720930233
304090,304098,304152,8,54,16,324000,1.14814814815
304157,304163,305236,6,1073,4,3600,1.0055917987
304217,304224,304281,7,57,16,324000,1.12280701754
304249,304256,304257,7,1,1,18000,1.0
304259,304292,304293,33,1,1,18000,3.4
304261,304308,304309,47,1,1,18000,4.8
304573,304580,308222,7,3642,2,7200,1.00192202087
304575,304586,307670,11,3084,2,7200,1.00356679637
304576,304591,308339,15,3748,2,7200,1.00400213447
304578,304597,308078,19,3481,2,7200,1.00545820167
304579,304602,308041,23,3439,2,7200,1.00668799069
304580,304607,307873,27,3266,2,7200,1.00826699326
304582,304618,307987,36,3369,2,7200,1.0106856634
304583,304623,307841,40,3218,2,7200,1.0124300808
304584,305065,305355,481,290,16,324000,2.65862068966
304584,304629,307885,45,3256,2,7200,1.01382063882
304586,304634,307757,48,3123,2,7200,1.0153698367
304587,304639,307748,52,3109,2,7200,1.01672563525
304588,304645,307975,57,3330,2,7200,1.01711711712
304590,304650,307982,60,3332,2,7200,1.01800720288
304591,304655,307803,64,3148,2,7200,1.02033036849
304593,304660,307912,67,3252,2,7200,1.02060270603
304594,304666,307887,72,3221,2,7200,1.02235330643
304595,304671,308011,76,3340,2,7200,1.02275449102
304597,304676,307836,79,3160,2,7200,1.025
304598,304681,308108,83,3427,2,7200,1.02421943391
304599,304687,307925,88,3238,2,7200,1.02717726992
304601,304692,308029,91,3337,2,7200,1.027270003
304602,304697,308084,95,3387,2,7200,1.02804842043
304603,304703,308231,100,3528,2,7200,1.0283446712
304605,304708,308149,103,3441,2,7200,1.02993315897
304606,304713,308199,107,3486,2,7200,1.03069420539
304607,304718,307811,111,3093,2,7200,1.03588748788
304609,304725,307854,116,3129,2,7200,1.03707254714
304610,304731,307761,121,3030,2,7200,1.0399339934
304611,304736,308123,125,3387,2,7200,1.03690581636
304613,304741,308181,128,3440,2,7200,1.03720930233
304614,304746,307821,132,3075,2,7200,1.04292682927
304615,304752,308196,137,3444,2,7200,1.03977932636
304617,304757,307858,140,3101,2,7200,1.04514672686
304618,304762,308259,144,3497,2,7200,1.0411781527
304620,304767,308049,147,3282,2,7200,1.04478976234
304622,304773,308221,151,3448,2,7200,1.04379350348
304623,304778,308219,155,3441,2,7200,1.04504504505
304624,304783,308145,159,3362,2,7200,1.04729327781
304626,304789,307928,163,3139,2,7200,1.0519273654
304627,304794,307977,167,3183,2,7200,1.05246622683
304851,305193,312401,342,7208,2,7200,1.0474472808
305439,305446,305488,7,42,16,324000,1.16666666667
305538,306269,312613,731,6344,16,324000,1.11522698613
305778,305784,305807,6,23,2,660,1.26086956522
306546,306553,306895,7,342,2,660,1.02046783626
307262,307269,307270,7,1,1,18000,1.0
307267,307286,307287,19,1,1,18000,2.0
307273,307298,307299,25,1,1,18000,2.6
307283,307314,307315,31,1,1,18000,3.2
307620,307626,308830,6,1204,2,10800,1.0049833887
307675,307682,310897,7,3215,2,7200,1.00217729393
307747,307754,310774,7,3020,2,7200,1.00231788079
307762,307768,310992,6,3224,2,7200,1.00186104218
307763,307776,310992,13,3216,2,7200,1.00404228856
307802,307809,311151,7,3342,2,7200,1.00209455416
307816,307823,311418,7,3595,2,7200,1.00194714882
307831,307837,311319,6,3482,2,7200,1.00172314762
307846,307853,311197,7,3344,2,7200,1.00209330144
307851,307860,311200,9,3340,2,7200,1.00269461078
307866,307873,311229,7,3356,2,7200,1.00208581645
307867,307880,311245,13,3365,2,7200,1.00386329866
307882,307888,311251,6,3363,2,7200,1.00178412132
307897,307903,311202,6,3299,2,7200,1.00181873295
307898,307909,311380,11,3471,2,7200,1.00316911553
307913,307920,311281,7,3361,2,7200,1.00208271348
307927,307934,311399,7,3465,2,7200,1.00202020202
307929,307941,311354,12,3413,2,7200,1.00351596836
307971,307978,308243,7,265,16,324000,1.02641509434
307974,307985,311453,11,3468,2,7200,1.00317185698
307975,307990,311771,15,3781,2,7200,1.00396720444
307990,307997,311374,7,3377,2,7200,1.00207284572
307991,308004,311241,13,3237,2,7200,1.00401606426
308012,308019,311656,7,3637,2,7200,1.00192466318
308026,308033,311452,7,3419,2,7200,1.00204738228
308041,308047,311728,6,3681,2,7200,1.00162999185
308056,308062,311452,6,3390,2,7200,1.0017699115
308079,308085,311507,6,3422,2,7200,1.00175336061
308091,308099,309847,8,1748,2,10800,1.00457665904
308094,308105,311734,11,3629,2,7200,1.00303113805
308109,308115,311509,6,3394,2,7200,1.00176782557
308123,308130,311344,7,3214,2,7200,1.00217797138
308147,308153,311660,6,3507,2,7200,1.00171086399
308162,308169,311434,7,3265,2,7200,1.002143951
308179,308186,311884,7,3698,2,7200,1.00189291509
308197,308204,311342,7,3138,2,7200,1.0022307202
308198,308211,311672,13,3461,2,7200,1.00375613984
308216,308222,311727,6,3505,2,7200,1.00171184023
308231,308238,311601,7,3363,2,7200,1.00208147487
308232,308245,311510,13,3265,2,7200,1.00398162328
308234,308250,311648,16,3398,2,7200,1.00470865215
308259,308266,309242,7,976,16,324000,1.00717213115
308260,308273,311828,13,3555,2,7200,1.00365682138
308293,310155,310156,1862,1,19,172800,186.3
308338,308345,311697,7,3352,2,7200,1.00208830549
308589,308595,654206,6,345611,4,345600,1.00001736056
308621,309156,312616,535,3460,10,43200,1.15462427746
308768,308842,308843,74,1,2,10800,7.5
308921,308927,309521,6,594,2,10800,1.0101010101
308984,308990,308991,6,1,1,68400,1.0
309094,309161,309165,67,4,4,3600,7.1
309318,310168,312223,850,2055,16,324000,1.41362530414
309433,309440,309669,7,229,2,10800,1.03056768559
309813,309820,310037,7,217,2,10800,1.03225806452
309892,309899,310579,7,680,2,18000,1.01029411765
309976,309982,310581,6,599,2,18000,1.01001669449
310088,310094,310444,6,350,2,10800,1.01714285714
310406,310412,310806,6,394,2,10800,1.0152284264
310651,310659,333339,8,22680,4,57600,1.00035273369
310675,310681,333293,6,22612,4,57600,1.00026534583
310773,310780,314134,7,3354,2,7200,1.00208706023
310777,310787,312601,10,1814,2,18000,1.00551267916
310781,310819,311081,38,262,2,10800,1.14503816794
310895,310903,314332,8,3429,2,7200,1.0023330417
310991,310998,314356,7,3358,2,7200,1.00208457415
310993,311005,314531,12,3526,2,7200,1.00340328985
311042,311049,312594,7,1545,2,18000,1.00453074434
311067,311093,312355,26,1262,2,10800,1.0206022187
311149,311156,314607,7,3451,2,7200,1.00202839757
311197,311204,314590,7,3386,2,7200,1.00206733609
311198,311211,314744,13,3533,2,7200,1.00367959241
311213,311219,314784,6,3565,2,7200,1.00168302945
311227,311234,314710,7,3476,2,7200,1.00201380898
311242,311249,314709,7,3460,2,7200,1.00202312139
311244,311256,314958,12,3702,2,7200,1.00324149109
311259,311265,314500,6,3235,2,7200,1.00185471406
311282,311288,314675,6,3387,2,7200,1.00177147919
311296,311303,311459,7,156,2,10800,1.04487179487
311306,311331,311973,25,642,2,660,1.03894080997
311318,311325,314637,7,3312,2,7200,1.00211352657
311342,311348,314897,6,3549,2,7200,1.00169061708
311343,311355,314580,12,3225,2,7200,1.00372093023
311357,311365,314709,8,3344,2,7200,1.0023923445
311375,311381,314819,6,3438,2,7200,1.0017452007
311390,311396,314845,6,3449,2,7200,1.00173963468
311404,311411,314901,7,3490,2,7200,1.00200573066
311418,311469,311615,51,146,4,345600,1.34931506849
311419,311426,314815,7,3389,2,7200,1.00206550605
311434,311440,314616,6,3176,2,7200,1.00188916877
311454,311461,314853,7,3392,2,7200,1.00206367925
311456,311474,315133,18,3659,2,7200,1.00491937688
311457,311480,314988,23,3508,2,7200,1.00655644242
311508,311514,314964,6,3450,2,7200,1.00173913043
311510,311521,315090,11,3569,2,7200,1.00308209583
311511,311526,314841,15,3315,2,7200,1.00452488688
311525,311533,311678,8,145,4,345600,1.05517241379
311535,311543,311966,8,423,2,10800,1.01891252955
311598,311604,314827,6,3223,2,7200,1.00186161961
311646,311653,315150,7,3497,2,7200,1.00200171576
311660,311667,314978,7,3311,2,7200,1.0021141649
311662,311675,314922,13,3247,2,7200,1.00400369572
311676,311683,315064,7,3381,2,7200,1.00207039337
311697,311704,315062,7,3358,2,7200,1.00208457415
311727,311734,314997,7,3263,2,7200,1.00214526509
311742,311754,315338,12,3584,2,7200,1.00334821429
311743,311761,315151,18,3390,2,7200,1.00530973451
311773,311780,315280,7,3500,2,7200,1.002
311829,311835,654511,6,342676,4,345600,1.00001750925
311829,311840,315107,11,3267,2,7200,1.00336700337
311852,311859,311882,7,23,4,345600,1.30434782609
311886,311892,314988,6,3096,2,7200,1.0019379845
311908,311915,312110,7,195,2,10800,1.0358974359
311971,311978,312043,7,65,4,360000,1.10769230769
312045,312052,342186,7,30134,4,345600,1.00023229575
312107,312113,672135,6,360022,4,360000,1.00001666565
312193,312367,672395,174,360028,4,360000,1.00048329574
312357,312606,380223,249,67617,4,360000,1.00368250588
312440,312616,423631,176,111015,4,360000,1.00158537135
312522,312630,466482,108,153852,4,360000,1.00070197333
312611,312635,312642,24,7,2,86400,3.1
312736,312742,312761,6,19,2,900,1.31578947368
312840,312846,399287,6,86441,2,86400,1.00006941151
312878,312885,388358,7,75473,16,324000,1.0000927484
312961,312967,312976,6,9,2,900,1.5
312979,312987,312990,8,3,1,600,1.1
312992,312998,331018,6,18020,2,18000,1.00033296337
313002,313008,313040,6,32,2,900,1.1875
313022,313028,313045,6,17,2,1200,1.35294117647
313064,313071,329646,7,16575,2,18000,1.00042232278
313146,313152,313185,6,33,2,900,1.18181818182
313155,313162,313164,7,2,1,600,1.0
313332,313338,329649,6,16311,2,18000,1.00036784992
313351,313358,313390,7,32,2,900,1.21875
313381,313388,329655,7,16267,2,18000,1.00043031905
313561,313571,313633,10,62,2,900,1.16129032258
314130,314138,314140,8,2,1,600,1.0
314136,314145,317430,9,3285,2,7200,1.00273972603
314254,314261,314262,7,1,1,600,1.0
314331,314337,317781,6,3444,2,7200,1.00174216028
314334,314345,314348,11,3,1,600,1.4
314358,314365,317950,7,3585,2,7200,1.0019525802
314385,314392,314395,7,3,1,600,1.0
314499,314506,317683,7,3177,2,7200,1.00220333648
314532,314539,318029,7,3490,2,7200,1.00200573066
314574,314581,314585,7,4,1,600,1.1
314583,314590,318071,7,3481,2,7200,1.0020109164
314597,314603,317796,6,3193,2,7200,1.00187911055
314612,314619,318058,7,3439,2,7200,1.00203547543
314626,314634,317810,8,3176,2,7200,1.00251889169
314641,314647,317996,6,3349,2,7200,1.00179157958
314650,314656,314680,6,24,1,600,1.25
314677,314683,317879,6,3196,2,7200,1.00187734668
314709,314716,318206,7,3490,2,7200,1.00200573066
314711,314723,318417,12,3694,2,7200,1.0032485111
314725,314733,318388,8,3655,2,7200,1.00218878249
314735,314741,315411,6,670,8,660,1.00895522388
314746,314753,318051,7,3298,2,7200,1.00212249848
314753,314760,317077,7,2317,2,18000,1.00302114804
314754,314766,314851,12,85,1,600,1.14117647059
314785,314791,318401,6,3610,2,7200,1.00166204986
314815,314821,318361,6,3540,2,7200,1.00169491525
314816,314828,318263,12,3435,2,7200,1.00349344978
314831,314837,318462,6,3625,2,7200,1.00165517241
314846,314853,318398,7,3545,2,7200,1.00197461213
314847,314859,318258,12,3399,2,7200,1.00353045013
314862,314869,318267,7,3398,2,7200,1.00206003531
314898,314905,318325,7,3420,2,7200,1.00204678363
314912,314919,318179,7,3260,2,7200,1.00214723926
314927,314934,318266,7,3332,2,7200,1.00210084034
314960,314966,318225,6,3259,2,7200,1.00184105554
314974,314981,318299,7,3318,2,7200,1.00210970464
314989,314995,318124,6,3129,2,7200,1.00191754554
314990,315002,318232,12,3230,2,7200,1.00371517028
314992,315007,318279,15,3272,2,7200,1.00458435208
315006,315015,318601,9,3586,2,7200,1.00250976018
315063,315070,318559,7,3489,2,7200,1.00200630553
315078,315085,318390,7,3305,2,7200,1.00211800303
315092,315100,318566,8,3466,2,7200,1.00230813618
315107,315113,318556,6,3443,2,7200,1.00174266628
315134,315140,318863,6,3723,2,7200,1.00161160355
315149,315155,318604,6,3449,2,7200,1.00173963468
315150,315162,318581,12,3419,2,7200,1.00350979819
315279,315285,318717,6,3432,2,7200,1.00174825175
315295,315301,317538,6,2237,2,18000,1.00268216361
315339,315346,318917,7,3571,2,7200,1.00196023523
315748,315754,317464,6,1710,2,18000,1.00350877193
315813,315819,316263,6,444,2,660,1.01351351351
315932,315939,323242,7,7303,2,7200,1.0009585102
316272,317156,317583,884,427,8,660,3.07025761124
316679,317594,322923,915,5329,8,86400,1.17170200788
317078,317085,317144,7,59,2,10800,1.1186440678
317341,317445,317498,104,53,2,10800,2.96226415094
317431,317438,321090,7,3652,2,7200,1.00191675794
317591,317601,318167,10,566,4,660,1.01766784452
317607,317613,317614,6,1,1,7200,1.0
317684,317690,321132,6,3442,2,7200,1.00174317257
317783,317789,320968,6,3179,2,7200,1.00188738597
317798,317805,321157,7,3352,2,7200,1.00208830549
317812,317819,321356,7,3537,2,7200,1.00197907831
317878,317885,321209,7,3324,2,7200,1.00210589651
317944,317950,321473,6,3523,2,7200,1.00170309395
317994,318001,321324,7,3323,2,7200,1.00210653024
318030,318036,321527,6,3491,2,7200,1.00171870524
318051,318057,321655,6,3598,2,7200,1.00166759311
318065,318072,321582,7,3510,2,7200,1.00199430199
318080,318087,321732,7,3645,2,7200,1.00192043896
318125,318132,321439,7,3307,2,7200,1.0021167221
318182,318188,321419,6,3231,2,7200,1.00185701021
318208,318214,321672,6,3458,2,7200,1.001735107
318226,318233,321523,7,3290,2,7200,1.00212765957
318241,318248,321402,7,3154,2,7200,1.00221940393
318258,318265,321683,7,3418,2,7200,1.00204798128
318273,318281,321698,8,3417,2,7200,1.002341235
318275,318286,321739,11,3453,2,7200,1.00318563568
318276,318293,321515,17,3222,2,7200,1.00527622595
318290,318299,321720,9,3421,2,7200,1.0026308097
318305,318312,321809,7,3497,2,7200,1.00200171576
318310,318318,318835,8,517,2,10800,1.01547388781
318326,318332,321376,6,3044,2,7200,1.00197109067
318359,318365,321724,6,3359,2,7200,1.00178624591
318385,318391,321973,6,3582,2,7200,1.00167504188
318400,318406,321827,6,3421,2,7200,1.00175387314
318401,318413,321610,12,3197,2,7200,1.00375351892
318403,318418,321970,15,3552,2,7200,1.00422297297
318418,318425,321794,7,3369,2,7200,1.00207776788
318462,318469,321995,7,3526,2,7200,1.00198525241
318558,318565,321809,7,3244,2,7200,1.00215782984
318560,318572,321904,12,3332,2,7200,1.00360144058
318574,318580,321820,6,3240,2,7200,1.00185185185
318589,318595,322033,6,3438,2,7200,1.0017452007
318604,318610,322036,6,3426,2,7200,1.00175131349
318618,318626,321928,8,3302,2,7200,1.00242277408
318717,318723,322044,6,3321,2,7200,1.00180668473
318833,318847,320238,14,1391,4,1740,1.01006470165
318861,318868,322071,7,3203,2,7200,1.00218545114
318898,320249,320259,1351,10,4,3600,136.1
318915,318921,322282,6,3361,2,7200,1.00178518298
319048,319055,341012,7,21957,1,68400,1.00031880494
319150,336212,433847,17062,97635,19,172800,1.17475290623
320735,320741,322898,6,2157,2,3540,1.00278164117
320838,320845,321181,7,336,2,900,1.02083333333
320971,320977,324311,6,3334,2,7200,1.00179964007
321088,321094,324494,6,3400,2,7200,1.00176470588
321133,321140,324113,7,2973,2,7200,1.00235452405
321157,321163,324681,6,3518,2,7200,1.0017055145
321204,321211,324803,7,3592,2,7200,1.00194877506
321305,321311,323684,6,2373,2,14400,1.00252844501
321324,321331,324920,7,3589,2,7200,1.00195040401
321357,321363,324718,6,3355,2,7200,1.00178837556
321378,321385,324805,7,3420,2,7200,1.00204678363
321404,321411,324847,7,3436,2,7200,1.00203725262
321422,321428,324722,6,3294,2,7200,1.00182149362
321440,321447,324632,7,3185,2,7200,1.0021978022
321473,321480,324659,7,3179,2,7200,1.0022019503
321514,321522,324892,8,3370,2,7200,1.00237388724
321529,321535,324736,6,3201,2,7200,1.00187441425
321530,321542,324728,12,3186,2,7200,1.00376647834
321581,321588,325100,7,3512,2,7200,1.00199316629
321611,321618,324912,7,3294,2,7200,1.0021250759
321656,321662,325241,6,3579,2,7200,1.00167644593
321670,321677,325405,7,3728,2,7200,1.0018776824
321685,321691,325072,6,3381,2,7200,1.00177462289
321700,321706,325317,6,3611,2,7200,1.00166158959
321720,321728,325406,8,3678,2,7200,1.00217509516
321735,321741,324909,6,3168,2,7200,1.00189393939
321737,321749,325105,12,3356,2,7200,1.00357568534
321753,321760,325205,7,3445,2,7200,1.00203193033
321795,321801,325323,6,3522,2,7200,1.00170357751
321810,321817,324831,7,3014,2,7200,1.00232249502
321811,321824,325094,13,3270,2,7200,1.00397553517
321826,321832,325222,6,3390,2,7200,1.0017699115
321840,321847,325384,7,3537,2,7200,1.00197907831
321903,321909,325372,6,3463,2,7200,1.00173260179
321927,321933,325098,6,3165,2,7200,1.0018957346
321972,321979,325417,7,3438,2,7200,1.00203606748
321987,321994,325414,7,3420,2,7200,1.00204678363
322001,322008,325362,7,3354,2,7200,1.00208706023
322034,322042,325401,8,3359,2,7200,1.00238166121
322036,322049,325378,13,3329,2,7200,1.0039050766
322051,322057,325532,6,3475,2,7200,1.00172661871
322071,322077,325915,6,3838,2,7200,1.00156331423
322282,322289,325905,7,3616,2,7200,1.00193584071
322896,322902,322911,6,9,1,900,1.5
322906,322912,326454,6,3542,2,3540,1.00169395822
323442,323449,323470,7,21,1,900,1.33333333333
324111,324117,327401,6,3284,2,7200,1.00182704019
324312,324318,327606,6,3288,2,7200,1.00182481752
324496,324502,327796,6,3294,2,7200,1.00182149362
324634,324641,328109,7,3468,2,7200,1.00201845444
324660,324667,328005,7,3338,2,7200,1.00209706411
324681,324691,328147,10,3456,2,7200,1.00289351852
324720,324727,327963,7,3236,2,7200,1.0021631644
324735,324741,328129,6,3388,2,7200,1.00177095632
324736,324748,328222,12,3474,2,7200,1.00345423143
324751,324757,328136,6,3379,2,7200,1.00177567328
324805,324811,328107,6,3296,2,7200,1.00182038835
324806,324819,328457,13,3638,2,7200,1.00357339197
324830,324836,328317,6,3481,2,7200,1.00172364263
324848,324855,328057,7,3202,2,7200,1.00218613367
324892,324899,328217,7,3318,2,7200,1.00210970464
324911,324917,328337,6,3420,2,7200,1.00175438596
324925,324933,328454,8,3521,2,7200,1.00227208179
324927,324939,328483,12,3544,2,7200,1.00338600451
325071,325077,328671,6,3594,2,7200,1.00166944908
325095,325101,328685,6,3584,2,7200,1.00167410714
325110,325117,328518,7,3401,2,7200,1.00205821817
325111,325124,328548,13,3424,2,7200,1.00379672897
325113,325129,328608,16,3479,2,7200,1.00459902271
325206,325212,328810,6,3598,2,7200,1.00166759311
325224,325230,328635,6,3405,2,7200,1.00176211454
325241,325247,328655,6,3408,2,7200,1.00176056338
325313,325319,328810,6,3491,2,7200,1.00171870524
325328,325335,328640,7,3305,2,7200,1.00211800303
325364,325371,328938,7,3567,2,7200,1.00196243342
325379,325385,328543,6,3158,2,7200,1.00189993667
325380,325391,328964,11,3573,2,7200,1.0030786454
325395,325402,328709,7,3307,2,7200,1.0021167221
325409,325417,328811,8,3394,2,7200,1.00235710077
325411,325424,328660,13,3236,2,7200,1.00401730532
325412,325429,328936,17,3507,2,7200,1.00484744796
325427,325436,328752,9,3316,2,7200,1.00271411339
325428,325441,328992,13,3551,2,7200,1.00366094058
325530,325536,328938,6,3402,2,7200,1.00176366843
325678,325684,325685,6,1,1,7200,1.0
325737,325744,326887,7,1143,1,7200,1.00612423447
325906,325913,329168,7,3255,2,7200,1.00215053763
325921,325927,329492,6,3565,2,7200,1.00168302945
326371,326377,540903,6,214526,1,342000,1.00002796864
326460,326468,327044,8,576,2,3540,1.01388888889
327400,327407,330761,7,3354,2,7200,1.00208706023
327443,333336,377065,5893,43729,16,324000,1.13476182853
327551,327557,341834,6,14277,4,259200,1.00042025636
327607,327614,331174,7,3560,2,7200,1.00196629213
327617,328122,355907,505,27785,4,259200,1.01817527443
327796,327803,331215,7,3412,2,7200,1.00205158265
327965,327971,331693,6,3722,2,7200,1.00161203654
328007,328013,331390,6,3377,2,7200,1.0017767249
328058,328064,331549,6,3485,2,7200,1.00172166428
328108,328115,331704,7,3589,2,7200,1.00195040401
328123,328129,331263,6,3134,2,7200,1.00191448628
328138,328144,331321,6,3177,2,7200,1.00188857413
328139,328151,331474,12,3323,2,7200,1.0036111947
328154,328160,331386,6,3226,2,7200,1.00185988841
328217,328224,331696,7,3472,2,7200,1.00201612903
328231,328237,331506,6,3269,2,7200,1.00183542368
328318,328325,331894,7,3569,2,7200,1.00196133371
328339,328345,331833,6,3488,2,7200,1.00172018349
328456,328463,332024,7,3561,2,7200,1.00196573996
328471,328477,331862,6,3385,2,7200,1.00177252585
328486,328492,331743,6,3251,2,7200,1.00184558597
328519,328525,331820,6,3295,2,7200,1.00182094082
328537,328561,342837,24,14276,4,259200,1.00168114318
328545,328551,331993,6,3442,2,7200,1.00174317257
328560,328567,331755,7,3188,2,7200,1.002195734
328611,328617,332181,6,3564,2,7200,1.00168350168
328635,328641,332007,6,3366,2,7200,1.00178253119
328649,328656,332053,7,3397,2,7200,1.00206064174
328664,328670,332135,6,3465,2,7200,1.00173160173
328665,328677,331942,12,3265,2,7200,1.00367534456
328680,328687,332047,7,3360,2,7200,1.00208333333
328695,328702,331949,7,3247,2,7200,1.00215583616
328710,328717,331864,7,3147,2,7200,1.00222434064
328751,328757,332111,6,3354,2,7200,1.00178890877
328759,328765,328790,6,25,4,259200,1.24
328808,328814,332124,6,3310,2,7200,1.00181268882
328823,328829,332324,6,3495,2,7200,1.0017167382
328824,328836,332208,12,3372,2,7200,1.00355871886
328935,328942,332079,7,3137,2,7200,1.0022314313
328950,328957,332428,7,3471,2,7200,1.00201670988
328951,328964,332243,13,3279,2,7200,1.00396462336
328966,328972,332530,6,3558,2,7200,1.00168634064
328995,329003,332237,8,3234,2,7200,1.00247371676
329167,329174,332523,7,3349,2,7200,1.00209017617
329478,329485,330593,7,1108,2,18000,1.00631768953
329489,329496,332852,7,3356,2,7200,1.00208581645
330463,330470,346315,7,15845,2,18000,1.00044177974
330621,330628,333989,7,3361,2,18000,1.00208271348
330761,330768,334187,7,3419,2,7200,1.00204738228
331117,331124,336577,7,5453,2,18000,1.00128369705
331177,331183,334422,6,3239,2,7200,1.00185242359
331215,331222,334681,7,3459,2,7200,1.00202370627
331263,331269,334407,6,3138,2,7200,1.00191204589
331280,331287,333333,7,2046,1,18000,1.00342130987
331281,331299,333231,18,1932,1,18000,1.00931677019
331281,331292,332418,11,1126,1,18000,1.00976909414
331282,331304,333297,22,1993,1,18000,1.01103863522
331283,331315,333560,32,2245,1,18000,1.01425389755
331283,331310,333323,27,2013,1,18000,1.01341281669
331288,331320,333318,32,1998,1,18000,1.01601601602
331289,331326,332628,37,1302,1,18000,1.02841781874
331290,331399,333430,109,2031,1,18000,1.05366814377
331291,331404,333388,113,1984,1,18000,1.05695564516
331292,331490,333583,198,2093,1,18000,1.09460105112
331293,331495,333426,202,1931,1,18000,1.10460901088
331294,331519,333430,225,1911,1,18000,1.11773940345
331296,331524,333398,228,1874,1,18000,1.12166488794
331297,331562,333609,265,2047,1,18000,1.12945774304
331299,331567,332681,268,1114,1,18000,1.24057450628
331300,331758,333570,458,1812,1,18000,1.2527593819
331300,331763,333758,463,1995,1,18000,1.2320802005
331301,331836,333821,535,1985,1,18000,1.26952141058
331302,331841,333841,539,2000,1,18000,1.2695
331320,331333,334772,13,3439,2,7200,1.00378016865
331386,331392,334562,6,3170,2,7200,1.00189274448
331401,331411,334880,10,3469,2,7200,1.00288267512
331476,331482,334700,6,3218,2,7200,1.00186451212
331506,331512,334498,6,2986,2,7200,1.00200937709
331548,331554,334894,6,3340,2,7200,1.00179640719
331692,331709,349754,17,18045,2,18000,1.00094208922
331695,331701,335141,6,3440,2,7200,1.00174418605
331696,331714,334952,18,3238,2,7200,1.00555898703
331711,331721,335252,10,3531,2,7200,1.00283205891
331744,331751,335184,7,3433,2,7200,1.00203903292
331759,331770,335279,11,3509,2,7200,1.00313479624
331822,331828,335068,6,3240,2,7200,1.00185185185
331836,331848,335192,12,3344,2,7200,1.00358851675
331860,331867,335305,7,3438,2,7200,1.00203606748
331875,331881,335385,6,3504,2,7200,1.00171232877
331893,331900,335127,7,3227,2,7200,1.0021691974
331943,331951,335543,8,3592,2,7200,1.00222717149
331958,331965,335346,7,3381,2,7200,1.00207039337
331994,332000,335469,6,3469,2,7200,1.00172960507
332009,332016,335418,7,3402,2,7200,1.00205761317
332023,332031,335428,8,3397,2,7200,1.00235501913
332047,332054,335361,7,3307,2,7200,1.0021167221
332062,332068,335294,6,3226,2,7200,1.00185988841
332080,332086,335462,6,3376,2,7200,1.00177725118
332112,332120,335456,8,3336,2,7200,1.00239808153
332127,332134,335269,7,3135,2,7200,1.00223285486
332142,332149,335533,7,3384,2,7200,1.00206855792
332177,332183,332185,6,2,2,3540,1.0
332181,332189,335598,8,3409,2,7200,1.00234672925
332207,332215,335688,8,3473,2,7200,1.00230348402
332237,332244,335762,7,3518,2,7200,1.00198976691
332252,332258,335657,6,3399,2,7200,1.00176522507
332324,332331,335654,7,3323,2,7200,1.00210653024
332426,332433,335908,7,3475,2,7200,1.00201438849
332522,332529,335823,7,3294,2,7200,1.0021250759
332537,332544,336035,7,3491,2,7200,1.00200515612
332850,332856,336241,6,3385,2,7200,1.00177252585
333899,333906,335805,7,1899,1,18000,1.00368615061
333905,333913,336152,8,2239,1,18000,1.00357302367
333907,333918,336060,11,2142,1,18000,1.00513538749
333917,333925,336004,8,2079,1,18000,1.00384800385
333919,333932,336247,13,2315,1,18000,1.00561555076
333920,333937,335879,17,1942,1,18000,1.008753862
333931,333944,336203,13,2259,1,18000,1.00575475874
333936,333950,336028,14,2078,1,18000,1.00673724735
333939,333956,335930,17,1974,1,18000,1.00861195542
333941,333962,336149,21,2187,1,18000,1.00960219479
333947,333967,336205,20,2238,1,18000,1.00893655049
333950,333972,335887,22,1915,1,18000,1.01148825065
333951,333979,336074,28,2095,1,18000,1.01336515513
333953,333984,336179,31,2195,1,18000,1.01412300683
333957,333989,336199,32,2210,1,18000,1.01447963801
333965,333994,335973,29,1979,1,18000,1.01465386559
333973,334000,336001,27,2001,1,18000,1.01349325337
333974,334007,335942,33,1935,1,18000,1.01705426357
333976,334012,336098,36,2086,1,18000,1.01725790988
333977,334200,336150,223,1950,1,18000,1.11435897436
334187,334193,337515,6,3322,2,7200,1.00180614088
334406,334413,337485,7,3072,2,7200,1.00227864583
334420,334428,337697,8,3269,2,7200,1.00244723157
334498,334505,337553,7,3048,2,7200,1.00229658793
334564,334570,338136,6,3566,2,7200,1.00168255749
334681,334688,338083,7,3395,2,7200,1.00206185567
334699,334705,337967,6,3262,2,7200,1.00183936235
334728,334785,334928,57,143,2,18000,1.3986013986
334771,334777,337885,6,3108,2,7200,1.00193050193
334882,334889,338317,7,3428,2,7200,1.002042007
334896,334903,338498,7,3595,2,7200,1.00194714882
334954,334960,338327,6,3367,2,7200,1.00178200178
335068,335075,338509,7,3434,2,7200,1.00203843914
335128,335134,338364,6,3230,2,7200,1.00185758514
335143,335150,338621,7,3471,2,7200,1.00201670988
335185,335191,338924,6,3733,2,7200,1.00160728636
335200,335206,338493,6,3287,2,7200,1.00182537268
335254,335261,338601,7,3340,2,7200,1.00209580838
335269,335276,338626,7,3350,2,7200,1.00208955224
335283,335290,338539,7,3249,2,7200,1.00215450908
335298,335305,338608,7,3303,2,7200,1.0021192855
335313,335319,338713,6,3394,2,7200,1.00176782557
335348,335362,335463,14,101,1,3600,1.13861386139
335349,335355,338563,6,3208,2,7200,1.00187032419
335363,335371,338835,8,3464,2,7200,1.00230946882
335384,335391,338715,7,3324,2,7200,1.00210589651
335420,335427,338765,7,3338,2,7200,1.00209706411
335435,335441,338585,6,3144,2,7200,1.00190839695
335455,335462,338943,7,3481,2,7200,1.0020109164
335470,335477,338778,7,3301,2,7200,1.00212056952
335472,335484,338839,12,3355,2,7200,1.00357675112
335532,335539,338695,7,3156,2,7200,1.00221799747
335546,335554,338691,8,3137,2,7200,1.0025502072
335597,335604,338992,7,3388,2,7200,1.0020661157
335654,335661,338632,7,2971,2,7200,1.00235610905
335669,335676,339257,7,3581,2,7200,1.00195476124
335689,335696,338966,7,3270,2,7200,1.00214067278
335764,335772,339083,8,3311,2,7200,1.00241618846
335824,335831,339114,7,3283,2,7200,1.00213219616
335908,335915,339128,7,3213,2,7200,1.00217864924
336034,336041,339637,7,3596,2,7200,1.00194660734
336242,336248,339679,6,3431,2,7200,1.00174876129
336274,336281,338188,7,1907,1,18000,1.00367068694
336275,336287,338118,12,1831,1,18000,1.00655379574
336276,336293,338436,17,2143,1,18000,1.00793280448
336277,336589,338479,312,1890,1,18000,1.16507936508
336278,336594,338771,316,2177,1,18000,1.14515388149
336279,337502,339589,1223,2087,1,18000,1.58600862482
336280,337594,339446,1314,1852,1,18000,1.70950323974
336280,337589,339320,1309,1731,1,18000,1.75621028307
336281,337709,339577,1428,1868,1,18000,1.76445396146
336282,337714,339755,1432,2041,1,18000,1.70161685448
336282,337983,340000,1701,2017,1,18000,1.84333168071
336283,337988,340090,1705,2102,1,18000,1.811132255
336284,338131,340147,1847,2016,1,18000,1.91617063492
336288,338201,340217,1913,2016,1,18000,1.94890873016
336288,338448,340642,2160,2194,1,18000,1.98450319052
336290,338491,340639,2201,2148,1,18000,2.02467411546
336290,338516,340661,2226,2145,1,18000,2.03776223776
336292,338522,340446,2230,1924,1,18000,2.15904365904
336293,338552,340638,2259,2086,1,18000,2.08293384468
337096,337568,337577,472,9,2,18000,48.1
337488,337495,340955,7,3460,2,7200,1.00202312139
337518,337524,340837,6,3313,2,7200,1.00181104739
337554,337561,341015,7,3454,2,7200,1.00202663578
337695,337701,341260,6,3559,2,7200,1.00168586682
337886,337892,341346,6,3454,2,7200,1.00173711639
337970,337976,341303,6,3327,2,7200,1.00180342651
338084,338090,341466,6,3376,2,7200,1.00177725118
338138,338145,341696,7,3551,2,7200,1.0019712757
338317,338339,356359,22,18020,2,18000,1.0012208657
338318,338325,341713,7,3388,2,7200,1.0020661157
338321,340012,342784,1691,2772,8,7200,1.61002886003
338333,338346,341548,13,3202,2,7200,1.00405996252
338366,338372,341813,6,3441,2,7200,1.00174367916
338380,338508,339246,128,738,2,18000,1.17344173442
338495,338502,341997,7,3495,2,7200,1.00200286123
338510,338529,342019,19,3490,2,7200,1.00544412607
338511,338534,341908,23,3374,2,7200,1.00681683462
338538,338545,341967,7,3422,2,7200,1.00204558738
338565,338572,342286,7,3714,2,7200,1.00188476037
338582,338600,356626,18,18026,2,18000,1.00099855764
338586,338593,341948,7,3355,2,7200,1.00208643815
338601,338607,341712,6,3105,2,7200,1.00193236715
338615,338622,342160,7,3538,2,7200,1.00197851894
338630,338636,342228,6,3592,2,7200,1.00167037862
338631,338643,342030,12,3387,2,7200,1.00354295837
338646,338652,342142,6,3490,2,7200,1.00171919771
338691,338698,341901,7,3203,2,7200,1.00218545114
338706,338712,342006,6,3294,2,7200,1.00182149362
338720,338728,342317,8,3589,2,7200,1.00222903316
338722,338733,342174,11,3441,2,7200,1.00319674513
338767,338773,342204,6,3431,2,7200,1.00174876129
338781,338787,342188,6,3401,2,7200,1.001764187
338786,340674,427124,1888,86450,8,86400,1.02183921342
338835,338842,342079,7,3237,2,7200,1.00216249614
338850,338857,342204,7,3347,2,7200,1.00209142516
338925,338931,342480,6,3549,2,7200,1.00169061708
338945,338952,342390,7,3438,2,7200,1.00203606748
338966,338973,342430,7,3457,2,7200,1.00202487706
338993,338999,342191,6,3192,2,7200,1.00187969925
339083,339089,342509,6,3420,2,7200,1.00175438596
339112,339119,342774,7,3655,2,7200,1.00191518468
339127,339134,342681,7,3547,2,7200,1.00197349873
339253,339260,342844,7,3584,2,7200,1.001953125
339388,339395,341766,7,2371,2,18000,1.00295234078
339638,339646,343032,8,3386,2,7200,1.00236266982
339677,339683,342994,6,3311,2,7200,1.00181214135
340836,340844,344449,8,3605,2,7200,1.00221914008
340956,340964,344504,8,3540,2,7200,1.00225988701
341013,341019,344158,6,3139,2,7200,1.00191143676
341260,341266,344497,6,3231,2,7200,1.00185701021
341302,341308,344271,6,2963,2,7200,1.00202497469
341346,341353,344609,7,3256,2,7200,1.00214987715
341466,341474,344831,8,3357,2,7200,1.00238308013
341547,341554,344812,7,3258,2,7200,1.0021485574
341698,341705,345296,7,3591,2,7200,1.00194931774
341712,341719,345051,7,3332,2,7200,1.00210084034
341714,341726,344944,12,3218,2,7200,1.00372902424
341813,341820,345154,7,3334,2,7200,1.00209958008
341900,341906,345252,6,3346,2,7200,1.00179318589
341915,341921,345169,6,3248,2,7200,1.00184729064
341947,341954,345399,7,3445,2,7200,1.00203193033
341965,341972,345093,7,3121,2,7200,1.00224287087
341998,342005,345401,7,3396,2,7200,1.00206124853
342013,342019,345466,6,3447,2,7200,1.00174064404
342028,342034,345413,6,3379,2,7200,1.00177567328
342042,342049,345685,7,3636,2,7200,1.00192519252
342081,342087,345524,6,3437,2,7200,1.00174570847
342141,342148,345655,7,3507,2,7200,1.00199600798
342162,342168,345641,6,3473,2,7200,1.00172761301
342177,342183,345691,6,3508,2,7200,1.00171037628
342191,342198,345484,7,3286,2,7200,1.00213024954
342193,342205,345734,12,3529,2,7200,1.00340039671
342208,342214,345453,6,3239,2,7200,1.00185242359
342209,342221,345568,12,3347,2,7200,1.00358530027
342230,342237,345709,7,3472,2,7200,1.00201612903
342287,342293,345487,6,3194,2,7200,1.00187852223
342320,342327,345747,7,3420,2,7200,1.00204678363
342391,342398,346085,7,3687,2,7200,1.00189856252
342430,342437,345558,7,3121,2,7200,1.00224287087
342481,342487,345801,6,3314,2,7200,1.00181050091
342511,342518,345736,7,3218,2,7200,1.00217526414
342683,342695,345870,12,3175,2,7200,1.00377952756
342683,342689,360708,6,18019,2,18000,1.00033298185
342776,342782,346090,6,3308,2,7200,1.00181378476
342845,342852,346077,7,3225,2,7200,1.00217054264
342995,343002,346425,7,3423,2,7200,1.00204498978
343031,343038,346240,7,3202,2,7200,1.00218613367
343149,343156,345085,7,1929,1,18000,1.00362882322
343154,343162,344191,8,1029,1,18000,1.00777453839
343155,343168,344885,13,1717,1,18000,1.00757134537
343157,343175,344642,18,1467,1,18000,1.01226993865
343160,343180,344571,20,1391,1,18000,1.01437814522
343162,343186,345105,24,1919,1,18000,1.01250651381
343163,343191,344916,28,1725,1,18000,1.01623188406
343164,343196,344928,32,1732,1,18000,1.01847575058
343166,343207,344793,41,1586,1,18000,1.02585119798
343166,343202,344863,36,1661,1,18000,1.02167369055
343167,343212,344722,45,1510,1,18000,1.0298013245
343169,343225,344970,56,1745,1,18000,1.03209169054
343169,343217,345160,48,1943,1,18000,1.02470406588
343172,343230,345044,58,1814,1,18000,1.03197353914
343173,343236,344844,63,1608,1,18000,1.03917910448
343174,344204,345850,1030,1646,1,18000,1.62575941677
343175,344584,346195,1409,1611,1,18000,1.87461204221
343176,344655,346374,1479,1719,1,18000,1.86038394415
344159,344166,347575,7,3409,2,7200,1.00205338809
344273,344280,347726,7,3446,2,7200,1.00203134068
344447,344454,347921,7,3467,2,7200,1.00201903663
344498,344504,347893,6,3389,2,7200,1.00177043376
344513,344520,347916,7,3396,2,7200,1.00206124853
344609,344615,347914,6,3299,2,7200,1.00181873295
344813,344819,348472,6,3653,2,7200,1.00164248563
344831,344838,347982,7,3144,2,7200,1.0022264631
344945,344952,348596,7,3644,2,7200,1.00192096597
345050,345057,348229,7,3172,2,7200,1.00220680958
345095,345101,348552,6,3451,2,7200,1.00173862649
345155,345161,348465,6,3304,2,7200,1.00181598063
345169,345176,348454,7,3278,2,7200,1.00213544844
345253,345260,348576,7,3316,2,7200,1.00211097708
345298,345304,348717,6,3413,2,7200,1.00175798418
345400,345407,348723,7,3316,2,7200,1.00211097708
345402,345414,348855,12,3441,2,7200,1.00348735833
345417,345423,348510,6,3087,2,7200,1.0019436346
345456,345462,348684,6,3222,2,7200,1.00186219739
345470,345476,348864,6,3388,2,7200,1.00177095632
345485,345491,348925,6,3434,2,7200,1.00174723355
345500,345506,348943,6,3437,2,7200,1.00174570847
345526,345532,348820,6,3288,2,7200,1.00182481752
345559,345565,349068,6,3503,2,7200,1.00171281758
345574,345580,348939,6,3359,2,7200,1.00178624591
345643,345649,349224,6,3575,2,7200,1.00167832168
345658,345665,348966,7,3301,2,7200,1.00212056952
345685,345691,348905,6,3214,2,7200,1.00186683261
345700,345706,348988,6,3282,2,7200,1.00182815356
345714,345721,348994,7,3273,2,7200,1.00213871066
345735,345741,349025,6,3284,2,7200,1.00182704019
345750,345757,349049,7,3292,2,7200,1.00212636695
345751,345764,349334,13,3570,2,7200,1.00364145658
345802,345809,349248,7,3439,2,7200,1.00203547543
345871,345877,349085,6,3208,2,7200,1.00187032419
346075,346082,349351,7,3269,2,7200,1.00214132762
346090,346097,349434,7,3337,2,7200,1.00209769254
346104,346112,349632,8,3520,2,7200,1.00227272727
346240,346247,349661,7,3414,2,7200,1.00205038079
346426,346433,349861,7,3428,2,7200,1.002042007
346432,346440,348218,8,1778,1,18000,1.00449943757
346434,346447,348127,13,1680,1,18000,1.00773809524
346437,346452,348182,15,1730,1,18000,1.00867052023
346441,346458,348049,17,1591,1,18000,1.01068510371
346443,346464,348078,21,1614,1,18000,1.01301115242
346448,346469,348395,21,1926,1,18000,1.01090342679
346451,346474,348230,23,1756,1,18000,1.01309794989
346453,348062,349875,1609,1813,1,18000,1.88747931605
346454,348091,349909,1637,1818,1,18000,1.900440044
346456,348140,349813,1684,1673,1,18000,2.00657501494
346461,348195,350013,1734,1818,1,18000,1.95379537954
346467,348231,349817,1764,1586,1,18000,2.11223203026
346469,348244,350031,1775,1787,1,18000,1.99328483492
346481,348249,349934,1768,1685,1,18000,2.04925816024
346486,348255,349997,1769,1742,1,18000,2.01549942595
346488,348408,350149,1920,1741,1,18000,2.10281447444
346499,348469,350027,1970,1558,1,18000,2.26444159178
346501,348474,350072,1973,1598,1,18000,2.23466833542
347576,347583,350913,7,3330,2,7200,1.0021021021
347727,347733,351230,6,3497,2,7200,1.00171575636
347835,369505,542338,21670,172833,12,172800,1.12538114828
347895,347902,351163,7,3261,2,7200,1.0021465808
347916,347922,351096,6,3174,2,7200,1.00189035917
347931,347937,351228,6,3291,2,7200,1.00182315406
347932,347944,351493,12,3549,2,7200,1.00338123415
347983,347989,351292,6,3303,2,7200,1.00181653043
348230,348237,351400,7,3163,2,7200,1.00221308884
348455,348462,351832,7,3370,2,7200,1.00207715134
348470,348481,352105,11,3624,2,7200,1.00303532009
348484,348492,351847,8,3355,2,7200,1.00238450075
348511,348517,351846,6,3329,2,7200,1.00180234305
348553,348560,352071,7,3511,2,7200,1.00199373398
348577,348584,351888,7,3304,2,7200,1.00211864407
348598,348604,351940,6,3336,2,7200,1.00179856115
348685,348691,352016,6,3325,2,7200,1.00180451128
348717,348724,352204,7,3480,2,7200,1.00201149425
348732,348739,352161,7,3422,2,7200,1.00204558738
348822,348829,352579,7,3750,2,7200,1.00186666667
348858,348865,352400,7,3535,2,7200,1.00198019802
348873,348879,352374,6,3495,2,7200,1.0017167382
348906,348913,352504,7,3591,2,7200,1.00194931774
348926,348933,352218,7,3285,2,7200,1.00213089802
348941,348947,352324,6,3377,2,7200,1.0017767249
348956,348962,352325,6,3363,2,7200,1.00178412132
348970,348978,352621,8,3643,2,7200,1.00219599231
348988,348994,352035,6,3041,2,7200,1.00197303519
349003,349009,352442,6,3433,2,7200,1.0017477425
349027,349033,352142,6,3109,2,7200,1.00192988099
349050,349058,352160,8,3102,2,7200,1.0025789813
349068,349074,352390,6,3316,2,7200,1.00180940893
349086,349092,352602,6,3510,2,7200,1.00170940171
349224,349231,352750,7,3519,2,7200,1.00198920148
349249,349256,352625,7,3369,2,7200,1.00207776788
349330,349336,352629,6,3293,2,7200,1.00182204677
349351,349357,352747,6,3390,2,7200,1.0017699115
349435,349441,352967,6,3526,2,7200,1.00170164492
349499,349947,351550,448,1603,8,14400,1.27947598253
349633,349639,353054,6,3415,2,7200,1.00175695461
349660,349666,353015,6,3349,2,7200,1.00179157958
349692,349698,364195,6,14497,1,14400,1.00041387873
349862,349869,353066,7,3197,2,7200,1.00218955271
350496,351560,355006,1064,3446,8,86400,1.3087637841
350914,350922,354381,8,3459,2,7200,1.00231280717
351095,351101,354735,6,3634,2,7200,1.0016510732
351164,351170,354818,6,3648,2,7200,1.00164473684
351230,351237,354371,7,3134,2,7200,1.00223356733
351231,351244,354601,13,3357,2,7200,1.00387250521
351291,351298,354630,7,3332,2,7200,1.00210084034
351399,351405,354709,6,3304,2,7200,1.00181598063
351495,351502,354770,7,3268,2,7200,1.00214198286
351832,351839,355267,7,3428,2,7200,1.002042007
351847,351854,355239,7,3385,2,7200,1.00206794682
351849,351861,354954,12,3093,2,7200,1.00387972842
351890,351897,355284,7,3387,2,7200,1.00206672572
351941,351947,355099,6,3152,2,7200,1.0019035533
351960,355018,369456,3058,14438,8,14400,1.21180218867
352016,352023,355415,7,3392,2,7200,1.00206367925
352034,352041,355448,7,3407,2,7200,1.00205459348
352073,352080,355407,7,3327,2,7200,1.0021039976
352106,352113,355421,7,3308,2,7200,1.00211608222
352142,352148,355339,6,3191,2,7200,1.00188028831
352159,352166,355385,7,3219,2,7200,1.00217458838
352161,352173,355486,12,3313,2,7200,1.00362209478
352206,352212,355734,6,3522,2,7200,1.00170357751
352220,352227,355514,7,3287,2,7200,1.00212960146
352326,352332,355707,6,3375,2,7200,1.00177777778
352327,352340,355668,13,3328,2,7200,1.00390625
352375,352382,355724,7,3342,2,7200,1.00209455416
352393,352400,355729,7,3329,2,7200,1.00210273355
352407,352413,356202,6,3789,2,7200,1.00158353127
352443,352450,355760,7,3310,2,7200,1.00211480363
352503,352510,355988,7,3478,2,7200,1.00201265095
352581,352588,356349,7,3761,2,7200,1.00186120713
352602,352608,355869,6,3261,2,7200,1.0018399264
352623,352630,356052,7,3422,2,7200,1.00204558738
352637,352644,356224,7,3580,2,7200,1.00195530726
352639,352650,355881,11,3231,2,7200,1.00340451872
352747,352754,356319,7,3565,2,7200,1.00196353436
352762,352769,356153,7,3384,2,7200,1.00206855792
352969,352976,356365,7,3389,2,7200,1.00206550605
353017,353024,356351,7,3327,2,7200,1.0021039976
353056,353063,356396,7,3333,2,7200,1.00210021002
353071,353078,356401,7,3323,2,7200,1.00210653024
354279,354286,354287,7,1,2,3540,1.0
354373,354380,357713,7,3333,2,7200,1.00210021002
354388,354395,357727,7,3332,2,7200,1.00210084034
354602,354609,357993,7,3384,2,7200,1.00206855792
354632,354638,357971,6,3333,2,7200,1.00180018002
354710,354717,358065,7,3348,2,7200,1.00209080048
354734,354740,358129,6,3389,2,7200,1.00177043376
354772,354778,358152,6,3374,2,7200,1.00177830468
354817,354823,358113,6,3290,2,7200,1.00182370821
354931,354938,355115,7,177,1,3600,1.0395480226
354955,354963,358499,8,3536,2,7200,1.00226244344
355100,355106,358407,6,3301,2,7200,1.00181763102
355239,355245,358509,6,3264,2,7200,1.00183823529
355266,355273,358704,7,3431,2,7200,1.00204022151
355284,355290,358705,6,3415,2,7200,1.00175695461
355297,355304,355661,7,357,1,3600,1.01960784314
355341,355348,358821,7,3473,2,7200,1.00201554852
355385,355392,358913,7,3521,2,7200,1.00198807157
355409,355416,358914,7,3498,2,7200,1.00200114351
355424,355431,358911,7,3480,2,7200,1.00201149425
355425,355438,359056,13,3618,2,7200,1.00359314538
355449,355455,358620,6,3165,2,7200,1.0018957346
355488,355494,358872,6,3378,2,7200,1.00177619893
355515,355522,358893,7,3371,2,7200,1.00207653515
355670,355676,358968,6,3292,2,7200,1.00182260024
355708,355715,359008,7,3293,2,7200,1.00212572123
355723,355729,359232,6,3503,2,7200,1.00171281758
355738,355744,359018,6,3274,2,7200,1.00183262065
355739,355751,359157,12,3406,2,7200,1.00352319436
355760,355766,359052,6,3286,2,7200,1.00182592818
355872,355878,359307,6,3429,2,7200,1.00174978128
355886,355893,359238,7,3345,2,7200,1.00209267564
355988,355996,359551,8,3555,2,7200,1.00225035162
356030,356037,356906,7,869,1,3600,1.0080552359
356054,356062,359532,8,3470,2,7200,1.0023054755
356153,356161,359552,8,3391,2,7200,1.00235918608
356204,356211,359787,7,3576,2,7200,1.00195749441
356225,356231,359703,6,3472,2,7200,1.0017281106
356318,356325,359708,7,3383,2,7200,1.00206916938
356348,356355,359768,7,3413,2,7200,1.00205098154
356363,356370,359726,7,3356,2,7200,1.00208581645
356364,356377,359648,13,3271,2,7200,1.00397431978
356397,356405,359677,8,3272,2,7200,1.00244498778
356412,356418,359710,6,3292,2,7200,1.00182260024
357716,357722,361126,6,3404,2,7200,1.0017626322
357730,357737,361121,7,3384,2,7200,1.00206855792
357973,357980,361300,7,3320,2,7200,1.00210843373
357993,358000,361388,7,3388,2,7200,1.0020661157
358065,358073,361504,8,3431,2,7200,1.00233168173
358113,358119,361470,6,3351,2,7200,1.0017905103
358131,358138,361351,7,3213,2,7200,1.00217864924
358155,358162,361593,7,3431,2,7200,1.00204022151
358179,358185,358301,6,116,1,3600,1.05172413793
358409,358416,361776,7,3360,2,7200,1.00208333333
358476,358483,358805,7,322,1,3600,1.02173913043
358499,358506,361945,7,3439,2,7200,1.00203547543
358499,358511,358681,12,170,1,3600,1.07058823529
358514,358520,361981,6,3461,2,7200,1.001733603
358619,358626,362151,7,3525,2,7200,1.0019858156
358707,358713,362186,6,3473,2,7200,1.00172761301
358708,358721,362092,13,3371,2,7200,1.00385642243
358821,358827,362211,6,3384,2,7200,1.00177304965
358851,358858,359218,7,360,1,3600,1.01944444444
358875,358881,362300,6,3419,2,7200,1.00175489909
358892,358899,362182,7,3283,2,7200,1.00213219616
358910,358916,362610,6,3694,2,7200,1.00162425555
358925,358931,362259,6,3328,2,7200,1.00180288462
358926,358938,362401,12,3463,2,7200,1.00346520358
358968,358975,362300,7,3325,2,7200,1.00210526316
359007,359014,362277,7,3263,2,7200,1.00214526509
359022,359029,362400,7,3371,2,7200,1.00207653515
359052,359058,362505,6,3447,2,7200,1.00174064404
359066,359074,362209,8,3135,2,7200,1.00255183413
359160,359166,362723,6,3557,2,7200,1.00168681473
359233,359239,362904,6,3665,2,7200,1.00163710778
359247,359255,362510,8,3255,2,7200,1.0024577573
359284,359291,359915,7,624,1,3600,1.01121794872
359307,359314,362643,7,3329,2,7200,1.00210273355
359533,359540,363134,7,3594,2,7200,1.0019476906
359551,359557,362920,6,3363,2,7200,1.00178412132
359553,359564,362967,11,3403,2,7200,1.00323244196
359583,359591,360446,8,855,1,3600,1.00935672515
359649,359656,363051,7,3395,2,7200,1.00206185567
359678,359686,363098,8,3412,2,7200,1.00234466589
359705,359712,363179,7,3467,2,7200,1.00201903663
359720,359727,362984,7,3257,2,7200,1.00214921707
359721,359734,363226,13,3492,2,7200,1.00372279496
359736,359742,363044,6,3302,2,7200,1.00181708056
359769,359775,362842,6,3067,2,7200,1.0019563091
359787,359793,363101,6,3308,2,7200,1.00181378476
361123,361130,364172,7,3042,2,7200,1.00230111769
361137,361143,364726,6,3583,2,7200,1.00167457438
361300,361307,364638,7,3331,2,7200,1.00210147103
361351,361357,364775,6,3418,2,7200,1.00175541252
361390,361396,364964,6,3568,2,7200,1.00168161435
361471,361479,365044,8,3565,2,7200,1.00224403927
361504,361510,364914,6,3404,2,7200,1.0017626322
361591,361599,365165,8,3566,2,7200,1.00224340998
361747,361753,361866,6,113,1,3600,1.05309734513
361778,361785,365269,7,3484,2,7200,1.00200918485
361946,361953,365297,7,3344,2,7200,1.00209330144
361981,361988,365620,7,3632,2,7200,1.00192731278
362056,362062,362396,6,334,1,3600,1.01796407186
362090,362096,365569,6,3473,2,7200,1.00172761301
362150,362156,365758,6,3602,2,7200,1.00166574125
362182,362189,365665,7,3476,2,7200,1.00201380898
362192,362198,362316,6,118,1,1800,1.05084745763
362197,362204,365630,7,3426,2,7200,1.00204319907
362212,362219,365417,7,3198,2,7200,1.00218886804
362213,362226,365667,13,3441,2,7200,1.00377797152
362261,362268,365474,7,3206,2,7200,1.00218340611
362279,362286,365876,7,3590,2,7200,1.00194986072
362300,362306,365437,6,3131,2,7200,1.00191632066
362301,362313,365606,12,3293,2,7200,1.00364409353
362405,362412,365892,7,3480,2,7200,1.00201149425
362406,362419,365799,13,3380,2,7200,1.00384615385
362505,362512,365875,7,3363,2,7200,1.00208147487
362520,362526,365728,6,3202,2,7200,1.00187382886
362610,362618,366069,8,3451,2,7200,1.00231816865
362622,362629,362752,7,123,1,1800,1.05691056911
362643,362650,365986,7,3336,2,7200,1.00209832134
362725,362732,366010,7,3278,2,7200,1.00213544844
362846,362853,366273,7,3420,2,7200,1.00204678363
362879,362886,363499,7,613,1,3600,1.01141924959
362906,362913,366453,7,3540,2,7200,1.00197740113
362921,362928,366195,7,3267,2,7200,1.00214263851
362965,362973,366381,8,3408,2,7200,1.00234741784
362983,362990,366164,7,3174,2,7200,1.00220541903
363044,363051,366387,7,3336,2,7200,1.00209832134
363058,363066,366313,8,3247,2,7200,1.00246381275
363097,363104,366302,7,3198,2,7200,1.00218886804
363112,363118,366398,6,3280,2,7200,1.00182926829
363133,363139,366516,6,3377,2,7200,1.0017767249
363181,363187,366590,6,3403,2,7200,1.00176315016
363214,363220,366822,6,3602,1,3600,1.00166574125
363228,363236,366449,8,3213,2,7200,1.00248988484
363425,363432,364013,7,581,1,1800,1.01204819277
364174,364180,367717,6,3537,2,7200,1.00169635284
364492,364499,364500,7,1,4,86400,1.0
364505,364511,365678,6,1167,4,86400,1.00514138817
364638,364645,367714,7,3069,2,7200,1.00228087325
364726,364732,368112,6,3380,2,7200,1.00177514793
364777,364784,368110,7,3326,2,7200,1.00210463019
364915,364921,368368,6,3447,2,7200,1.00174064404
364963,364970,368293,7,3323,2,7200,1.00210653024
365044,365051,368133,7,3082,2,7200,1.00227125243
365164,365172,368593,8,3421,2,7200,1.00233849752
365270,365276,368745,6,3469,2,7200,1.00172960507
365296,365304,368665,8,3361,2,7200,1.00238024398
365420,365426,368607,6,3181,2,7200,1.00188619931
365438,365445,369274,7,3829,2,7200,1.00182815356
365474,365482,369018,8,3536,2,7200,1.00226244344
365571,365577,369154,6,3577,2,7200,1.00167738328
365607,365613,369009,6,3396,2,7200,1.00176678445
365621,365627,369171,6,3544,2,7200,1.00169300226
365636,365642,368931,6,3289,2,7200,1.00182426269
365666,365672,369105,6,3433,2,7200,1.0017477425
365681,365688,368983,7,3295,2,7200,1.00212443096
365728,365735,369142,7,3407,2,7200,1.00205459348
365758,365764,369087,6,3323,2,7200,1.00180559735
365768,365774,365824,6,50,1,1800,1.12
365770,365831,371267,61,5436,4,86400,1.01122148639
365800,365806,369005,6,3199,2,7200,1.00187558612
365876,365882,368975,6,3093,2,7200,1.00193986421
365878,365889,369157,11,3268,2,7200,1.00336597307
365884,365896,366010,12,114,1,1800,1.10526315789
365892,365903,369219,11,3316,2,7200,1.0033172497
365986,365992,369492,6,3500,2,7200,1.00171428571
366010,366017,369404,7,3387,2,7200,1.00206672572
366070,366077,369350,7,3273,2,7200,1.00213871066
366143,366149,366230,6,81,1,1800,1.07407407407
366163,366169,369621,6,3452,2,7200,1.00173812283
366196,366203,369335,7,3132,2,7200,1.00223499361
366275,366282,369363,7,3081,2,7200,1.00227198961
366302,366308,369269,6,2961,2,7200,1.00202634245
366317,366324,369489,7,3165,2,7200,1.00221169036
366346,366352,366478,6,126,1,1800,1.04761904762
366383,366390,369493,7,3103,2,7200,1.00225588141
366398,366404,369704,6,3300,2,7200,1.00181818182
366412,366418,369571,6,3153,2,7200,1.00190294957
366451,366458,369814,7,3356,2,7200,1.00208581645
366466,366473,369768,7,3295,2,7200,1.00212443096
366517,366523,369916,6,3393,2,7200,1.0017683466
366589,366595,369999,6,3404,2,7200,1.0017626322
367190,367197,367769,7,572,1,1800,1.01223776224
367216,367222,367499,6,277,1,1800,1.02166064982
367717,367724,371203,7,3479,2,7200,1.00201207243
367732,367738,371002,6,3264,2,7200,1.00183823529
368113,368120,371590,7,3470,2,7200,1.00201729107
368114,368127,371538,13,3411,2,7200,1.00381119906
368135,368142,371178,7,3036,2,7200,1.00230566535
368295,368301,371389,6,3088,2,7200,1.00194300518
368370,368377,371727,7,3350,2,7200,1.00208955224
368596,368602,371990,6,3388,2,7200,1.00177095632
368610,368618,372004,8,3386,2,7200,1.00236266982
368667,368674,371887,7,3213,2,7200,1.00217864924
368746,368753,371918,7,3165,2,7200,1.00221169036
368932,368938,372294,6,3356,2,7200,1.00178784267
368974,368980,372212,6,3232,2,7200,1.00185643564
368989,368995,372329,6,3334,2,7200,1.00179964007
369007,369014,372425,7,3411,2,7200,1.00205218411
369022,369028,372279,6,3251,2,7200,1.00184558597
369023,369035,372452,12,3417,2,7200,1.0035118525
369089,369096,372212,7,3116,2,7200,1.00224646983
369107,369114,372584,7,3470,2,7200,1.00201729107
369143,369150,372467,7,3317,2,7200,1.00211034067
369157,369164,372523,7,3359,2,7200,1.00208395356
369159,369170,372609,11,3439,2,7200,1.00319860425
369173,369180,372538,7,3358,2,7200,1.00208457415
369218,369225,372346,7,3121,2,7200,1.00224287087
369269,369276,372557,7,3281,2,7200,1.00213349589
369284,369290,372521,6,3231,2,7200,1.00185701021
369335,369342,372867,7,3525,2,7200,1.0019858156
369350,369356,372456,6,3100,2,7200,1.00193548387
369364,369370,372868,6,3498,2,7200,1.00171526587
369406,369413,373057,7,3644,2,7200,1.00192096597
369490,369497,372921,7,3424,2,7200,1.00204439252
369505,369511,372946,6,3435,2,7200,1.00174672489
369507,369517,372822,10,3305,2,7200,1.00302571861
369573,369580,372899,7,3319,2,7200,1.002109069
369621,369628,373088,7,3460,2,7200,1.00202312139
369686,369692,369740,6,48,1,1800,1.125
369705,369711,373279,6,3568,2,7200,1.00168161435
369768,369774,373092,6,3318,2,7200,1.00180831826
369816,369824,373159,8,3335,2,7200,1.0023988006
369916,369923,373203,7,3280,2,7200,1.00213414634
370000,370007,373165,7,3158,2,7200,1.00221659278
370088,370094,370175,6,81,1,1800,1.07407407407
371006,371012,374461,6,3449,2,7200,1.00173963468
371177,371184,374571,7,3387,2,7200,1.00206672572
371204,371210,374345,6,3135,2,7200,1.0019138756
371228,371235,371518,7,283,1,1800,1.02473498233
371388,371394,374637,6,3243,2,7200,1.00185013876
371540,371547,374881,7,3334,2,7200,1.00209958008
371591,371597,375120,6,3523,2,7200,1.00170309395
371603,371609,373642,6,2033,4,14400,1.00295130349
371730,371737,375136,7,3399,2,7200,1.00205942924
371886,371893,375098,7,3205,2,7200,1.00218408736
371919,371925,375392,6,3467,2,7200,1.00173060283
371931,372004,372579,73,575,2,660,1.12695652174
371991,371997,375540,6,3543,2,7200,1.0016934801
372006,372013,375422,7,3409,2,7200,1.00205338809
372188,372195,375825,7,3630,1,3600,1.00192837466
372213,372220,375554,7,3334,2,7200,1.00209958008
372215,372227,375579,12,3352,2,7200,1.00357995227
372281,372287,375672,6,3385,2,7200,1.00177252585
372296,372303,375547,7,3244,2,7200,1.00215782984
372328,372336,375734,8,3398,2,7200,1.00235432607
372346,372352,375761,6,3409,2,7200,1.00176004693
372424,372431,375738,7,3307,2,7200,1.0021167221
372451,372457,375914,6,3457,2,7200,1.00173560891
372466,372472,375845,6,3373,2,7200,1.0017788319
372467,372479,376156,12,3677,2,7200,1.00326353005
372521,372528,375894,7,3366,2,7200,1.00207961973
372536,372542,376131,6,3589,2,7200,1.00167177487
372551,372557,376002,6,3445,2,7200,1.00174165457
372566,372572,375970,6,3398,2,7200,1.00176574456
372587,372594,376027,7,3433,2,7200,1.00203903292
372587,377989,378324,5402,335,14,660,17.1253731343
372611,372618,376004,7,3386,2,7200,1.00206733609
372821,372827,375886,6,3059,2,7200,1.0019614253
372866,372873,376250,7,3377,2,7200,1.00207284572
372881,372888,376211,7,3323,2,7200,1.00210653024
372898,372906,376532,8,3626,2,7200,1.00220628792
372922,372928,376271,6,3343,2,7200,1.00179479509
372943,372950,376171,7,3221,2,7200,1.00217323812
373057,373064,376391,7,3327,2,7200,1.0021039976
373090,373096,376340,6,3244,2,7200,1.00184956843
373105,373111,376466,6,3355,2,7200,1.00178837556
373159,373166,376259,7,3093,2,7200,1.00226317491
373174,373181,376476,7,3295,2,7200,1.00212443096
373203,373210,376501,7,3291,2,7200,1.00212701307
373279,373285,376952,6,3667,2,7200,1.00163621489
374346,374353,377872,7,3519,2,7200,1.00198920148
374464,374470,377610,6,3140,2,7200,1.00191082803
374572,374579,377949,7,3370,2,7200,1.00207715134
374635,374641,378129,6,3488,2,7200,1.00172018349
374657,374663,374888,6,225,4,1200,1.02666666667
374882,374888,378259,6,3371,2,7200,1.00177988727
375098,375105,378487,7,3382,2,7200,1.00206978119
375119,375125,378541,6,3416,2,7200,1.00175644028
375137,375144,378743,7,3599,2,7200,1.00194498472
375172,375179,376753,7,1574,2,1980,1.00444726811
375393,375400,378830,7,3430,2,7200,1.00204081633
375423,375430,378829,7,3399,2,7200,1.00205942924
375541,375547,378772,6,3225,2,7200,1.00186046512
375555,375562,378895,7,3333,2,7200,1.00210021002
375557,375568,378890,11,3322,2,7200,1.00331125828
375580,375587,378862,7,3275,2,7200,1.00213740458
375671,375678,379060,7,3382,2,7200,1.00206978119
375734,375740,379010,6,3270,2,7200,1.00183486239
375748,375756,379106,8,3350,2,7200,1.0023880597
375763,375769,379015,6,3246,2,7200,1.00184842884
375847,375855,379308,8,3453,2,7200,1.00231682595
375886,375894,379337,8,3443,2,7200,1.00232355504
375901,375908,379189,7,3281,2,7200,1.00213349589
375916,375922,379509,6,3587,2,7200,1.001672707
375970,375976,379186,6,3210,2,7200,1.00186915888
376001,376017,377322,16,1305,4,1200,1.0122605364
376003,376010,379300,7,3290,2,7200,1.00212765957
376004,376022,379303,18,3281,2,7200,1.00548613228
376028,376035,379213,7,3178,2,7200,1.00220264317
376134,376141,379505,7,3364,2,7200,1.00208085612
376158,376165,379395,7,3230,2,7200,1.00216718266
376172,376179,379623,7,3444,2,7200,1.00203252033
376211,376218,379288,7,3070,2,7200,1.00228013029
376250,376257,376422,7,165,1,3600,1.04242424242
376253,376264,379691,11,3427,2,7200,1.00320980449
376268,376274,379388,6,3114,2,7200,1.00192678227
376283,376289,379550,6,3261,2,7200,1.0018399264
376336,376488,377902,152,1414,4,3540,1.10749646393
376340,376347,379980,7,3633,2,7200,1.00192678227
376391,376398,379809,7,3411,2,7200,1.00205218411
376466,376473,379819,7,3346,2,7200,1.00209205021
376481,376493,379944,12,3451,2,7200,1.00347725297
376502,376509,379824,7,3315,2,7200,1.00211161388
376531,376538,380102,7,3564,2,7200,1.0019640853
376764,376771,377504,7,733,2,1980,1.00954979536
376888,376895,376896,7,1,1,600,1.0
376953,376959,380279,6,3320,2,7200,1.00180722892
377155,377161,377505,6,344,2,900,1.01744186047
377502,377509,377513,7,4,1,900,1.1
377510,377517,377953,7,436,2,900,1.01605504587
377513,377524,379363,11,1839,2,1980,1.00598151169
377554,377560,377893,6,333,2,900,1.01801801802
377613,377620,381003,7,3383,2,7200,1.00206916938
377731,378335,554567,604,176232,8,324000,1.00342730038
377872,377879,381164,7,3285,2,7200,1.00213089802
377898,377905,379581,7,1676,1,18000,1.00417661098
377906,377913,379755,7,1842,1,18000,1.00380021716
377907,377918,377920,11,2,1,18000,1.3
377907,377924,379776,17,1852,1,18000,1.00917926566
377908,377930,379413,22,1483,1,18000,1.01483479434
377915,377936,379648,21,1712,1,18000,1.01226635514
377919,377941,379636,22,1695,1,18000,1.01297935103
377920,377946,379840,26,1894,1,18000,1.01372756072
377923,377951,379785,28,1834,1,18000,1.01526717557
377926,377966,379652,40,1686,1,18000,1.02372479241
377929,377971,379710,42,1739,1,18000,1.02415181139
377930,377977,379772,47,1795,1,18000,1.02618384401
377934,377982,379406,48,1424,1,18000,1.03370786517
377937,377994,379783,57,1789,1,18000,1.03186137507
377939,378000,379620,61,1620,1,18000,1.03765432099
377943,378145,380336,202,2191,1,18000,1.09219534459
377949,378150,378152,201,2,1,18000,20.3
377950,377959,381318,9,3359,2,7200,1.00267936886
377951,378164,378165,213,1,1,18000,21.4
378075,378340,378343,265,3,2,900,26.8
378131,378138,381555,7,3417,2,7200,1.00204858063
378261,378267,381680,6,3413,2,7200,1.00175798418
378378,378385,380161,7,1776,1,18000,1.00394144144
378487,378494,381942,7,3448,2,7200,1.00203016241
378513,378521,380062,8,1541,1,18000,1.00519143413
378541,378548,381963,7,3415,2,7200,1.00204978038
378554,378561,380388,7,1827,1,18000,1.00383141762
378743,378749,382179,6,3430,2,7200,1.00174927114
378773,378780,382206,7,3426,2,7200,1.00204319907
378778,378844,381024,66,2180,2,3540,1.03027522936
378830,378837,382138,7,3301,2,7200,1.00212056952
378831,378849,382057,18,3208,2,7200,1.00561097257
378861,378867,382034,6,3167,2,7200,1.00189453742
378891,378898,382232,7,3334,2,7200,1.00209958008
378906,378912,382184,6,3272,2,7200,1.00183374083
379011,379018,382051,7,3033,2,7200,1.00230794593
379026,379032,382186,6,3154,2,7200,1.00190234623
379062,379069,382598,7,3529,2,7200,1.00198356475
379107,379113,382383,6,3270,2,7200,1.00183486239
379188,379195,382685,7,3490,2,7200,1.00200573066
379202,379210,382562,8,3352,2,7200,1.00238663484
379217,379224,382557,7,3333,2,7200,1.00210021002
379289,379296,382771,7,3475,2,7200,1.00201438849
379304,379313,721472,9,342159,4,345600,1.00002630356
379305,379318,382851,13,3533,2,7200,1.00367959241
379306,379323,382664,17,3341,2,7200,1.00508829692
379321,379331,382690,10,3359,2,7200,1.00297707651
379339,379346,382844,7,3498,2,7200,1.00200114351
379372,379379,381260,7,1881,2,1980,1.00372142477
379390,379396,382812,6,3416,2,7200,1.00175644028
379404,379411,382920,7,3509,2,7200,1.00199487033
379507,379514,382710,7,3196,2,7200,1.0021902378
379522,379529,382930,7,3401,2,7200,1.00205821817
379548,379556,383279,8,3723,2,7200,1.00214880473
379625,379631,383076,6,3445,2,7200,1.00174165457
379659,379667,379836,8,169,4,345600,1.04733727811
379692,379699,382913,7,3214,2,7200,1.00217797138
379747,379785,381288,38,1503,4,86400,1.0252827678
379809,379816,382868,7,3052,2,7200,1.00229357798
379824,379831,382906,7,3075,2,7200,1.00227642276
379825,379838,383599,13,3761,2,7200,1.00345652752
379946,379953,380151,7,198,4,345600,1.03535353535
379946,379958,383347,12,3389,2,7200,1.00354086751
379979,379986,383363,7,3377,2,7200,1.00207284572
380099,380105,383193,6,3088,2,7200,1.00194300518
380151,380157,421143,6,40986,4,259200,1.00014639145
380227,380233,399383,6,19150,4,259200,1.00031331593
380279,380285,383661,6,3376,2,7200,1.00177725118
380421,380429,382500,8,2071,1,18000,1.00386286818
380422,380434,382166,12,1732,1,18000,1.00692840647
380423,381018,383070,595,2052,1,18000,1.28996101365
380424,381023,382732,599,1709,1,18000,1.35049736688
380426,381036,382864,610,1828,1,18000,1.33369803063
380428,381041,382942,613,1901,1,18000,1.32246186218
380429,381272,382967,843,1695,1,18000,1.49734513274
380433,381277,383091,844,1814,1,18000,1.46527012128
380437,381331,381332,894,1,1,18000,89.5
380439,381345,381346,906,1,1,18000,90.7
380440,381359,381361,919,2,1,18000,92.1
380447,381372,381373,925,1,1,18000,92.6
380452,381386,381387,934,1,1,18000,93.5
380454,381399,381400,945,1,1,18000,94.6
380456,381413,381414,957,1,1,18000,95.8
380457,381426,381427,969,1,1,18000,97.0
380458,381440,381441,982,1,1,18000,98.3
380463,381454,381455,991,1,1,18000,99.2
381004,381011,384238,7,3227,2,7200,1.0021691974
381022,381468,381471,446,3,1,900,44.9
381031,381181,384719,150,3538,2,3540,1.04239683437
381100,381136,383300,36,2164,4,259200,1.01663585952
381121,381300,622045,179,240745,4,259200,1.00074352531
381167,381174,384384,7,3210,2,7200,1.00218068536
381251,382196,382199,945,3,4,86400,94.8
381318,381324,384627,6,3303,2,7200,1.00181653043
381448,382470,382501,1022,31,4,86400,33.9677419355
381556,381563,384927,7,3364,2,7200,1.00208085612
381679,381685,385111,6,3426,2,7200,1.00175131349
381718,382215,532268,497,150053,4,259200,1.00331216304
381752,381955,382443,203,488,2,900,1.41598360656
381914,382455,382458,541,3,4,86400,54.4
381941,381948,385447,7,3499,2,7200,1.00200057159
381965,381972,385565,7,3593,2,7200,1.00194823267
382035,382042,385647,7,3605,2,7200,1.00194174757
382053,382059,385251,6,3192,2,7200,1.00187969925
382068,382078,385611,10,3533,2,7200,1.0028304557
382140,382146,385430,6,3284,2,7200,1.00182704019
382182,382189,385445,7,3256,2,7200,1.00214987715
382196,382202,385637,6,3435,2,7200,1.00174672489
382198,382208,385600,10,3392,2,7200,1.00294811321
382212,382222,385504,10,3282,2,7200,1.00304692261
382233,382239,385482,6,3243,2,7200,1.00185013876
382383,382390,385974,7,3584,2,7200,1.001953125
382558,382565,385958,7,3393,2,7200,1.00206307103
382573,382579,386353,6,3774,2,7200,1.00158982512
382600,382607,386012,7,3405,2,7200,1.00205580029
382629,382700,383930,71,1230,2,10800,1.05772357724
382663,382670,385802,7,3132,2,7200,1.00223499361
382687,382693,386155,6,3462,2,7200,1.00173310225
382701,382709,386151,8,3442,2,7200,1.0023242301
382716,382724,385883,8,3159,2,7200,1.00253244698
382770,382777,386406,7,3629,2,7200,1.00192890603
382812,382819,386142,7,3323,2,7200,1.00210653024
382840,382847,382853,7,6,2,18000,1.3
382840,382866,382870,26,4,2,18000,3.0
382841,382880,382885,39,5,2,18000,4.4
382841,382887,382890,46,3,2,18000,4.9
382841,382899,382903,58,4,2,18000,6.2
382841,382906,382910,65,4,2,18000,6.9
382842,382938,382942,96,4,2,18000,10.0
382842,382933,382939,91,6,2,18000,9.7
382842,382913,382917,71,4,2,18000,7.5
382843,382967,382970,124,3,2,18000,12.7
382843,382961,382966,118,5,2,18000,12.3
382843,382956,382960,113,4,2,18000,11.7
382843,382979,382982,136,3,2,18000,13.9
382844,382991,382995,147,4,2,18000,15.1
382844,382984,382989,140,5,2,18000,14.5
382844,383005,383009,161,4,2,18000,16.5
382844,382998,383002,154,4,2,18000,15.8
382845,383026,383029,181,3,2,18000,18.4
382845,382854,386389,9,3535,2,7200,1.00254596888
382845,383012,383016,167,4,2,18000,17.1
382845,383032,383036,187,4,2,18000,19.1
382845,383019,383023,174,4,2,18000,17.8
382846,383061,383065,215,4,2,18000,21.9
382846,383054,383058,208,4,2,18000,21.2
382846,383047,383051,201,4,2,18000,20.5
382846,383040,383044,194,4,2,18000,19.8
382847,383082,383086,235,4,2,18000,23.9
382847,383068,383072,221,4,2,18000,22.5
382847,383075,383079,228,4,2,18000,23.2
382848,383094,383097,246,3,2,18000,24.9
382848,383099,383103,251,4,2,18000,25.5
382848,383112,383116,264,4,2,18000,26.8
382848,383087,383092,239,5,2,18000,24.4
382849,383122,383127,273,5,2,18000,27.8
382849,383117,383120,268,3,2,18000,27.1
382860,382872,386366,12,3494,2,7200,1.00343445907
382874,382892,386322,18,3430,2,7200,1.00524781341
382883,382926,394488,43,11562,4,14400,1.00371907974
382907,382919,386134,12,3215,2,7200,1.00373250389
382922,382943,386323,21,3380,2,7200,1.00621301775
382924,382949,386531,25,3582,2,7200,1.00697934115
382939,382972,386143,33,3171,2,7200,1.01040681173
383077,383104,386746,27,3642,2,7200,1.00741350906
383191,383198,386474,7,3276,2,7200,1.00213675214
383279,383285,386636,6,3351,2,7200,1.0017905103
383327,383334,384220,7,886,4,21600,1.0079006772
383348,383354,386858,6,3504,2,7200,1.00171232877
383363,383369,386783,6,3414,2,7200,1.00175746924
383489,383496,385946,7,2450,2,10800,1.00285714286
383601,383608,386836,7,3228,2,7200,1.0021685254
383661,383667,387158,6,3491,2,7200,1.00171870524
383873,383943,386407,70,2464,2,10800,1.02840909091
384228,384235,405933,7,21698,4,21600,1.00032261038
384240,384246,387346,6,3100,2,7200,1.00193548387
384384,384391,387824,7,3433,2,7200,1.00203903292
384390,384730,385709,340,979,2,10800,1.34729315628
384429,385643,389289,1214,3646,2,18000,1.33296763577
384429,385623,385631,1194,8,2,18000,120.2
384429,385659,387207,1230,1548,2,18000,1.79457364341
384429,385722,389308,1293,3586,2,18000,1.36056887897
384430,385999,390060,1569,4061,2,18000,1.38635803989
384430,385895,390213,1465,4318,2,18000,1.33927744326
384430,385959,389916,1529,3957,2,18000,1.38640384129
384430,385973,392634,1543,6661,2,18000,1.23164689986
384430,385994,404024,1564,18030,2,18000,1.08674431503
384431,386367,394410,1936,8043,2,18000,1.24070620415
384431,386166,393702,1735,7536,2,18000,1.23022823779
384431,386026,387328,1595,1302,2,18000,2.22503840246
384431,386420,387336,1989,916,2,18000,3.17139737991
384432,386614,390474,2182,3860,2,18000,1.56528497409
384432,386851,391176,2419,4325,2,18000,1.55930635838
384432,386797,391565,2365,4768,2,18000,1.49601510067
384432,386489,388364,2057,1875,2,18000,2.09706666667
384432,386652,390061,2220,3409,2,18000,1.6512173658
384433,387340,393786,2907,6446,2,18000,1.45097735029
384433,387174,391924,2741,4750,2,18000,1.57705263158
384433,387220,394624,2787,7404,2,18000,1.37641815235
384433,387348,390129,2915,2781,2,18000,2.04818410644
384433,386871,389001,2438,2130,2,18000,2.14460093897
384434,389012,394159,4578,5147,2,18000,1.88945016514
384434,389928,393306,5494,3378,2,18000,2.62640615749
384434,389301,394025,4867,4724,2,18000,2.03027095682
384434,388376,392869,3942,4493,2,18000,1.87736478967
384434,389320,390850,4886,1530,2,18000,4.19346405229
384435,390079,390987,5644,908,2,18000,7.21585903084
384435,390224,391632,5789,1408,2,18000,5.11150568182
384435,390141,393344,5706,3203,2,18000,2.78145488604
384435,390486,391732,6051,1246,2,18000,5.85634028892
384435,390072,391002,5637,930,2,18000,7.06129032258
384436,390862,396768,6426,5906,2,18000,2.08804605486
384499,391936,392009,7437,73,2,18000,102.876712329
384525,392022,392075,7497,53,2,18000,142.452830189
384537,392645,392691,8108,46,2,18000,177.260869565
384628,384636,387981,8,3345,2,7200,1.0023916293
384726,385048,385982,322,934,4,3540,1.34475374732
384768,385520,386601,752,1081,2,10800,1.69565217391
384926,384932,388219,6,3287,2,7200,1.00182537268
385114,385120,388455,6,3335,2,7200,1.00179910045
385253,385260,388401,7,3141,2,7200,1.00222858962
385258,404986,405857,19728,871,8,86400,23.6498277842
385349,385462,929203,113,543741,3,604800,1.00020781953
385433,385439,388844,6,3405,2,7200,1.00176211454
385448,385454,388484,6,3030,2,7200,1.00198019802
385449,385467,388811,18,3344,2,7200,1.00538277512
385482,385489,388868,7,3379,2,7200,1.00207161882
385506,385513,388924,7,3411,2,7200,1.00205218411
385566,385572,388953,6,3381,2,7200,1.00177462289
385602,385609,388962,7,3353,2,7200,1.00208768267
385617,385629,388921,12,3292,2,7200,1.00364520049
385638,385650,388942,12,3292,2,7200,1.00364520049
385652,385664,388865,12,3201,2,7200,1.00374882849
385803,385809,389123,6,3314,2,7200,1.00181050091
385881,385887,389070,6,3183,2,7200,1.00188501414
385959,385966,389014,7,3048,2,7200,1.00229658793
385974,385980,389148,6,3168,2,7200,1.00189393939
386013,386019,389208,6,3189,2,7200,1.00188146754
386137,386144,389490,7,3346,2,7200,1.00209205021
386152,386158,389361,6,3203,2,7200,1.00187324383
386153,386171,389358,18,3187,2,7200,1.00564794478
386155,386176,389538,21,3362,2,7200,1.00624628198
386170,386183,389601,13,3418,2,7200,1.0038033938
386261,392882,393213,6621,331,2,900,21.003021148
386320,386326,389803,6,3477,2,7200,1.00172562554
386335,386342,389876,7,3534,2,7200,1.00198075835
386353,386359,389566,6,3207,2,7200,1.00187090739
386367,386373,389737,6,3364,2,7200,1.00178359096
386391,386398,389823,7,3425,2,7200,1.00204379562
386406,386412,389695,6,3283,2,7200,1.00182759671
386475,386482,390225,7,3743,2,7200,1.00187015763
386532,386539,389899,7,3360,2,7200,1.00208333333
386542,391014,457536,4472,66522,2,180000,1.06722588016
386638,386645,390020,7,3375,2,7200,1.00207407407
386683,391579,458465,4896,66886,2,180000,1.07319917472
386746,386754,390327,8,3573,2,7200,1.00223901483
386767,391644,458275,4877,66631,2,180000,1.07319415887
386783,386790,390094,7,3304,2,7200,1.00211864407
386819,390999,391712,4180,713,2,10800,6.86255259467
386837,386843,390234,6,3391,2,7200,1.00176938956
386858,386864,389958,6,3094,2,7200,1.00193923723
386913,391745,478175,4832,86430,2,86400,1.05590651394
387159,387167,390713,8,3546,2,7200,1.00225606317
387346,387354,390836,8,3482,2,7200,1.00229753016
387573,387580,610732,7,223152,1,360000,1.00003136875
387614,388957,612794,1343,223837,1,360000,1.00599990171
387639,389086,619452,1447,230366,1,360000,1.00628130887
387659,389224,506551,1565,117327,1,432000,1.01333878817
387679,389373,749419,1694,360046,1,360000,1.00470495437
387703,390110,586458,2407,196348,1,360000,1.01225884654
387729,392063,612043,4334,219980,1,360000,1.01970179107
387825,387831,391053,6,3222,2,7200,1.00186219739
387981,387987,391302,6,3315,2,7200,1.00180995475
388219,388225,391560,6,3335,2,7200,1.00179910045
388236,391188,393430,2952,2242,2,4140,2.31668153434
388400,388407,391670,7,3263,2,7200,1.00214526509
388454,388460,392172,6,3712,2,7200,1.00161637931
388484,388491,391798,7,3307,2,7200,1.0021167221
388810,388817,392190,7,3373,2,7200,1.00207530388
388846,388852,392077,6,3225,2,7200,1.00186046512
388867,388873,392384,6,3511,2,7200,1.00170891484
388882,388889,392199,7,3310,2,7200,1.00211480363
388921,388927,392239,6,3312,2,7200,1.0018115942
388922,388934,392344,12,3410,2,7200,1.00351906158
388943,388949,392258,6,3309,2,7200,1.00181323663
388958,388965,392223,7,3258,2,7200,1.0021485574
388973,388980,392240,7,3260,2,7200,1.00214723926
389014,389272,390307,258,1035,16,324000,1.24927536232
389015,389020,392269,5,3249,2,7200,1.00153893506
389072,389079,392462,7,3383,2,7200,1.00206916938
389123,389129,392616,6,3487,2,7200,1.0017206768
389147,389153,392417,6,3264,2,7200,1.00183823529
389210,389217,392303,7,3086,2,7200,1.00226830849
389357,389364,392805,7,3441,2,7200,1.00203429236
389372,389379,392825,7,3446,2,7200,1.00203134068
389388,400981,404073,11593,3092,8,345600,4.74935316947
389398,391725,393333,2327,1608,2,36000,2.44713930348
389489,389496,392953,7,3457,2,7200,1.00202487706
389533,391220,395050,1687,3830,16,324000,1.44046997389
389537,389543,393012,6,3469,2,7200,1.00172960507
389567,389574,392899,7,3325,2,7200,1.00210526316
389600,389606,392971,6,3365,2,7200,1.00178306092
389696,389702,393316,6,3614,2,7200,1.00166021029
389738,389744,393126,6,3382,2,7200,1.00177409817
389805,389812,393147,7,3335,2,7200,1.00209895052
389825,389832,393248,7,3416,2,7200,1.00204918033
389876,389884,392997,8,3113,2,7200,1.00256986829
389897,389903,393105,6,3202,2,7200,1.00187382886
389957,389964,393524,7,3560,2,7200,1.00196629213
390021,390028,393475,7,3447,2,7200,1.00203075138
390096,390103,393550,7,3447,2,7200,1.00203075138
390119,392703,415420,2584,22717,1,28800,1.11374741383
390225,390238,393625,13,3387,2,7200,1.0038382049
390240,390247,393635,7,3388,2,7200,1.0020661157
390259,392708,407640,2449,14932,1,28800,1.16401017948
390328,390338,393701,10,3363,2,7200,1.00297353553
390713,390725,394096,12,3371,2,7200,1.00355977455
390837,390848,394222,11,3374,2,7200,1.00326022525
391055,391065,394389,10,3324,2,7200,1.00300842359
391199,392352,415714,1153,23362,4,259200,1.04935365123
391302,391315,395188,13,3873,2,7200,1.00335657113
391436,393356,408481,1920,15125,4,259200,1.12694214876
391561,391572,394643,11,3071,2,7200,1.00358189515
391670,391682,395361,12,3679,2,7200,1.00326175591
391799,391809,395366,10,3557,2,7200,1.00281135789
392076,392087,395368,11,3281,2,7200,1.00335263639
392173,392180,395405,7,3225,2,7200,1.00217054264
392190,392197,395530,7,3333,2,7200,1.00210021002
392205,392212,395624,7,3412,2,7200,1.00205158265
392223,392229,395472,6,3243,2,7200,1.00185013876
392238,392244,395533,6,3289,2,7200,1.00182426269
392253,392260,395697,7,3437,2,7200,1.00203665988
392267,392274,395491,7,3217,2,7200,1.00217594032
392282,392289,395678,7,3389,2,7200,1.00206550605
392300,392306,395687,6,3381,2,7200,1.00177462289
392345,392357,395695,12,3338,2,7200,1.00359496705
392387,392394,395556,7,3162,2,7200,1.00221378874
392417,392423,395640,6,3217,2,7200,1.0018650917
392462,392468,395843,6,3375,2,7200,1.00177777778
392616,392623,395808,7,3185,2,7200,1.0021978022
392805,392812,395878,7,3066,2,7200,1.00228310502
392826,392832,396032,6,3200,2,7200,1.001875
392901,392909,396610,8,3701,2,7200,1.00216157795
392952,392958,396523,6,3565,2,7200,1.00168302945
392973,392980,396284,7,3304,2,7200,1.00211864407
392998,393005,396480,7,3475,2,7200,1.00201438849
393013,393020,396488,7,3468,2,7200,1.00201845444
393106,393114,396611,8,3497,2,7200,1.00228767515
393127,393134,396822,7,3688,2,7200,1.00189804772
393145,393152,396789,7,3637,2,7200,1.00192466318
393248,393254,396764,6,3510,2,7200,1.00170940171
393317,393324,396818,7,3494,2,7200,1.00200343446
393430,393443,393446,13,3,1,900,1.6
393445,393458,396457,13,2999,2,4140,1.00433477826
393477,393484,396790,7,3306,2,7200,1.00211736237
393525,393532,396810,7,3278,2,7200,1.00213544844
393553,393560,396996,7,3436,2,7200,1.00203725262
393619,393625,396876,6,3251,2,7200,1.00184558597
393634,393640,396871,6,3231,2,7200,1.00185701021
393701,393708,397241,7,3533,2,7200,1.00198131899
393880,393887,395376,7,1489,1,18000,1.00470114171
393888,393895,395809,7,1914,1,18000,1.00365726228
393894,393902,395811,8,1909,1,18000,1.00419067575
393900,393909,395696,9,1787,1,18000,1.00503637381
393906,394037,395741,131,1704,1,18000,1.07687793427
393913,394042,395720,129,1678,1,18000,1.0768772348
393920,394173,396002,253,1829,1,18000,1.13832695462
393928,394178,395971,250,1793,1,18000,1.13943112103
393934,394422,396276,488,1854,1,18000,1.26321467098
393939,394427,396255,488,1828,1,18000,1.26695842451
394095,394101,397394,6,3293,2,7200,1.00182204677
394225,394232,397625,7,3393,2,7200,1.00206307103
394391,394397,397994,6,3597,2,7200,1.00166805671
394509,394516,395414,7,898,2,900,1.00779510022
394626,394632,398054,6,3422,2,7200,1.00175336061
394716,394722,398534,6,3812,2,7200,1.00157397692
394879,394885,398672,6,3787,2,7200,1.00158436757
394915,394922,398711,7,3789,2,7200,1.00184745315
395038,395063,396743,25,1680,16,324000,1.01488095238
395145,395382,397631,237,2249,2,14400,1.10538016896
395337,395343,398563,6,3220,2,7200,1.00186335404
395404,395411,398662,7,3251,2,7200,1.00215318364
395473,395480,398779,7,3299,2,7200,1.00212185511
395491,395498,398781,7,3283,2,7200,1.00213219616
395531,395537,399073,6,3536,2,7200,1.00169683258
395546,395552,399002,6,3450,2,7200,1.00173913043
395561,395568,398902,7,3334,2,7200,1.00209958008
395591,395754,399746,163,3992,2,36000,1.04083166333
395627,395633,399039,6,3406,2,7200,1.00176159718
395642,395649,399038,7,3389,2,7200,1.00206550605
395679,395685,398955,6,3270,2,7200,1.00183486239
395694,395701,399323,7,3622,2,7200,1.0019326339
395696,395708,399013,12,3305,2,7200,1.00363086233
395711,395717,399051,6,3334,2,7200,1.00179964007
395810,395817,399327,7,3510,2,7200,1.00199430199
395844,395851,399099,7,3248,2,7200,1.00215517241
395880,395886,398941,6,3055,2,7200,1.00196399345
396034,396040,399482,6,3442,2,7200,1.00174317257
396287,396294,399601,7,3307,2,7200,1.0021167221
396483,396489,399784,6,3295,2,7200,1.00182094082
396498,396505,400036,7,3531,2,7200,1.00198244123
396525,396532,399906,7,3374,2,7200,1.0020746888
396613,396620,399951,7,3331,2,7200,1.00210147103
396615,396627,400020,12,3393,2,7200,1.00353669319
396741,396755,465207,14,68452,16,324000,1.00020452288
396757,433859,554511,37102,120652,16,324000,1.30751251533
396765,396772,400167,7,3395,2,7200,1.00206185567
396790,396797,400162,7,3365,2,7200,1.00208023774
396791,396804,400153,13,3349,2,7200,1.00388175575
396810,396816,400019,6,3203,2,7200,1.00187324383
396825,396832,400071,7,3239,2,7200,1.00216116085
396827,396838,400230,11,3392,2,7200,1.00324292453
396872,396879,400177,7,3298,2,7200,1.00212249848
396887,396894,400199,7,3305,2,7200,1.00211800303
396968,434903,435382,37935,479,14,1560,80.1962421712
397000,397007,399987,7,2980,2,7200,1.00234899329
397243,397249,400549,6,3300,2,7200,1.00181818182
397395,397402,400445,7,3043,2,7200,1.00230036149
397452,397644,399281,192,1637,1,18000,1.11728772144
397453,397649,399477,196,1828,1,18000,1.10722100656
397465,398069,399856,604,1787,1,18000,1.33799664242
397471,398074,399786,603,1712,1,18000,1.35221962617
397476,398551,400228,1075,1677,1,18000,1.64102564103
397477,398556,400501,1079,1945,1,18000,1.55475578406
397480,398679,400439,1199,1760,1,18000,1.68125
397485,398793,400575,1308,1782,1,18000,1.73400673401
397487,398798,400704,1311,1906,1,18000,1.68782791186
397488,399068,401060,1580,1992,1,18000,1.79317269076
397490,399113,400744,1623,1631,1,18000,1.99509503372
397491,399118,400722,1627,1604,1,18000,2.01433915212
397494,399294,400927,1800,1633,1,18000,2.10226576852
397494,399301,401277,1807,1976,1,18000,1.91447368421
397498,399306,400969,1808,1663,1,18000,2.08719182201
397499,399486,401036,1987,1550,1,18000,2.28193548387
397501,399500,401476,1999,1976,1,18000,2.01163967611
397502,399505,401162,2003,1657,1,18000,2.20881110441
397550,399666,399668,2116,2,1,600,211.8
397626,397632,401090,6,3458,2,7200,1.001735107
397998,398004,401437,6,3433,2,7200,1.0017477425
398056,398062,401092,6,3030,2,7200,1.00198019802
398073,399671,399672,1598,1,1,1800,159.9
398399,399395,512538,996,113143,4,259200,1.00880301919
398537,398543,401926,6,3383,2,7200,1.00177357375
398565,398572,401912,7,3340,2,7200,1.00209580838
398665,398671,401997,6,3326,2,7200,1.00180396873
398680,398688,401958,8,3270,2,7200,1.00244648318
398711,398717,401945,6,3228,2,7200,1.00185873606
398780,398786,402238,6,3452,2,7200,1.00173812283
398795,398805,401992,10,3187,2,7200,1.0031377471
398856,399799,569556,943,169757,3,172800,1.0055549992
398904,398911,402310,7,3399,2,7200,1.00205942924
398940,398948,402395,8,3447,2,7200,1.00232085872
398956,398963,402404,7,3441,2,7200,1.00203429236
399004,399011,402248,7,3237,2,7200,1.00216249614
399019,399026,402426,7,3400,2,7200,1.00205882353
399038,399044,402379,6,3335,2,7200,1.00179910045
399039,399051,402639,12,3588,2,7200,1.00334448161
399054,399060,402507,6,3447,2,7200,1.00174064404
399072,399080,402466,8,3386,2,7200,1.00236266982
399100,399106,402498,6,3392,2,7200,1.00176886792
399105,399760,512401,655,112641,4,259200,1.00581493417
399324,399330,402737,6,3407,2,7200,1.00176108013
399339,399346,402936,7,3590,2,7200,1.00194986072
399481,399493,402733,12,3240,2,7200,1.0037037037
399564,399618,399654,54,36,2,900,2.5
399603,399611,402821,8,3210,2,7200,1.00249221184
399785,399791,403260,6,3469,2,7200,1.00172960507
399906,399913,403295,7,3382,2,7200,1.00206978119
399942,400002,400048,60,46,1,600,2.30434782609
399951,399957,403262,6,3305,2,7200,1.00181543116
399988,399994,403217,6,3223,2,7200,1.00186161961
399995,400007,401081,12,1074,1,1800,1.01117318436
400018,400024,403377,6,3353,2,7200,1.00178944229
400033,400040,403345,7,3305,2,7200,1.00211800303
400048,400055,403474,7,3419,2,7200,1.00204738228
400072,400078,403283,6,3205,2,7200,1.00187207488
400154,400160,403508,6,3348,2,7200,1.0017921147
400169,400177,403319,8,3142,2,7200,1.00254614895
400171,400184,403780,13,3596,2,7200,1.00361512792
400186,400192,403650,6,3458,2,7200,1.001735107
400201,400208,403428,7,3220,2,7200,1.00217391304
400231,400238,403443,7,3205,2,7200,1.00218408736
400446,400454,403862,8,3408,2,7200,1.00234741784
400517,400524,400573,7,49,2,900,1.14285714286
400551,400559,404127,8,3568,2,7200,1.00224215247
401091,401098,404535,7,3437,2,7200,1.00203665988
401093,401105,404542,12,3437,2,7200,1.00349141693
401381,401388,402811,7,1423,1,1800,1.00491918482
401437,401444,404817,7,3373,2,7200,1.00207530388
401537,401543,403248,6,1705,1,18000,1.00351906158
401539,402442,404125,903,1683,1,18000,1.53654188948
401541,402747,404442,1206,1695,1,18000,1.71150442478
401542,402823,404947,1281,2124,1,18000,1.60310734463
401543,403267,404937,1724,1670,1,18000,2.03233532934
401552,403296,405074,1744,1778,1,18000,1.98087739033
401557,403337,405157,1780,1820,1,18000,1.97802197802
401557,403309,405139,1752,1830,1,18000,1.95737704918
401558,403342,404898,1784,1556,1,18000,2.14652956298
401567,403361,405183,1794,1822,1,18000,1.98463227223
401569,403458,405348,1889,1890,1,18000,1.99947089947
401569,403366,405190,1797,1824,1,18000,1.98519736842
401570,403463,405159,1893,1696,1,18000,2.11615566038
401571,403521,405164,1950,1643,1,18000,2.1868533171
401572,403526,405236,1954,1710,1,18000,2.14269005848
401574,404037,405823,2463,1786,1,18000,2.3790593505
401575,404042,405541,2467,1499,1,18000,2.64576384256
401576,404143,405995,2567,1852,1,18000,2.38606911447
401645,611091,697510,209446,86419,36,86400,3.42361054861
401916,401923,405362,7,3439,2,7200,1.00203547543
401931,401937,405349,6,3412,2,7200,1.00175849941
401946,401953,405271,7,3318,2,7200,1.00210970464
401961,401967,405158,6,3191,2,7200,1.00188028831
401992,401999,405107,7,3108,2,7200,1.00225225225
402007,402013,405335,6,3322,2,7200,1.00180614088
402240,402248,405170,8,2922,2,7200,1.00273785079
402256,402262,405695,6,3433,2,7200,1.0017477425
402307,402314,405705,7,3391,2,7200,1.00206428782
402383,402389,405629,6,3240,2,7200,1.00185185185
402398,402404,405738,6,3334,2,7200,1.00179964007
402413,402419,405593,6,3174,2,7200,1.00189035917
402428,402434,405671,6,3237,2,7200,1.00185356812
402467,402475,405873,8,3398,2,7200,1.00235432607
402501,402507,405746,6,3239,2,7200,1.00185242359
402516,402523,406009,7,3486,2,7200,1.00200803213
402640,402646,406201,6,3555,2,7200,1.00168776371
402733,402739,406419,6,3680,2,7200,1.00163043478
402748,402756,406228,8,3472,2,7200,1.00230414747
402821,402829,406361,8,3532,2,7200,1.00226500566
402936,402943,406446,7,3503,2,7200,1.00199828718
403219,403227,406660,8,3433,2,7200,1.00233032333
403262,403274,406344,12,3070,2,7200,1.00390879479
403277,403284,406654,7,3370,2,7200,1.00207715134
403292,403302,406988,10,3686,2,7200,1.00271296799
403307,403316,406479,9,3163,2,7200,1.00284539994
403323,403330,406451,7,3121,2,7200,1.00224287087
403347,403353,406778,6,3425,2,7200,1.00175182482
403377,403383,406703,6,3320,2,7200,1.00180722892
403428,403436,406659,8,3223,2,7200,1.00248215948
403444,403450,406858,6,3408,2,7200,1.00176056338
403474,403483,406862,9,3379,2,7200,1.00266350991
403507,403513,407095,6,3582,2,7200,1.00167504188
403578,403795,583128,217,179333,2,259200,1.00121003942
403602,403878,514007,276,110129,2,172800,1.00250615188
403649,403656,407172,7,3516,2,7200,1.00199089875
403782,403788,407168,6,3380,2,7200,1.00177514793
403863,403870,407246,7,3376,2,7200,1.00207345972
404070,405869,407480,1799,1611,8,345600,2.11669770329
404129,404136,407257,7,3121,2,7200,1.00224287087
404537,404545,407679,8,3134,2,7200,1.00255264837
404553,404559,408247,6,3688,2,7200,1.00162689805
404818,404825,408161,7,3336,2,7200,1.00209832134
405028,410353,437898,5325,27545,10,43200,1.19332002178
405110,405117,408536,7,3419,2,7200,1.00204738228
405159,405166,408498,7,3332,2,7200,1.00210084034
405174,405180,408548,6,3368,2,7200,1.00178147268
405270,405277,408638,7,3361,2,7200,1.00208271348
405337,405343,408664,6,3321,2,7200,1.00180668473
405352,405358,408814,6,3456,2,7200,1.00173611111
405367,405373,408517,6,3144,2,7200,1.00190839695
405593,405600,409140,7,3540,2,7200,1.00197740113
405630,405636,408948,6,3312,2,7200,1.0018115942
405672,405679,408860,7,3181,2,7200,1.00220056586
405696,405703,409000,7,3297,2,7200,1.00212314225
405711,405718,409070,7,3352,2,7200,1.00208830549
405739,405746,408980,7,3234,2,7200,1.00216450216
405754,405761,409398,7,3637,2,7200,1.00192466318
405874,405881,409210,7,3329,2,7200,1.00210273355
406010,406017,409268,7,3251,2,7200,1.00215318364
406018,406026,406043,8,17,1,3600,1.47058823529
406029,408683,408712,2654,29,1,3600,92.5172413793
406029,406040,407691,11,1651,1,18000,1.00666262871
406030,406047,407970,17,1923,1,18000,1.00884035361
406032,406055,407678,23,1623,1,18000,1.01417128774
406032,408688,408770,2656,82,1,3600,33.3902439024
406047,407657,409568,1610,1911,1,18000,1.84249084249
406048,407704,409597,1656,1893,1,18000,1.87480190174
406049,407983,409723,1934,1740,1,18000,2.11149425287
406050,408176,409826,2126,1650,1,18000,2.28848484848
406057,408493,410282,2436,1789,1,18000,2.36165455562
406069,408498,410340,2429,1842,1,18000,2.31867535288
406075,408503,410305,2428,1802,1,18000,2.3473917869
406081,408509,410206,2428,1697,1,18000,2.430760165
406085,408532,410352,2447,1820,1,18000,2.34450549451
406087,408550,410378,2463,1828,1,18000,2.34737417943
406091,408555,410034,2464,1479,1,18000,2.66599053414
406095,408653,410337,2558,1684,1,18000,2.5190023753
406097,408658,410407,2561,1749,1,18000,2.46426529445
406098,408725,408736,2627,11,1,3600,239.818181818
406102,408664,410341,2562,1677,1,18000,2.52772808587
406105,408669,410471,2564,1802,1,18000,2.42286348502
406200,406207,409570,7,3363,2,7200,1.00208147487
406231,406237,409582,6,3345,2,7200,1.00179372197
406345,406351,409868,6,3517,2,7200,1.00170599943
406361,406368,409763,7,3395,2,7200,1.00206185567
406386,408782,408803,2396,21,2,900,115.095238095
406421,406427,409684,6,3257,2,7200,1.00184218606
406448,406454,409929,6,3475,2,7200,1.00172661871
406463,406470,409931,7,3461,2,7200,1.00202253684
406479,406486,409709,7,3223,2,7200,1.00217188954
406562,407694,412219,1132,4525,2,18000,1.25016574586
406654,406660,409732,6,3072,2,7200,1.001953125
406669,406676,410174,7,3498,2,7200,1.00200114351
406670,406682,410085,12,3403,2,7200,1.00352630032
406704,406711,410099,7,3388,2,7200,1.0020661157
406779,406786,410237,7,3451,2,7200,1.00202839757
406861,406868,410256,7,3388,2,7200,1.0020661157
406877,406883,410032,6,3149,2,7200,1.00190536678
406988,406994,410233,6,3239,2,7200,1.00185242359
407094,407100,410591,6,3491,2,7200,1.00171870524
407159,408260,408378,1101,118,2,18000,10.3305084746
407169,407177,410297,8,3120,2,7200,1.00256410256
407185,407191,410772,6,3581,2,7200,1.00167550963
407245,407251,410398,6,3147,2,7200,1.00190657769
407260,407267,410509,7,3242,2,7200,1.00215916101
407476,408397,729524,921,321127,8,345600,1.00286802418
407626,408390,408640,764,250,2,18000,4.056
407679,407686,410892,7,3206,2,7200,1.00218340611
408162,408169,411467,7,3298,2,7200,1.00212249848
408246,408253,411768,7,3515,2,7200,1.00199146515
408500,408516,411889,16,3373,2,7200,1.00474355173
408518,408525,411761,7,3236,2,7200,1.0021631644
408536,408542,411798,6,3256,2,7200,1.00184275184
408551,408562,411951,11,3389,2,7200,1.00324579522
408622,410230,410294,1608,64,8,4140,26.125
408639,408646,412087,7,3441,2,7200,1.00203429236
408666,408676,411872,10,3196,2,7200,1.00312891114
408814,408820,411901,6,3081,2,7200,1.00194741967
408859,408866,412295,7,3429,2,7200,1.00204141149
408950,408956,412248,6,3292,2,7200,1.00182260024
408980,408987,412272,7,3285,2,7200,1.00213089802
409001,409009,412435,8,3426,2,7200,1.00233508465
409071,409077,412307,6,3230,2,7200,1.00185758514
409143,409151,412476,8,3325,2,7200,1.00240601504
409210,409217,412759,7,3542,2,7200,1.00197628458
409267,409274,412775,7,3501,2,7200,1.00199942873
409400,409406,412797,6,3391,2,7200,1.00176938956
409572,409580,413007,8,3427,2,7200,1.00233440327
409588,409594,413083,6,3489,2,7200,1.00171969046
409684,409691,412822,7,3131,2,7200,1.00223570744
409712,409719,413132,7,3413,2,7200,1.00205098154
409733,409740,413103,7,3363,2,7200,1.00208147487
409763,409769,413178,6,3409,2,7200,1.00176004693
409869,409876,413428,7,3552,2,7200,1.00197072072
409930,409936,413012,6,3076,2,7200,1.00195058518
409931,409944,413186,13,3242,2,7200,1.00400987045
410028,410034,413553,6,3519,2,7200,1.00170502984
410086,410093,413368,7,3275,2,7200,1.00213740458
410101,410107,413392,6,3285,2,7200,1.00182648402
410176,410184,413124,8,2940,2,7200,1.00272108844
410232,410239,413569,7,3330,2,7200,1.0021021021
410247,410253,414045,6,3792,2,7200,1.00158227848
410262,410269,413518,7,3249,2,7200,1.00215450908
410298,410305,413763,7,3458,2,7200,1.0020242915
410398,410404,413983,6,3579,2,7200,1.00167644593
410502,410509,412226,7,1717,1,18000,1.00407687828
410503,410514,412511,11,1997,1,18000,1.00550826239
410506,411905,413774,1399,1869,1,18000,1.74852862493
410510,410520,413964,10,3444,2,7200,1.00290360046
410511,411910,413611,1399,1701,1,18000,1.82245737801
410513,411969,413733,1456,1764,1,18000,1.8253968254
410519,411974,413763,1455,1789,1,18000,1.81330352152
410523,412231,414216,1708,1985,1,18000,1.8604534005
410527,412236,413957,1709,1721,1,18000,1.9930273097
410528,412243,414219,1715,1976,1,18000,1.86791497976
410533,412310,413915,1777,1605,1,18000,2.10716510903
410534,412315,414101,1781,1786,1,18000,1.99720044793
410538,412524,414341,1986,1817,1,18000,2.0930104568
410538,412775,414544,2237,1769,1,18000,2.26455624647
410539,412790,414509,2251,1719,1,18000,2.30948225713
410541,412814,414582,2273,1768,1,18000,2.28563348416
410544,412820,414524,2276,1704,1,18000,2.33568075117
410550,412838,414470,2288,1632,1,18000,2.40196078431
410551,413023,414827,2472,1804,1,18000,2.37028824834
410591,410599,413981,8,3382,2,7200,1.00236546422
410713,413970,586796,3257,172826,6,172800,1.01884554407
410772,410779,414141,7,3362,2,7200,1.00208209399
410893,410899,414344,6,3445,2,7200,1.00174165457
411272,413746,434594,2474,20848,3,604800,1.11866845741
411466,411473,414658,7,3185,2,7200,1.0021978022
411761,411768,415106,7,3338,2,7200,1.00209706411
411776,411782,415090,6,3308,2,7200,1.00181378476
411797,411805,414992,8,3187,2,7200,1.00251019768
411873,411880,415236,7,3356,2,7200,1.00208581645
411891,411898,415260,7,3362,2,7200,1.00208209399
411906,411918,415088,12,3170,2,7200,1.00378548896
411955,411962,415322,7,3360,2,7200,1.00208333333
412087,412094,415456,7,3362,2,7200,1.00208209399
412250,412257,415867,7,3610,2,7200,1.00193905817
412275,412281,415905,6,3624,2,7200,1.00165562914
412296,412303,415618,7,3315,2,7200,1.00211161388
412311,412322,415567,11,3245,2,7200,1.00338983051
412435,412442,415919,7,3477,2,7200,1.0020132298
412477,412484,415746,7,3262,2,7200,1.00214592275
412761,412768,416303,7,3535,2,7200,1.00198019802
412776,412783,416328,7,3545,2,7200,1.00197461213
412800,412807,416404,7,3597,2,7200,1.00194606617
412824,412831,416169,7,3338,2,7200,1.00209706411
413009,413016,416533,7,3517,2,7200,1.00199033267
413024,413032,416304,8,3272,2,7200,1.00244498778
413084,413091,416698,7,3607,2,7200,1.00194067092
413106,413112,416359,6,3247,2,7200,1.00184785956
413124,413131,416557,7,3426,2,7200,1.00204319907
413139,413147,416444,8,3297,2,7200,1.00242644829
413178,413184,416369,6,3185,2,7200,1.00188383046
413193,413200,416511,7,3311,2,7200,1.0021141649
413368,413374,416790,6,3416,2,7200,1.00175644028
413393,413400,416746,7,3346,2,7200,1.00209205021
413429,413436,417074,7,3638,2,7200,1.00192413414
413520,413527,416934,7,3407,2,7200,1.00205459348
413556,413562,416951,6,3389,2,7200,1.00177043376
413571,413577,416953,6,3376,2,7200,1.00177725118
413764,413770,417025,6,3255,2,7200,1.00184331797
413963,413975,417440,12,3465,2,7200,1.00346320346
413981,413989,417396,8,3407,2,7200,1.00234810684
413997,414003,417348,6,3345,2,7200,1.00179372197
414048,414054,417529,6,3475,2,7200,1.00172661871
414142,414148,417450,6,3302,2,7200,1.00181708056
414347,414353,417736,6,3383,2,7200,1.00177357375
414658,414664,418249,6,3585,2,7200,1.00167364017
414883,414890,416641,7,1751,1,18000,1.00399771559
414890,414897,416785,7,1888,1,18000,1.00370762712
414896,414903,416546,7,1643,1,18000,1.00426049909
414897,414908,416777,11,1869,1,18000,1.00588550027
414900,414915,416684,15,1769,1,18000,1.00847936687
414902,414920,416790,18,1870,1,18000,1.00962566845
414907,415112,416760,205,1648,1,18000,1.12439320388
414909,415117,416942,208,1825,1,18000,1.11397260274
414915,415727,417536,812,1809,1,18000,1.44886677722
414915,415436,417770,521,2334,1,18000,1.22322193659
414917,415732,417241,815,1509,1,18000,1.54009277667
414921,415737,417655,816,1918,1,18000,1.42544316997
414923,415743,417419,820,1676,1,18000,1.4892601432
414925,416559,418285,1634,1726,1,18000,1.94669756663
414926,416573,418308,1647,1735,1,18000,1.9492795389
414927,416654,418509,1727,1855,1,18000,1.93099730458
414929,416696,418469,1767,1773,1,18000,1.99661590525
414933,416761,418578,1828,1817,1,18000,2.00605393506
414993,415000,418244,7,3244,2,7200,1.00215782984
415090,415100,418456,10,3356,2,7200,1.00297973778
415091,415105,418448,14,3343,2,7200,1.00418785522
415106,415125,418421,19,3296,2,7200,1.00576456311
415236,415242,418455,6,3213,2,7200,1.00186741363
415261,415268,418669,7,3401,2,7200,1.00205821817
415324,415331,418715,7,3384,2,7200,1.00206855792
415457,415464,418963,7,3499,2,7200,1.00200057159
415497,427137,427205,11640,68,8,4140,172.176470588
415569,415576,418848,7,3272,2,7200,1.0021393643
415620,415627,419053,7,3426,2,7200,1.00204319907
415747,415753,419005,6,3252,2,7200,1.00184501845
415870,415877,419166,7,3289,2,7200,1.00212830648
415907,415913,419132,6,3219,2,7200,1.0018639329
415922,415928,419325,6,3397,2,7200,1.00176626435
416169,416176,419633,7,3457,2,7200,1.00202487706
416305,416311,419591,6,3280,2,7200,1.00182926829
416307,416318,419557,11,3239,2,7200,1.00339610991
416328,416334,419933,6,3599,2,7200,1.00166712976
416361,416368,419662,7,3294,2,7200,1.0021250759
416377,416383,419695,6,3312,2,7200,1.0018115942
416404,416411,419703,7,3292,2,7200,1.00212636695
416446,416453,419999,7,3546,2,7200,1.00197405527
416513,416519,419732,6,3213,2,7200,1.00186741363
416534,416540,420100,6,3560,2,7200,1.00168539326
416558,416566,420048,8,3482,2,7200,1.00229753016
416700,416707,419988,7,3281,2,7200,1.00213349589
416748,416754,419915,6,3161,2,7200,1.0018981335
416794,416800,420245,6,3445,2,7200,1.00174165457
416936,416943,420438,7,3495,2,7200,1.00200286123
416951,416957,420550,6,3593,2,7200,1.00166991372
416966,416972,420588,6,3616,2,7200,1.00165929204
417026,417034,420288,8,3254,2,7200,1.0024585126
417075,417081,420529,6,3448,2,7200,1.00174013921
417192,421156,493169,3964,72013,4,72000,1.05504561676
417349,417361,420734,12,3373,2,7200,1.0035576638
417349,417366,566113,17,148747,1,259200,1.00011428802
417361,417412,558968,51,141556,1,259200,1.00036028144
417398,417405,420793,7,3388,2,7200,1.0020661157
417440,417446,420753,6,3307,2,7200,1.00181433323
417455,417461,420822,6,3361,2,7200,1.00178518298
417531,417538,420919,7,3381,2,7200,1.00207039337
417736,417743,421267,7,3524,2,7200,1.00198637911
417762,417768,553101,6,135333,1,259200,1.00004433508
418050,418057,544001,7,125944,1,259200,1.00005558026
418106,418112,558651,6,140539,1,259200,1.00004269278
418200,418262,560379,62,142117,1,259200,1.00043626026
418246,418252,421708,6,3456,2,7200,1.00173611111
418261,418268,421840,7,3572,2,7200,1.00195968645
418421,418427,421621,6,3194,2,7200,1.00187852223
418448,418455,421999,7,3544,2,7200,1.0019751693
418464,418471,421979,7,3508,2,7200,1.001995439
418466,418478,421824,12,3346,2,7200,1.00358637179
418558,418565,418566,7,1,2,3540,1.0
418606,418612,420361,6,1749,1,18000,1.00343053173
418610,418620,420568,10,1948,1,18000,1.00513347023
418611,418625,420371,14,1746,1,18000,1.00801832761
418612,420262,422005,1650,1743,1,18000,1.94664371773
418616,420267,422022,1651,1755,1,18000,1.94074074074
418617,420374,422102,1757,1728,1,18000,2.01678240741
418618,420453,422243,1835,1790,1,18000,2.0251396648
418618,420384,422057,1766,1673,1,18000,2.0555887627
418621,420458,422132,1837,1674,1,18000,2.09737156511
418623,420564,422284,1941,1720,1,18000,2.12848837209
418623,420569,422568,1946,1999,1,18000,1.97348674337
418627,420748,422445,2121,1697,1,18000,2.2498526812
418627,420580,422459,1953,1879,1,18000,2.03938265035
418630,420753,422364,2123,1611,1,18000,2.31781502173
418637,420768,422576,2131,1808,1,18000,2.17865044248
418639,420932,422818,2293,1886,1,18000,2.21580063627
418640,421284,422998,2644,1714,1,18000,2.54259043174
418646,421289,423081,2643,1792,1,18000,2.47488839286
418671,418678,421718,7,3040,2,7200,1.00230263158
418713,418719,422150,6,3431,2,7200,1.00174876129
418849,418855,422192,6,3337,2,7200,1.00179802218
418964,418970,422445,6,3475,2,7200,1.00172661871
419006,419013,422491,7,3478,2,7200,1.00201265095
419054,419061,422539,7,3478,2,7200,1.00201265095
419133,419139,422511,6,3372,2,7200,1.00177935943
419166,419173,422558,7,3385,2,7200,1.00206794682
419326,419333,422483,7,3150,2,7200,1.00222222222
419555,419561,423062,6,3501,2,7200,1.00171379606
419592,419599,422935,7,3336,2,7200,1.00209832134
419634,419641,422825,7,3184,2,7200,1.00219849246
419661,419669,423254,8,3585,2,7200,1.00223152022
419695,419702,422920,7,3218,2,7200,1.00217526414
419710,419717,422839,7,3122,2,7200,1.00224215247
419731,419739,422995,8,3256,2,7200,1.00245700246
419918,419926,423500,8,3574,2,7200,1.00223838836
419934,419940,423480,6,3540,2,7200,1.00169491525
419991,419997,423340,6,3343,2,7200,1.00179479509
420006,420013,423441,7,3428,2,7200,1.002042007
420048,420055,423773,7,3718,2,7200,1.00188273265
420100,420106,423361,6,3255,2,7200,1.00184331797
420248,420255,423501,7,3246,2,7200,1.00215650031
420290,420296,423948,6,3652,2,7200,1.00164293538
420438,420445,423701,7,3256,2,7200,1.00214987715
420510,422115,494160,1605,72045,4,72000,1.02227774308
420529,420535,424002,6,3467,2,7200,1.00173060283
420550,420557,424004,7,3447,2,7200,1.00203075138
420587,420593,423982,6,3389,2,7200,1.00177043376
420734,420741,423870,7,3129,2,7200,1.00223713647
420753,420761,423905,8,3144,2,7200,1.00254452926
420795,420801,423845,6,3044,2,7200,1.00197109067
420822,420830,424394,8,3564,2,7200,1.00224466891
420919,420926,424358,7,3432,2,7200,1.00203962704
421270,421276,424859,6,3583,2,7200,1.00167457438
421623,421630,425251,7,3621,2,7200,1.00193316763
421710,421717,425034,7,3317,2,7200,1.00211034067
421725,421732,424933,7,3201,2,7200,1.00218681662
421825,421832,425093,7,3261,2,7200,1.0021465808
421840,421847,425245,7,3398,2,7200,1.00206003531
421979,421986,425606,7,3620,2,7200,1.00193370166
422000,422006,425389,6,3383,2,7200,1.00177357375
422151,422158,425694,7,3536,2,7200,1.00197963801
422194,422200,425633,6,3433,2,7200,1.0017477425
422447,422453,425574,6,3121,2,7200,1.00192246075
422484,422491,425889,7,3398,2,7200,1.00206003531
422499,422506,425881,7,3375,2,7200,1.00207407407
422514,422520,426148,6,3628,2,7200,1.00165380375
422541,422548,426116,7,3568,2,7200,1.00196188341
422560,422567,426114,7,3547,2,7200,1.00197349873
422825,422833,426076,8,3243,2,7200,1.00246685168
422840,422846,426430,6,3584,2,7200,1.00167410714
422922,422929,426210,7,3281,2,7200,1.00213349589
422937,422943,426183,6,3240,2,7200,1.00185185185
422997,423004,426285,7,3281,2,7200,1.00213349589
423064,423070,426505,6,3435,2,7200,1.00174672489
423101,423109,424799,8,1690,1,18000,1.00473372781
423102,424544,426343,1442,1799,1,18000,1.80155642023
423116,424549,426363,1433,1814,1,18000,1.78996692393
423118,424554,426194,1436,1640,1,18000,1.8756097561
423122,424560,426153,1438,1593,1,18000,1.90269930948
423122,424811,426543,1689,1732,1,18000,1.97517321016
423122,425049,426846,1927,1797,1,18000,2.07234279354
423123,425054,426665,1931,1611,1,18000,2.19863438858
423128,425590,427382,2462,1792,1,18000,2.37388392857
423129,425595,427099,2466,1504,1,18000,2.63962765957
423132,425621,427492,2489,1871,1,18000,2.33030464992
423135,425708,427616,2573,1908,1,18000,2.34853249476
423136,425896,427861,2760,1965,1,18000,2.40458015267
423138,425902,427836,2764,1934,1,18000,2.42916235781
423139,425908,427535,2769,1627,1,18000,2.70190534726
423147,426092,427972,2945,1880,1,18000,2.5664893617
423148,426097,428026,2949,1929,1,18000,2.52877138414
423150,426166,427863,3016,1697,1,18000,2.77725397761
423254,423261,426653,7,3392,2,7200,1.00206367925
423339,423345,426721,6,3376,2,7200,1.00177725118
423363,423369,426599,6,3230,2,7200,1.00185758514
423441,423448,426802,7,3354,2,7200,1.00208706023
423481,423488,426826,7,3338,2,7200,1.00209706411
423502,423509,427218,7,3709,2,7200,1.00188730116
423504,423516,426952,12,3436,2,7200,1.00349243306
423703,423710,426850,7,3140,2,7200,1.00222929936
423773,423779,427300,6,3521,2,7200,1.00170406135
423845,423852,427199,7,3347,2,7200,1.00209142516
423870,423876,427362,6,3486,2,7200,1.0017211704
423906,423912,427290,6,3378,2,7200,1.00177619893
423948,423956,427084,8,3128,2,7200,1.00255754476
423952,426376,426387,2424,11,2,300,221.363636364
423972,426399,426408,2427,9,2,300,243.6
423985,423991,427086,6,3095,2,7200,1.00193861066
424003,424010,427426,7,3416,2,7200,1.00204918033
424018,424024,427319,6,3295,2,7200,1.00182094082
424359,424366,427665,7,3299,2,7200,1.00212185511
424395,424402,427725,7,3323,2,7200,1.00210653024
424859,424866,428471,7,3605,2,7200,1.00194174757
424935,424942,428351,7,3409,2,7200,1.00205338809
425035,425042,428434,7,3392,2,7200,1.00206367925
425095,425102,428230,7,3128,2,7200,1.00223785166
425246,425253,428400,7,3147,2,7200,1.00222434064
425261,425269,428625,8,3356,2,7200,1.00238379023
425391,425398,428897,7,3499,2,7200,1.00200057159
425576,425583,428805,7,3222,2,7200,1.00217256363
425606,425614,428751,8,3137,2,7200,1.0025502072
425634,425640,428979,6,3339,2,7200,1.00179694519
425694,425700,429091,6,3391,2,7200,1.00176938956
425882,425888,429517,6,3629,2,7200,1.00165334803
425897,425915,429395,18,3480,2,7200,1.00517241379
426078,426085,429722,7,3637,2,7200,1.00192466318
426115,426122,429468,7,3346,2,7200,1.00209205021
426130,426136,429329,6,3193,2,7200,1.00187911055
426148,426155,429717,7,3562,2,7200,1.0019651881
426184,426191,429466,7,3275,2,7200,1.00213740458
426211,426219,429565,8,3346,2,7200,1.00239091452
426287,426293,429765,6,3472,2,7200,1.0017281106
426432,426438,430138,6,3700,2,7200,1.00162162162
426505,426512,429814,7,3302,2,7200,1.00211992732
426602,426609,430051,7,3442,2,7200,1.00203370134
426656,426663,429909,7,3246,2,7200,1.00215650031
426720,426727,430261,7,3534,2,7200,1.00198075835
426805,426812,430175,7,3363,2,7200,1.00208147487
426829,426836,430547,7,3711,2,7200,1.00188628402
426850,426857,430341,7,3484,2,7200,1.00200918485
426953,426959,430053,6,3094,2,7200,1.00193923723
427086,427093,430668,7,3575,2,7200,1.00195804196
427088,427100,430589,12,3489,2,7200,1.00343938091
427200,427207,430575,7,3368,2,7200,1.0020783848
427218,427224,430657,6,3433,2,7200,1.0017477425
427290,427298,430972,8,3674,2,7200,1.00217746326
427306,427313,430710,7,3397,2,7200,1.00206064174
427321,427328,431013,7,3685,2,7200,1.00189959294
427363,427370,430627,7,3257,2,7200,1.00214921707
427427,427434,430794,7,3360,2,7200,1.00208333333
427662,427669,430992,7,3323,2,7200,1.00210653024
427726,427733,430906,7,3173,2,7200,1.00220611409
428095,428101,429963,6,1862,1,18000,1.00322234157
428099,428108,429846,9,1738,1,18000,1.00517836594
428099,428113,429934,14,1821,1,18000,1.00768808347
428103,428119,429891,16,1772,1,18000,1.00902934537
428105,429581,431286,1476,1705,1,18000,1.86568914956
428105,428125,429978,20,1853,1,18000,1.01079330815
428108,429832,431741,1724,1909,1,18000,1.90309062336
428109,429859,431790,1750,1931,1,18000,1.90626618332
428111,429904,431686,1793,1782,1,18000,2.00617283951
428113,429947,431641,1834,1694,1,18000,2.0826446281
428113,429976,431729,1863,1753,1,18000,2.06274957216
428115,429991,431775,1876,1784,1,18000,2.05156950673
428117,430065,431881,1948,1816,1,18000,2.07268722467
428121,430070,431721,1949,1651,1,18000,2.18049666869
428122,430152,431707,2030,1555,1,18000,2.30546623794
428132,430157,431914,2025,1757,1,18000,2.15253272624
428135,430274,432030,2139,1756,1,18000,2.21810933941
428139,430589,432393,2450,1804,1,18000,2.35809312639
428232,428238,431489,6,3251,2,7200,1.00184558597
428352,428358,431706,6,3348,2,7200,1.0017921147
428356,431927,518352,3571,86425,8,86400,1.04131906277
428401,428407,431599,6,3192,2,7200,1.00187969925
428435,428442,432070,7,3628,2,7200,1.00192943771
428471,428477,432086,6,3609,2,7200,1.00166251039
428625,428631,432146,6,3515,2,7200,1.00170697013
428752,428758,432228,6,3470,2,7200,1.00172910663
428806,428812,432162,6,3350,2,7200,1.00179104478
428897,428903,432419,6,3516,2,7200,1.00170648464
428982,428989,432430,7,3441,2,7200,1.00203429236
429090,429096,432500,6,3404,2,7200,1.0017626322
429329,429336,432491,7,3155,2,7200,1.00221870048
429396,429402,432730,6,3328,2,7200,1.00180288462
429465,429473,433107,8,3634,2,7200,1.00220143093
429481,429487,432999,6,3512,2,7200,1.00170842825
429518,429525,433110,7,3585,2,7200,1.0019525802
429566,429574,432778,8,3204,2,7200,1.0024968789
429717,429725,433441,8,3716,2,7200,1.00215285253
429733,429740,433212,7,3472,2,7200,1.00201612903
429766,429773,433043,7,3270,2,7200,1.00214067278
429818,429824,433010,6,3186,2,7200,1.00188323917
429911,429918,433119,7,3201,2,7200,1.00218681662
430051,430057,433298,6,3241,2,7200,1.00185128047
430066,430078,433567,12,3489,2,7200,1.00343938091
430138,430145,433402,7,3257,2,7200,1.00214921707
430175,430182,433546,7,3364,2,7200,1.00208085612
430260,430266,433627,6,3361,2,7200,1.00178518298
430344,430351,433778,7,3427,2,7200,1.00204260286
430547,430554,434003,7,3449,2,7200,1.00202957379
430574,430582,434007,8,3425,2,7200,1.00233576642
430590,430596,434111,6,3515,2,7200,1.00170697013
430629,430636,433795,7,3159,2,7200,1.0022158911
430656,430664,433953,8,3289,2,7200,1.00243235026
430671,430679,434018,8,3339,2,7200,1.00239592692
430711,430718,433985,7,3267,2,7200,1.00214263851
430796,430803,434441,7,3638,2,7200,1.00192413414
430907,430913,433915,6,3002,2,7200,1.00199866755
430974,430981,434307,7,3326,2,7200,1.00210463019
430992,430998,434295,6,3297,2,7200,1.00181983621
431013,431020,434332,7,3312,2,7200,1.00211352657
431488,431494,434783,6,3289,2,7200,1.00182426269
431600,431607,435134,7,3527,2,7200,1.00198468954
431706,431713,434896,7,3183,2,7200,1.00219918316
432072,432079,435394,7,3315,2,7200,1.00211161388
432087,432093,435608,6,3515,2,7200,1.00170697013
432148,432154,435734,6,3580,2,7200,1.00167597765
432163,432169,435373,6,3204,2,7200,1.00187265918
432229,432236,435680,7,3444,2,7200,1.00203252033
432417,432424,435744,7,3320,2,7200,1.00210843373
432419,433582,434852,1163,1270,1,18000,1.9157480315
432425,433865,434855,1440,990,1,18000,2.45454545455
432430,433870,434857,1440,987,1,18000,2.45896656535
432431,433875,434866,1444,991,1,18000,2.45711402624
432432,432439,435928,7,3489,2,7200,1.00200630553
432437,433931,434868,1494,937,1,18000,2.59445037353
432440,434314,434870,1874,556,1,18000,4.37050359712
432440,434309,434869,1869,560,1,18000,4.3375
432441,434348,434871,1907,523,1,18000,4.64627151052
432447,434353,434872,1906,519,1,18000,4.67244701349
432448,434455,434874,2007,419,1,18000,5.78997613365
432451,434460,434874,2009,414,1,18000,5.85265700483
432452,434606,434881,2154,275,1,18000,8.83272727273
432457,434612,434887,2155,275,1,18000,8.83636363636
432460,434617,434888,2157,271,1,18000,8.9594095941
432471,434799,434889,2328,90,1,18000,26.8666666667
432472,434804,434890,2332,86,1,18000,28.1162790698
432481,434864,434891,2383,27,1,18000,89.2592592593
432486,434871,434892,2385,21,1,18000,114.571428571
432493,432500,435865,7,3365,2,7200,1.00208023774
432508,432514,436002,6,3488,2,7200,1.00172018349
432729,432736,436141,7,3405,2,7200,1.00205580029
432778,432785,436102,7,3317,2,7200,1.00211034067
433001,433007,436149,6,3142,2,7200,1.00190961171
433016,433023,436543,7,3520,2,7200,1.00198863636
433044,433051,436302,7,3251,2,7200,1.00215318364
433107,433113,436136,6,3023,2,7200,1.00198478333
433123,433129,436290,6,3161,2,7200,1.0018981335
433124,433137,436533,13,3396,2,7200,1.00382803298
433215,433222,436462,7,3240,2,7200,1.00216049383
433297,433303,436802,6,3499,2,7200,1.00171477565
433402,433409,436922,7,3513,2,7200,1.00199259892
433442,433449,436904,7,3455,2,7200,1.0020260492
433545,433552,436903,7,3351,2,7200,1.00208892868
433569,433576,437020,7,3444,2,7200,1.00203252033
433629,433636,436962,7,3326,2,7200,1.00210463019
433778,433784,437096,6,3312,2,7200,1.0018115942
433796,433803,437074,7,3271,2,7200,1.00214001834
433917,433924,437191,7,3267,2,7200,1.00214263851
433953,433961,437276,8,3315,2,7200,1.002413273
433987,433994,437411,7,3417,2,7200,1.00204858063
434005,434012,437177,7,3165,2,7200,1.00221169036
434020,434028,437441,8,3413,2,7200,1.0023439789
434022,434035,437249,13,3214,2,7200,1.00404480398
434113,434119,437707,6,3588,2,7200,1.0016722408
434295,434302,437729,7,3427,2,7200,1.00204260286
434310,434321,437684,11,3363,2,7200,1.00327088909
434334,434341,437690,7,3349,2,7200,1.00209017617
434440,434447,437786,7,3339,2,7200,1.00209643606
434785,434791,438265,6,3474,2,7200,1.00172711572
434896,434908,438086,12,3178,2,7200,1.00377595972
435132,435139,438808,7,3669,2,7200,1.00190787681
435184,435191,436861,7,1670,1,18000,1.00419161677
435188,435197,436996,9,1799,1,18000,1.00500277932
435189,435203,437115,14,1912,1,18000,1.00732217573
435197,435394,437287,197,1893,1,18000,1.10406761754
435199,435399,437306,200,1907,1,18000,1.1048767698
435203,435404,437197,201,1793,1,18000,1.11210262131
435204,435410,437026,206,1616,1,18000,1.12747524752
435207,435415,437222,208,1807,1,18000,1.11510791367
435222,435420,437107,198,1687,1,18000,1.11736810907
435226,435426,437293,200,1867,1,18000,1.10712372791
435232,435431,437188,199,1757,1,18000,1.11326124075
435236,435436,437341,200,1905,1,18000,1.10498687664
435247,435441,437183,194,1742,1,18000,1.11136624569
435248,435447,437054,199,1607,1,18000,1.12383322962
435254,435452,437256,198,1804,1,18000,1.10975609756
435257,435457,437145,200,1688,1,18000,1.11848341232
435259,435463,437070,204,1607,1,18000,1.1269446173
435268,436875,438446,1607,1571,1,18000,2.02291534055
435274,437009,438783,1735,1774,1,18000,1.97801578354
435277,437038,438671,1761,1633,1,18000,2.07838334354
435374,435381,438708,7,3327,2,7200,1.0021039976
435396,435470,438890,74,3420,2,7200,1.0216374269
435611,435618,439100,7,3482,2,7200,1.00201033889
435683,435690,439041,7,3351,2,7200,1.00208892868
435735,435742,439235,7,3493,2,7200,1.00200400802
435750,435757,439280,7,3523,2,7200,1.00198694295
435865,435872,439418,7,3546,2,7200,1.00197405527
435929,435936,439251,7,3315,2,7200,1.00211161388
436004,436011,439545,7,3534,2,7200,1.00198075835
436104,436111,439526,7,3415,2,7200,1.00204978038
436138,436144,439575,6,3431,2,7200,1.00174876129
436153,436160,439461,7,3301,2,7200,1.00212056952
436155,436166,439674,11,3508,2,7200,1.00313568985
436291,436298,439794,7,3496,2,7200,1.00200228833
436306,436312,439742,6,3430,2,7200,1.00174927114
436463,436471,439925,8,3454,2,7200,1.00231615518
436533,436540,439958,7,3418,2,7200,1.00204798128
436548,436554,439900,6,3346,2,7200,1.00179318589
436802,436808,440137,6,3329,2,7200,1.00180234305
436905,436912,440313,7,3401,2,7200,1.00205821817
436907,436919,440368,12,3449,2,7200,1.00347926935
436922,436929,440262,7,3333,2,7200,1.00210021002
436962,436968,440310,6,3342,2,7200,1.00179533214
436965,437910,439333,945,1423,8,86400,1.66408995081
437022,437028,440559,6,3531,2,7200,1.00169923534
437077,437085,440323,8,3238,2,7200,1.0024706609
437098,437104,440523,6,3419,2,7200,1.00175489909
437180,437187,440678,7,3491,2,7200,1.00200515612
437195,437203,440504,8,3301,2,7200,1.00242350803
437249,437256,440790,7,3534,2,7200,1.00198075835
437277,437284,440899,7,3615,2,7200,1.00193637621
437413,437419,440851,6,3432,2,7200,1.00174825175
437443,437449,441016,6,3567,2,7200,1.00168208579
437685,437692,441003,7,3311,2,7200,1.0021141649
437700,437706,440848,6,3142,2,7200,1.00190961171
437715,437723,441122,8,3399,2,7200,1.00235363342
437730,437738,441228,8,3490,2,7200,1.00229226361
437785,437792,441291,7,3499,2,7200,1.00200057159
438087,438094,441450,7,3356,2,7200,1.00208581645
438266,438272,441741,6,3469,2,7200,1.00172960507
438711,438717,441939,6,3222,2,7200,1.00186219739
438810,438818,442344,8,3526,2,7200,1.0022688599
438832,438839,440473,7,1634,1,18000,1.00428396573
438833,438846,440586,13,1740,1,18000,1.00747126437
438835,439293,440897,458,1604,1,18000,1.2855361596
438835,438905,440636,70,1731,1,18000,1.04043905257
438837,439350,441142,513,1792,1,18000,1.28627232143
438837,439345,441202,508,1857,1,18000,1.27355950458
438838,439355,440967,517,1612,1,18000,1.32071960298
438839,439361,441090,522,1729,1,18000,1.3019086177
438840,439366,440970,526,1604,1,18000,1.32793017456
438843,439371,441117,528,1746,1,18000,1.30240549828
438844,439377,441151,533,1774,1,18000,1.30045095829
438846,439382,441057,536,1675,1,18000,1.32
438847,440485,442238,1638,1753,1,18000,1.93439817456
438849,440520,442114,1671,1594,1,18000,2.04830614806
438851,440525,442265,1674,1740,1,18000,1.96206896552
438852,440599,442130,1747,1531,1,18000,2.14108425865
438853,440649,442379,1796,1730,1,18000,2.03815028902
438854,440693,442397,1839,1704,1,18000,2.07922535211
438860,440699,442232,1839,1533,1,18000,2.19960861057
438861,440804,442545,1943,1741,1,18000,2.11602527283
438892,438898,442110,6,3212,2,7200,1.00186799502
439044,439051,442457,7,3406,2,7200,1.00205519671
439101,439109,442296,8,3187,2,7200,1.00251019768
439237,439244,442388,7,3144,2,7200,1.0022264631
439253,439259,442537,6,3278,2,7200,1.00183038438
439280,439286,442710,6,3424,2,7200,1.00175233645
439416,439422,442812,6,3390,2,7200,1.0017699115
439462,439468,443111,6,3643,2,7200,1.00164699424
439525,439532,442764,7,3232,2,7200,1.00216584158
439547,439554,443027,7,3473,2,7200,1.00201554852
439577,439583,442649,6,3066,2,7200,1.00195694716
439674,439680,443294,6,3614,2,7200,1.00166021029
439743,439751,443248,8,3497,2,7200,1.00228767515
439795,439802,443189,7,3387,2,7200,1.00206672572
439898,439904,443028,6,3124,2,7200,1.0019206146
439925,439932,443230,7,3298,2,7200,1.00212249848
439956,439962,443431,6,3469,2,7200,1.00172960507
440139,440146,443426,7,3280,2,7200,1.00213414634
440264,440272,443739,8,3467,2,7200,1.00230747044
440310,440316,443849,6,3533,2,7200,1.00169827342
440325,440332,443839,7,3507,2,7200,1.00199600798
440327,440339,443672,12,3333,2,7200,1.00360036004
440369,440375,443750,6,3375,2,7200,1.00177777778
440505,440513,443751,8,3238,2,7200,1.0024706609
440524,440531,443860,7,3329,2,7200,1.00210273355
440560,440567,444116,7,3549,2,7200,1.00197238659
440681,440687,444239,6,3552,2,7200,1.00168918919
440789,440796,444028,7,3232,2,7200,1.00216584158
440847,440854,444246,7,3392,2,7200,1.00206367925
440862,440869,444136,7,3267,2,7200,1.00214263851
440899,440905,444672,6,3767,2,7200,1.0015927794
441005,441012,444288,7,3276,2,7200,1.00213675214
441020,441026,444501,6,3475,2,7200,1.00172661871
441123,441130,444677,7,3547,2,7200,1.00197349873
441228,441235,444765,7,3530,2,7200,1.00198300283
441289,441296,444477,7,3181,2,7200,1.00220056586
441452,441458,444706,6,3248,2,7200,1.00184729064
441742,441748,445022,6,3274,2,7200,1.00183262065
441941,441948,445521,7,3573,2,7200,1.00195913798
442111,442117,445501,6,3384,2,7200,1.00177304965
442298,442305,445663,7,3358,2,7200,1.00208457415
442344,442351,445959,7,3608,2,7200,1.00194013304
442389,442396,445995,7,3599,2,7200,1.00194498472
442459,442466,445952,7,3486,2,7200,1.00200803213
442512,442518,442675,6,157,1,3600,1.03821656051
442537,442543,446059,6,3516,2,7200,1.00170648464
442606,442614,444253,8,1639,1,18000,1.00488102502
442608,442619,444305,11,1686,1,18000,1.00652431791
442614,442627,444192,13,1565,1,18000,1.00830670927
442618,442632,444443,14,1811,1,18000,1.00773053562
442619,442637,444247,18,1610,1,18000,1.01118012422
442621,442644,444292,23,1648,1,18000,1.01395631068
442622,442649,444290,27,1641,1,18000,1.01645338208
442623,442655,444339,32,1684,1,18000,1.0190023753
442628,442660,444342,32,1682,1,18000,1.01902497027
442629,442665,444289,36,1624,1,18000,1.02216748768
442633,442671,444233,38,1562,1,18000,1.02432778489
442635,442681,444199,46,1518,1,18000,1.0303030303
442635,442676,444285,41,1609,1,18000,1.02548166563
442636,442687,444350,51,1663,1,18000,1.03066746843
442639,442699,444447,60,1748,1,18000,1.03432494279
442640,442705,444486,65,1781,1,18000,1.03649635036
442643,442710,444188,67,1478,1,18000,1.04533152909
442649,442694,446183,45,3489,2,7200,1.01289767842
442649,442715,444375,66,1660,1,18000,1.03975903614
442654,442721,444192,67,1471,1,18000,1.04554724677
442660,442726,444361,66,1635,1,18000,1.04036697248
442713,442733,446066,20,3333,2,7200,1.00600060006
442764,442771,446110,7,3339,2,7200,1.00209643606
442813,442820,446275,7,3455,2,7200,1.0020260492
443028,443035,446202,7,3167,2,7200,1.00221029365
443030,443042,446486,12,3444,2,7200,1.00348432056
443038,443686,444042,648,356,1,3600,2.8202247191
443112,443118,446571,6,3453,2,7200,1.00173761946
443190,443198,446465,8,3267,2,7200,1.00244872972
443233,443239,446618,6,3379,2,7200,1.00177567328
443251,443257,446878,6,3621,2,7200,1.00165700083
443297,443303,446768,6,3465,2,7200,1.00173160173
443427,443433,446846,6,3413,2,7200,1.00175798418
443442,443449,446914,7,3465,2,7200,1.00202020202
443672,443678,446933,6,3255,2,7200,1.00184331797
443743,443749,447394,6,3645,2,7200,1.00164609053
443758,443766,447239,8,3473,2,7200,1.00230348402
443760,443771,447334,11,3563,2,7200,1.00308728599
443843,443849,447311,6,3462,2,7200,1.00173310225
443858,443865,447129,7,3264,2,7200,1.00214460784
443873,443880,447482,7,3602,2,7200,1.0019433648
444027,444034,447224,7,3190,2,7200,1.00219435737
444119,444125,447639,6,3514,2,7200,1.00170745589
444137,444143,447637,6,3494,2,7200,1.00171722954
444243,444250,447703,7,3453,2,7200,1.0020272227
444258,444265,447367,7,3102,2,7200,1.00225660864
444289,444295,447583,6,3288,2,7200,1.00182481752
444476,444483,447835,7,3352,2,7200,1.00208830549
444501,444508,447665,7,3157,2,7200,1.0022172949
444540,444552,446215,12,1663,1,18000,1.00721587492
444540,444547,446230,7,1683,1,18000,1.00415923945
444545,444559,446197,14,1638,1,18000,1.00854700855
444546,444564,446063,18,1499,1,18000,1.01200800534
444553,444571,446084,18,1513,1,18000,1.01189689359
444559,444576,446219,17,1643,1,18000,1.01034692635
444560,444582,446243,22,1661,1,18000,1.01324503311
444563,444587,446074,24,1487,1,18000,1.01613987895
444576,444594,446229,18,1635,1,18000,1.01100917431
444579,444599,446072,20,1473,1,18000,1.01357773252
444580,444605,446066,25,1461,1,18000,1.01711156742
444581,444610,446191,29,1581,1,18000,1.018342821
444589,444616,446248,27,1632,1,18000,1.01654411765
444592,444627,446213,35,1586,1,18000,1.02206809584
444592,444622,446158,30,1536,1,18000,1.01953125
444594,444638,446283,44,1645,1,18000,1.02674772036
444594,444632,446249,38,1617,1,18000,1.02350030921
444595,444643,446289,48,1646,1,18000,1.02916160389
444601,444648,446263,47,1615,1,18000,1.02910216718
444605,444687,446243,82,1556,1,18000,1.05269922879
444625,444694,445534,69,840,1,3600,1.08214285714
444673,444680,448152,7,3472,2,7200,1.00201612903
444689,444703,448085,14,3382,2,7200,1.00413956239
444707,444713,447985,6,3272,2,7200,1.00183374083
444764,444771,448024,7,3253,2,7200,1.00215185982
445022,445028,448545,6,3517,2,7200,1.00170599943
445503,445509,449229,6,3720,2,7200,1.00161290323
445518,445525,448646,7,3121,2,7200,1.00224287087
445664,445671,449202,7,3531,2,7200,1.00198244123
445953,445960,449435,7,3475,2,7200,1.00201438849
445968,445975,449357,7,3382,2,7200,1.00206978119
445995,446002,449340,7,3338,2,7200,1.00209706411
446059,446066,449440,7,3374,2,7200,1.0020746888
446074,446081,449475,7,3394,2,7200,1.00206246317
446111,446117,449680,6,3563,2,7200,1.00168397418
446144,446150,446331,6,181,1,3600,1.03314917127
446180,446187,449734,7,3547,2,7200,1.00197349873
446202,446208,449546,6,3338,2,7200,1.00179748352
446274,446281,449912,7,3631,2,7200,1.00192784357
446302,446308,447805,6,1497,1,18000,1.00400801603
446303,446315,447853,12,1538,1,18000,1.0078023407
446304,446321,447996,17,1675,1,18000,1.01014925373
446309,446326,447901,17,1575,1,18000,1.01079365079
446310,446333,447951,23,1618,1,18000,1.01421508035
446311,446338,447949,27,1611,1,18000,1.01675977654
446312,446344,447764,32,1420,1,18000,1.02253521127
446314,446349,447762,35,1413,1,18000,1.02476999292
446315,446354,447833,39,1479,1,18000,1.02636916836
446316,446365,448019,49,1654,1,18000,1.02962515115
446316,446359,447901,43,1542,1,18000,1.02788586252
446319,446370,447893,51,1523,1,18000,1.03348653972
446326,446375,448043,49,1668,1,18000,1.0293764988
446330,446382,447982,52,1600,1,18000,1.0325
446331,446387,447943,56,1556,1,18000,1.03598971722
446334,447388,448915,1054,1527,1,18000,1.69024230517
446334,447383,448922,1049,1539,1,18000,1.681611436
446335,447410,448951,1075,1541,1,18000,1.69759896171
446336,447599,449151,1263,1552,1,18000,1.81378865979
446341,447604,449119,1263,1515,1,18000,1.83366336634
446465,446472,450007,7,3535,2,7200,1.00198019802
446487,446493,449851,6,3358,2,7200,1.00178677784
446571,446578,450043,7,3465,2,7200,1.00202020202
446617,446623,450106,6,3483,2,7200,1.00172265289
446666,447679,448035,1013,356,1,3600,3.84550561798
446768,446774,450146,6,3372,2,7200,1.00177935943
446848,446854,450364,6,3510,2,7200,1.00170940171
446866,447777,460256,911,12479,4,14400,1.07300264444
446878,446885,450373,7,3488,2,7200,1.00200688073
446917,446924,450478,7,3554,2,7200,1.00196961171
446936,446942,450599,6,3657,2,7200,1.00164068909
447129,447135,450723,6,3588,2,7200,1.0016722408
447223,447230,450658,7,3428,2,7200,1.002042007
447238,447246,450783,8,3537,2,7200,1.00226180379
447311,447317,450456,6,3139,2,7200,1.00191143676
447335,447342,450621,7,3279,2,7200,1.00213479719
447369,447376,450739,7,3363,2,7200,1.00208147487
447396,447403,450646,7,3243,2,7200,1.00215849522
447481,447488,450964,7,3476,2,7200,1.00201380898
447584,447592,451119,8,3527,2,7200,1.00226821661
447639,447645,450975,6,3330,2,7200,1.0018018018
447641,447652,450965,11,3313,2,7200,1.00332025355
447665,447671,451328,6,3657,2,7200,1.00164068909
447705,447712,451073,7,3361,2,7200,1.00208271348
447838,447844,451278,6,3434,2,7200,1.00174723355
447983,447989,451386,6,3397,2,7200,1.00176626435
448016,448022,448136,6,114,1,3600,1.05263157895
448022,448029,451268,7,3239,2,7200,1.00216116085
448086,448092,451571,6,3479,2,7200,1.00172463352
448154,448160,451504,6,3344,2,7200,1.00179425837
448472,448479,448822,7,343,1,3600,1.02040816327
448545,448552,451900,7,3348,2,7200,1.00209080048
448596,448602,449456,6,854,1,3600,1.00702576112
448648,448655,452289,7,3634,2,7200,1.00192625206
449177,449183,450589,6,1406,1,18000,1.00426742532
449180,449191,450773,11,1582,1,18000,1.00695322377
449182,449196,450711,14,1515,1,18000,1.00924092409
449183,449201,450788,18,1587,1,18000,1.01134215501
449184,449206,450805,22,1599,1,18000,1.01375859912
449188,449218,450794,30,1576,1,18000,1.01903553299
449189,449223,450718,34,1495,1,18000,1.02274247492
449189,449228,450932,39,1704,1,18000,1.02288732394
449191,449234,450840,43,1606,1,18000,1.02677459527
449192,449239,450764,47,1525,1,18000,1.03081967213
449195,449244,450805,49,1561,1,18000,1.03139013453
449198,449249,450956,51,1707,1,18000,1.02987697715
449199,449357,450948,158,1591,1,18000,1.09930861094
449202,449362,450852,160,1490,1,18000,1.10738255034
449204,449376,450911,172,1535,1,18000,1.11205211726
449206,449212,452576,6,3364,2,7200,1.00178359096
449207,449262,450903,55,1641,1,18000,1.03351614869
449208,449268,450815,60,1547,1,18000,1.03878474467
449211,449381,451002,170,1621,1,18000,1.10487353486
449212,449450,451062,238,1612,1,18000,1.1476426799
449213,449455,451268,242,1813,1,18000,1.13348041919
449231,449257,452585,26,3328,2,7200,1.0078125
449342,449349,453054,7,3705,2,7200,1.00188933873
449357,449369,452899,12,3530,2,7200,1.00339943343
449436,449442,453042,6,3600,2,7200,1.00166666667
449451,449462,452923,11,3461,2,7200,1.00317827218
449476,449483,452648,7,3165,2,7200,1.00221169036
449483,449491,450102,8,611,1,3600,1.01309328969
449549,449555,452864,6,3309,2,7200,1.00181323663
449591,449598,449717,7,119,1,1800,1.05882352941
449680,449686,453340,6,3654,2,7200,1.00164203612
449734,449741,453174,7,3433,2,7200,1.00203903292
449852,449859,453367,7,3508,2,7200,1.001995439
449913,449919,453325,6,3406,2,7200,1.00176159718
450007,450014,453253,7,3239,2,7200,1.00216116085
450043,450049,453294,6,3245,2,7200,1.00184899846
450107,450114,453513,7,3399,2,7200,1.00205942924
450147,450153,453313,6,3160,2,7200,1.00189873418
450185,450601,450747,416,146,1,1800,3.84931506849
450365,450372,453747,7,3375,2,7200,1.00207407407
450380,450386,453474,6,3088,2,7200,1.00194300518
450455,450462,453968,7,3506,2,7200,1.0019965773
450479,450487,453744,8,3257,2,7200,1.00245624808
450600,450608,453628,8,3020,2,7200,1.00264900662
450622,450628,453882,6,3254,2,7200,1.00184388445
450646,450652,453971,6,3319,2,7200,1.00180777343
450662,450668,453847,6,3179,2,7200,1.00188738597
450722,450728,454037,6,3309,2,7200,1.00181323663
450741,450747,454090,6,3343,2,7200,1.00179479509
450784,450791,454153,7,3362,2,7200,1.00208209399
450965,450971,454443,6,3472,2,7200,1.0017281106
450967,450978,454485,11,3507,2,7200,1.00313658397
450982,450990,454309,8,3319,2,7200,1.00241036457
451073,451080,454495,7,3415,2,7200,1.00204978038
451122,451128,454428,6,3300,2,7200,1.00181818182
451270,451278,454771,8,3493,2,7200,1.00229029488
451285,451293,454721,8,3428,2,7200,1.00233372229
451328,451334,455209,6,3875,2,7200,1.0015483871
451333,451341,452981,8,1640,1,18000,1.00487804878
451339,451348,452778,9,1430,1,18000,1.00629370629
451339,451353,452876,14,1523,1,18000,1.00919238345
451344,451360,452914,16,1554,1,18000,1.0102960103
451345,451365,452955,20,1590,1,18000,1.01257861635
451346,451403,453025,57,1622,1,18000,1.03514180025
451347,451408,452934,61,1526,1,18000,1.03997378768
451348,451518,453041,170,1523,1,18000,1.11162179908
451349,451523,452865,174,1342,1,18000,1.12965722802
451350,451585,453223,235,1638,1,18000,1.14346764347
451350,451590,453126,240,1536,1,18000,1.15625
451352,451913,453455,561,1542,1,18000,1.36381322957
451354,451918,453448,564,1530,1,18000,1.36862745098
451355,452304,453881,949,1577,1,18000,1.60177552315
451358,452309,453801,951,1492,1,18000,1.63739946381
451359,452593,454145,1234,1552,1,18000,1.79510309278
451360,452598,454098,1238,1500,1,18000,1.82533333333
451361,452662,454229,1301,1567,1,18000,1.83024888322
451364,452792,454365,1428,1573,1,18000,1.90781945327
451365,452881,454397,1516,1516,1,18000,2.0
451388,451395,454795,7,3400,2,7200,1.00205882353
451504,451511,454993,7,3482,2,7200,1.00201033889
451555,452886,453001,1331,115,1,3600,12.5739130435
451570,451577,454997,7,3420,2,7200,1.00204678363
451785,452893,453474,1108,581,1,1800,2.90705679862
451900,451906,454906,6,3000,2,7200,1.002
452290,452297,455798,7,3501,2,7200,1.00199942873
452579,452586,455860,7,3274,2,7200,1.00213805742
452594,452605,456127,11,3522,2,7200,1.00312322544
452649,452655,455881,6,3226,2,7200,1.00185988841
452866,452873,456163,7,3290,2,7200,1.00212765957
452900,452906,456197,6,3291,2,7200,1.00182315406
452924,452931,456195,7,3264,2,7200,1.00214460784
453043,453049,456187,6,3138,2,7200,1.00191204589
453058,453065,456279,7,3214,2,7200,1.00217797138
453173,453180,456769,7,3589,2,7200,1.00195040401
453255,453262,456438,7,3176,2,7200,1.00220403023
453264,453270,453377,6,107,1,1800,1.05607476636
453295,453301,456783,6,3482,2,7200,1.00172314762
453313,453320,456531,7,3211,2,7200,1.00218000623
453328,453334,456654,6,3320,2,7200,1.00180722892
453344,453351,456573,7,3222,2,7200,1.00217256363
453365,453371,453701,6,330,1,3600,1.01818181818
453368,453378,456598,10,3220,2,7200,1.00310559006
453474,453481,456749,7,3268,2,7200,1.00214198286
453514,453522,456792,8,3270,2,7200,1.00244648318
453629,453637,456986,8,3349,2,7200,1.00238877277
453746,453753,457234,7,3481,2,7200,1.0020109164
453761,453767,457319,6,3552,2,7200,1.00168918919
453846,453852,457039,6,3187,2,7200,1.00188264826
453882,453890,457415,8,3525,2,7200,1.00226950355
453954,453960,454083,6,123,1,1800,1.0487804878
453970,453976,457611,6,3635,2,7200,1.00165061898
453972,453983,457375,11,3392,2,7200,1.00324292453
454039,454046,457322,7,3276,2,7200,1.00213675214
454090,454097,457317,7,3220,2,7200,1.00217391304
454154,454160,457546,6,3386,2,7200,1.00177200236
454308,454315,457651,7,3336,2,7200,1.00209832134
454328,454335,454953,7,618,1,3600,1.01132686084
454426,454432,457920,6,3488,2,7200,1.00172018349
454442,454450,455868,8,1418,1,18000,1.00564174894
454443,454455,455917,12,1462,1,18000,1.00820793434
454444,454467,455953,23,1486,1,18000,1.01547779273
454445,454473,456107,28,1634,1,18000,1.01713586291
454445,454462,457726,17,3264,2,7200,1.00520833333
454446,454478,455889,32,1411,1,18000,1.0226789511
454447,454483,455960,36,1477,1,18000,1.02437373053
454449,454489,455988,40,1499,1,18000,1.0266844563
454451,454503,456245,52,1742,1,18000,1.02985074627
454452,454508,455955,56,1447,1,18000,1.03870076019
454454,454734,456218,280,1484,1,18000,1.18867924528
454455,454739,456105,284,1366,1,18000,1.20790629575
454456,454785,456197,329,1412,1,18000,1.23300283286
454456,454790,456192,334,1402,1,18000,1.23823109843
454459,454963,456321,504,1358,1,18000,1.37113402062
454460,455225,456633,765,1408,1,18000,1.54332386364
454462,455230,456718,768,1488,1,18000,1.51612903226
454463,455902,457438,1439,1536,1,18000,1.93684895833
454463,455881,457523,1418,1642,1,18000,1.86358099878
454465,455929,457464,1464,1535,1,18000,1.95374592834
454468,455966,457363,1498,1397,1,18000,2.07229778096
454487,454496,457969,9,3473,2,7200,1.00259141952
454502,454515,457775,13,3260,2,7200,1.00398773006
454720,454726,458033,6,3307,2,7200,1.00181433323
454771,454777,458040,6,3263,2,7200,1.00183879865
454796,454803,458256,7,3453,2,7200,1.0020272227
454904,454911,458354,7,3443,2,7200,1.00203311066
454994,455001,458364,7,3363,2,7200,1.00208147487
455008,455015,458414,7,3399,2,7200,1.00205942924
455211,455218,458502,7,3284,2,7200,1.00213154689
455222,455973,456544,751,571,1,1800,2.31523642732
455798,455806,459202,8,3396,2,7200,1.0023557126
455862,455868,459287,6,3419,2,7200,1.00175489909
455883,455890,459069,7,3179,2,7200,1.0022019503
456086,456093,456141,7,48,1,1800,1.14583333333
456128,456134,459537,6,3403,2,7200,1.00176315016
456162,456168,459478,6,3310,2,7200,1.00181268882
456186,456192,459324,6,3132,2,7200,1.00191570881
456201,456208,459463,7,3255,2,7200,1.00215053763
456203,456215,459231,12,3016,2,7200,1.00397877984
456279,456286,459930,7,3644,2,7200,1.00192096597
456440,456446,459896,6,3450,2,7200,1.00173913043
456530,456538,460096,8,3558,2,7200,1.00224845419
456576,456584,460092,8,3508,2,7200,1.00228050171
456601,456607,459944,6,3337,2,7200,1.00179802218
456655,456661,460086,6,3425,2,7200,1.00175182482
456659,456669,456744,10,75,1,1800,1.13333333333
456749,456757,460374,8,3617,2,7200,1.00221177772
456768,456774,460074,6,3300,2,7200,1.00181818182
456783,456789,459985,6,3196,2,7200,1.00187734668
456798,456805,460318,7,3513,2,7200,1.00199259892
456986,456992,460126,6,3134,2,7200,1.00191448628
457038,457045,460464,7,3419,2,7200,1.00204738228
457235,457242,460678,7,3436,2,7200,1.00203725262
457320,457327,460541,7,3214,2,7200,1.00217797138
457321,457334,460818,13,3484,2,7200,1.00373134328
457336,457343,460615,7,3272,2,7200,1.0021393643
457376,457382,460844,6,3462,2,7200,1.00173310225
457415,457421,460473,6,3052,2,7200,1.00196592398
457544,457551,459004,7,1453,1,18000,1.00481761872
457545,457564,460820,19,3256,2,7200,1.00583538084
457545,457569,459061,24,1492,1,18000,1.01608579088
457545,457557,459109,12,1552,1,18000,1.00773195876
457547,457574,459124,27,1550,1,18000,1.01741935484
457548,457579,459072,31,1493,1,18000,1.0207635633
457548,457585,459036,37,1451,1,18000,1.02549965541
457550,457590,459112,40,1522,1,18000,1.02628120894
457551,457666,459211,115,1545,1,18000,1.07443365696
457552,457671,459115,119,1444,1,18000,1.0824099723
457553,457741,459273,188,1532,1,18000,1.1227154047
457553,457746,459161,193,1415,1,18000,1.13639575972
457554,457790,459218,236,1428,1,18000,1.16526610644
457554,457795,459329,241,1534,1,18000,1.15710560626
457555,457933,459444,378,1511,1,18000,1.25016545334
457556,457938,459409,382,1471,1,18000,1.25968728756
457557,458287,459771,730,1484,1,18000,1.49191374663
457557,458292,459792,735,1500,1,18000,1.49
457558,458477,460006,919,1529,1,18000,1.60104643558
457559,459017,460578,1458,1561,1,18000,1.93401665599
457559,458482,460005,923,1523,1,18000,1.60604070913
457612,457618,461182,6,3564,2,7200,1.00168350168
457652,457659,460942,7,3283,2,7200,1.00213219616
457727,457734,460890,7,3156,2,7200,1.00221799747
457776,457783,461363,7,3580,2,7200,1.00195530726
457918,457924,461187,6,3263,2,7200,1.00183879865
457935,459049,459327,1114,278,1,1800,5.0071942446
457970,457977,461368,7,3391,2,7200,1.00206428782
458033,458039,461410,6,3371,2,7200,1.00177988727
458048,458055,461396,7,3341,2,7200,1.00209518108
458257,458264,461689,7,3425,2,7200,1.00204379562
458259,459784,546189,1525,86405,8,86400,1.01764944158
458357,458364,461809,7,3445,2,7200,1.00203193033
458372,458379,461490,7,3111,2,7200,1.00225008036
458414,458422,461704,8,3282,2,7200,1.00243753809
458502,458509,461788,7,3279,2,7200,1.00213479719
459072,459078,462323,6,3245,2,7200,1.00184899846
459201,459208,462573,7,3365,2,7200,1.00208023774
459231,459238,462371,7,3133,2,7200,1.00223428024
459249,459256,459304,7,48,1,1800,1.14583333333
459289,459295,462648,6,3353,2,7200,1.00178944229
459326,459333,462553,7,3220,2,7200,1.00217391304
459466,459472,462744,6,3272,2,7200,1.00183374083
459481,459487,462589,6,3102,2,7200,1.00193423598
459538,459545,462915,7,3370,2,7200,1.00207715134
459895,459902,463181,7,3279,2,7200,1.00213479719
459917,459924,460019,7,95,1,1800,1.07368421053
459931,459937,463374,6,3437,2,7200,1.00174570847
459946,459952,463204,6,3252,2,7200,1.00184501845
459986,459993,463354,7,3361,2,7200,1.00208271348
460074,460080,463382,6,3302,2,7200,1.00181708056
460089,460096,463401,7,3305,2,7200,1.00211800303
460104,460110,463446,6,3336,2,7200,1.00179856115
460106,460116,463618,10,3502,2,7200,1.00285551114
460127,460134,463360,7,3226,2,7200,1.00216986981
460321,460328,463802,7,3474,2,7200,1.00201496834
460375,460382,463791,7,3409,2,7200,1.00205338809
460464,460470,466008,6,5538,4,86400,1.00108342362
460466,460478,464081,12,3603,2,7200,1.00333055787
460481,460489,463717,8,3228,2,7200,1.00247831475
460541,460549,463986,8,3437,2,7200,1.00232761129
460614,460620,463975,6,3355,2,7200,1.00178837556
460635,460641,462082,6,1441,1,18000,1.00416377516
460637,460692,462183,55,1491,1,18000,1.03688799463
460638,460846,462411,208,1565,1,18000,1.13290734824
460638,460840,462284,202,1444,1,18000,1.13988919668
460639,462095,463667,1456,1572,1,18000,1.9262086514
460639,460861,462329,222,1468,1,18000,1.15122615804
460640,462196,463638,1556,1442,1,18000,2.07905686546
460641,462296,463545,1655,1249,1,18000,2.32506004804
460642,462337,463686,1695,1349,1,18000,2.25648628614
460644,462344,463575,1700,1231,1,18000,2.38099106418
460645,462393,463785,1748,1392,1,18000,2.25574712644
460645,462388,463744,1743,1356,1,18000,2.28539823009
460646,462567,464102,1921,1535,1,18000,2.25146579805
460646,462424,463841,1778,1417,1,18000,2.25476358504
460647,462587,464107,1940,1520,1,18000,2.27631578947
460647,462572,464119,1925,1547,1,18000,2.2443438914
460648,462592,464298,1944,1706,1,18000,2.13950762016
460649,462607,464080,1958,1473,1,18000,2.32926001358
460649,462612,464092,1963,1480,1,18000,2.32635135135
460651,462664,464038,2013,1374,1,18000,2.46506550218
460678,460685,464079,7,3394,2,7200,1.00206246317
460821,460827,464051,6,3224,2,7200,1.00186104218
460822,460835,464146,13,3311,2,7200,1.00392630625
460847,460854,464333,7,3479,2,7200,1.00201207243
460893,460899,464067,6,3168,2,7200,1.00189393939
460945,460951,464268,6,3317,2,7200,1.00180886343
461183,461190,464244,7,3054,2,7200,1.00229207597
461198,461206,464535,8,3329,2,7200,1.00240312406
461362,461369,465049,7,3680,2,7200,1.00190217391
461377,461384,464824,7,3440,2,7200,1.00203488372
461399,461405,464624,6,3219,2,7200,1.0018639329
461407,462669,462964,1262,295,1,1800,5.27796610169
461414,461421,464468,7,3047,2,7200,1.00229734165
461490,461497,464638,7,3141,2,7200,1.00222858962
461689,461696,464989,7,3293,2,7200,1.00212572123
461705,461713,465037,8,3324,2,7200,1.00240673887
461790,461796,464945,6,3149,2,7200,1.00190536678
461812,461818,465199,6,3381,2,7200,1.00177462289
462323,462330,465646,7,3316,2,7200,1.00211097708
462374,462380,465572,6,3192,2,7200,1.00187969925
462388,462758,463313,370,555,2,900,1.66666666667
462400,463325,487122,925,23797,4,28800,1.03887044585
462553,462559,465832,6,3273,2,7200,1.00183318057
462574,462580,465967,6,3387,2,7200,1.00177147919
462589,462600,466055,11,3455,2,7200,1.00318379161
462650,462657,466128,7,3471,2,7200,1.00201670988
462744,462750,466131,6,3381,2,7200,1.00177462289
462771,463756,467170,985,3414,8,14400,1.2885178676
462917,462923,466265,6,3342,2,7200,1.00179533214
463184,463191,466360,7,3169,2,7200,1.00220889871
463206,463213,466622,7,3409,2,7200,1.00205338809
463354,463361,466727,7,3366,2,7200,1.00207961973
463369,463376,466515,7,3139,2,7200,1.00223000956
463385,463392,466808,7,3416,2,7200,1.00204918033
463386,463399,466970,13,3571,2,7200,1.00364043685
463402,463409,466886,7,3477,2,7200,1.0020132298
463447,463453,466571,6,3118,2,7200,1.00192431046
463620,463626,466970,6,3344,2,7200,1.00179425837
463717,463724,466970,7,3246,2,7200,1.00215650031
463792,463800,466970,8,3170,2,7200,1.00252365931
463808,463815,466970,7,3155,2,7200,1.00221870048
463949,466984,467471,3035,487,14,1560,7.23203285421
463974,463980,466970,6,2990,2,7200,1.00200668896
463989,463997,466971,8,2974,2,7200,1.00268997983
464053,464060,466970,7,2910,2,7200,1.00240549828
464068,464074,466970,6,2896,2,7200,1.0020718232
464079,464119,565324,40,101205,4,129600,1.00039523739
464084,464090,466971,6,2881,2,7200,1.0020826102
464085,464098,466971,13,2873,2,7200,1.00452488688
464149,464155,466971,6,2816,2,7200,1.00213068182
464243,464250,466971,7,2721,2,7200,1.00257258361
464267,464274,466971,7,2697,2,7200,1.00259547646
464332,466020,466077,1688,57,2,2340,30.6140350877
464334,464340,466971,6,2631,2,7200,1.00228050171
464337,466031,467341,1694,1310,1,18000,2.29312977099
464337,466025,467246,1688,1221,1,18000,2.38247338247
464338,466089,467699,1751,1610,1,18000,2.08757763975
464338,466094,467443,1756,1349,1,18000,2.30170496664
464339,466381,467460,2042,1079,1,18000,2.89249304912
464339,466530,467814,2191,1284,1,18000,2.70638629283
464339,466376,467368,2037,992,1,18000,3.05342741935
464340,466587,467806,2247,1219,1,18000,2.84331419196
464340,466535,467834,2195,1299,1,18000,2.68976135489
464341,466592,467750,2251,1158,1,18000,2.94386873921
464341,466636,467823,2295,1187,1,18000,2.93344566133
464342,466641,467984,2299,1343,1,18000,2.71183916605
464342,466825,468004,2483,1179,1,18000,3.10602205259
464343,466830,467953,2487,1123,1,18000,3.21460373998
464343,466901,467992,2558,1091,1,18000,3.34463794684
464344,466998,468152,2654,1154,1,18000,3.29982668977
464344,466989,468309,2645,1320,1,18000,3.00378787879
464345,467004,468336,2659,1332,1,18000,2.99624624625
464345,467009,468169,2664,1160,1,18000,3.29655172414
464346,467014,468419,2668,1405,1,18000,2.89893238434
464467,464474,466971,7,2497,2,7200,1.00280336404
464537,464544,466971,7,2427,2,7200,1.0028842192
464625,464631,466971,6,2340,2,7200,1.00256410256
464640,464647,466971,7,2324,2,7200,1.00301204819
464825,464831,466971,6,2140,2,7200,1.00280373832
464946,464952,466971,6,2019,2,7200,1.0029717682
464991,464999,466971,8,1972,2,7200,1.00405679513
465040,465046,466971,6,1925,2,7200,1.00311688312
465055,465062,466971,7,1909,2,7200,1.00366684128
465200,465207,466971,7,1764,2,7200,1.00396825397
465572,465579,466971,7,1392,2,7200,1.00502873563
465648,465655,466971,7,1316,2,7200,1.00531914894
465833,465840,466971,7,1131,2,7200,1.00618921309
465966,465972,466971,6,999,2,7200,1.00600600601
466057,466064,466971,7,907,2,7200,1.00771775083
466085,466120,466233,35,113,16,324000,1.30973451327
466130,466137,466971,7,834,2,7200,1.00839328537
466131,466143,466971,12,828,2,7200,1.01449275362
466268,466274,466971,6,697,2,7200,1.00860832138
466272,467020,503723,748,36703,1,43200,1.02037980547
466280,467025,491913,745,24888,1,43200,1.02993410479
466362,466369,466971,7,602,2,7200,1.01162790698
466369,467146,479833,777,12687,16,324000,1.06124379286
466516,466523,466971,7,448,2,7200,1.015625
466574,466580,466971,6,391,2,7200,1.01534526854
466622,466628,466971,6,343,2,7200,1.01749271137
466728,466736,466971,8,235,2,7200,1.03404255319
466810,466817,466971,7,154,2,7200,1.04545454545
466886,466893,466971,7,78,2,7200,1.08974358974
467129,467180,467311,51,131,4,86400,1.3893129771
467223,467231,467491,8,260,2,18000,1.03076923077
467276,467282,467408,6,126,2,18000,1.04761904762
467428,467440,468993,12,1553,2,14400,1.00772698004
467428,467435,470994,7,3559,2,7200,1.00196684462
467430,467447,470907,17,3460,2,7200,1.0049132948
467431,467452,470715,21,3263,2,7200,1.00643579528
467433,467457,470900,24,3443,2,7200,1.00697066512
467434,467463,471129,29,3666,2,7200,1.00791052919
467436,467468,470626,32,3158,2,7200,1.01013299557
467438,467473,470702,35,3229,2,7200,1.01083926912
467439,467478,470653,39,3175,2,7200,1.01228346457
467441,467486,470949,45,3463,2,7200,1.01299451343
467443,467491,470705,48,3214,2,7200,1.01493466086
467444,467497,470775,53,3278,2,7200,1.01616839536
467446,467502,470867,56,3365,2,7200,1.01664190193
467447,467507,471148,60,3641,2,7200,1.01647898929
467449,467512,470811,63,3299,2,7200,1.01909669597
467451,467518,470919,67,3401,2,7200,1.01970008821
467452,467523,470545,71,3022,2,7200,1.02349437459
467454,467528,470680,74,3152,2,7200,1.02347715736
467455,467533,470586,78,3053,2,7200,1.02554864068
467457,467539,470762,82,3223,2,7200,1.02544213466
467459,467544,471233,85,3689,2,7200,1.02304147465
467460,467549,471199,89,3650,2,7200,1.02438356164
467462,467554,470977,92,3423,2,7200,1.02687700847
467463,467560,470985,97,3425,2,7200,1.02832116788
467465,467565,470824,100,3259,2,7200,1.03068425898
467467,467570,471012,103,3442,2,7200,1.02992446252
467468,467575,470916,107,3341,2,7200,1.03202633942
467470,467581,471072,111,3491,2,7200,1.03179604698
467471,467586,470879,115,3293,2,7200,1.03492256301
467473,467591,470708,118,3117,2,7200,1.0378569137
467475,467596,471069,121,3473,2,7200,1.0348401958
467476,467602,470702,126,3100,2,7200,1.04064516129
467478,467607,471142,129,3535,2,7200,1.03649222065
467480,467612,470979,132,3367,2,7200,1.0392040392
467481,467619,471041,138,3422,2,7200,1.04032729398
467483,467624,470762,141,3138,2,7200,1.04493307839
467484,467629,470988,145,3359,2,7200,1.04316760941
467486,467638,470974,152,3336,2,7200,1.04556354916
467488,467643,470814,155,3171,2,7200,1.04888047934
467489,467648,470999,159,3351,2,7200,1.04744852283
467491,467653,471229,162,3576,2,7200,1.04530201342
467697,467711,467713,14,2,1,3600,1.6
467794,467800,467814,6,14,1,3600,1.42857142857
468186,468193,469760,7,1567,2,18000,1.00446713465
468456,468468,469338,12,870,1,18000,1.01379310345
468456,468463,470034,7,1571,1,18000,1.00445576066
468459,468475,469417,16,942,1,18000,1.016985138
468459,468480,470193,21,1713,1,18000,1.0122591944
468460,468486,470184,26,1698,1,18000,1.01531213192
468461,468496,470219,35,1723,1,18000,1.02031340685
468461,468491,470177,30,1686,1,18000,1.01779359431
468464,468501,470185,37,1684,1,18000,1.02197149644
468465,468507,470412,42,1905,1,18000,1.02204724409
468466,468512,469610,46,1098,1,18000,1.04189435337
468466,468517,470166,51,1649,1,18000,1.03092783505
468467,468523,469439,56,916,1,18000,1.06113537118
468471,468535,470217,64,1682,1,18000,1.03804994055
468472,469005,470048,533,1043,1,18000,1.51102588686
468472,469010,470803,538,1793,1,18000,1.30005577245
468474,469351,471033,877,1682,1,18000,1.52140309156
468480,469428,470361,948,933,1,18000,2.01607717042
468480,469452,470431,972,979,1,18000,1.99284984678
468481,469623,471231,1142,1608,1,18000,1.71019900498
468483,470047,471864,1564,1817,1,18000,1.86075949367
469004,469772,470938,768,1166,2,18000,1.65866209262
470109,470178,470638,69,460,2,1740,1.15
470297,470304,470564,7,260,2,18000,1.02692307692
470545,470552,473197,7,2645,2,7200,1.00264650284
470587,470594,473197,7,2603,2,7200,1.00268920476
470609,470615,474250,6,3635,2,3600,1.00165061898
470626,470632,473197,6,2565,2,7200,1.00233918129
470650,470657,473197,7,2540,2,7200,1.00275590551
470680,470686,473197,6,2511,2,7200,1.00238948626
470705,470711,473197,6,2486,2,7200,1.00241351569
470707,470718,473197,11,2479,2,7200,1.00443727309
470708,470723,473197,15,2474,2,7200,1.00606305578
470723,470730,473197,7,2467,2,7200,1.0028374544
470725,470736,473197,11,2461,2,7200,1.00446972775
470764,470770,473197,6,2427,2,7200,1.00247218789
470766,470777,473197,11,2420,2,7200,1.00454545455
470781,470788,473197,7,2409,2,7200,1.00290577003
470811,470819,473197,8,2378,2,7200,1.00336417157
470826,470833,473197,7,2364,2,7200,1.00296108291
470828,470840,473197,12,2357,2,7200,1.00509121765
470848,470921,470925,73,4,4,3600,7.7
470867,470874,473197,7,2323,2,7200,1.00301334481
470882,470889,473197,7,2308,2,7200,1.00303292894
470901,470907,473197,6,2290,2,7200,1.00262008734
470916,470927,473197,11,2270,2,7200,1.00484581498
470917,470933,473197,16,2264,2,7200,1.00706713781
470932,470940,473197,8,2257,2,7200,1.00354452813
470950,470958,473197,8,2239,2,7200,1.00357302367
470975,470981,473197,6,2216,2,7200,1.00270758123
470990,470996,473197,6,2201,2,7200,1.00272603362
470992,471004,473197,12,2193,2,7200,1.00547195622
470993,471009,473197,16,2188,2,7200,1.00731261426
470995,471014,473197,19,2183,2,7200,1.00870361887
471010,471022,473197,12,2175,2,7200,1.00551724138
471012,471027,473197,15,2170,2,7200,1.0069124424
471013,471032,473197,19,2165,2,7200,1.00877598152
471041,471048,473197,7,2149,2,7200,1.00325732899
471068,471074,473197,6,2123,2,7200,1.00282618935
471083,471089,473197,6,2108,2,7200,1.00284629981
471131,471138,473197,7,2059,2,7200,1.0033997086
471146,471153,473197,7,2044,2,7200,1.00342465753
471148,471160,473197,12,2037,2,7200,1.0058910162
471199,471205,473197,6,1992,2,7200,1.00301204819
471229,471236,473197,7,1961,2,7200,1.00356960734
471244,471251,473197,7,1946,2,7200,1.0035971223
471368,473229,479499,1861,6270,19,28800,1.29681020734
471557,471563,471592,6,29,2,18000,1.20689655172
471703,471709,471747,6,38,1,3600,1.15789473684
471754,471761,473024,7,1263,2,18000,1.00554235946
471928,471935,473689,7,1754,1,18000,1.00399087799
471930,471943,473583,13,1640,1,18000,1.00792682927
471934,473234,474970,1300,1736,1,18000,1.74884792627
471934,471948,473360,14,1412,1,18000,1.00991501416
471935,473240,474493,1305,1253,1,18000,2.04150039904
471938,473245,474758,1307,1513,1,18000,1.86384666226
471942,473250,475515,1308,2265,1,18000,1.57748344371
471942,473256,474854,1314,1598,1,18000,1.82227784731
471943,473261,474930,1318,1669,1,18000,1.7896944278
471945,473519,475149,1574,1630,1,18000,1.96564417178
471945,473595,475258,1650,1663,1,18000,1.99218280216
471947,473710,475369,1763,1659,1,18000,2.06268836649
471948,473716,475411,1768,1695,1,18000,2.04306784661
471948,473721,474566,1773,845,1,18000,3.09822485207
471950,473726,475379,1776,1653,1,18000,2.07441016334
471952,473732,475154,1780,1422,1,18000,2.2517580872
471953,473737,475078,1784,1341,1,18000,2.33035048471
471956,473748,475272,1792,1524,1,18000,2.17585301837
471956,473742,474641,1786,899,1,18000,2.98665183537
471957,473753,475303,1796,1550,1,18000,2.15870967742
472035,473036,473638,1001,602,2,1740,2.66279069767
472392,473216,476930,824,3714,2,18000,1.22186322025
472907,473221,474538,314,1317,2,18000,1.238420653
472937,473211,473688,274,477,14,1560,1.57442348008
473262,473269,473504,7,235,2,7200,1.02978723404
473264,473275,473504,11,229,2,7200,1.0480349345
473266,473281,473504,15,223,2,7200,1.06726457399
473267,473286,473504,19,218,2,7200,1.0871559633
473269,473291,473504,22,213,2,7200,1.10328638498
473270,473297,473504,27,207,2,7200,1.13043478261
473272,473303,473504,31,201,2,7200,1.15422885572
473274,473308,473504,34,196,2,7200,1.17346938776
473275,473313,473504,38,191,2,7200,1.19895287958
473277,473318,473504,41,186,2,7200,1.22043010753
473278,473324,473504,46,180,2,7200,1.25555555556
473280,473329,473504,49,175,2,7200,1.28
473282,473334,473504,52,170,2,7200,1.30588235294
473283,473339,473504,56,165,2,7200,1.33939393939
473285,473345,473504,60,159,2,7200,1.37735849057
473287,473350,473504,63,154,2,7200,1.40909090909
473288,473355,473504,67,149,2,7200,1.44966442953
473290,473360,473504,70,144,2,7200,1.48611111111
473291,473366,473504,75,138,2,7200,1.54347826087
473293,473373,473504,80,131,2,7200,1.6106870229
473295,473378,473504,83,126,2,7200,1.65873015873
473296,473383,473504,87,121,2,7200,1.71900826446
473298,473389,473504,91,115,2,7200,1.79130434783
473299,473394,473504,95,110,2,7200,1.86363636364
473301,473399,473504,98,105,2,7200,1.93333333333
473303,473404,473504,101,100,2,7200,2.01
473307,473410,473504,103,94,2,7200,2.09574468085
473308,473415,473504,107,89,2,7200,2.20224719101
473310,473420,473504,110,84,2,7200,2.30952380952
473312,473426,473504,114,78,2,7200,2.46153846154
473313,473431,473504,118,73,2,7200,2.61643835616
473315,473436,473504,121,68,2,7200,2.77941176471
473316,473441,473504,125,63,2,7200,2.98412698413
473318,473447,473504,129,57,2,7200,3.26315789474
473320,473452,473504,132,52,2,7200,3.53846153846
473321,473457,473504,136,47,2,7200,3.89361702128
473323,473462,473504,139,42,2,7200,4.30952380952
473324,473468,473504,144,36,2,7200,5.0
473326,473473,473504,147,31,2,7200,5.74193548387
473328,473478,473504,150,26,2,7200,6.76923076923
473332,473650,478408,318,4758,2,18000,1.06683480454
473341,473705,476294,364,2589,2,18000,1.14059482426
473636,473758,473762,122,4,1,900,12.6
473682,473699,474408,17,709,2,1740,1.023977433
473701,473765,477281,64,3516,2,7200,1.01820250284
473702,473770,477300,68,3530,2,7200,1.01926345609
473704,473775,477167,71,3392,2,7200,1.02093160377
473705,473781,476874,76,3093,2,7200,1.02457161332
473707,473786,477243,79,3457,2,7200,1.02285218397
473708,473791,477282,83,3491,2,7200,1.02377542252
473710,473796,477388,86,3592,2,7200,1.02394209354
473711,473802,477319,91,3517,2,7200,1.02587432471
473713,473807,477073,94,3266,2,7200,1.02878138396
473715,473812,477222,97,3410,2,7200,1.0284457478
473716,473817,477331,101,3514,2,7200,1.02874217416
473718,473823,476981,105,3158,2,7200,1.0332488917
473719,473828,477100,109,3272,2,7200,1.03331295844
473721,473833,477567,112,3734,2,7200,1.02999464381
473722,473838,477475,116,3637,2,7200,1.03189441848
473724,473844,477366,120,3522,2,7200,1.03407155026
473725,473849,477346,124,3497,2,7200,1.03545896483
473727,473854,477297,127,3443,2,7200,1.03688643625
473728,473859,477495,131,3636,2,7200,1.03602860286
473730,473865,477384,135,3519,2,7200,1.03836317136
473732,473870,477352,138,3482,2,7200,1.03963239518
473733,473875,477392,142,3517,2,7200,1.04037531987
473735,473880,477412,145,3532,2,7200,1.04105322763
473736,473886,477431,150,3545,2,7200,1.04231311707
473738,473891,477263,153,3372,2,7200,1.04537366548
473739,473896,477261,157,3365,2,7200,1.04665676077
473741,473901,476841,160,2940,2,7200,1.05442176871
473742,473907,477251,165,3344,2,7200,1.04934210526
473744,473912,477339,168,3427,2,7200,1.04902246863
473745,473917,477341,172,3424,2,7200,1.05023364486
473747,473922,477322,175,3400,2,7200,1.05147058824
473748,473928,477469,180,3541,2,7200,1.05083309799
473750,473933,477180,183,3247,2,7200,1.05635971666
473752,473938,477397,186,3459,2,7200,1.0537727667
473753,473943,477523,190,3580,2,7200,1.0530726257
473755,473949,477472,194,3523,2,7200,1.05506670451
473756,473954,477189,198,3235,2,7200,1.06120556414
473758,473959,477233,201,3274,2,7200,1.06139279169
473759,473965,477449,206,3484,2,7200,1.05912743972
473761,473971,477688,210,3717,2,7200,1.05649717514
473864,474262,474271,398,9,2,18000,40.7
474407,474414,474418,7,4,1,900,1.1
474457,474464,474614,7,150,2,1740,1.04666666667
474917,475090,475543,173,453,14,1560,1.38189845475
475177,475183,476172,6,989,2,18000,1.00606673407
475541,475548,475553,7,5,1,900,1.2
475550,475557,476535,7,978,14,1560,1.00715746421
475580,475586,477177,6,1591,1,18000,1.00377121307
475589,475596,477300,7,1704,1,18000,1.00410798122
475591,475603,477376,12,1773,1,18000,1.00676818951
475604,475610,477242,6,1632,1,18000,1.00367647059
475609,475616,476893,7,1277,1,18000,1.00548159749
475630,475636,477152,6,1516,1,18000,1.00395778364
475635,475644,477200,9,1556,1,18000,1.0057840617
475636,476312,478032,676,1720,1,18000,1.39302325581
475639,476905,478569,1266,1664,1,18000,1.76081730769
475643,476911,478342,1268,1431,1,18000,1.88609364081
475643,476916,478494,1273,1578,1,18000,1.80671736375
475645,476921,478449,1276,1528,1,18000,1.83507853403
475650,476927,478468,1277,1541,1,18000,1.82868267359
475652,476932,478559,1280,1627,1,18000,1.78672403196
475655,476937,478585,1282,1648,1,18000,1.77791262136
475658,476943,478598,1285,1655,1,18000,1.77643504532
475658,476950,478717,1292,1767,1,18000,1.7311827957
475659,477165,478792,1506,1627,1,18000,1.92562999385
475671,477190,478900,1519,1710,1,18000,1.88830409357
475673,477212,479008,1539,1796,1,18000,1.85690423163
475716,476307,485716,591,9409,1,36000,1.06281220108
476054,476060,478203,6,2143,2,3600,1.00279981335
476054,476185,480636,131,4451,2,18000,1.02943158841
476336,476895,479884,559,2989,4,14400,1.18701906992
476529,477255,477260,726,5,1,900,73.1
476539,476548,476877,9,329,14,1560,1.0273556231
476694,476900,478146,206,1246,2,18000,1.16532905297
476840,476854,480150,14,3296,2,7200,1.00424757282
476877,476888,480248,11,3360,2,7200,1.00327380952
476944,477843,480780,899,2937,2,18000,1.30609465441
476982,476995,480327,13,3332,2,7200,1.00390156062
477075,477086,480558,11,3472,2,7200,1.00316820276
477102,477114,480712,12,3598,2,7200,1.00333518621
477168,477181,480664,13,3483,2,7200,1.00373241459
477183,477197,480781,14,3584,2,7200,1.00390625
477198,477205,480676,7,3471,2,7200,1.00201670988
477222,477234,480426,12,3192,2,7200,1.0037593985
477231,477296,477981,65,685,2,1740,1.09489051095
477238,477246,480622,8,3376,2,7200,1.00236966825
477253,477262,480852,9,3590,2,7200,1.00250696379
477256,477269,480638,13,3369,2,7200,1.00385871178
477271,477284,480537,13,3253,2,7200,1.0039963111
477273,477289,480879,16,3590,2,7200,1.00445682451
477288,477301,480735,13,3434,2,7200,1.00378567268
477289,477310,480774,21,3464,2,7200,1.00606235566
477305,477319,480668,14,3349,2,7200,1.00418035234
477306,477324,480801,18,3477,2,7200,1.00517687662
477324,477333,480405,9,3072,2,7200,1.0029296875
477326,477340,480729,14,3389,2,7200,1.0041310121
477341,477349,480958,8,3609,2,7200,1.00221668052
477343,477356,480667,13,3311,2,7200,1.00392630625
477344,477361,480664,17,3303,2,7200,1.00514683621
477360,477368,480588,8,3220,2,7200,1.00248447205
477362,477373,480918,11,3545,2,7200,1.00310296192
477377,477384,480772,7,3388,2,7200,1.0020661157
477392,477401,480699,9,3298,2,7200,1.00272892662
477394,477406,480653,12,3247,2,7200,1.00369571913
477396,477413,480726,17,3313,2,7200,1.00513130094
477411,477420,480927,9,3507,2,7200,1.00256629598
477412,477426,480692,14,3266,2,7200,1.0042865891
477434,477445,480973,11,3528,2,7200,1.00311791383
477452,477463,481062,11,3599,2,7200,1.00305640456
477470,477482,480888,12,3406,2,7200,1.00352319436
477485,477491,480782,6,3291,2,7200,1.00182315406
477486,477497,480986,11,3489,2,7200,1.00315276584
477501,477508,481137,7,3629,2,7200,1.00192890603
477526,477536,480906,10,3370,2,7200,1.00296735905
477568,477580,480889,12,3309,2,7200,1.00362647325
477688,477702,480973,14,3271,2,7200,1.00428003669
477981,477993,477995,12,2,1,900,1.4
477987,478007,478710,20,703,2,1740,1.02844950213
478031,478158,480740,127,2582,2,18000,1.04918667699
478191,478199,479175,8,976,2,18000,1.00819672131
478226,478232,485693,6,7461,2,21600,1.00080418175
478708,478715,478720,7,5,1,900,1.2
478718,478724,479413,6,689,2,1740,1.00870827286
479057,479064,480732,7,1668,1,18000,1.00419664269
479058,479070,480728,12,1658,1,18000,1.00723763571
479059,479075,480718,16,1643,1,18000,1.00973828363
479061,479081,480683,20,1602,1,18000,1.01248439451
479062,479086,480611,24,1525,1,18000,1.01573770492
479064,479091,480720,27,1629,1,18000,1.01657458564
479064,479096,480658,32,1562,1,18000,1.0204865557
479066,479109,480693,43,1584,1,18000,1.02714646465
479066,479103,480620,37,1517,1,18000,1.0243902439
479068,479114,480700,46,1586,1,18000,1.0290037831
479068,479119,480604,51,1485,1,18000,1.03434343434
479069,479125,480771,56,1646,1,18000,1.0340218712
479069,479130,480678,61,1548,1,18000,1.03940568475
479071,479135,480701,64,1566,1,18000,1.04086845466
479072,479141,480791,69,1650,1,18000,1.04181818182
479073,479187,480755,114,1568,1,18000,1.07270408163
479074,479192,480801,118,1609,1,18000,1.07333747669
479075,479521,481166,446,1645,1,18000,1.27112462006
479075,479516,480957,441,1441,1,18000,1.30603747398
479076,479527,481118,451,1591,1,18000,1.28346951603
479356,479532,627117,176,147585,1,259200,1.00119253312
479412,479511,479514,99,3,1,900,10.2
479419,479425,480116,6,691,2,1740,1.00868306802
479443,479537,630434,94,150897,1,259200,1.00062294148
479593,479599,479609,6,10,2,300,1.6
479596,479606,479617,10,11,2,300,1.90909090909
479820,479845,480234,25,389,16,324000,1.06426735219
479856,479862,482823,6,2961,2,18000,1.00202634245
480114,480121,480138,7,17,1,900,1.41176470588
480124,480131,480396,7,265,2,1740,1.02641509434
480151,480157,483418,6,3261,2,7200,1.0018399264
480227,480234,481235,7,1001,2,18000,1.00699300699
480233,481152,497025,919,15873,16,324000,1.0578970579
480251,480257,483698,6,3441,2,7200,1.00174367916
480329,480336,483755,7,3419,2,7200,1.00204738228
480404,480411,483648,7,3237,2,7200,1.00216249614
480428,480435,483927,7,3492,2,7200,1.0020045819
480439,485293,485722,4854,429,8,86400,12.3146853147
480456,485740,486169,5284,429,8,86400,13.317016317
480472,486182,486611,5710,429,8,86400,14.31002331
480486,486623,487256,6137,633,8,86400,10.6951026856
480539,480546,483717,7,3171,2,7200,1.00220750552
480554,480562,483667,8,3105,2,7200,1.00257648953
480588,480595,484345,7,3750,2,7200,1.00186666667
480624,480630,484075,6,3445,2,7200,1.00174165457
480639,480645,483965,6,3320,2,7200,1.00180722892
480654,480660,484191,6,3531,2,7200,1.00169923534
480666,480735,498770,69,18035,2,18000,1.00382589409
480669,480677,484121,8,3444,2,7200,1.00232288037
480671,480684,484224,13,3540,2,7200,1.00367231638
480673,480689,484041,16,3352,2,7200,1.00477326969
480674,480695,484024,21,3329,2,7200,1.00630820066
480689,480702,484172,13,3470,2,7200,1.00374639769
480705,480712,484080,7,3368,2,7200,1.0020783848
480706,480719,484017,13,3298,2,7200,1.0039417829
480721,480728,483639,7,2911,2,7200,1.00240467193
480737,480744,483837,7,3093,2,7200,1.00226317491
480738,480751,484120,13,3369,2,7200,1.00385871178
480740,480756,484163,16,3407,2,7200,1.00469621368
480773,480780,484130,7,3350,2,7200,1.00208955224
480788,480796,484210,8,3414,2,7200,1.00234329233
480790,480803,484381,13,3578,2,7200,1.0036333147
480791,480808,484299,17,3491,2,7200,1.00486966485
480806,480815,484242,9,3427,2,7200,1.00262620368
480812,481130,487670,318,6540,2,18000,1.04862385321
480851,480859,483977,8,3118,2,7200,1.00256574727
480878,480885,484166,7,3281,2,7200,1.00213349589
480894,480901,484394,7,3493,2,7200,1.00200400802
480895,480908,484370,13,3462,2,7200,1.00375505488
480895,481247,482944,352,1697,2,18000,1.20742486741
480910,480917,484424,7,3507,2,7200,1.00199600798
480925,480932,484517,7,3585,2,7200,1.0019525802
480940,480947,484451,7,3504,2,7200,1.00199771689
480958,480966,484198,8,3232,2,7200,1.00247524752
480973,480980,484367,7,3387,2,7200,1.00206672572
480975,480988,484497,13,3509,2,7200,1.00370475919
480990,480997,484494,7,3497,2,7200,1.00200171576
481039,482175,482976,1136,801,2,7200,2.41822721598
481062,481069,484402,7,3333,2,7200,1.00210021002
481138,481144,484660,6,3516,2,7200,1.00170648464
481207,481213,482866,6,1653,1,18000,1.00362976407
481208,482835,484310,1627,1475,1,18000,2.10305084746
481208,482180,483960,972,1780,1,18000,1.54606741573
481210,482879,484353,1669,1474,1,18000,2.13229308005
481210,482840,484325,1630,1485,1,18000,2.09764309764
481213,482988,484608,1775,1620,1,18000,2.09567901235
481214,482993,484654,1779,1661,1,18000,2.07104154124
481214,483682,485163,2468,1481,1,18000,2.66644159352
481215,483687,485288,2472,1601,1,18000,2.54403497814
481216,483712,485285,2496,1573,1,18000,2.5867768595
481217,481549,482449,332,900,2,18000,1.36888888889
481218,483717,485311,2499,1594,1,18000,2.56775407779
481222,483733,485221,2511,1488,1,18000,2.6875
481223,483738,485434,2515,1696,1,18000,2.4829009434
481224,483769,485214,2545,1445,1,18000,2.76124567474
481225,483774,485280,2549,1506,1,18000,2.69256308101
481226,483852,485480,2626,1628,1,18000,2.61302211302
481227,483857,485440,2630,1583,1,18000,2.66140240051
481227,483864,485459,2637,1595,1,18000,2.65329153605
481228,483869,485619,2641,1750,1,18000,2.50914285714
481228,483942,485566,2714,1624,1,18000,2.67118226601
481862,482165,484785,303,2620,2,18000,1.11564885496
481919,483978,484022,2059,44,2,900,47.7954545455
481994,482170,487000,176,4830,2,18000,1.0364389234
482206,482462,483849,256,1387,2,18000,1.18457101658
482862,482956,490256,94,7300,2,18000,1.01287671233
483080,487281,832920,4201,345639,8,345600,1.01215429972
483340,483433,484702,93,1269,2,18000,1.07328605201
483419,483425,487031,6,3606,2,7200,1.00166389351
483639,483646,486944,7,3298,2,7200,1.00212249848
483653,483660,487104,7,3444,2,7200,1.00203252033
483668,483675,487136,7,3461,2,7200,1.00202253684
483698,483704,487091,6,3387,2,7200,1.00177147919
483719,483725,487220,6,3495,2,7200,1.0017167382
483754,483762,487330,8,3568,2,7200,1.00224215247
483838,483844,487413,6,3569,2,7200,1.00168114318
483928,483935,487365,7,3430,2,7200,1.00204081633
483964,483971,487325,7,3354,2,7200,1.00208706023
483979,483985,487447,6,3462,2,7200,1.00173310225
484018,484024,487362,6,3338,2,7200,1.00179748352
484032,484040,487246,8,3206,2,7200,1.00249532127
484047,484054,487327,7,3273,2,7200,1.00213871066
484077,484084,487488,7,3404,2,7200,1.00205640423
484091,484097,487573,6,3476,2,7200,1.00172612198
484121,484129,487442,8,3313,2,7200,1.00241472985
484123,484134,487442,11,3308,2,7200,1.00332527207
484137,484144,487412,7,3268,2,7200,1.00214198286
484161,484168,487646,7,3478,2,7200,1.00201265095
484176,484183,487380,7,3197,2,7200,1.00218955271
484177,484190,487893,13,3703,2,7200,1.00351066703
484192,484198,487667,6,3469,2,7200,1.00172960507
484208,484215,487781,7,3566,2,7200,1.00196298374
484222,484228,487572,6,3344,2,7200,1.00179425837
484224,484236,487785,12,3549,2,7200,1.00338123415
484245,484252,487942,7,3690,2,7200,1.00189701897
484301,484308,487764,7,3456,2,7200,1.00202546296
484346,484352,487746,6,3394,2,7200,1.00176782557
484367,484374,487585,7,3211,2,7200,1.00218000623
484382,484388,487520,6,3132,2,7200,1.00191570881
484383,484396,487944,13,3548,2,7200,1.00366403608
484398,484404,487681,6,3277,2,7200,1.00183094294
484412,484418,487870,6,3452,2,7200,1.00173812283
484427,484433,487798,6,3365,2,7200,1.00178306092
484453,484460,488319,7,3859,2,7200,1.00181394144
484495,484503,488051,8,3548,2,7200,1.00225479143
484497,484508,487851,11,3343,2,7200,1.00329045767
484498,484667,494769,169,10102,2,18000,1.01672936052
484514,484520,487938,6,3418,2,7200,1.00175541252
484662,484674,487995,12,3321,2,7200,1.00361336947
484956,484964,485045,8,81,2,900,1.0987654321
485371,485378,489234,7,3856,2,18000,1.0018153527
485516,485522,504106,6,18584,1,342000,1.00032285837
485698,485710,487232,12,1522,1,18000,1.00788436268
485698,485705,487229,7,1524,1,18000,1.00459317585
485699,485717,487224,18,1507,1,18000,1.01194426012
485699,485722,487251,23,1529,1,18000,1.01504251145
485701,485733,487246,32,1513,1,18000,1.02115003305
485701,485727,487267,26,1540,1,18000,1.01688311688
485703,485745,487363,42,1618,1,18000,1.02595797281
485705,487116,488709,1411,1593,1,18000,1.88575015694
485706,487121,488665,1415,1544,1,18000,1.9164507772
485707,487237,488765,1530,1528,1,18000,2.00130890052
485708,487243,488883,1535,1640,1,18000,1.93597560976
485709,487248,488766,1539,1518,1,18000,2.01383399209
485710,487274,488794,1564,1520,1,18000,2.02894736842
485710,487263,488922,1553,1659,1,18000,1.936106088
485710,487269,488847,1559,1578,1,18000,1.98795944233
485711,487286,488822,1575,1536,1,18000,2.025390625
485712,487292,488747,1580,1455,1,18000,2.08591065292
485713,487338,488962,1625,1624,1,18000,2.00061576355
485715,487344,488723,1629,1379,1,18000,2.18129079043
485716,487349,488980,1633,1631,1,18000,2.00122624157
486116,487012,491164,896,4152,2,18000,1.21579961464
487115,487132,490513,17,3381,2,7200,1.0050280982
487117,487137,490604,20,3467,2,7200,1.00576867609
487118,487143,490522,25,3379,2,7200,1.00739863865
487119,487148,490437,29,3289,2,7200,1.00881726969
487137,487155,490576,18,3421,2,7200,1.00526161941
487156,487588,491007,432,3419,4,7200,1.12635273472
487220,487227,490637,7,3410,2,7200,1.00205278592
487246,487256,490543,10,3287,2,7200,1.0030422878
487325,487332,490683,7,3351,2,7200,1.00208892868
487339,487356,490589,17,3233,2,7200,1.00525827405
487341,487361,491053,20,3692,2,7200,1.00541711809
487364,487372,490673,8,3301,2,7200,1.00242350803
487366,487379,490792,13,3413,2,7200,1.00380896572
487381,487387,491116,6,3729,2,7200,1.00160901046
487413,487420,490653,7,3233,2,7200,1.00216517167
487415,487428,490839,13,3411,2,7200,1.00381119906
487445,487452,490985,7,3533,2,7200,1.00198131899
487446,487459,490900,13,3441,2,7200,1.00377797152
487461,487467,491012,6,3545,2,7200,1.00169252468
487490,487498,490799,8,3301,2,7200,1.00242350803
487520,487526,490974,6,3448,2,7200,1.00174013921
487574,487581,490800,7,3219,2,7200,1.00217458838
487575,487593,490923,18,3330,2,7200,1.00540540541
487590,487600,490985,10,3385,2,7200,1.00295420975
487647,487653,491027,6,3374,2,7200,1.00177830468
487667,487674,490970,7,3296,2,7200,1.00212378641
487682,487689,491253,7,3564,2,7200,1.0019640853
487706,487761,487786,55,25,1,3600,3.2
487748,487754,491033,6,3279,2,7200,1.00182982617
487763,487769,491149,6,3380,2,7200,1.00177514793
487780,487788,490989,8,3201,2,7200,1.00249921899
487795,487802,490959,7,3157,2,7200,1.0022172949
487810,487816,491268,6,3452,2,7200,1.00173812283
487852,487859,491285,7,3426,2,7200,1.00204319907
487870,487876,491278,6,3402,2,7200,1.00176366843
487893,487901,491354,8,3453,2,7200,1.00231682595
487895,487908,505930,13,18022,2,18000,1.00072134058
487938,487944,491626,6,3682,2,7200,1.00162954916
487953,487959,491609,6,3650,2,7200,1.00164383562
487955,487966,491290,11,3324,2,7200,1.00330926594
487964,490914,491086,2950,172,2,900,18.1511627907
487992,488779,494211,787,5432,2,18000,1.14488217968
487996,488003,491535,7,3532,2,7200,1.00198187995
488050,488057,491562,7,3505,2,7200,1.00199714693
488103,488835,492785,732,3950,2,18000,1.1853164557
488254,488722,489637,468,915,2,1740,1.51147540984
488257,491017,491197,2760,180,2,900,16.3333333333
488318,488325,491855,7,3530,2,7200,1.00198300283
488389,488760,490322,371,1562,2,1740,1.23751600512
488419,488895,494582,476,5687,2,18000,1.0836996659
488527,488974,493649,447,4675,2,18000,1.09561497326
488648,489246,498294,598,9048,2,18000,1.06609195402
489110,490269,508280,1159,18011,2,18000,1.06434956416
489343,490363,490371,1020,8,2,18000,102.8
489422,493661,532540,4239,38879,8,86400,1.10903058206
489459,490528,508536,1069,18008,2,18000,1.05936250555
489562,490620,508638,1058,18018,2,18000,1.05871905872
489567,518365,556663,28798,38298,8,86400,1.75194527129
489637,489644,489649,7,5,1,900,1.2
489645,489651,490351,6,700,2,1740,1.00857142857
489686,526274,564474,36588,38200,8,86400,1.95780104712
489704,532552,571208,42848,38656,8,86400,2.10844370861
490320,490327,490331,7,4,1,900,1.1
490329,490335,491866,6,1531,2,1740,1.00391900718
490360,490383,490666,23,283,2,1740,1.08127208481
490439,490446,493952,7,3506,2,7200,1.0019965773
490514,490522,494197,8,3675,2,7200,1.00217687075
490529,490536,494142,7,3606,2,7200,1.0019412091
490544,490550,493466,6,2916,2,7200,1.00205761317
490577,490583,494133,6,3550,2,7200,1.00169014085
490591,490597,494035,6,3438,2,7200,1.0017452007
490606,490612,494073,6,3461,2,7200,1.001733603
490639,490646,494132,7,3486,2,7200,1.00200803213
490656,490663,493902,7,3239,2,7200,1.00216116085
490665,490678,490681,13,3,1,900,1.6
490674,490685,494018,11,3333,2,7200,1.00330033003
490684,490813,491786,129,973,2,1740,1.13257965057
490689,490695,494107,6,3412,2,7200,1.00175849941
490694,490854,495162,160,4308,2,18000,1.03714020427
490794,490800,494193,6,3393,2,7200,1.0017683466
490809,490819,494405,10,3586,2,7200,1.00278862242
490810,490825,494113,15,3288,2,7200,1.0045620438
490840,490847,494445,7,3598,2,7200,1.00194552529
490900,490906,494304,6,3398,2,7200,1.00176574456
490923,490929,494281,6,3352,2,7200,1.00178997613
490959,490966,494519,7,3553,2,7200,1.00197016606
490974,490981,494208,7,3227,2,7200,1.0021691974
490975,490988,494446,13,3458,2,7200,1.0037593985
490990,490997,494609,7,3612,2,7200,1.0019379845
490992,491004,494414,12,3410,2,7200,1.00351906158
490993,491009,494357,16,3348,2,7200,1.00477897252
491014,491024,494544,10,3520,2,7200,1.00284090909
491029,491035,494547,6,3512,2,7200,1.00170842825
491043,491050,494472,7,3422,2,7200,1.00204558738
491058,491065,494479,7,3414,2,7200,1.00205038079
491118,491124,494617,6,3493,2,7200,1.00171772116
491150,491158,494486,8,3328,2,7200,1.00240384615
491252,491259,494848,7,3589,2,7200,1.00195040401
491267,491274,494504,7,3230,2,7200,1.00216718266
491282,491289,494774,7,3485,2,7200,1.00200860832
491297,491304,494985,7,3681,2,7200,1.00190165716
491298,491309,494674,11,3365,2,7200,1.00326894502
491355,491362,494903,7,3541,2,7200,1.0019768427
491402,491462,491765,60,303,2,18000,1.19801980198
491536,491543,495254,7,3711,2,7200,1.00188628402
491563,491570,494962,7,3392,2,7200,1.00206367925
491611,491617,495029,6,3412,2,7200,1.00175849941
491625,491632,494717,7,3085,2,7200,1.00226904376
491797,491803,491980,6,177,2,1740,1.03389830508
491854,491860,495138,6,3278,2,7200,1.00183038438
491874,491881,493548,7,1667,2,1740,1.00419916017
491979,491986,492000,7,14,1,900,1.5
491994,492001,492868,7,867,2,1740,1.00807381776
492875,492881,493332,6,451,2,1740,1.0133037694
492981,492988,495002,7,2014,2,18000,1.00347567031
493330,493337,493342,7,5,1,900,1.2
493337,493345,493629,8,284,2,1740,1.02816901408
493470,493477,496877,7,3400,2,7200,1.00205882353
493559,493565,495181,6,1616,2,1740,1.00371287129
493627,493634,493635,7,1,1,900,1.0
493903,493909,497291,6,3382,2,7200,1.00177409817
493954,493961,497388,7,3427,2,7200,1.00204260286
494019,494026,497437,7,3411,2,7200,1.00205218411
494034,494040,497330,6,3290,2,7200,1.00182370821
494073,494079,497448,6,3369,2,7200,1.0017809439
494109,494115,497628,6,3513,2,7200,1.00170794193
494123,494130,497540,7,3410,2,7200,1.00205278592
494138,494145,497268,7,3123,2,7200,1.00224143452
494139,494151,497344,12,3193,2,7200,1.00375822111
494154,494161,497340,7,3179,2,7200,1.0022019503
494193,494199,497479,6,3280,2,7200,1.00182926829
494208,494215,497566,7,3351,2,7200,1.00208892868
494222,494229,497564,7,3335,2,7200,1.00209895052
494279,494285,497810,6,3525,2,7200,1.00170212766
494303,494310,497664,7,3354,2,7200,1.00208706023
494357,494364,497599,7,3235,2,7200,1.00216383308
494405,494412,497677,7,3265,2,7200,1.002143951
494420,494427,497755,7,3328,2,7200,1.00210336538
494444,494450,497941,6,3491,2,7200,1.00171870524
494445,494457,498044,12,3587,2,7200,1.00334541399
494472,494478,498110,6,3632,2,7200,1.00165198238
494486,494493,497996,7,3503,2,7200,1.00199828718
494488,494500,497924,12,3424,2,7200,1.0035046729
494505,494513,498088,8,3575,2,7200,1.00223776224
494520,494527,497932,7,3405,2,7200,1.00205580029
494544,494551,498008,7,3457,2,7200,1.00202487706
494559,494565,498086,6,3521,2,7200,1.00170406135
494609,494616,497894,7,3278,2,7200,1.00213544844
494624,494631,498090,7,3459,2,7200,1.00202370627
494666,494672,497010,6,2338,2,18000,1.00256629598
494675,494682,498182,7,3500,2,7200,1.002
494717,494723,498043,6,3320,2,7200,1.00180722892
494725,494731,512781,6,18050,2,18000,1.00033240997
494773,494780,498041,7,3261,2,7200,1.0021465808
494817,494823,494863,6,40,2,18000,1.15
494848,494855,498558,7,3703,2,7200,1.00189035917
494905,494912,498249,7,3337,2,7200,1.00209769254
494962,494968,498291,6,3323,2,7200,1.00180559735
494986,494992,498271,6,3279,2,7200,1.00182982617
495028,495034,498279,6,3245,2,7200,1.00184899846
495056,495062,495089,6,27,1,3600,1.22222222222
495139,495146,498406,7,3260,2,7200,1.00214723926
495179,495187,495191,8,4,1,900,1.2
495190,495196,496748,6,1552,2,1740,1.00386597938
495253,495260,498678,7,3418,2,7200,1.00204798128
495272,496761,501372,1489,4611,2,18000,1.32292344394
496260,498306,498309,2046,3,4,172800,204.9
496277,497022,515047,745,18025,2,18000,1.04133148405
496759,496893,498492,134,1599,2,1740,1.08380237649
496879,496885,500224,6,3339,2,7200,1.00179694519
496894,497492,497938,598,446,2,18000,2.34080717489
497013,497038,809689,25,312651,16,324000,1.00007996136
497266,497273,500478,7,3205,2,7200,1.00218408736
497293,497299,500610,6,3311,2,7200,1.00181214135
497332,497339,500775,7,3436,2,7200,1.00203725262
497347,497353,500800,6,3447,2,7200,1.00174064404
497348,497361,500725,13,3364,2,7200,1.00386444709
497390,497396,500653,6,3257,2,7200,1.00184218606
497438,497445,501073,7,3628,2,7200,1.00192943771
497452,497460,500670,8,3210,2,7200,1.00249221184
497479,497486,500936,7,3450,2,7200,1.00202898551
497539,497545,500755,6,3210,2,7200,1.00186915888
497563,497569,500845,6,3276,2,7200,1.00183150183
497564,497576,501243,12,3667,2,7200,1.00327242978
497600,497607,500910,7,3303,2,7200,1.0021192855
497627,497633,500865,6,3232,2,7200,1.00185643564
497666,497672,500949,6,3277,2,7200,1.00183094294
497668,497770,504242,102,6472,2,18000,1.01576019778
497681,497688,501152,7,3464,2,7200,1.00202078522
497756,497763,500939,7,3176,2,7200,1.00220403023
497813,497819,501172,6,3353,2,7200,1.00178944229
497858,497908,515946,50,18038,2,18000,1.00277192593
497894,497901,501485,7,3584,2,7200,1.001953125
497923,497930,501367,7,3437,2,7200,1.00203665988
497938,497946,501367,8,3421,2,7200,1.00233849752
497953,497960,501242,7,3282,2,7200,1.00213284583
497997,498005,501332,8,3327,2,7200,1.00240456868
498012,498019,501500,7,3481,2,7200,1.0020109164
498013,498321,498322,308,1,4,172800,30.9
498036,498108,504359,72,6251,2,18000,1.01151815709
498042,498048,501387,6,3339,2,7200,1.00179694519
498044,498055,501385,11,3330,2,7200,1.0033033033
498045,498062,501458,17,3396,2,7200,1.00500588928
498087,498094,501358,7,3264,2,7200,1.00214460784
498088,498101,501617,13,3516,2,7200,1.00369738339
498103,498114,501737,11,3623,2,7200,1.00303615788
498118,498124,501513,6,3389,2,7200,1.00177043376
498184,498191,501533,7,3342,2,7200,1.00209455416
498249,498256,501472,7,3216,2,7200,1.00217661692
498273,498279,501568,6,3289,2,7200,1.00182426269
498288,498294,501654,6,3360,2,7200,1.00178571429
498302,498313,501646,11,3333,2,7200,1.00330033003
498407,498414,501623,7,3209,2,7200,1.00218136491
498499,498506,500249,7,1743,2,1740,1.00401606426
498516,498523,498529,7,6,4,172800,1.3
498558,498564,502020,6,3456,2,7200,1.00173611111
498678,498684,502188,6,3504,2,7200,1.00171232877
499211,499217,522553,6,23336,1,36000,1.00025711347
500224,500230,503488,6,3258,2,7200,1.00184162063
500257,500264,501498,7,1234,2,1740,1.0056726094
500460,501636,501638,1176,2,4,172800,117.8
500480,500487,503796,7,3309,2,7200,1.00211544273
500606,500613,504368,7,3755,2,7200,1.00186418109
500651,500658,504473,7,3815,2,7200,1.00183486239
500671,500677,504039,6,3362,2,7200,1.00178465199
500725,500732,504096,7,3364,2,7200,1.00208085612
500755,500761,504418,6,3657,2,7200,1.00164068909
500776,500782,504210,6,3428,2,7200,1.00175029172
500803,500810,504295,7,3485,2,7200,1.00200860832
500844,500851,504106,7,3255,2,7200,1.00215053763
500865,500872,504379,7,3507,2,7200,1.00199600798
500910,500917,504636,7,3719,2,7200,1.0018822264
500937,500944,504344,7,3400,2,7200,1.00205882353
500951,500959,504269,8,3310,2,7200,1.00241691843
500953,500966,504190,13,3224,2,7200,1.00403225806
501073,501080,504551,7,3471,2,7200,1.00201670988
501125,501255,527279,130,26024,1,36000,1.00499538887
501154,501161,504700,7,3539,2,7200,1.00197795988
501172,501179,504679,7,3500,2,7200,1.002
501240,501246,504671,6,3425,2,7200,1.00175182482
501255,501262,504462,7,3200,2,7200,1.0021875
501333,501340,504995,7,3655,2,7200,1.00191518468
501360,501366,504564,6,3198,2,7200,1.00187617261
501375,501382,504448,7,3066,2,7200,1.00228310502
501376,501389,504828,13,3439,2,7200,1.00378016865
501391,501399,505079,8,3680,2,7200,1.00217391304
501392,501404,504642,12,3238,2,7200,1.00370599135
501458,501466,505010,8,3544,2,7200,1.00225733634
501473,501480,504798,7,3318,2,7200,1.00210970464
501488,501495,504677,7,3182,2,7200,1.00219987429
501502,501509,504972,7,3463,2,7200,1.00202136876
501517,501523,504628,6,3105,2,7200,1.00193236715
501534,501541,504973,7,3432,2,7200,1.00203962704
501570,501577,504625,7,3048,2,7200,1.00229658793
501618,501624,504962,6,3338,2,7200,1.00179748352
501633,501642,505075,9,3433,2,7200,1.00262161375
501647,501653,505151,6,3498,2,7200,1.00171526587
501662,501669,505220,7,3551,2,7200,1.0019712757
501740,501746,505532,6,3786,2,7200,1.00158478605
501853,502037,502696,184,659,1,36000,1.27921092564
502022,502029,505492,7,3463,2,7200,1.00202136876
502191,502198,505477,7,3279,2,7200,1.00213479719
503377,503383,683405,6,180022,1,180000,1.00003332926
503489,503496,506732,7,3236,2,7200,1.0021631644
503795,503802,507417,7,3615,2,7200,1.00193637621
504040,504046,507566,6,3520,2,7200,1.00170454545
504097,504104,507150,7,3046,2,7200,1.00229809586
504112,504120,507807,8,3687,2,7200,1.00216978573
504145,504151,596785,6,92634,1,342000,1.00006477103
504189,504197,507342,8,3145,2,7200,1.00254372019
504210,504216,507736,6,3520,2,7200,1.00170454545
504270,504277,507295,7,3018,2,7200,1.00231941683
504297,504304,507506,7,3202,2,7200,1.00218613367
504342,504349,507619,7,3270,2,7200,1.00214067278
504369,504376,507881,7,3505,2,7200,1.00199714693
504383,504389,507560,6,3171,2,7200,1.00189214759
504419,504425,507617,6,3192,2,7200,1.00187969925
504449,504456,507681,7,3225,2,7200,1.00217054264
504464,504470,507891,6,3421,2,7200,1.00175387314
504478,504485,507957,7,3472,2,7200,1.00201612903
504553,504560,508102,7,3542,2,7200,1.00197628458
504568,504574,508376,6,3802,2,7200,1.00157811678
504628,504635,507760,7,3125,2,7200,1.00224
504629,504642,508234,13,3592,2,7200,1.00361915367
504644,504650,507940,6,3290,2,7200,1.00182370821
504646,504658,508142,12,3484,2,7200,1.00344431688
504672,504679,508364,7,3685,2,7200,1.00189959294
504674,504687,507984,13,3297,2,7200,1.00394297847
504688,504696,508005,8,3309,2,7200,1.00241764884
504703,504710,508113,7,3403,2,7200,1.00205700852
504796,504803,508175,7,3372,2,7200,1.00207591934
504829,504836,508248,7,3412,2,7200,1.00205158265
504964,504972,508330,8,3358,2,7200,1.00238237046
504979,504986,508524,7,3538,2,7200,1.00197851894
504981,504992,508301,11,3309,2,7200,1.00332426715
504995,505002,508325,7,3323,2,7200,1.00210653024
505013,505019,508293,6,3274,2,7200,1.00183262065
505029,505092,505094,63,2,2,3540,6.5
505076,505083,508178,7,3095,2,7200,1.00226171244
505090,505099,508361,9,3262,2,7200,1.00275904353
505150,505157,508590,7,3433,2,7200,1.00203903292
505219,505226,508434,7,3208,2,7200,1.00218204489
505248,505254,533848,6,28594,1,36000,1.00020983423
505478,505485,508686,7,3201,2,7200,1.00218681662
505493,505499,508792,6,3293,2,7200,1.00182204677
505532,505539,508778,7,3239,2,7200,1.00216116085
506734,506740,510052,6,3312,2,7200,1.0018115942
506821,506828,506989,7,161,1,36000,1.04347826087
507150,507157,510377,7,3220,2,7200,1.00217391304
507163,507170,507289,7,119,1,36000,1.05882352941
507294,507301,510576,7,3275,2,7200,1.00213740458
507342,507349,510875,7,3526,2,7200,1.00198525241
507385,507393,507880,8,487,1,36000,1.01642710472
507417,507424,510954,7,3530,2,7200,1.00198300283
507507,507513,511001,6,3488,2,7200,1.00172018349
507561,507567,510665,6,3098,2,7200,1.00193673338
507575,507582,510668,7,3086,2,7200,1.00226830849
507616,507623,511015,7,3392,2,7200,1.00206367925
507617,507630,511020,13,3390,2,7200,1.00383480826
507680,507686,511120,6,3434,2,7200,1.00174723355
507737,507743,511153,6,3410,2,7200,1.00175953079
507761,507767,511274,6,3507,2,7200,1.00171086399
507809,507815,511219,6,3404,2,7200,1.0017626322
507881,507888,511510,7,3622,2,7200,1.0019326339
507896,507903,511199,7,3296,2,7200,1.00212378641
507937,507944,511409,7,3465,2,7200,1.00202020202
507958,507964,511262,6,3298,2,7200,1.00181928441
507985,507991,511579,6,3588,2,7200,1.0016722408
508006,508012,511330,6,3318,2,7200,1.00180831826
508102,508109,511393,7,3284,2,7200,1.00213154689
508117,508124,511472,7,3348,2,7200,1.00209080048
508143,508150,511543,7,3393,2,7200,1.00206307103
508166,508250,510757,84,2507,1,36000,1.03350618269
508176,508183,511767,7,3584,2,7200,1.001953125
508191,508198,511751,7,3553,2,7200,1.00197016606
508235,508243,511615,8,3372,2,7200,1.00237247924
508250,508256,511771,6,3515,2,7200,1.00170697013
508292,508298,511550,6,3252,2,7200,1.00184501845
508307,508313,511954,6,3641,2,7200,1.00164789893
508324,508330,511654,6,3324,2,7200,1.00180505415
508339,508346,511429,7,3083,2,7200,1.00227051573
508360,508366,511798,6,3432,2,7200,1.00174825175
508361,508374,511687,13,3313,2,7200,1.00392393601
508376,508383,511316,7,2933,2,7200,1.00238663484
508436,508442,511787,6,3345,2,7200,1.00179372197
508523,508530,511899,7,3369,2,7200,1.00207776788
508592,508598,512057,6,3459,2,7200,1.00173460538
508688,508694,511949,6,3255,2,7200,1.00184331797
508778,508784,512437,6,3653,2,7200,1.00164248563
508792,508799,512170,7,3371,2,7200,1.00207653515
510051,510058,513742,7,3684,2,7200,1.00190010858
510379,510386,513743,7,3357,2,7200,1.00208519511
510577,510584,513830,7,3246,2,7200,1.00215650031
510667,510675,514130,8,3455,2,7200,1.0023154848
510669,510680,514154,11,3474,2,7200,1.00316637881
510826,510834,546869,8,36035,1,36000,1.00022200638
510876,510883,514317,7,3434,2,7200,1.00203843914
510954,510961,514414,7,3453,2,7200,1.0020272227
511002,511008,514169,6,3161,2,7200,1.0018981335
511017,511023,514396,6,3373,2,7200,1.0017788319
511031,511037,514317,6,3280,2,7200,1.00182926829
511052,511967,527766,915,15799,4,259200,1.05791505792
511118,511125,514413,7,3288,2,7200,1.00212895377
511143,512554,523915,1411,11361,4,259200,1.12419681366
511151,511157,514362,6,3205,2,7200,1.00187207488
511199,511205,514470,6,3265,2,7200,1.00183767228
511220,511227,514740,7,3513,2,7200,1.00199259892
511265,511272,514738,7,3466,2,7200,1.00201961916
511279,511286,514677,7,3391,2,7200,1.00206428782
511318,511324,514534,6,3210,2,7200,1.00186915888
511333,511339,514805,6,3466,2,7200,1.00173110214
511396,511402,514725,6,3323,2,7200,1.00180559735
511410,511418,514823,8,3405,2,7200,1.00234948605
511431,511437,514968,6,3531,2,7200,1.00169923534
511473,511480,514832,7,3352,2,7200,1.00208830549
511512,511519,514812,7,3293,2,7200,1.00212572123
511541,511548,514891,7,3343,2,7200,1.00209392761
511556,511563,514824,7,3261,2,7200,1.0021465808
511580,511587,515332,7,3745,2,7200,1.00186915888
511584,512793,512797,1209,4,4,86400,121.3
511613,511620,514957,7,3337,2,7200,1.00209769254
511655,511662,514977,7,3315,2,7200,1.00211161388
511661,512810,512811,1149,1,4,86400,115.0
511685,511691,515226,6,3535,2,7200,1.00169731259
511754,511760,515003,6,3243,2,7200,1.00185013876
511769,511777,515140,8,3363,2,7200,1.00237882843
511784,511790,514820,6,3030,2,7200,1.00198019802
511790,512822,514357,1032,1535,4,259200,1.67231270358
511799,511806,515417,7,3611,2,7200,1.00193852119
511800,511813,515201,13,3388,2,7200,1.00383707202
511899,511905,515273,6,3368,2,7200,1.00178147268
511916,513314,622933,1398,109619,4,259200,1.01275326358
511947,511954,515418,7,3464,2,7200,1.00202078522
511962,511973,515576,11,3603,2,7200,1.00305301138
512054,513756,513759,1702,3,4,172800,170.5
512055,512063,515579,8,3516,2,7200,1.00227531286
512173,512179,515675,6,3496,2,7200,1.00171624714
512437,512444,515655,7,3211,2,7200,1.00218000623
512652,513771,772998,1119,259227,4,259200,1.00431667998
512743,514019,773249,1276,259230,4,259200,1.0049222698
513740,513747,517071,7,3324,2,7200,1.00210589651
513755,513762,517430,7,3668,2,7200,1.00190839695
513830,513837,517003,7,3166,2,7200,1.00221099179
514086,514144,517672,58,3528,2,3600,1.0164399093
514130,514137,517539,7,3402,2,7200,1.00205761317
514154,514161,517527,7,3366,2,7200,1.00207961973
514172,514178,517324,6,3146,2,7200,1.00190718373
514316,514324,517744,8,3420,2,7200,1.00233918129
514318,514329,517775,11,3446,2,7200,1.00319210679
514360,514367,517916,7,3549,2,7200,1.00197238659
514398,514405,517932,7,3527,2,7200,1.00198468954
514413,514419,517804,6,3385,2,7200,1.00177252585
514415,514427,517606,12,3179,2,7200,1.00377477194
514472,514478,517789,6,3311,2,7200,1.00181214135
514535,514542,517772,7,3230,2,7200,1.00216718266
514679,514686,518015,7,3329,2,7200,1.00210273355
514724,514731,518093,7,3362,2,7200,1.00208209399
514739,514746,518276,7,3530,2,7200,1.00198300283
514740,514753,518054,13,3301,2,7200,1.00393820055
514803,514811,518257,8,3446,2,7200,1.00232153221
514818,514826,517968,8,3142,2,7200,1.00254614895
514820,514831,518343,11,3512,2,7200,1.00313211845
514835,514842,518113,7,3271,2,7200,1.00214001834
514836,514849,518102,13,3253,2,7200,1.0039963111
514837,514854,518008,17,3154,2,7200,1.00538998098
514891,514898,518360,7,3462,2,7200,1.00202195263
514957,514964,518383,7,3419,2,7200,1.00204738228
514972,514978,518437,6,3459,2,7200,1.00173460538
514987,514993,518408,6,3415,2,7200,1.00175695461
515004,515011,518312,7,3301,2,7200,1.00212056952
515139,515147,518695,8,3548,2,7200,1.00225479143
515202,515209,518473,7,3264,2,7200,1.00214460784
515226,515232,518793,6,3561,2,7200,1.00168491997
515271,515278,518689,7,3411,2,7200,1.00205218411
515334,515340,518349,6,3009,2,7200,1.00199401795
515418,515424,519002,6,3578,2,7200,1.00167691448
515419,515431,518763,12,3332,2,7200,1.00360144058
515576,515583,518895,7,3312,2,7200,1.00211352657
515591,515597,519067,6,3470,2,7200,1.00172910663
515654,515660,519088,6,3428,2,7200,1.00175029172
515674,515681,519032,7,3351,2,7200,1.00208892868
517002,517010,520621,8,3611,2,7200,1.00221545278
517071,517077,520568,6,3491,2,7200,1.00171870524
517324,517331,520642,7,3311,2,7200,1.0021141649
517429,517435,521033,6,3598,2,7200,1.00166759311
517525,517533,521111,8,3578,2,7200,1.00223588597
517540,517546,520971,6,3425,2,7200,1.00175182482
517606,517613,521112,7,3499,2,7200,1.00200057159
517746,517752,521403,6,3651,2,7200,1.00164338537
517772,517780,521130,8,3350,2,7200,1.0023880597
517787,517794,521426,7,3632,2,7200,1.00192731278
517788,517801,521094,13,3293,2,7200,1.00394776799
517803,517809,521163,6,3354,2,7200,1.00178890877
517917,517924,521197,7,3273,2,7200,1.00213871066
517932,517938,521231,6,3293,2,7200,1.00182204677
517968,517975,521352,7,3377,2,7200,1.00207284572
518010,518016,521268,6,3252,2,7200,1.00184501845
518024,518030,521217,6,3187,2,7200,1.00188264826
518054,518060,521580,6,3520,2,7200,1.00170454545
518093,518100,521377,7,3277,2,7200,1.00213610009
518108,518114,521451,6,3337,2,7200,1.00179802218
518122,518129,521452,7,3323,2,7200,1.00210653024
518258,518264,521597,6,3333,2,7200,1.00180018002
518275,518282,521738,7,3456,2,7200,1.00202546296
518311,518317,521737,6,3420,2,7200,1.00175438596
518344,518350,521956,6,3606,2,7200,1.00166389351
518359,518371,521789,12,3418,2,7200,1.00351082504
518360,518377,521514,17,3137,2,7200,1.00541919031
518384,518390,521736,6,3346,2,7200,1.00179318589
518406,518412,521604,6,3192,2,7200,1.00187969925
518439,518446,522006,7,3560,2,7200,1.00196629213
518475,518482,522034,7,3552,2,7200,1.00197072072
518691,518698,522210,7,3512,2,7200,1.00199316629
518706,518712,522174,6,3462,2,7200,1.00173310225
518763,518769,522512,6,3743,2,7200,1.00160299225
518793,518800,522270,7,3470,2,7200,1.00201729107
518895,518901,522311,6,3410,2,7200,1.00175953079
519003,519009,522391,6,3382,2,7200,1.00177409817
519033,519039,522747,6,3708,2,7200,1.00161812298
519066,519073,522386,7,3313,2,7200,1.00211288862
519086,519094,522545,8,3451,2,7200,1.00231816865
519592,521465,522873,1873,1408,4,172800,2.33025568182
519592,522885,524357,3293,1472,4,172800,3.2370923913
519593,523927,525987,4334,2060,4,172800,3.10388349515
519593,524372,526262,4779,1890,4,172800,3.52857142857
520568,520576,524090,8,3514,2,7200,1.00227660785
520619,520626,524177,7,3551,2,7200,1.0019712757
520640,520646,524036,6,3390,2,7200,1.0017699115
520971,520977,524389,6,3412,2,7200,1.00175849941
521034,521040,524318,6,3278,2,7200,1.00183038438
521094,521100,524339,6,3239,2,7200,1.00185242359
521109,521116,524352,7,3236,2,7200,1.0021631644
521123,521129,524357,6,3228,2,7200,1.00185873606
521138,521144,524496,6,3352,2,7200,1.00178997613
521165,521171,524853,6,3682,2,7200,1.00162954916
521198,521205,524674,7,3469,2,7200,1.00201787259
521218,521226,524690,8,3464,2,7200,1.00230946882
521233,521239,524313,6,3074,2,7200,1.00195185426
521269,521275,524687,6,3412,2,7200,1.00175849941
521353,521360,524745,7,3385,2,7200,1.00206794682
521377,521383,524770,6,3387,2,7200,1.00177147919
521404,521410,524586,6,3176,2,7200,1.00188916877
521427,521435,524913,8,3478,2,7200,1.00230017251
521451,521458,524924,7,3466,2,7200,1.00201961916
521466,521473,524599,7,3126,2,7200,1.00223928343
521514,521520,525022,6,3502,2,7200,1.00171330668
521580,521586,525003,6,3417,2,7200,1.00175592625
521594,521601,525005,7,3404,2,7200,1.00205640423
521609,521616,525129,7,3513,2,7200,1.00199259892
521735,521742,525049,7,3307,2,7200,1.0021167221
521751,521757,525055,6,3298,2,7200,1.00181928441
521752,521765,525318,13,3553,2,7200,1.00365887982
521788,521794,524966,6,3172,2,7200,1.00189155107
521956,521963,525374,7,3411,2,7200,1.00205218411
522007,522014,525116,7,3102,2,7200,1.00225660864
522034,522040,525152,6,3112,2,7200,1.00192802057
522175,522182,525684,7,3502,2,7200,1.0019988578
522211,522217,525508,6,3291,2,7200,1.00182315406
522268,522275,525436,7,3161,2,7200,1.00221448909
522313,522320,525636,7,3316,2,7200,1.00211097708
522388,522394,525889,6,3495,2,7200,1.0017167382
522390,522402,525967,12,3565,2,7200,1.00336605891
522513,522519,525962,6,3443,2,7200,1.00174266628
522546,522553,525960,7,3407,2,7200,1.00205459348
522747,522754,525949,7,3195,2,7200,1.00219092332
524035,524042,527312,7,3270,2,7200,1.00214067278
524092,524099,527509,7,3410,2,7200,1.00205278592
524179,524186,527389,7,3203,2,7200,1.00218545114
524314,524320,527807,6,3487,2,7200,1.0017206768
524329,524336,527480,7,3144,2,7200,1.0022264631
524344,524350,528029,6,3679,2,7200,1.00163087796
524358,524365,527793,7,3428,2,7200,1.002042007
524360,524377,527862,17,3485,2,7200,1.00487804878
524390,524396,527987,6,3591,2,7200,1.00167084378
524498,524504,527698,6,3194,2,7200,1.00187852223
524588,524595,527948,7,3353,2,7200,1.00208768267
524602,524608,527973,6,3365,2,7200,1.00178306092
524674,524680,528399,6,3719,2,7200,1.00161333692
524689,524695,527932,6,3237,2,7200,1.00185356812
524691,524702,528051,11,3349,2,7200,1.00328456256
524747,524754,528142,7,3388,2,7200,1.0020661157
524771,524777,527863,6,3086,2,7200,1.00194426442
524852,524859,528288,7,3429,2,7200,1.00204141149
524915,524921,528230,6,3309,2,7200,1.00181323663
524930,524938,528267,8,3329,2,7200,1.00240312406
524966,524973,528062,7,3089,2,7200,1.00226610554
525001,525009,528447,8,3438,2,7200,1.00232693426
525016,525023,528422,7,3399,2,7200,1.00205942924
525031,525038,528587,7,3549,2,7200,1.00197238659
525051,525059,528395,8,3336,2,7200,1.00239808153
525066,525072,528460,6,3388,2,7200,1.00177095632
525117,525124,528670,7,3546,2,7200,1.00197405527
525132,525139,528468,7,3329,2,7200,1.00210273355
525152,525160,528421,8,3261,2,7200,1.0024532352
525321,525328,528801,7,3473,2,7200,1.00201554852
525375,525381,528499,6,3118,2,7200,1.00192431046
525438,525444,528670,6,3226,2,7200,1.00185988841
525510,525517,528861,7,3344,2,7200,1.00209330144
525637,525644,529174,7,3530,2,7200,1.00198300283
525685,525691,529029,6,3338,2,7200,1.00179748352
525890,525897,529380,7,3483,2,7200,1.0020097617
525947,525953,529105,6,3152,2,7200,1.0019035533
525962,525968,529849,6,3881,2,7200,1.0015459933
525963,525975,529576,12,3601,2,7200,1.00333240766
525978,525984,529474,6,3490,2,7200,1.00171919771
527315,527322,530711,7,3389,2,7200,1.00206550605
527390,527397,530694,7,3297,2,7200,1.00212314225
527480,527487,530848,7,3361,2,7200,1.00208271348
527510,527516,530835,6,3319,2,7200,1.00180777343
527621,527627,527794,6,167,1,3600,1.03592814371
527699,527706,531127,7,3421,2,7200,1.00204618533
527795,527804,531317,9,3513,2,7200,1.00256191289
527810,527816,531352,6,3536,2,7200,1.00169683258
527861,527868,531176,7,3308,2,7200,1.00211608222
527875,527882,531509,7,3627,2,7200,1.00192996967
527932,527939,531295,7,3356,2,7200,1.00208581645
527950,527956,531404,6,3448,2,7200,1.00174013921
527952,527963,528319,11,356,1,3600,1.0308988764
527974,527980,531412,6,3432,2,7200,1.00174825175
527988,527994,531438,6,3444,2,7200,1.00174216028
528030,528036,531445,6,3409,2,7200,1.00176004693
528054,528061,531415,7,3354,2,7200,1.00208706023
528068,528076,531585,8,3509,2,7200,1.00227985181
528140,528146,531449,6,3303,2,7200,1.00181653043
528230,528238,531884,8,3646,2,7200,1.00219418541
528266,528277,531551,11,3274,2,7200,1.00335980452
528290,528296,531933,6,3637,2,7200,1.0016497113
528396,528403,532076,7,3673,2,7200,1.00190579907
528411,528417,531929,6,3512,2,7200,1.00170842825
528426,528433,531818,7,3385,2,7200,1.00206794682
528427,528440,531725,13,3285,2,7200,1.00395738204
528448,528454,531799,6,3345,2,7200,1.00179372197
528462,528468,532017,6,3549,2,7200,1.00169061708
528477,528484,531861,7,3377,2,7200,1.00207284572
528501,528507,532181,6,3674,2,7200,1.00163309744
528588,528595,531999,7,3404,2,7200,1.00205640423
528646,528817,529647,171,830,1,3600,1.20602409639
528672,528678,531764,6,3086,2,7200,1.00194426442
528673,528686,532237,13,3551,2,7200,1.00366094058
528802,528810,532379,8,3569,2,7200,1.00224152424
528862,528869,532345,7,3476,2,7200,1.00201380898
529031,529037,532377,6,3340,2,7200,1.00179640719
529106,529112,532520,6,3408,2,7200,1.00176056338
529175,529182,532502,7,3320,2,7200,1.00210843373
529381,529388,532715,7,3327,2,7200,1.0021039976
529474,529481,533058,7,3577,2,7200,1.00195694716
529577,529584,532914,7,3330,2,7200,1.0021021021
529853,529860,533170,7,3310,2,7200,1.00211480363
530697,530705,533925,8,3220,2,7200,1.00248447205
530712,530719,534300,7,3581,2,7200,1.00195476124
530723,530729,530851,6,122,1,3600,1.04918032787
530836,530843,534297,7,3454,2,7200,1.00202663578
530850,530861,534388,11,3527,2,7200,1.00311879785
530988,530995,531318,7,323,1,3600,1.02167182663
531020,531142,531313,122,171,1,3600,1.7134502924
531128,531135,534619,7,3484,2,7200,1.00200918485
531176,531183,534620,7,3437,2,7200,1.00203665988
531293,531299,534618,6,3319,2,7200,1.00180777343
531317,531324,534831,7,3507,2,7200,1.00199600798
531353,531360,534708,7,3348,2,7200,1.00209080048
531404,531411,534530,7,3119,2,7200,1.00224430907
531419,531425,535024,6,3599,2,7200,1.00166712976
531420,531432,534675,12,3243,2,7200,1.00370027752
531438,531445,534892,7,3447,2,7200,1.00203075138
531446,531452,531814,6,362,1,3600,1.01657458564
531453,531459,534783,6,3324,2,7200,1.00180505415
531454,531466,535063,12,3597,2,7200,1.00333611343
531511,531518,534849,7,3331,2,7200,1.00210147103
531550,531557,534924,7,3367,2,7200,1.00207900208
531586,531592,534921,6,3329,2,7200,1.00180234305
531727,531734,535077,7,3343,2,7200,1.00209392761
531757,531824,532450,67,626,1,3600,1.10702875399
531766,531773,535103,7,3330,2,7200,1.0021021021
531802,531808,535124,6,3316,2,7200,1.00180940893
531820,531831,535080,11,3249,2,7200,1.00338565713
531862,531869,535046,7,3177,2,7200,1.00220333648
531886,531892,535309,6,3417,2,7200,1.00175592625
531931,531937,535382,6,3445,2,7200,1.00174165457
531946,531952,535342,6,3390,2,7200,1.0017699115
531999,532007,535393,8,3386,2,7200,1.00236266982
532017,532023,535436,6,3413,2,7200,1.00175798418
532077,532083,535850,6,3767,2,7200,1.0015927794
532162,532170,533029,8,859,1,3600,1.00931315483
532182,532189,535375,7,3186,2,7200,1.00219711237
532239,532246,535559,7,3313,2,7200,1.00211288862
532344,532351,535623,7,3272,2,7200,1.0021393643
532377,532384,535788,7,3404,2,7200,1.00205640423
532392,532399,535657,7,3258,2,7200,1.0021485574
532504,532510,535915,6,3405,2,7200,1.00176211454
532522,532529,535917,7,3388,2,7200,1.0020661157
532714,532721,536062,7,3341,2,7200,1.00209518108
532916,532923,536514,7,3591,2,7200,1.00194931774
533061,533068,536397,7,3329,2,7200,1.00210273355
533173,533180,536798,7,3618,2,7200,1.00193477059
533927,533935,537536,8,3601,2,7200,1.00222160511
534203,534209,534325,6,116,1,3600,1.05172413793
534299,534306,537968,7,3662,2,7200,1.00191152376
534313,534320,537525,7,3205,2,7200,1.00218408736
534389,534395,537757,6,3362,2,7200,1.00178465199
534475,534482,534823,7,341,1,3600,1.02052785924
534531,534539,538049,8,3510,2,7200,1.00227920228
534619,534626,538035,7,3409,2,7200,1.00205338809
534620,534633,537998,13,3365,2,7200,1.00386329866
534621,534638,538121,17,3483,2,7200,1.00488084984
534675,534683,537932,8,3249,2,7200,1.00246229609
534708,534715,538063,7,3348,2,7200,1.00209080048
534783,534789,538263,6,3474,2,7200,1.00172711572
534789,534796,534920,7,124,1,1800,1.0564516129
534832,534838,538321,6,3483,2,7200,1.00172265289
534849,534856,538328,7,3472,2,7200,1.00201612903
534891,534897,538048,6,3151,2,7200,1.00190415741
534921,534930,538434,9,3504,2,7200,1.00256849315
534936,534942,538441,6,3499,2,7200,1.00171477565
535026,535032,538823,6,3791,2,7200,1.00158269586
535047,535053,538498,6,3445,2,7200,1.00174165457
535064,535072,538627,8,3555,2,7200,1.00225035162
535079,535086,538187,7,3101,2,7200,1.00225733634
535081,535093,538331,12,3238,2,7200,1.00370599135
535104,535111,538379,7,3268,2,7200,1.00214198286
535125,535131,538514,6,3383,2,7200,1.00177357375
535155,535163,535280,8,117,1,1800,1.06837606838
535266,535273,535898,7,625,1,3600,1.0112
535309,535315,538812,6,3497,2,7200,1.00171575636
535342,535349,538838,7,3489,2,7200,1.00200630553
535375,535382,538763,7,3381,2,7200,1.00207039337
535389,535397,538935,8,3538,2,7200,1.0022611645
535404,535410,538929,6,3519,2,7200,1.00170502984
535437,535444,538954,7,3510,2,7200,1.00199430199
535560,535567,538969,7,3402,2,7200,1.00205761317
535623,535630,538985,7,3355,2,7200,1.00208643815
535659,535666,538841,7,3175,2,7200,1.00220472441
535788,535795,539202,7,3407,2,7200,1.00205459348
535851,535857,539134,6,3277,2,7200,1.00183094294
535915,535922,539227,7,3305,2,7200,1.00211800303
535919,535930,536532,11,602,1,1800,1.01827242525
535930,535937,539336,7,3399,2,7200,1.00205942924
536062,536069,539467,7,3398,2,7200,1.00206003531
536397,536404,539915,7,3511,2,7200,1.00199373398
536514,536521,539993,7,3472,2,7200,1.00201612903
536799,536806,540066,7,3260,2,7200,1.00214723926
537528,537535,540860,7,3325,2,7200,1.00210526316
537543,537549,541020,6,3471,2,7200,1.00172860847
537757,537764,541115,7,3351,2,7200,1.00208892868
537939,537945,541636,6,3691,2,7200,1.00162557572
537968,537974,541138,6,3164,2,7200,1.00189633375
537998,538004,541286,6,3282,2,7200,1.00182815356
538031,538038,541417,7,3379,2,7200,1.00207161882
538049,538056,541252,7,3196,2,7200,1.0021902378
538051,538063,541424,12,3361,2,7200,1.00357036596
538065,538072,541560,7,3488,2,7200,1.00200688073
538123,538129,541580,6,3451,2,7200,1.00173862649
538178,538184,538235,6,51,1,1800,1.11764705882
538188,538195,541565,7,3370,2,7200,1.00207715134
538264,538270,541764,6,3494,2,7200,1.00171722954
538321,538327,541928,6,3601,2,7200,1.00166620383
538336,538342,541973,6,3631,2,7200,1.00165243735
538337,538350,541959,13,3609,2,7200,1.00360210585
538379,538385,541844,6,3459,2,7200,1.00173460538
538398,538405,538528,7,123,1,1800,1.05691056911
538436,538442,541802,6,3360,2,7200,1.00178571429
538451,538458,542078,7,3620,2,7200,1.00193370166
538498,538506,541684,8,3178,2,7200,1.00251730648
538516,538523,541886,7,3363,2,7200,1.00208147487
538525,538532,538609,7,77,1,1800,1.09090909091
538626,538633,541869,7,3236,2,7200,1.0021631644
538764,538770,542095,6,3325,2,7200,1.00180451128
538803,538811,538930,8,119,1,1800,1.06722689076
538815,538822,542029,7,3207,2,7200,1.00218272529
538830,538836,542392,6,3556,2,7200,1.00168728909
538845,538852,542145,7,3293,2,7200,1.00212572123
538846,538859,542267,13,3408,2,7200,1.00381455399
538932,538941,542199,9,3258,2,7200,1.00276243094
538947,538954,542292,7,3338,2,7200,1.00209706411
538962,538969,542666,7,3697,2,7200,1.0018934271
538976,538982,542486,6,3504,2,7200,1.00171232877
538991,538997,542566,6,3569,2,7200,1.00168114318
539135,539143,542501,8,3358,2,7200,1.00238237046
539204,539211,542885,7,3674,2,7200,1.00190528035
539228,539235,542574,7,3339,2,7200,1.00209643606
539337,539343,542912,6,3569,2,7200,1.00168114318
539390,539397,712232,7,172835,1,172800,1.00004050106
539469,539475,542808,6,3333,2,7200,1.00180018002
539480,539487,540055,7,568,1,1800,1.01232394366
539486,540007,540302,521,295,1,1800,2.76610169492
539915,539921,543474,6,3553,2,7200,1.00168871376
539993,540000,543337,7,3337,2,7200,1.00209769254
540069,540075,543507,6,3432,2,7200,1.00174825175
540859,540865,544417,6,3552,2,7200,1.00168918919
541022,541029,544711,7,3682,2,7200,1.00190114068
541115,541121,544324,6,3203,2,7200,1.00187324383
541139,541146,544660,7,3514,2,7200,1.00199203187
541253,541260,544363,7,3103,2,7200,1.00225588141
541286,541293,544770,7,3477,2,7200,1.0020132298
541418,541425,544478,7,3053,2,7200,1.00229282673
541433,541439,544898,6,3459,2,7200,1.00173460538
541559,541566,544908,7,3342,2,7200,1.00209455416
541574,541581,544891,7,3310,2,7200,1.00211480363
541589,541595,544904,6,3309,2,7200,1.00181323663
541637,541644,545178,7,3534,2,7200,1.00198075835
541684,541692,544890,8,3198,2,7200,1.00250156348
541766,541772,545222,6,3450,2,7200,1.00173913043
541801,541807,545199,6,3392,2,7200,1.00176886792
541837,541844,545084,7,3240,2,7200,1.00216049383
541870,541877,545134,7,3257,2,7200,1.00214921707
541888,541895,545094,7,3199,2,7200,1.00218818381
541907,541914,541969,7,55,1,1800,1.12727272727
541930,541937,545391,7,3454,2,7200,1.00202663578
541959,541967,545326,8,3359,2,7200,1.00238166121
541974,541981,545421,7,3440,2,7200,1.00203488372
542031,542038,545384,7,3346,2,7200,1.00209205021
542079,542086,545404,7,3318,2,7200,1.00210970464
542094,542101,545521,7,3420,2,7200,1.00204678363
542148,542155,545613,7,3458,2,7200,1.0020242915
542202,542208,545232,6,3024,2,7200,1.00198412698
542268,542274,545877,6,3603,2,7200,1.00166527893
542291,542299,545768,8,3469,2,7200,1.0023061401
542293,542306,542402,13,96,1,1800,1.13541666667
542393,542400,545783,7,3383,2,7200,1.00206916938
542487,542494,545919,7,3425,2,7200,1.00204379562
542502,542509,546098,7,3589,2,7200,1.00195040401
542568,542575,546143,7,3568,2,7200,1.00196188341
542583,542590,546025,7,3435,2,7200,1.00203784571
542667,542674,545950,7,3276,2,7200,1.00213675214
542808,542814,546073,6,3259,2,7200,1.00184105554
542886,542893,546188,7,3295,2,7200,1.00212443096
542913,542919,546240,6,3321,2,7200,1.00180668473
543341,543348,546825,7,3477,2,7200,1.0020132298
543410,543417,543707,7,290,1,1800,1.02413793103
543473,543480,546744,7,3264,2,7200,1.00214460784
543506,543513,547122,7,3609,2,7200,1.00193959546
544324,544331,547872,7,3541,2,7200,1.0019768427
544363,544369,547818,6,3449,2,7200,1.00173963468
544411,544419,717226,8,172807,1,172800,1.00004629442
544417,544426,547604,9,3178,2,7200,1.00283196979
544480,544486,547953,6,3467,2,7200,1.00173060283
544663,544669,548147,6,3478,2,7200,1.00172512938
544711,544717,548330,6,3613,2,7200,1.0016606698
544771,544777,548378,6,3601,2,7200,1.00166620383
544888,544894,548474,6,3580,2,7200,1.00167597765
544903,544909,548553,6,3644,2,7200,1.00164654226
544905,544916,548286,11,3370,2,7200,1.00326409496
544906,544921,548345,15,3424,2,7200,1.00438084112
544921,544927,548302,6,3375,2,7200,1.00177777778
545086,545093,548485,7,3392,2,7200,1.00206367925
545101,545108,548567,7,3459,2,7200,1.00202370627
545134,545141,548609,7,3468,2,7200,1.00201845444
545179,545185,548619,6,3434,2,7200,1.00174723355
545199,545206,548414,7,3208,2,7200,1.00218204489
545223,545230,548548,7,3318,2,7200,1.00210970464
545238,545244,548717,6,3473,2,7200,1.00172761301
545328,545335,548820,7,3485,2,7200,1.00200860832
545382,545388,548680,6,3292,2,7200,1.00182260024
545397,545403,548880,6,3477,2,7200,1.00172562554
545412,545418,548945,6,3527,2,7200,1.00170116246
545426,545434,548801,8,3367,2,7200,1.00237600238
545522,545529,548838,7,3309,2,7200,1.00211544273
545616,545623,549049,7,3426,2,7200,1.00204319907
545769,545775,549140,6,3365,2,7200,1.00178306092
545784,545791,549129,7,3338,2,7200,1.00209706411
545877,545883,549152,6,3269,2,7200,1.00183542368
545919,545925,549238,6,3313,2,7200,1.00181104739
545952,545958,549545,6,3587,2,7200,1.001672707
546027,546034,549474,7,3440,2,7200,1.00203488372
546075,546081,549601,6,3520,2,7200,1.00170454545
546099,546106,549445,7,3339,2,7200,1.00209643606
546138,546145,549477,7,3332,2,7200,1.00210084034
546188,546195,549688,7,3493,2,7200,1.00200400802
546242,546248,549989,6,3741,2,7200,1.00160384924
546745,546753,550454,8,3701,2,7200,1.00216157795
546826,546834,550132,8,3298,2,7200,1.00242571255
547121,547127,550468,6,3341,2,7200,1.0017958695
547603,547609,551040,6,3431,2,7200,1.00174876129
547820,547827,551358,7,3531,2,7200,1.00198244123
547871,547877,551182,6,3305,2,7200,1.00181543116
547952,547959,551513,7,3554,2,7200,1.00196961171
548150,548158,551333,8,3175,2,7200,1.00251968504
548286,548292,551572,6,3280,2,7200,1.00182926829
548304,548310,551575,6,3265,2,7200,1.00183767228
548330,548338,551665,8,3327,2,7200,1.00240456868
548345,548351,551836,6,3485,2,7200,1.00172166428
548378,548385,551743,7,3358,2,7200,1.00208457415
548414,548421,551724,7,3303,2,7200,1.0021192855
548474,548480,552052,6,3572,2,7200,1.00167973124
548488,548495,551980,7,3485,2,7200,1.00200860832
548506,548562,549334,56,772,4,172800,1.0725388601
548507,549346,550244,839,898,4,172800,1.93429844098
548507,549489,550404,982,915,4,172800,2.07322404372
548548,548555,552137,7,3582,2,7200,1.00195421552
548563,548571,552112,8,3541,2,7200,1.0022592488
548578,548585,551954,7,3369,2,7200,1.00207776788
548610,548618,552140,8,3522,2,7200,1.00227143668
548625,548633,552098,8,3465,2,7200,1.00230880231
548682,548688,551951,6,3263,2,7200,1.00183879865
548718,548725,552397,7,3672,2,7200,1.00190631808
548802,548808,552245,6,3437,2,7200,1.00174570847
548805,550256,552576,1451,2320,4,172800,1.62543103448
548820,548827,551953,7,3126,2,7200,1.00223928343
548827,550417,552546,1590,2129,4,172800,1.74682949742
548838,548845,552522,7,3677,2,7200,1.00190372586
548880,548887,552420,7,3533,2,7200,1.00198131899
548946,548952,552409,6,3457,2,7200,1.00173560891
549051,549058,552135,7,3077,2,7200,1.00227494313
549054,550469,551967,1415,1498,4,172800,1.94459279039
549054,551587,552658,2533,1071,4,172800,3.36507936508
549132,549138,552564,6,3426,2,7200,1.00175131349
549147,549153,552557,6,3404,2,7200,1.0017626322
549162,549168,552581,6,3413,2,7200,1.00175798418
549200,551980,553039,2780,1059,4,172800,3.62511803588
549240,549247,552656,7,3409,2,7200,1.00205338809
549411,549418,722262,7,172844,1,172800,1.00004049895
549448,549455,553059,7,3604,2,7200,1.00194228635
549475,549481,552854,6,3373,2,7200,1.0017788319
549489,549496,552968,7,3472,2,7200,1.00201612903
549546,549553,552763,7,3210,2,7200,1.00218068536
549600,549606,552918,6,3312,2,7200,1.0018115942
549687,549693,553068,6,3375,2,7200,1.00177777778
549988,549995,553325,7,3330,2,7200,1.0021021021
550132,550139,553441,7,3302,2,7200,1.00211992732
550455,550462,553534,7,3072,2,7200,1.00227864583
550470,550476,553721,6,3245,2,7200,1.00184899846
551040,551047,554444,7,3397,2,7200,1.00206064174
551182,551189,554617,7,3428,2,7200,1.002042007
551253,552558,725404,1305,172846,4,172800,1.00755007348
551332,551340,554787,8,3447,2,7200,1.00232085872
551359,551366,554701,7,3335,2,7200,1.00209895052
551513,551520,555138,7,3618,2,7200,1.00193477059
551573,551580,554801,7,3221,2,7200,1.00217323812
551588,551595,555145,7,3550,2,7200,1.00197183099
551666,551672,555299,6,3627,2,7200,1.00165425972
551726,551732,555105,6,3373,2,7200,1.0017788319
551744,551750,555185,6,3435,2,7200,1.00174672489
551837,551843,555136,6,3293,2,7200,1.00182204677
551954,551961,555513,7,3552,2,7200,1.00197072072
551956,551968,555186,12,3218,2,7200,1.00372902424
551957,551973,555363,16,3390,2,7200,1.00471976401
551981,551988,555322,7,3334,2,7200,1.00209958008
552014,554522,565939,2508,11417,12,43200,1.21967241832
552053,552060,555595,7,3535,2,7200,1.00198019802
552098,552105,555549,7,3444,2,7200,1.00203252033
552112,552119,555597,7,3478,2,7200,1.00201265095
552136,552143,555645,7,3502,2,7200,1.0019988578
552138,552150,555591,12,3441,2,7200,1.00348735833
552152,552160,555582,8,3422,2,7200,1.00233781414
552245,552252,555838,7,3586,2,7200,1.00195203569
552396,552403,555832,7,3429,2,7200,1.00204141149
552410,552418,555992,8,3574,2,7200,1.00223838836
552425,552432,556141,7,3709,2,7200,1.00188730116
552524,552531,556017,7,3486,2,7200,1.00200803213
552557,552564,555784,7,3220,2,7200,1.00217391304
552572,552579,555999,7,3420,2,7200,1.00204678363
552586,552593,555923,7,3330,2,7200,1.0021021021
552655,552662,555895,7,3233,2,7200,1.00216517167
552764,552771,555854,7,3083,2,7200,1.00227051573
552854,552861,556398,7,3537,2,7200,1.00197907831
552887,552894,553761,7,867,4,172800,1.00807381776
552921,552928,556310,7,3382,2,7200,1.00206978119
552969,552976,556604,7,3628,2,7200,1.00192943771
552997,553051,554287,54,1236,4,172800,1.04368932039
553059,553066,556513,7,3447,2,7200,1.00203075138
553074,553080,556549,6,3469,2,7200,1.00172960507
553113,553773,556121,660,2348,4,172800,1.28109028961
553202,554299,555644,1097,1345,4,172800,1.8156133829
553304,554528,556906,1224,2378,4,172800,1.51471825063
553324,553331,556965,7,3634,2,7200,1.00192625206
553413,554579,555826,1166,1247,4,172800,1.93504410585
553438,553445,556906,7,3461,2,7200,1.00202253684
553534,553541,556913,7,3372,2,7200,1.00207591934
553721,553727,557073,6,3346,2,7200,1.00179318589
554443,554450,557792,7,3342,2,7200,1.00209455416
554618,554625,558038,7,3413,2,7200,1.00205098154
554699,554706,557973,7,3267,2,7200,1.00214263851
554789,554795,558043,6,3248,2,7200,1.00184729064
554804,554811,558067,7,3256,2,7200,1.00214987715
555108,555114,558507,6,3393,2,7200,1.0017683466
555138,555144,558657,6,3513,2,7200,1.00170794193
555139,555151,558597,12,3446,2,7200,1.00348229832
555154,555161,558737,7,3576,2,7200,1.00195749441
555184,555190,558503,6,3313,2,7200,1.00181104739
555185,555198,558584,13,3386,2,7200,1.00383933845
555299,555307,558845,8,3538,2,7200,1.0022611645
555323,555330,558548,7,3218,2,7200,1.00217526414
555365,555371,558968,6,3597,2,7200,1.00166805671
555513,555520,558946,7,3426,2,7200,1.00204319907
555549,555555,558956,6,3401,2,7200,1.001764187
555582,555588,558942,6,3354,2,7200,1.00178890877
555597,555603,558967,6,3364,2,7200,1.00178359096
555598,555610,559020,12,3410,2,7200,1.00351906158
555599,555615,559014,16,3399,2,7200,1.00470726684
555647,555655,559243,8,3588,2,7200,1.0022296544
555786,555793,559345,7,3552,2,7200,1.00197072072
555834,555840,559112,6,3272,2,7200,1.00183374083
555849,555855,559331,6,3476,2,7200,1.00172612198
555863,555870,559565,7,3695,2,7200,1.00189445196
555896,555903,559241,7,3338,2,7200,1.00209706411
555923,555929,559450,6,3521,2,7200,1.00170406135
555992,555998,559394,6,3396,2,7200,1.00176678445
556007,556013,559388,6,3375,2,7200,1.00177777778
556021,556027,559393,6,3366,2,7200,1.00178253119
556030,556675,584038,645,27363,16,324000,1.02357197676
556141,556148,559582,7,3434,2,7200,1.00203843914
556310,556317,559638,7,3321,2,7200,1.00210779886
556400,556406,559966,6,3560,2,7200,1.00168539326
556514,556521,560026,7,3505,2,7200,1.00199714693
556550,556556,559904,6,3348,2,7200,1.0017921147
556604,556611,560018,7,3407,2,7200,1.00205459348
556905,556912,560466,7,3554,2,7200,1.00196961171
556920,556927,560303,7,3376,2,7200,1.00207345972
556965,556972,560344,7,3372,2,7200,1.00207591934
557073,557080,560405,7,3325,2,7200,1.00210526316
557792,557800,561279,8,3479,2,7200,1.00229951135
557973,557980,561579,7,3599,2,7200,1.00194498472
558040,558047,561501,7,3454,2,7200,1.00202663578
558054,558061,561250,7,3189,2,7200,1.00219504547
558069,558076,561548,7,3472,2,7200,1.00201612903
558506,558513,561914,7,3401,2,7200,1.00205821817
558507,558519,561869,12,3350,2,7200,1.00358208955
558549,558556,561787,7,3231,2,7200,1.00216651192
558585,558592,561908,7,3316,2,7200,1.00211097708
558600,558606,561978,6,3372,2,7200,1.00177935943
558657,558664,562113,7,3449,2,7200,1.00202957379
558735,558741,562170,6,3429,2,7200,1.00174978128
558846,558853,562446,7,3593,2,7200,1.00194823267
558942,558949,562424,7,3475,2,7200,1.00201438849
558957,558964,562478,7,3514,2,7200,1.00199203187
558958,558971,562567,13,3596,2,7200,1.00361512792
558973,558980,562767,7,3787,2,7200,1.00184842884
558974,558987,562172,13,3185,2,7200,1.00408163265
558984,559033,559732,49,699,2,1740,1.07010014306
559016,559023,562531,7,3508,2,7200,1.001995439
559031,559040,562741,9,3701,2,7200,1.0024317752
559112,559118,562752,6,3634,2,7200,1.0016510732
559242,559249,562721,7,3472,2,7200,1.00201612903
559243,559256,562601,13,3345,2,7200,1.00388639761
559333,559339,562595,6,3256,2,7200,1.00184275184
559348,559355,562853,7,3498,2,7200,1.00200114351
559390,559398,563070,8,3672,2,7200,1.00217864924
559405,559411,562783,6,3372,2,7200,1.00177935943
559406,559419,563026,13,3607,2,7200,1.00360410313
559451,559457,562827,6,3370,2,7200,1.00178041543
559565,559571,562908,6,3337,2,7200,1.00179802218
559583,559590,563188,7,3598,2,7200,1.00194552529
559637,559643,562952,6,3309,2,7200,1.00181323663
559730,559736,559740,6,4,1,900,1.0
559736,559743,560453,7,710,2,1740,1.00985915493
559905,559912,563235,7,3323,2,7200,1.00210653024
559968,559974,563412,6,3438,2,7200,1.0017452007
560019,560025,563419,6,3394,2,7200,1.00176782557
560034,560040,563551,6,3511,2,7200,1.00170891484
560305,560313,563768,8,3455,2,7200,1.0023154848
560344,560351,563606,7,3255,2,7200,1.00215053763
560407,560413,563725,6,3312,2,7200,1.0018115942
560451,560458,560462,7,4,1,900,1.1
560457,560465,561146,8,681,2,1740,1.01174743025
560467,560474,563588,7,3114,2,7200,1.00224791265
561144,561151,561159,7,8,1,900,1.5
561154,561161,561773,7,612,2,1740,1.0114379085
561252,561259,564623,7,3364,2,7200,1.00208085612
561282,561288,564766,6,3478,2,7200,1.00172512938
561502,561508,564902,6,3394,2,7200,1.00176782557
561550,561557,564909,7,3352,2,7200,1.00208830549
561579,561587,564897,8,3310,2,7200,1.00241691843
561771,561778,561782,7,4,1,900,1.1
561777,561785,562076,8,291,2,1740,1.02749140893
561788,561794,565165,6,3371,2,7200,1.00177988727
561869,561876,565156,7,3280,2,7200,1.00213414634
561908,561914,565390,6,3476,2,7200,1.00172612198
561922,561929,565263,7,3334,2,7200,1.00209958008
561976,561983,565326,7,3343,2,7200,1.00209392761
562112,562118,565208,6,3090,2,7200,1.00194174757
562172,562179,565712,7,3533,2,7200,1.00198131899
562173,562186,565653,13,3467,2,7200,1.00374963946
562370,562377,746935,7,184558,1,342000,1.00003792846
562423,562429,565597,6,3168,2,7200,1.00189393939
562444,562451,565893,7,3442,2,7200,1.00203370134
562480,562487,566083,7,3596,2,7200,1.00194660734
562531,562538,566219,7,3681,2,7200,1.00190165716
562569,562577,566060,8,3483,2,7200,1.00229687051
562596,562602,566012,6,3410,2,7200,1.00175953079
562611,562617,565992,6,3375,2,7200,1.00177777778
562722,562729,566437,7,3708,2,7200,1.00188781014
562740,562746,566322,6,3576,2,7200,1.00167785235
562755,562761,566086,6,3325,2,7200,1.00180451128
562769,562776,566208,7,3432,2,7200,1.00203962704
562784,562790,566340,6,3550,2,7200,1.00169014085
562826,562832,566411,6,3579,2,7200,1.00167644593
562853,562859,566350,6,3491,2,7200,1.00171870524
562910,562916,566423,6,3507,2,7200,1.00171086399
562952,562958,566445,6,3487,2,7200,1.0017206768
563027,563033,566544,6,3511,2,7200,1.00170891484
563072,563079,566556,7,3477,2,7200,1.0020132298
563189,563196,566584,7,3388,2,7200,1.0020661157
563231,563237,566739,6,3502,2,7200,1.00171330668
563412,563418,566644,6,3226,2,7200,1.00185988841
563427,563433,566857,6,3424,2,7200,1.00175233645
563553,563559,567035,6,3476,2,7200,1.00172612198
563589,563595,567026,6,3431,2,7200,1.00174876129
563607,563614,567076,7,3462,2,7200,1.00202195263
563724,563730,567235,6,3505,2,7200,1.00171184023
563769,563776,567121,7,3345,2,7200,1.00209267564
564624,564631,567926,7,3295,2,7200,1.00212443096
564765,564772,568394,7,3622,2,7200,1.0019326339
564785,564791,564861,6,70,2,2340,1.08571428571
564898,564904,568280,6,3376,2,7200,1.00177725118
564913,564919,568359,6,3440,2,7200,1.00174418605
564915,564927,568400,12,3473,2,7200,1.00345522603
565001,565008,576524,7,11516,1,86400,1.00060784995
565156,565163,568729,7,3566,2,7200,1.00196298374
565171,565177,568557,6,3380,2,7200,1.00177514793
565207,565214,568676,7,3462,2,7200,1.00202195263
565256,565263,565546,7,283,6,88200,1.02473498233
565264,565271,568805,7,3534,2,7200,1.00198075835
565268,565341,565348,73,7,6,88200,8.0
565279,565360,566081,81,721,6,174600,1.11234396671
565290,565557,566511,267,954,6,88200,1.27987421384
565299,565955,568667,656,2712,6,87300,1.2418879056
565306,565960,570077,654,4117,6,88200,1.15885353413
565314,566095,570018,781,3923,6,88200,1.19908233495
565321,566524,571192,1203,4668,6,88200,1.25771208226
565327,566362,572284,1035,5922,4,88200,1.17477203647
565327,565334,568711,7,3377,2,7200,1.00207284572
565334,566435,572396,1101,5961,4,88200,1.1847005536
565390,565397,568962,7,3565,2,7200,1.00196353436
565598,565605,568914,7,3309,2,7200,1.00211544273
565655,565662,569286,7,3624,2,7200,1.00193156733
565712,565719,569171,7,3452,2,7200,1.00202780997
565895,565901,569416,6,3515,2,7200,1.00170697013
565912,565919,708800,7,142881,1,259200,1.00004899182
565991,565997,569347,6,3350,2,7200,1.00179104478
566012,566018,569509,6,3491,2,7200,1.00171870524
566060,566066,569498,6,3432,2,7200,1.00174825175
566081,566088,569619,7,3531,2,7200,1.00198244123
566095,566102,569613,7,3511,2,7200,1.00199373398
566210,566217,569473,7,3256,2,7200,1.00214987715
566224,566231,569729,7,3498,2,7200,1.00200114351
566324,566331,569719,7,3388,2,7200,1.0020661157
566341,566347,569834,6,3487,2,7200,1.0017206768
566356,566372,569967,16,3595,2,7200,1.00445062587
566413,566419,569537,6,3118,2,7200,1.00192431046
566428,566440,569853,12,3413,2,7200,1.00351596836
566443,566449,569769,6,3320,2,7200,1.00180722892
566457,566463,569817,6,3354,2,7200,1.00178890877
566544,566552,570133,8,3581,2,7200,1.00223401285
566559,566566,569816,7,3250,2,7200,1.00215384615
566586,566593,570149,7,3556,2,7200,1.00196850394
566646,566652,569995,6,3343,2,7200,1.00179479509
566739,566745,570175,6,3430,2,7200,1.00174927114
566859,566866,570104,7,3238,2,7200,1.00216182829
567025,567031,570638,6,3607,2,7200,1.00166343222
567039,567046,570398,7,3352,2,7200,1.00208830549
567075,567082,570446,7,3364,2,7200,1.00208085612
567123,567129,570795,6,3666,2,7200,1.00163666121
567235,567242,570541,7,3299,2,7200,1.00212185511
567642,567648,567728,6,80,2,2340,1.075
567929,567935,571425,6,3490,2,7200,1.00171919771
568024,568031,763750,7,195719,1,259200,1.00003576556
568143,568296,569607,153,1311,2,2340,1.11670480549
568281,568288,571738,7,3450,2,7200,1.00202898551
568359,568367,571686,8,3319,2,7200,1.00241036457
568395,568401,572006,6,3605,2,7200,1.00166435506
568410,568416,572022,6,3606,2,7200,1.00166389351
568558,568565,572091,7,3526,2,7200,1.00198525241
568675,568681,571933,6,3252,2,7200,1.00184501845
568711,568718,572132,7,3414,2,7200,1.00205038079
568728,568735,572017,7,3282,2,7200,1.00213284583
568807,568814,572250,7,3436,2,7200,1.00203725262
568915,568922,572429,7,3507,2,7200,1.00199600798
568964,568970,572194,6,3224,2,7200,1.00186104218
569168,569175,572544,7,3369,2,7200,1.00207776788
569286,569293,572748,7,3455,2,7200,1.0020260492
569346,569352,572655,6,3303,2,7200,1.00181653043
569418,569425,572778,7,3353,2,7200,1.00208768267
569472,569478,572947,6,3469,2,7200,1.00172960507
569495,569502,572601,7,3099,2,7200,1.00225879316
569510,569516,572945,6,3429,2,7200,1.00174978128
569537,569544,572898,7,3354,2,7200,1.00208706023
569612,569619,573218,7,3599,2,7200,1.00194498472
569618,569626,571018,8,1392,2,2340,1.00574712644
569627,569635,573035,8,3400,2,7200,1.00235294118
569660,570030,608766,370,38736,8,86400,1.00955183808
569661,571220,609566,1559,38346,8,86400,1.04065613102
569661,570687,609535,1026,38848,8,86400,1.02641062603
569661,571827,610353,2166,38526,8,86400,1.05622177231
569717,570089,570675,372,586,6,88200,1.63481228669
569717,569724,573292,7,3568,2,7200,1.00196188341
569727,571204,571816,1477,612,6,88200,3.41339869281
569732,569739,573184,7,3445,2,7200,1.00203193033
569736,572310,573414,2574,1104,6,88200,3.33152173913
569744,573427,575086,3683,1659,6,88200,3.22001205546
569753,575098,581486,5345,6388,6,87300,1.83672510958
569771,569778,573069,7,3291,2,7200,1.00212701307
569819,569826,573076,7,3250,2,7200,1.00215384615
569820,569833,573511,13,3678,2,7200,1.00353452964
569835,569841,573362,6,3521,2,7200,1.00170406135
569856,569862,573132,6,3270,2,7200,1.00183486239
569967,569973,573567,6,3594,2,7200,1.00166944908
569994,570000,573542,6,3542,2,7200,1.00169395822
570102,570109,573636,7,3527,2,7200,1.00198468954
570132,570138,573406,6,3268,2,7200,1.00183598531
570149,570157,573574,8,3417,2,7200,1.002341235
570176,570182,573729,6,3547,2,7200,1.00169157034
570400,570407,573844,7,3437,2,7200,1.00203665988
570448,570455,573841,7,3386,2,7200,1.00206733609
570541,570548,573966,7,3418,2,7200,1.00204798128
570638,570645,574145,7,3500,2,7200,1.002
570794,570801,574119,7,3318,2,7200,1.00210970464
570839,570845,738390,6,167545,1,259200,1.00003581127
571016,571024,571029,8,5,1,900,1.3
571027,571034,573387,7,2353,2,2340,1.00297492563
571425,571432,574663,7,3231,2,7200,1.00216651192
571688,571694,575158,6,3464,2,7200,1.00173210162
571739,571745,575278,6,3533,2,7200,1.00169827342
571932,571939,575442,7,3503,2,7200,1.00199828718
572007,572014,575473,7,3459,2,7200,1.00202370627
572022,572029,575478,7,3449,2,7200,1.00202957379
572023,572036,575421,13,3385,2,7200,1.00384047267
572092,572099,575652,7,3553,2,7200,1.00197016606
572134,572140,575535,6,3395,2,7200,1.00176730486
572195,572202,575710,7,3508,2,7200,1.001995439
572250,572257,575581,7,3324,2,7200,1.00210589651
572380,572408,582118,28,9710,1,10800,1.00288362513
572429,572435,575823,6,3388,2,7200,1.00177095632
572546,572552,575614,6,3062,2,7200,1.00195950359
572603,572609,575809,6,3200,2,7200,1.001875
572654,572661,576055,7,3394,2,7200,1.00206246317
572750,572756,576267,6,3511,2,7200,1.00170891484
572777,572783,576036,6,3253,2,7200,1.00184445128
572900,572907,576148,7,3241,2,7200,1.00215982721
572945,572952,576434,7,3482,2,7200,1.00201033889
572959,572967,576347,8,3380,2,7200,1.00236686391
573034,573041,576580,7,3539,2,7200,1.00197795988
573070,573077,576663,7,3586,2,7200,1.00195203569
573085,573092,576605,7,3513,2,7200,1.00199259892
573129,573137,576521,8,3384,2,7200,1.00236406619
573183,573191,576563,8,3372,2,7200,1.00237247924
573209,573230,582121,21,8891,1,10800,1.00236193904
573213,573220,576784,7,3564,2,7200,1.0019640853
573294,573301,576803,7,3502,2,7200,1.0019988578
573363,573369,576784,6,3415,2,7200,1.00175695461
573367,573376,582123,9,8747,1,10800,1.0010289242
573408,573415,576906,7,3491,2,7200,1.00200515612
573511,573518,577268,7,3750,2,7200,1.00186666667
573543,573550,576903,7,3353,2,7200,1.00208768267
573564,573570,577039,6,3469,2,7200,1.00172960507
573580,573587,576977,7,3390,2,7200,1.00206489676
573620,573744,712925,124,139181,1,259200,1.0008909262
573634,573641,577199,7,3558,2,7200,1.00196739741
573730,573736,577131,6,3395,2,7200,1.00176730486
573753,573855,588503,102,14648,2,172800,1.00696340797
573842,573848,577220,6,3372,2,7200,1.00177935943
573857,573864,577172,7,3308,2,7200,1.00211608222
573968,573975,577276,7,3301,2,7200,1.00212056952
574118,574126,577604,8,3478,2,7200,1.00230017251
574142,574148,577680,6,3532,2,7200,1.00169875425
574664,574671,578207,7,3536,2,7200,1.00197963801
575159,575167,578366,8,3199,2,7200,1.00250078149
575279,575286,578658,7,3372,2,7200,1.00207591934
575421,575428,578629,7,3201,2,7200,1.00218681662
575442,575448,578810,6,3362,2,7200,1.00178465199
575475,575482,578894,7,3412,2,7200,1.00205158265
575490,575496,579043,6,3547,2,7200,1.00169157034
575535,575541,579216,6,3675,2,7200,1.00163265306
575583,575590,579097,7,3507,2,7200,1.00199600798
575616,575622,579086,6,3464,2,7200,1.00173210162
575652,575658,579058,6,3400,2,7200,1.00176470588
575712,575718,579001,6,3283,2,7200,1.00182759671
575808,575814,579360,6,3546,2,7200,1.00169204738
575823,575829,579349,6,3520,2,7200,1.00170454545
576037,576044,579235,7,3191,2,7200,1.0021936697
576054,576062,579399,8,3337,2,7200,1.0023973629
576151,576158,579285,7,3127,2,7200,1.00223856732
576268,576274,579863,6,3589,2,7200,1.00167177487
576346,576353,579599,7,3246,2,7200,1.00215650031
576434,576441,579968,7,3527,2,7200,1.00198468954
576524,576530,579964,6,3434,2,7200,1.00174723355
576563,576570,580074,7,3504,2,7200,1.00199771689
576583,576590,580022,7,3432,2,7200,1.00203962704
576607,576613,580084,6,3471,2,7200,1.00172860847
576661,576668,580446,7,3778,2,7200,1.00185283219
576781,576789,580148,8,3359,2,7200,1.00238166121
576783,576794,580174,11,3380,2,7200,1.00325443787
576801,576808,580303,7,3495,2,7200,1.00200286123
576904,576910,580042,6,3132,2,7200,1.00191570881
576906,576917,580139,11,3222,2,7200,1.00341402855
576975,576981,580691,6,3710,2,7200,1.00161725067
577041,577047,580527,6,3480,2,7200,1.00172413793
577131,577137,580597,6,3460,2,7200,1.00173410405
577173,577180,580489,7,3309,2,7200,1.00211544273
577197,577203,580671,6,3468,2,7200,1.00173010381
577217,577225,580856,8,3631,2,7200,1.00220324979
577268,577275,580381,7,3106,2,7200,1.00225370251
577283,577290,580560,7,3270,2,7200,1.00214067278
577606,577613,580879,7,3266,2,7200,1.00214329455
577681,577687,580938,6,3251,2,7200,1.00184558597
578208,578215,581762,7,3547,2,7200,1.00197349873
578368,578374,581833,6,3459,2,7200,1.00173460538
578629,578637,582027,8,3390,2,7200,1.00235988201
578659,578666,581988,7,3322,2,7200,1.00210716436
578810,578817,582226,7,3409,2,7200,1.00205338809
578897,578903,582524,6,3621,2,7200,1.00165700083
579002,579008,582738,6,3730,2,7200,1.00160857909
579044,579050,582645,6,3595,2,7200,1.0016689847
579059,579065,582420,6,3355,2,7200,1.00178837556
579086,579093,582630,7,3537,2,7200,1.00197907831
579101,579108,582631,7,3523,2,7200,1.00198694295
579218,579224,582707,6,3483,2,7200,1.00172265289
579236,579242,582639,6,3397,2,7200,1.00176626435
579287,579293,582855,6,3562,2,7200,1.00168444694
579350,579357,582951,7,3594,2,7200,1.0019476906
579364,579372,582982,8,3610,2,7200,1.00221606648
579400,579407,582879,7,3472,2,7200,1.00201612903
579599,579606,582838,7,3232,2,7200,1.00216584158
579861,579868,583351,7,3483,2,7200,1.0020097617
579967,579973,583590,6,3617,2,7200,1.00165883329
579982,579988,583379,6,3391,2,7200,1.00176938956
580023,580031,583399,8,3368,2,7200,1.00237529691
580041,580048,583346,7,3298,2,7200,1.00212249848
580071,580077,583477,6,3400,2,7200,1.00176470588
580086,580092,583495,6,3403,2,7200,1.00176315016
580140,580146,583404,6,3258,2,7200,1.00184162063
580155,580163,583675,8,3512,2,7200,1.00227790433
580176,580183,583562,7,3379,2,7200,1.00207161882
580305,580312,583592,7,3280,2,7200,1.00213414634
580381,580388,583800,7,3412,2,7200,1.00205158265
580447,580453,583730,6,3277,2,7200,1.00183094294
580489,580496,583989,7,3493,2,7200,1.00200400802
580524,580531,584038,7,3507,2,7200,1.00199600798
580560,580567,583971,7,3404,2,7200,1.00205640423
580596,580603,584049,7,3446,2,7200,1.00203134068
580671,580679,583958,8,3279,2,7200,1.00243976822
580692,580699,584291,7,3592,2,7200,1.00194877506
580858,580864,584259,6,3395,2,7200,1.00176730486
580879,580885,584179,6,3294,2,7200,1.00182149362
580939,580946,584230,7,3284,2,7200,1.00213154689
581081,581088,582160,7,1072,1,7200,1.00652985075
581491,581515,581945,24,430,1,172800,1.05581395349
581571,581578,581766,7,188,2,7200,1.03723404255
581936,581942,581971,6,29,8,7200,1.20689655172
581943,581958,581959,15,1,1,172800,1.6
581982,581989,581990,7,1,1,172800,1.0
581991,581998,585397,7,3399,2,7200,1.00205942924
582026,582033,582160,7,127,4,7200,1.05511811024
582030,582039,585503,9,3464,2,7200,1.00259815242
582033,582045,582046,12,1,1,172800,1.3
582086,582092,754937,6,172845,1,172800,1.00003471318
582099,582128,628260,29,46132,1,172800,1.00062863089
582173,582179,583397,6,1218,1,7200,1.00492610837
582176,582192,582421,16,229,2,7200,1.06986899563
582179,582186,586251,7,4065,4,7200,1.00172201722
582226,582232,585435,6,3203,2,7200,1.00187324383
582241,584951,584995,2710,44,16,7200,62.5909090909
582421,582427,585736,6,3309,2,7200,1.00181323663
582524,582529,586080,5,3551,2,7200,1.00140805407
582632,582638,586079,6,3441,2,7200,1.00174367916
582634,582646,585981,12,3335,2,7200,1.0035982009
582648,582656,586175,8,3519,2,7200,1.00227337312
582650,582663,585931,13,3268,2,7200,1.00397796818
582707,582714,586193,7,3479,2,7200,1.00201207243
582740,582746,586299,6,3553,2,7200,1.00168871376
582751,582758,582981,7,223,1,7200,1.03139013453
582799,582853,583323,54,470,2,7200,1.11489361702
582839,582846,586233,7,3387,2,7200,1.00206672572
582857,582864,586437,7,3573,2,7200,1.00195913798
582878,582885,586250,7,3365,2,7200,1.00208023774
582898,583139,585339,241,2200,4,7200,1.10954545455
582950,582956,586490,6,3534,2,7200,1.00169779287
582983,582990,586407,7,3417,2,7200,1.00204858063
582986,585007,585348,2021,341,16,7200,6.92668621701
583259,583266,583303,7,37,1,7200,1.18918918919
583345,583351,586875,6,3524,2,7200,1.00170261067
583360,583367,586767,7,3400,2,7200,1.00205882353
583381,583388,586929,7,3541,2,7200,1.0019768427
583399,583405,586950,6,3545,2,7200,1.00169252468
583404,583413,583449,9,36,1,7200,1.25
583407,583446,583461,39,15,2,7200,3.6
583410,583420,583434,10,14,4,7200,1.71428571429
583413,583425,586765,12,3340,2,7200,1.00359281437
583475,583482,583499,7,17,4,7200,1.41176470588
583477,583489,586850,12,3361,2,7200,1.00357036596
583495,583502,586978,7,3476,2,7200,1.00201380898
583561,583567,586763,6,3196,2,7200,1.00187734668
583591,583598,587109,7,3511,2,7200,1.00199373398
583592,583605,586950,13,3345,2,7200,1.00388639761
583664,583670,583756,6,86,1,10800,1.06976744186
583677,583684,586944,7,3260,2,7200,1.00214723926
583718,583725,583938,7,213,2,7200,1.03286384977
583731,583737,587123,6,3386,2,7200,1.00177200236
583782,583950,583963,168,13,4,7200,13.9230769231
583800,583807,583845,7,38,1,7200,1.18421052632
583803,583813,587348,10,3535,2,7200,1.00282885431
583956,583962,587326,6,3364,2,7200,1.00178359096
583971,583977,587251,6,3274,2,7200,1.00183262065
583989,583995,587610,6,3615,2,7200,1.00165975104
584040,584047,587520,7,3473,2,7200,1.00201554852
584054,584060,587597,6,3537,2,7200,1.00169635284
584181,584188,587517,7,3329,2,7200,1.00210273355
584233,584240,587577,7,3337,2,7200,1.00209769254
584261,584268,587936,7,3668,2,7200,1.00190839695
584294,584300,587772,6,3472,2,7200,1.0017281106
584301,586265,653054,1964,66789,16,324000,1.02940603992
584544,584550,585715,6,1165,1,10800,1.00515021459
585402,585409,588629,7,3220,2,7200,1.00217391304
585434,585442,588922,8,3480,2,7200,1.00229885057
585503,585510,588607,7,3097,2,7200,1.00226025186
585737,585743,589163,6,3420,2,7200,1.00175438596
585930,585936,589240,6,3304,2,7200,1.00181598063
585981,585987,589442,6,3455,2,7200,1.0017366136
586080,586087,589363,7,3276,2,7200,1.00213675214
586081,586094,589693,13,3599,2,7200,1.00361211448
586151,586158,588122,7,1964,1,10800,1.00356415479
586168,586176,589765,8,3589,2,7200,1.00222903316
586192,586198,589382,6,3184,2,7200,1.00188442211
586231,586238,589634,7,3396,2,7200,1.00206124853
586252,586258,589627,6,3369,2,7200,1.0017809439
586300,586307,589852,7,3545,2,7200,1.00197461213
586408,586415,590056,7,3641,2,7200,1.00192254875
586432,586438,589868,6,3430,2,7200,1.00174927114
586492,586498,590100,6,3602,2,7200,1.00166574125
586760,586767,590274,7,3507,2,7200,1.00199600798
586775,586783,590305,8,3522,2,7200,1.00227143668
586777,586788,590042,11,3254,2,7200,1.00338045482
586849,586856,590181,7,3325,2,7200,1.00210526316
586876,586882,590125,6,3243,2,7200,1.00185013876
586930,586937,590217,7,3280,2,7200,1.00213414634
586945,586951,590271,6,3320,2,7200,1.00180722892
586959,586966,590474,7,3508,2,7200,1.001995439
586961,586973,590309,12,3336,2,7200,1.0035971223
586979,586986,590392,7,3406,2,7200,1.00205519671
586986,586993,588127,7,1134,2,10800,1.00617283951
587108,587115,590542,7,3427,2,7200,1.00204260286
587123,587129,590616,6,3487,2,7200,1.0017206768
587252,587259,590748,7,3489,2,7200,1.00200630553
587324,587331,590927,7,3596,2,7200,1.00194660734
587348,587354,591077,6,3723,2,7200,1.00161160355
587517,587524,590883,7,3359,2,7200,1.00208395356
587532,587538,590964,6,3426,2,7200,1.00175131349
587577,587584,591066,7,3482,2,7200,1.00201033889
587598,587605,591167,7,3562,2,7200,1.0019651881
587613,587620,591111,7,3491,2,7200,1.00200515612
587772,587778,591131,6,3353,2,7200,1.00178944229
587938,587945,591373,7,3428,2,7200,1.002042007
588606,588612,592041,6,3429,2,7200,1.00174978128
588627,588634,592265,7,3631,2,7200,1.00192784357
588922,588929,592291,7,3362,2,7200,1.00208209399
589163,589169,592599,6,3430,2,7200,1.00174927114
589241,589247,592397,6,3150,2,7200,1.0019047619
589364,589372,592866,8,3494,2,7200,1.00228963938
589382,589388,592815,6,3427,2,7200,1.00175080245
589442,589449,592733,7,3284,2,7200,1.00213154689
589630,589637,593103,7,3466,2,7200,1.00201961916
589644,589650,592942,6,3292,2,7200,1.00182260024
589695,589702,593141,7,3439,2,7200,1.00203547543
589764,589771,593320,7,3549,2,7200,1.00197238659
589851,589858,593235,7,3377,2,7200,1.00207284572
589869,589876,593325,7,3449,2,7200,1.00202957379
590038,590044,593387,6,3343,2,7200,1.00179479509
590055,590062,593502,7,3440,2,7200,1.00203488372
590101,590108,593834,7,3726,2,7200,1.00187869028
590127,590135,593720,8,3585,2,7200,1.00223152022
590181,590188,593620,7,3432,2,7200,1.00203962704
590217,590225,593624,8,3399,2,7200,1.00235363342
590268,590275,593751,7,3476,2,7200,1.00201380898
590270,590283,593792,13,3509,2,7200,1.00370475919
590306,590313,593470,7,3157,2,7200,1.0022172949
590320,590327,593716,7,3389,2,7200,1.00206550605
590389,590396,593793,7,3397,2,7200,1.00206064174
590474,590480,593876,6,3396,2,7200,1.00176678445
590543,590550,594034,7,3484,2,7200,1.00200918485
590618,590624,593957,6,3333,2,7200,1.00180018002
590750,590757,594194,7,3437,2,7200,1.00203665988
590883,590889,594381,6,3492,2,7200,1.00171821306
590928,590935,594410,7,3475,2,7200,1.00201438849
590964,590970,594400,6,3430,2,7200,1.00174927114
591066,591073,594407,7,3334,2,7200,1.00209958008
591080,591088,594708,8,3620,2,7200,1.00220994475
591110,591117,594502,7,3385,2,7200,1.00206794682
591131,591137,594707,6,3570,2,7200,1.00168067227
591167,591173,594663,6,3490,2,7200,1.00171919771
591373,591381,594671,8,3290,2,7200,1.00243161094
591427,591434,591436,7,2,2,3540,1.0
592041,592047,595741,6,3694,2,7200,1.00162425555
592264,592270,595602,6,3332,2,7200,1.00180072029
592291,592297,595834,6,3537,2,7200,1.00169635284
592396,592403,595697,7,3294,2,7200,1.0021250759
592599,592606,596059,7,3453,2,7200,1.0020272227
592626,592633,595160,7,2527,2,3540,1.0027700831
592734,592741,596273,7,3532,2,7200,1.00198187995
592815,592822,596110,7,3288,2,7200,1.00212895377
592866,592872,596220,6,3348,2,7200,1.0017921147
592941,592948,596404,7,3456,2,7200,1.00202546296
593104,593111,596428,7,3317,2,7200,1.00211034067
593143,593149,596646,6,3497,2,7200,1.00171575636
593236,593243,596880,7,3637,2,7200,1.00192466318
593320,593327,596666,7,3339,2,7200,1.00209643606
593335,593341,596636,6,3295,2,7200,1.00182094082
593389,593396,596733,7,3337,2,7200,1.00209769254
593470,593477,597066,7,3589,2,7200,1.00195040401
593503,593509,596988,6,3479,2,7200,1.00172463352
593620,593626,597018,6,3392,2,7200,1.00176886792
593635,593642,597074,7,3432,2,7200,1.00203962704
593716,593723,597308,7,3585,2,7200,1.0019525802
593731,593738,597155,7,3417,2,7200,1.00204858063
593751,593758,597250,7,3492,2,7200,1.0020045819
593790,593798,597096,8,3298,2,7200,1.00242571255
593792,593805,597506,13,3701,2,7200,1.00351256417
593834,593841,597292,7,3451,2,7200,1.00202839757
593876,593882,597361,6,3479,2,7200,1.00172463352
593954,593960,597626,6,3666,2,7200,1.00163666121
594035,594041,597459,6,3418,2,7200,1.00175541252
594195,594202,597710,7,3508,2,7200,1.001995439
594382,594389,597790,7,3401,2,7200,1.00205821817
594399,594405,597960,6,3555,2,7200,1.00168776371
594414,594422,597931,8,3509,2,7200,1.00227985181
594416,594427,597800,11,3373,2,7200,1.00326119182
594503,594509,598073,6,3564,2,7200,1.00168350168
594665,594672,598141,7,3469,2,7200,1.00201787259
594680,594686,598175,6,3489,2,7200,1.00171969046
594707,594713,598104,6,3391,2,7200,1.00176938956
594708,594720,598260,12,3540,2,7200,1.00338983051
595158,595164,595170,6,6,1,900,1.2
595168,595175,596710,7,1535,2,3540,1.00456026059
595604,595611,598859,7,3248,2,7200,1.00215517241
595697,595704,599035,7,3331,2,7200,1.00210147103
595742,595750,599283,8,3533,2,7200,1.00226436456
595836,595842,599408,6,3566,2,7200,1.00168255749
596058,596065,599438,7,3373,2,7200,1.00207530388
596109,596117,599626,8,3509,2,7200,1.00227985181
596221,596228,599602,7,3374,2,7200,1.0020746888
596275,596281,599615,6,3334,2,7200,1.00179964007
596404,596411,599817,7,3406,2,7200,1.00205519671
596428,596435,599550,7,3115,2,7200,1.00224719101
596636,596643,600073,7,3430,2,7200,1.00204081633
596651,596658,599898,7,3240,2,7200,1.00216049383
596666,596673,600122,7,3449,2,7200,1.00202957379
596718,596725,598135,7,1410,2,3540,1.00496453901
596735,596742,600365,7,3623,2,7200,1.00193210047
596879,596887,600433,8,3546,2,7200,1.00225606317
596988,596994,600306,6,3312,2,7200,1.0018115942
597017,597025,600607,8,3582,2,7200,1.00223338917
597068,597076,600468,8,3392,2,7200,1.00235849057
597083,597090,600288,7,3198,2,7200,1.00218886804
597098,597104,600668,6,3564,2,7200,1.00168350168
597155,597162,600914,7,3752,2,7200,1.00186567164
597251,597258,600694,7,3436,2,7200,1.00203725262
597294,597300,600871,6,3571,2,7200,1.00168020162
597308,597315,600973,7,3658,2,7200,1.001913614
597362,597368,600737,6,3369,2,7200,1.0017809439
597462,597469,600891,7,3422,2,7200,1.00204558738
597507,597513,600669,6,3156,2,7200,1.00190114068
597627,597635,601007,8,3372,2,7200,1.00237247924
597712,597718,601190,6,3472,2,7200,1.0017281106
597793,597800,601482,7,3682,2,7200,1.00190114068
597808,597815,601430,7,3615,2,7200,1.00193637621
597931,597938,601406,7,3468,2,7200,1.00201845444
597961,597968,601349,7,3381,2,7200,1.00207039337
598075,598083,601466,8,3383,2,7200,1.002364765
598105,598113,601377,8,3264,2,7200,1.00245098039
598143,598149,598850,6,701,2,3540,1.00855920114
598144,598156,601674,12,3518,2,7200,1.00341102899
598178,598185,601637,7,3452,2,7200,1.00202780997
598262,598268,601581,6,3313,2,7200,1.00181104739
598848,598854,598860,6,6,1,900,1.2
598860,598866,602606,6,3740,2,7200,1.00160427807
598860,598871,600285,11,1414,2,3540,1.00777934936
599034,599041,602528,7,3487,2,7200,1.00200745627
599281,599288,602762,7,3474,2,7200,1.00201496834
599408,599414,602801,6,3387,2,7200,1.00177147919
599438,599445,602815,7,3370,2,7200,1.00207715134
599470,599478,601619,8,2141,1,10800,1.0037365717
599549,599556,603104,7,3548,2,7200,1.0019729425
599604,599610,602945,6,3335,2,7200,1.00179910045
599618,599625,602985,7,3360,2,7200,1.00208333333
599633,599640,603128,7,3488,2,7200,1.00200688073
599817,599823,603242,6,3419,2,7200,1.00175489909
599898,599904,603260,6,3356,2,7200,1.00178784267
600076,600083,603578,7,3495,2,7200,1.00200286123
600124,600131,603442,7,3311,2,7200,1.0021141649
600289,600296,604050,7,3754,2,7200,1.00186467768
600297,600303,601369,6,1066,2,3540,1.00562851782
600307,600313,603515,6,3202,2,7200,1.00187382886
600364,600371,603660,7,3289,2,7200,1.00212830648
600433,600440,603866,7,3426,2,7200,1.00204319907
600469,600475,603835,6,3360,2,7200,1.00178571429
600605,600611,603869,6,3258,2,7200,1.00184162063
600668,600675,604052,7,3377,2,7200,1.00207284572
600669,600682,604330,13,3648,2,7200,1.00356359649
600693,600699,603985,6,3286,2,7200,1.00182592818
600738,600745,604470,7,3725,2,7200,1.00187919463
600874,600881,604418,7,3537,2,7200,1.00197907831
600892,600898,604496,6,3598,2,7200,1.00166759311
600913,600919,604197,6,3278,2,7200,1.00183038438
600973,600980,604457,7,3477,2,7200,1.0020132298
601006,601012,604321,6,3309,2,7200,1.00181323663
601190,601197,604739,7,3542,2,7200,1.00197628458
601350,601357,604722,7,3365,2,7200,1.00208023774
601379,601391,602093,12,702,2,3540,1.01709401709
601379,601386,604731,7,3345,2,7200,1.00209267564
601406,601413,605001,7,3588,2,7200,1.0019509476
601430,601437,604908,7,3471,2,7200,1.00201670988
601466,601474,604783,8,3309,2,7200,1.00241764884
601481,601487,604911,6,3424,2,7200,1.00175233645
601580,601588,604916,8,3328,2,7200,1.00240384615
601628,601635,602403,7,768,2,10800,1.00911458333
601638,601645,605306,7,3661,2,7200,1.00191204589
601674,601680,604957,6,3277,2,7200,1.00183094294
601774,601780,612721,6,10941,1,10800,1.00054839594
602092,602099,602107,7,8,1,900,1.5
602103,602109,603169,6,1060,2,3540,1.00566037736
602406,602413,613344,7,10931,2,10800,1.00064038057
602530,602537,605786,7,3249,2,7200,1.00215450908
602609,602615,606001,6,3386,2,7200,1.00177200236
602763,602769,606518,6,3749,2,7200,1.00160042678
602802,602808,606115,6,3307,2,7200,1.00181433323
602816,602822,606357,6,3535,2,7200,1.00169731259
602946,602952,606286,6,3334,2,7200,1.00179964007
602985,602992,606367,7,3375,2,7200,1.00207407407
603103,603109,606463,6,3354,2,7200,1.00178890877
603130,603136,606716,6,3580,2,7200,1.00167597765
603176,603182,604261,6,1079,2,3540,1.00556070436
603244,603250,606568,6,3318,2,7200,1.00180831826
603261,603269,606810,8,3541,2,7200,1.0022592488
603442,603448,606690,6,3242,2,7200,1.00185070944
603517,603524,606779,7,3255,2,7200,1.00215053763
603580,603587,606786,7,3199,2,7200,1.00218818381
603661,603669,607201,8,3532,2,7200,1.00226500566
603833,603840,607268,7,3428,2,7200,1.002042007
603866,603873,607137,7,3264,2,7200,1.00214460784
603881,603887,607306,6,3419,2,7200,1.00175489909
603986,603993,607505,7,3512,2,7200,1.00199316629
604049,604055,607524,6,3469,2,7200,1.00172960507
604064,604070,607636,6,3566,2,7200,1.00168255749
604199,604206,607588,7,3382,2,7200,1.00206978119
604268,604274,604983,6,709,2,3540,1.00846262341
604323,604330,607695,7,3365,2,7200,1.00208023774
604338,604344,607790,6,3446,2,7200,1.00174114916
604419,604426,608015,7,3589,2,7200,1.00195040401
604458,604464,607593,6,3129,2,7200,1.00191754554
604472,604478,608069,6,3591,2,7200,1.00167084378
604499,604506,607747,7,3241,2,7200,1.00215982721
604722,604729,608007,7,3278,2,7200,1.00213544844
604737,604744,608126,7,3382,2,7200,1.00206978119
604752,604758,608188,6,3430,2,7200,1.00174927114
604785,604792,608377,7,3585,2,7200,1.0019525802
